Y => wai
Y chromosome => 'wai krәjmәsәjm
y'all => jɔ:l
y-axis => 'wai,æksis
y-front => wai'frʌnt
ya => 'jә
yabber => 'jæbә
yabby => 'jæbi
yacht => jɒt
yachtie => 'jɔti
yachting => 'jɔtiŋ
yachts => jɔts
yachtsman => 'jɒtsmәn
yachtswoman => 'jɔts,wjmәn
yack => jæk
yacked => jæk
yackety-yak => 'jækiti'jæk
yacking => jæk
yacks => jæk
yaffle => 'jæfl
Yafo => 'jɑ:fәj
yah => jɑ:
yahoo => jә'hu:
yahoos => jɑ:hʊz:
Yahweh => 'ja:wei; ja:va:
Yahwist => 'jɑ:wist
yak => jæk
yakitori => ,jɑ:ki'tɔ:ri
yakka => 'jækә
yaks => 'jæks
Yakut => jɑ:'kut
Yakutsk => jɑ:'kutsk
yakuza => jә'ku:zә
Yale => jeil
Yalie => 'jeili
yalta => 'jæltә
Yalu => 'jɑ:lu:
yam => jæm
yam bean => jæm bi:n
Yamato-e => jɑ:'mɑ:tә,wei
yammer => 'jæmә
yammered => ˈjæməd
yammering => ˈjæmərɪŋ
yammers => ˈjæməz
Yamoussoukro => ,jɑ:mu:'su:krәj
yams => 'jæmz
yan => jæn
yang => jɑ:ŋ,jæŋ
Yangon => 'jɑ:n'^ɔn
yangtze => 'jæŋtsi
yank => jæŋk
yanked => jæŋkt
Yankee => 'jæŋki
yanking => jæŋkɪŋ
yanks => jæŋks
yantra => 'jʌntrә,'jæn-,'jɑ:n-
yap => jæp
yapok => jә'pɔk
yapp => jæp
yapped => jæpt
yapping => jæpɪŋ
yappy => 'jæpi
yaps => jæps
yarak => 'jæræk
yard => jɑ:d
yardage => 'jɑ:didʒ
yardang => 'jɑ:dɑ:ŋ
yardarm => 'jɑ:dɑ:m
Yardie => 'ja:di
yardman => 'jɑ:dmәn
yardstick => 'jɑ:dstik
yardsticks => 'jɑ:dstɪks
yare => yєә
yarmouth => 'jɑ:mәθ
yarmulke => 'jɑ:mәlkә
yarn => jɑ:n
yarn-dyed => 'jɑ:ndaid
yarns => jɑ:nz
Yaroslavl => ,jɑ:rәu'slɑ:vl
yarran => 'jærәn
yarrow => 'jærәu
yashmak => 'jæʃmæk
yataghan => 'jætәgæn
yatter => 'jætә
yaupon => 'jɔ:pәn
yautia => jau'ti:ә
yaw => jɒ:
yawed => jɒd
yawl => jɒ:l
yawled => jɔːl
yawling => jɔːl
yawls => jɔːl
yawn => jɒ:n
yawned => jɔ:nd
yawning => 'jɔ:niŋ
yawningly => 'jɔ:nɪŋlɪ
yawns => jɔ:nz
yawp => jɒ:p
yawped => jɔːp
yawper => 'jɔ:pә(r),'jɑ:-
yawping => 'jɔ:piŋ,'jɑ:-
yawps => jɔːp
yaws => jɔ:z
yclept => i'klept
ye => ji:
yea => jei
yeah => jɑ:
yean => ji:n
year => jiә
year-long => jə: lɔŋ
yearbook => 'jiәbuk
yearbooks => 'jɜ:bʊks
yearling => 'yiәliŋ
yearlong => 'jә:lɔŋ
yearly => 'jiәli
yearn => jә:n
yearned => jə:nd
yearning => 'jә:niŋ
yearningly => 'jɜ:nɪŋlɪ
yearns => jə:nz
yeas => 'jeɪz
yeast => ji:st
yeastiness => 'ji:stinis
yeasts => ji:sts
yeasty => 'ji:sti
yeats => jeits
yech => jek,jʌk
yechy => 'jʌki
yegg => jeg
yeh => je
Yehudi => 'jehudi
yell => jel
yelled => jeld
yelling => jelɪŋ
yellow => 'jelәu
yellow card => ˈjeləu kɑ:d
yellow flag => ˈjeləu flæɡ
yellow jasmine => ˈjeləu ˈdʒæzmɪn
yellow line => ˈjeləu lain
yellow poplar => ˈjeləu ˈpɔplə
yellow-bellied => ˈjeləʊˌbeli:d
yellowbill => 'jelәjbil
yellowcake => 'jelәjkeik
yellowed => ˈjeləud
yellower => 'jeləʊ
yellowfin => 'jelәjfin
yellowhammer => 'jelәjhæmә(r)
yellowhead => 'jeləʊhed
yellowish => 'jelәuiʃ
yellowlegs => 'jelәulegz
yellowness => 'jeləʊnəs
Yellowstone => 'jelәjstәjn
yellowtail => jeləʊ'teɪl
yellowthroat => 'jelәjθrәjt
yellowy => 'jelәji
yells => jelz
yelp => jelp
yelped => jelpt
yelper => 'jelpə
yelping => jelpɪŋ
yelps => jelps
Yemen => 'jemәn
Yemeni => 'jemәni
Yemenite => 'jemәnait
yen => jen
Yenisei => jeni'sei
yenta => 'jentә
Yeo => jәu
yeoman => 'jәumәn
yeomanly => 'jәjmәnli
yeomanry => 'jәumәnri
yep => jep
yerba => 'jә:bә
Yerevan => 'jere'vɑ:n
yes => jes
yes-man => 'jes‑men
yes-men => 'jesmæn
yeshiva => jә'ʃi:vә
yester- => 'jestә( r)
yesterday => 'jestәdi
yesteryear => 'jestәjiә(r)
yet => jet
yeti => 'jeti
yew => ju:
yews => joəʊz
YHA => ,wai eitʃ 'ei
yi => ji:
yid => jid
Yiddish => 'jidiʃ
Yiddishism => 'jidiʃizəm
yield => ji:ld
yielder => 'ji:ldә(r)
yielding => 'ji:ldiŋ
yieldingly => 'jɪəldɪŋlɪ
yike => jaik
yikes => jaiks
yin => jin
Yinchuan => 'jin'tʃuæn
yip => jip
yipped => jipt
yippee => 'jipi
yipping => jipɪŋ
yips => jips
ylang-ylang => i:'lɑ:ŋi:'lɑ:ŋ
ylem => 'ailәm
ylid => 'ilid
Ymir => 'i:miә
yo => jәu
yo-heave-ho => 'jәj'hi:v'hәj
yo-yo => 'jәu,jәu
YOB => jɒb
yobbish => 'jɒbɪʃ
yobbo => 'jɔbәu
yock => jɒk
yod => jjd,jɔ:d,jәjd
yodel => 'jәudl
yodelled => ˈjəudld
yodelling => ˈjəudlɪŋ
yodels => ˈjəudlz
yoga => 'jәugә
yogh => jәjk,jәj^,jɔk,jɔ^
yoghurt => 'jәugә:t
yoghurts => 'jɒɡət
yogi => 'jәu^i
yogis => 'jəʊgɪ
yogurt => 'jɔ^әt
yohimbe => jә'himbi
yohimbine => jә'himbi:n
yoicks => jɔiks
yok => jɔk
yoke => jәuk
yoked => 'jəʊkt
yokel => 'jәukәl
yokels => ˈjəʊkəlz
yokes => 'jəʊks
yoking => 'jәukiŋ
yokohama => 'jәukә'hɑ:mә
yokozuna => ,jәukә'zu:nә
Yolande => jәj'lændә
yolk => jәuk
yolky => 'jәuki
yom => jәum, jɔm
Yom Kippur => jɔm 'kipә(r)
yomp => jɔmp
yon => jɔn
yonder => 'jɒndә
yoni => 'jәuni
yonks => jɒŋks
yoo-hoo => 'ju:,hu:
yoof => ju:f
yore => jɔ:, jɔә
york => jɔ:k
yorker => 'jɒ:kә
Yorkers => 'jɔːkə
yorkie => 'jɔ:ki:
yorkist => 'jɔ:kist
Yorkshire => 'jɔ:kʃә
Yorkshire pudding => 'jɔ:kʃә
yorkshireman => 'jɔ:kʃiәmәn
Yorkshirewoman => 'jɔ:kʃiә,wjmәn
Yoruba => 'jɑ:rubә, 'jɔru'bɑ:
Yosemite => jәu'semiti
you => ju:
you are welcome => ju: ɑ: ˈwelkəm
you know => ju: nəʊ
you'd => juːd
you'll => juːl
you're => jʊə(r)
you've => ju:v
you-all => 'ju:ɔ:l, 'ju:l
young => jʌŋ
young lady => jʌŋ ˈleidi
young man => jʌŋ mæn
young offender => jʌŋ əˈfendə
young person => jʌŋ ˈpɜːsn
youngberry => 'jʌŋbәri
younger => 'jʌŋgә
youngest => 'jʌŋ^ist
youngish => 'jʌŋiʃ
youngling => 'jʌŋliŋ
youngster => 'jʌŋstә
youngsters => 'jʌŋstəz
younker => 'jʌŋkә
your => juә
yours => juәz
yours faithfully => jɔ:z ˈfeɪθfʊlɪ
yourself => juә'self
yourselves => jɔ:'selvz,jjә-,jә-
youse => ju:z
youth => ju:θ
youth club => ju:θ klʌb
youth culture => ju:θ ˈkʌltʃə
youthful => 'ju:θful
yow => jau
yowl => jaul
yowled => jauld
yowling => 'jauliŋ
yowls => jaulz
Ypres => 'iprɔ
ytterbium => i'tә:biәm
yttrium => 'itriәm
yu => ju
yuan => ju:'ɑ:n
yuca => ˈju:kə
Yucatec => 'ju:kә,tek
Yucatecan => ,ju:kә'tekәn
yucca => 'jʌkә
yuck => jʌk
yucky => ˈjʌki
yugoslav => 'ju:ɡәuslɑ:v
Yugoslavia => 'ju:^әu'slɑ:vjә
Yugoslavian => ,ju:^ә'slɑ:viәn
yugoslavs => ˈju:ɡəuˌslɑ:vz
yuk => jʌk
yukata => ju:'kɑ:tɑ:
yukky => 'jʌkɪ
yukon => 'ju:kɔn
yulan => 'ju:læn
yule => ju:l
yuletide => 'ju:ltaid
yum => jʌm
yum-yum => 'jʌm'jʌm
Yuman => 'ju:mәn
yummy => 'jʌmi
yummy mummy => ˈjʌmi ˈmʌmi:
yup => jʌp
yuppie => 'jʌpi
yuppie flu => ˈjʌpi flu:
yuppiedom => 'jʌpaɪdəm
yuppy => 'jʌpi
yurt => juәt
Yuzovka => 'jjzɔfkɑ:
yvette => i'vet
Yvonne => i'vɔn,i:-