G => dʒi:
G-man => 'dʒi:mæn
G-string => 'dʒi:striŋ
G-suit => 'dʒi:su:t
gab => gæb
GABA => '^æbә
gabardine => 'gæbәdi:n
gabardines => ˈɡæbədi:nz
gabbing => ɡæbɪŋ
gabble => 'gæbl
gabbled => ˈgæbəld
gabbles => ˈgæbəlz
gabbling => ˈgæbəlɪŋ
gabbro => '^æbrәu
gabbroid => '^æbrɔid
gabby => '^æbi
gaberdine => 'gæbәdi:n
gabfest => 'gæbfest
gabion => '^eibiәn
gable => 'geibl
gabled => 'geibld
gables => ˈɡeiblz
gablet => '^eiblit
gabon => ^a'b
Gabonese => ,^ɑ:bә'ni:z
gaboon => ^ә'bu:n
Gaborone => ,^ɑ:bә'rәun; hɑ:bɔ:rɔ:'ne
Gabriel => 'geibriәl
Gabriella => ɡɑ:bri:'el
gabrielle => ,^ɑ:bri'el,,^æb-
gaby => 'geibi
gad => gæd
gadabout => 'gædәbaut
gadded => ɡædid
gadding => '^ædiŋ
gadflies => ˈgædˌflaɪz
gadfly => 'gædflai
gadget => 'gædʒit
gadgeteer => .gædʒi'tiә
gadgetry => 'gædʒitri
gadgety => 'gædʒiti
gadid => '^eidid
gadoid => 'geidɒid
gadolinite => '^ædәlinait
gadolinium => .gædә'liniәm
gadroon => ^ә'dru:n
gadrooning => gə'druːn
gads => ɡædz
gadwall => '^ædwɔ:l
Gaea => 'dʒi:ә
Gael => geil
Gaeldom => 'ɡeildəm
Gaelic => 'geilik
Gaeltacht => '^eiltɑ:kt
gaff => gæf
gaffe => gæf
gaffed => gæf
gaffer => 'gæfә
gaffers => ˈɡæfəz
gaffes => gæfs
gaffing => '^æfiŋ
gag => gæg
gaga => 'gɑ:gɑ:
gage => geidʒ
gages => 'ɡeɪdʒɪz
gaggle => 'gægl
gaggled => 'gæg(ə)l
gaggles => ˈgægəlz
gaggling => 'gæg(ə)l
gagster => 'gægstә
gah => ^ɑ:
gaia => '^eiә, '^aiә
gaiety => 'geiәti
gaijin => '^aidʒin
gail => ^eil
gaillardia => ^ei'lɑ:diә
gaily => 'geili
gain => gein
gainable => 'geinәbl
gainer => 'geinә
gainers => ˈɡeinəz
gainful => 'geinful
gainfully => 'ɡeɪnfəlɪ
gaining => '^einiŋ
gains => ɡeinz
gainsay => gein'sei
gainsaying => geɪnˈseɪŋ
gainsays => ˌgeɪnˈsez
gait => geit
gaita => '^aitә
gaiter => 'geitә
gaits => geɪts
Gaitskell => '^eitskәl
gal => ^æl
gala => 'geilә
galactagogue => ^ә'læktә^ɔ^
galactic => gә'læktik
galactosamine => ^ә,læk'tәusә,mi:n
galactose => ^ә'læktәus
galactosemia => ^ә,læktә'si:miә
galago => ^ә'lei^әu
galah => ^ә'lɑ:
Galahad => 'gælәhæd
galangal => ^ә'læŋ^l
galant => ^ɑ:'lɔŋ
galantine => 'gælәnti:n
galapago => ^ә'lɑ:pә,^әu
galas => ˈgeɪləz
Galatia => gә'leiʃiә
galatian => ^ә'leiʃәn
Galatians => ^ә'leiʃiәnz
galaxies => 'gæləksi
galaxy => 'gælәksi
galbanum => 'gælbәnәm
gale => geil
gale-force => 'ɡeɪlf'ɔ:s
galea => '^eiljә
galen => '^eilәn, -lin
galena => ^ә'li:nә
galenic => gә'lenik
galenical => ^ә'lenikәl
Galerie => ɡɑ:'leriə
galette => ɡɑː'let
Galibi => ^ɑ:'li:bi
Galicia => ^ә'liʃiә
Galician => ^ә'liʃәn
Galilean => .gæli'li:әn
galilee => '^ælә,li
Galileo => .gæli'leiәu
galingale => 'gæliŋgeil
galiot => 'gæliәt
galipot => 'gælipɒt
galjoen => ^æl'ju:n
gall => gɒ:l
gall midge => gɔ:l midʒ
gall mite => gɔ:l maɪt
gall wasp => gɔ:l wɔsp
galla => '^ælә
gallant => 'gælәnt
gallantly => 'gælәntli
gallantries => ˈgæləntri:z
gallantry => 'gælәntri
gallate => '^ɔ:leit; -'^æ
gallbladder => 'gɒ:lblædә
galle => ^ɑ:l
galleon => '^æliәn
galleons => ˈɡæliənz
galleria => ˌgælə'rɪə
galleried => '^ælәrid
gallery => 'gælәri
gallery forest => ˈɡæləri ˈfɔrist
gallet => '^ælit
galley => 'gæli
galley slave => ˈgæli: sleiv
galleys => ˈgæli:z
galliambic => ,^æli'æmbik
Galliano => gæli'a:nəu
galliard => '^æljәd
galliass => '^æliæs
gallic => 'gælik
Gallican => 'gælikәn
Gallicanism => '^ælikәnizәm
gallice => 'gælisi:
galligaskins => ,^æli'^æskinz
gallimaufry => .gæli'mɒ:fri
gallinaceous => .gæli'neiʃәs
galling => 'gɒ:liŋ
gallinule => 'gælinju:l
galliot => '^æliәt
Gallipoli => ɡə'lipəli
gallipot => '^ælipɔt
gallium => 'gæliәm
gallivant => .gæli'vænt
gallivanted => ˌɡæliˈvæntid
gallivants => ˌɡæliˈvænts
galliwasp => '^æliwɔsp
GALLO => gæləu
Gallo- => '^ælәj
galloglass => '^ælәu,^læs
gallon => 'gælәn
gallonage => '^ælәnidʒ
galloon => gә'lu:n
gallop => 'gælәp
galloped => ˈɡæləpt
galloper => '^ælәpә
galloping => '^ælәpiŋ
gallops => ˈɡæləps
gallous => '^ælәs
Galloway => 'gælәwei
gallows => 'gælәuz
galls => gɔ:lz
gallstone => '^ɔ:lstәun
gallstones => 'ɡɔ:lstəʊnz
Gallup => '^ælәp
Gallup poll => '^ælәp
gallus => '^ælәs
galluses => 'gælәsiz
Galois => ^æl'wɑ:
galoot => gә'lu:t
galop => 'gælәp
galore => gә'lɒ:
galosh => gә'lɒʃ
Galsworthy => '^ɔ:lzwә:ði
Galton => '^ɔ:ltәn
galumph => gә'lʌmf
Galvani => ^æl'vɑ:ni
galvanic => gæl'vænik
galvanic skin response => ɡælˈvænik skin riˈspɔns
galvanise => '^ælvәnaiz
galvanising => 'ɡælvənaiz
galvanism => 'gælvәnizm
galvanization => .gælvәnai'zeiʃәn
galvanize => 'gælvәnaiz
galvanized => 'ɡælvənaɪzd
galvanizer => '^ælvәnaizә(r)
galvanizes => ˈgælvəˌnaɪziz
galvanizing => '^ælvә'naiziŋ
galvanometer => .gælvә'nɒmitә
galvanometric => .gælvәnәu'metrik
galvanoscope => 'gælvәnәskәup
galvanoscopic => ,^ælvәnә'skɔpik
galvo => '^ælvәj
gam => gæm
Gama => '^ɑ:mә
gamba => ˈɡæmbə
gambado => gæm'beidәu
Gambia => 'gæmbiә
Gambian => 'gæmbiәn
gambier => 'gæmbiә
gambit => 'gæmbit
gambits => ˈɡæmbits
gamble => 'gæmbl
gambled => ˈɡæmbld
gambler => 'gæmblә
gamblers => ˈgæmbəlz
gambles => ˈɡæmblz
gambling => 'gæmbliŋ
gamboge => gæm'bu:dʒ
gambol => 'gæmbәl
gambolled => ˈgæmbəld
gambolling => ˈgæmbəlɪŋ
gambols => ˈgæmbəlz
gambrel => 'gæmbrәl
gambusia => ^æm'bju:zjә
game => geim
game bird => ɡeim bə:d
game fish => ɡeim fiʃ
game on => ɡeim ɔn
game park => ɡeim pɑ:k
game point => ɡeim pɔint
game reserve => ɡeim riˈzə:v
game show => ɡeim ʃəu
game warden => ɡeim ˈwɔ:dn
gamecock => 'geimkɒk
gamekeeper => 'geimki:pә
gamelan => '^æmәlæn
gamely => 'geimli
gameness => 'geimnis
gameplay => ˈgeɪmpleɪ
gamer => 'ɡeimә
gamesman => '^eimzmәn
gamesmanship => 'geimzmәnʃip
gamesome => '^eimsәm
gamester => 'geimstә
gametangium => ,^æmi'tændʒjәm
gamete => gә'mi:t
gametic => ^æ'mefik
gametocyte => ^ә'mi:tә,sait
gametogenesis => ,^æmәtә'dʒenәsis
gametogeny => ,^æmi'tɔdʒini
gametophyte => gә'mi:tәfait
gametophytic => ɡə,miːtəʊ'fɪtɪk
gamey => '^eimi
gamily => '^eimili
gamin => 'ɡæmin
gamine => ^æ'mi:n
gaminess => '^eiminis
gaming => 'geimiŋ
gamma => '^æmә
gamma ray => ˈɡæmə rei
gammas => ˈɡæməz
gammer => 'gæmә
gammon => 'gæmәn
gammy => 'gæmi
gamp => gæmp
gamut => 'gæmәt
gamy => 'geimi
Gand => ^ɔ:ŋ
gander => 'gændә
ganders => ˈgændəz
Gandhi => 'gændi:
Gandhian => '^ændiәn
gandy dancer => 'ɡændi
ganef => 'gɑ:nәf
gang => gæŋ
gang bang => ɡæŋ bæŋ
gang rape => ɡæŋ reip
gang together => ɡæŋ təˈɡeðə
gangbanger => 'ɡæŋbænɡər
gangboard => '^æŋbɔ:d
gangbuster => '^æŋ,bʌstә(r)
ganged => 'ɡæŋd
ganger => 'gæŋә
ganges => '^ændʒi:z
Gangetic => ^æn'dʒetik
ganging => '^ændʒiŋ
gangland => '^æŋlænd
ganglia => '^æŋ^liә
gangling => 'gæŋgliŋ
ganglion => 'gæŋgliәn
ganglionic => ^æŋ^li'ɔnik
ganglioside => '^æŋ^liәsaid
gangly => '^ŋ^li
gangplank => 'gæŋplæŋk
gangplanks => ˈgæŋˌplæŋks
gangrene => 'gæŋgri:n
gangrened => ˈgæŋˌgri:nd
gangrening => ˈgæŋˌgri:nɪŋ
gangrenous => 'gæŋgrinәs
gangsta => ˈgæŋstə
gangster => 'gæŋstә
gangsterism => '^æŋstәrizәm
gangsters => 'ɡæŋstəz
Gangtok => '^ʌŋtɔk
gangue => gæŋ
gangway => 'gæŋwei
gangways => ˈgæŋˌweɪz
ganja => ˈgændʒə
gannet => 'gænit
gannetry => '^ænitri
ganoid => 'gænɒid
Gansu => '^ɑ:n'su:
gantlet => '^ɔ:ntlit
gantline => '^ænt,lain
gantries => ˈɡæntriz
gantry => '^æntri
ganzfeld => '^ɑ:ntsfelt
gaol => dʒeil
gaolbird => 'dʒeilbә:d
gaoled => dʒeild
gaoler => 'dʒeilә
gaolers => ˈdʒeɪlə(r)
gaoling => dʒeilɪŋ
gaols => dʒeilz
gap => gæp
gap year => ɡæp jə:
gap-toothed => '^æptu:θt
gape => geip
gaped => geɪpt
gaper => '^eipә(r),'^æp-
gapes => ɡeips
gapeworm => 'geipwә:m
gaping => '^æpiŋ
gapingly => 'ɡeɪpɪŋlɪ
gapping => 'ɡæppɪŋ
gappy => '^æpi
garage => gә'rɑ:ʒ. 'gærɑ:ʒ
garages => ˈɡærɑ:ʒɪz
Garamond => '^ærәmɔnd
garb => gɑ:b
garbage => 'gɑ:bidʒ
garbage disposal => ˈɡɑ:bidʒ disˈpəuzəl
garbageman => 'ɡɑːbɪdʒmən
garbanzo => ^ɑ:'bænzәu
garbed => gɑ:bd
garbing => gɑ:bɪŋ
garble => 'gɑ:bl
Garbo => '^ɑ:bәj
garboard => '^ɑ:bɔ:d, -bәd
garbologist => ^ɑ:'bɔlәdʒist
garbology => 'ɡɑ:bəʊlədʒɪ
garcia => '^ɑ:ʃjә
Garda => '^ɑ:dә
garden => 'gɑ:dn
garden centre => ˈɡɑ:dn ˈsentə
garden cress => ˈɡɑ:dn kres
garden pea => ˈɡɑ:dn pi:
garden spider => ˈɡɑ:dn ˈspaidə
garden-variety => '^ɑ:dәnvә,raiәti
gardened => 'ɡɑ:dnd
gardener => 'gɑ:dәnә
gardeners => ˈɡɑ:dnəz
gardenia => gɑ:'di:njә
gardenias => gɑ:ˈdi:njəz
gardening => 'gɑ:dniŋ
gardening leave => ˈgɑ:dnɪŋ li:v
garderobe => '^ɑ:drәub
gardner => '^ɑ:dnә(r)
Gare => ^eә
Gareth => '^æreθ
garfish => 'gɑ:fiʃ
garganey => '^ɑ:^әni
gargantuan => gɑ:'gæntʃuәn
garget => '^ɑ:^it
gargle => 'gɑ:gl
gargled => ˈɡɑ:ɡld
gargles => ˈɡɑ:ɡlz
gargling => ˈɡɑ:ɡlɪŋ
gargoyle => 'ɡɑ:ɡɔil
gargoyles => 'ɡɑ:ɡɔɪlz
gargoylism => '^ɑ:^ɔilizәm
garibaldi => .gæri'bɒ:ldi
garish => 'gєәriʃ
garishly => 'ɡeərɪʃlɪ
garishness => 'gɛəriʃnis
garland => 'gɑ:lәnd
garlanded => ˈgɑ:ləndid
garlanding => ˈgɑ:ləndɪŋ
garlands => ˈgɑ:ləndz
garlic => 'gɑ:lik
garlicky => '^ɑ:liki
garment => 'gɑ:mәnt
garner => 'gɑ:nә
garnered => 'ɡɑ:nəd
garnering => ˈgɑ:nərɪŋ
garners => 'ɡɑ:nəz
garnet => 'gɑ:nit
garnets => ˈɡɑ:nits
garnett => 'ɡɑ:nit
garnierite => '^ɑ:niәrait
garnish => 'gɑ:niʃ
garnished => ˈgɑ:nɪʃt
garnishee => .gɑ:ni'ʃi:
garnisheed => ˌɡɑ:niˈʃi:d
garnisheeing => ˌɡɑ:niˈʃi:ɪŋ
garnishes => ˈgɑ:nɪʃiz
garnishing => ˈgɑ:nɪʃɪŋ
garnishment => 'gɑ:niʃmәnt
garniture => 'gɑ:nitʃә
Garonne => ^ә'rɔn
garotte => ^ә'rɔt
garpike => '^ɑ: paik
garret => 'gærәt
garrets => ˈgærɪts
garrett => '^ærәt
Garrick => '^ærik
garrison => 'gærisn
garrison cap => ˈɡærisn kæp
garrisoned => ˈɡærisnd
garrisoning => ˈɡærisnɪŋ
garrisons => ˈɡærisnz
garron => '^ærәn
garrote => ^ә'rɔt
garrotte => gә'rɒt
garrotted => ɡəˈrɔtid
garrottes => ɡəˈrɔts
garrulity => gæ'ru:liti
garrulous => 'gærulәs
garrulously => 'gæruləsli
garry => '^æri
garryowen => ,^eәri'әjәn
garter => 'gɑ:tә
garter belt => ˈɡɑ:tə belt
garter snake => ˈɡɑ:tə sneik
garter stitch => ˈɡɑ:tə stitʃ
garters => ˈɡɑ:təz
garth => gɑ:θ
Garvey => '^ɑ: vi
gary => '^eәri
gas => gæs
gas fitter => ɡæs ˈfitə
gas giant => ɡæs ˈdʒaiənt
gas mantle => ɡæs ˈmæntl
gas pedal => ɡæs ˈpedl
gas ring => ɡæs riŋ
gas-guzzler => 'ɡæsɡ'ʌzlər
gas-tight => 'ɡæst'aɪt
gasbag => 'gæsbæg
gasbags => 'gæsbæg
Gascogne => ^ɑ:s'kɔnjә
Gascon => 'gæskәn
gasconade => .gæskә'neid
gasconaded => ˌɡæskəˈneidid
gasconading => ˌɡæskəˈneidɪŋ
Gascony => '^æskәni
gaseous => 'gæsiәs
gash => gæʃ
gashed => ɡæʃt
gashes => ɡæʃiz
gashing => ɡæʃɪŋ
gasholder => '^æshәjldә(r)
gasification => .ɡæsifi'keiʃәn
gasified => 'ɡæsɪfaɪd
gasifier => '^æsifaiә
gasify => 'gæsifai
Gaskell => '^æskәl
gasket => 'gæskit
gaskets => ˈɡæskits
gaskin => '^æskin
gaslight => 'gæslait
gaslit => 'gæslit
gasman => ˈgæsmæn
gasohol => '^æsәhɔl
gasoline => 'gæsәli:n
gasometer => gæs'ɒmitә
gasp => gæsp
gasped => ɡɑ:spt
gasper => 'gæspә
gasping => 'gæspiŋ
gasps => ɡɑ:sps
gassed => gæst
gasser => '^æsә
gasses => ɡæsiz
gassiness => '^æsinis
gassing => 'gæsiŋ
gassy => 'gæsi
Gastarbeiter => '^ɑ:st,ɑ:baitә(r)
gasteropod => '^æstәrәpɔd
gaston => '^æstәn
gastr- => ^æstr
gastrectomy => ^æs'trektәmi
gastric => 'gæstrik
gastric flu => ˈgæstrɪk flu:
gastric juice => ˈgæstrɪk dʒu:s
gastrin => '^æstrin
gastritis => gæs'tritis
gastro- => '^æstrәj
gastrocnemius => ,^æstrɔk'ni:miәs
gastrocolic => ,^æstrәu'kɔlik
gastroenteritis => ,^æstrәu,entә'raitis
gastroenterological => 'ɡæstrəu,entərə'lɔdʒikəl
gastroenterology => ,^æstrәu,entә'rɔlәdʒi
gastroesophageal => '^æstrәji,sɔfә'dʒi:әl
gastrointestinal => ,^æstrәuin'testәnl
gastrolith => '^æstrәliθ
gastronome => ^æ'strɔnәmi
gastronomic => ,^æstrәu'nɔmik
gastronomical => ,^æstrәu'nɔmikәl
gastronomically => ,gæstrə'nɔmikəli
gastronomy => gæs'trɒnәmi
gastropod => 'gæstrәpɒd
gastropub => ˈgæstrəʊpʌb
gastroscope => '^æstrәskәup
gastroscopy => ^æs'trɔskәpi
gastrostomy => ^æs'trɔstәmi
gastrotrich => '^æstrәtrik
gastrula => 'gæstrulә
gastrulation => ,^æstru'leiʃәn
gasworks => 'gæswә:ks
gat => gæt
gate => geit
gateaux => ˈgætəʊ
gatecrasher => 'ɡeɪtkræʃə(r)
gatecrashers => 'geit,kræʃə
gated => 'ɡeitid
gatefold => 'geitfәuld
gatehouse => 'geithaus
gatehouses => ˈgeɪtˌhaʊsiz
gatekeeper => 'geitki:pә
gatekeepers => ˈɡeitˌki:pəz
gateleg table => ˌgeɪtleg ˈteɪbl
gatepost => 'geitpәust
Gateshead => 'ɡeits,hed
gateway => 'geitwei
gateway drug => ˈgeɪtˌweɪ drʌɡ
gateways => 'ɡeɪtweɪz
gather => 'gæðә
gathered => 'gaðəd
gatherer => '^æðәrә
gatherers => ˈɡæðərəz
gathering => 'gæðәriŋ
gating => '^eitiŋ
gator => 'ɡeitә
GATT => ^æt
gauche => gәuʃ
gaucheness => 'gəuʃnis
gaucherie => 'gәuʃәri:
Gaucho => 'gautʃәu
gauchos => ˈɡautʃəuz
gaud => gɒ:d
gaudier => ˈgɔ:di:ə
gaudies => 'gɔːdɪ
gaudily => 'gɒ:dili
gaudiness => 'gɒ:dinis
gaudy => 'gɒ:di
gauge => geidʒ
gauged => '^eidʒid
gauger => 'geidʒә
gauges => ɡeidʒz
gauging => '^eidʒiŋ
gaul => ^ɔ:l
Gauleiter => '^au,laitә
Gaulish => 'gɒ:liʃ
Gaullism => '^ɔ:lizәm
Gaullist => '^ɔ:list
gault => gɒ:lt
gaunt => gɒ:nt
gauntlet => 'gɒ:ntlit
gauntlets => 'ɡɔ:ntlɪts
gauntly => 'ɡɔ:ntlɪ
gauntness => 'gɔ:ntnis
gaur => ^auә
gauss => gaus
Gaussian => '^ausiәn
Gautama => 'gautәmә
gauze => gɒ:z
gauzily => ˊgɒːzili
gauziness => 'ɡɔ:zɪnəs
gauzy => 'gɒ:zi
gavage => ^ә'vɑ:ʒ
gave => geiv
gavel => 'gævәl
gavelkind => 'gævәlkaind
gavels => ˈgævəlz
gavial => 'geiviәl
gavotte => ^ә'vɔt
Gawain => 'gɒwin
Gawd => ^ɔ:d
gawk => gɒ:k
gawked => ɡɔ:kt
gawkily => gɒːkili
gawkiness => ˊgɒːkinis
gawking => ɡɔ:kɪŋ
gawkish => 'gɒ:kiʃ
gawks => ɡɔ:ks
gawky => '^ɔ:ki
gawp => gɒ:p
gawped => ɡɔ:pt
gawping => ɡɔ:pɪŋ
gawps => ɡɔ:ps
gay => gei
gayal => 'ɡeɪəl
gaydar => ˈgeɪdɑ:(r)
gayety => '^eiәti
gayness => ˈgeɪnəs
gays => ɡeiz
gaza => '^ɑ:zә
gazania => ^ә'zeiniә
gaze => geiz
gazebo => gә'zi:bәu
gazed => ɡeizd
gazelle => gә'zel
gazelles => gəˈzelz
gazes => ɡeiziz
gazette => gә'zet
gazetteer => .gæzә'tiә
gazettes => ɡəˈzets
gazetting => ɡəˈzetiŋ
gazillion => gəˈzɪljən
gazpacho => ^ɑ:z'pɑ:tʃәu; ^ɑ:θ'pɑ:tʃә u
gazump => ^ә'zʌmp
gazumping => ɡə'zʌmpɪŋ
GBH => ,dʒi: bi: 'eitʃ
gcse => ˌdʒi: si: es ˈi:
Gdansk => ^ә'dɑ:nsk
Gdynia => ^ә'dinjә
GE => ʒei
gean => ^i:n
geanticline => dʒi'æntiklain
gear => giә
gear shift => ɡiə ʃift
gearbox => '^iәbɔks
gearboxes => ˈɡiəbɔksiz
geared => ^iәd
gearhead => 'ɡiəhed
gearing => 'giәriŋ
gearshift => 'giәʃift
gearwheel => '^iәwi:l
gecko => 'gekәu
Gedanken => ɡə'dɑ:ŋkən
Gedankenexperiment => ^ә'dɑ:ŋkәnik,sperimәnt
geddit => d'ʒedɪt
gee => 'dʒi:
gee up => dʒi: ʌp
gee whiz => ˌdʒi: ˈwɪz
gee-gee => dʒi: dʒi:
gee-string => 'dʒi:striŋ
geed => dʒi:d
geegaw => 'dʒi:^ɔ:,'^i:-
geek => gi:k
geeky => 'ɡiːkɪ
Geelong => dʒә'lɔŋ
geese => ^i:s
geest => ɡi:st
geez => ɡi:'ez
geezer => 'gi:zә
geezers => ˈɡi:zəz
gegenschein => '^ei^әnʃain
Gehenna => gi'henә
geiger => '^ai^ә
geisha => 'geiʃә
geishas => ˈɡeiʃəz
geitonogamy => ,^aitә'nɔ^әmi
gel => dʒel
gelada => 'dʒelәdә
gelati => dʒi'lɑ:ti:
gelatin => 'dʒelәtin, 'dʒelә'ti:n
gelatin paper => ˈdʒelətin ˈpeipə
gelatine => 'dʒelәtin, 'dʒelә'ti:n
gelatines => ˈdʒelətinz
gelatinize => dʒi'lætinaiz
gelatinized => dʒɪ'lætɪnaɪz
gelatinizes => dʒɪ'lætɪnaɪz
gelatinizing => dʒɪ'lætɪnaɪz
gelatinous => dʒi'lætinәs
gelation => dʒi'leiʃәn
gelato => dʒe'lɑ:təʊ
gelcoat => d'ʒelkəʊt
geld => geld
gelding => '^eldiŋ
geldings => ˈɡeldiŋz
gelid => 'dʒelid
gelignite => 'dʒelignait
gelling => 'dʒeliŋ
gelly => 'dʒeli
gelsemium => dʒel'si:miәm
Gelsenkirchen => ,^elzәn'kirʃәn
gelt => ^elt
gem => dʒem
Gemara => ge'mɑ:rә
Gemeinschaft => ^ә'mainʃɑ:ft
geminal => 'dʒeminәl
geminate => 'dʒeminit
geminated => 'dʒemɪneɪt; -nət
geminates => 'dʒemɪneɪt; -nət
geminating => 'dʒemɪneɪt; -nət
gemination => ,dʒemi'neiʃәn
gemini => 'dʒeminai
Geminids => 'dʒeminidz
gemma => 'dʒemә
gemmation => dʒe'meiʃәn
gemmiparous => dʒe'mipәrәs
gemmologist => dʒe'mɔlәdʒist
gemmology => dʒe'mɒlәdʒi
gemmulation => ,dʒemju'leiʃәn
gemmule => 'dʒemju:l
gemsbok => 'gemzbɒk
gemstone => 'dʒem,stәun
gemstones => d'ʒemstəʊnz
gen => dʒen
gena => 'dʒi:nә
gendarme => 'ʒɑ:ndɑ:m
gendarmerie => ʒɔŋ'dɑ:rmәri
gendarmes => ˈʒɑ:ndɑ:mz
gender => 'dʒendә
gendered => 'dʒendəd
gendering => 'dʒendə
genders => ˈdʒendəz
gene => dʒi:n
gene conversion => dʒi:n kənˈvə:ʃən
gene pool => dʒi:n pu:l
gene therapy => dʒi:n ˈθerəpi
genealogical => .dʒi:niә'lɒdʒikl
genealogies => ˌdʒi:niˈælədʒiz
genealogist => .dʒi:ni'ælәdʒist
genealogize => .dʒi:ni'ælәdʒaiz
genealogy => .dʒi:ni'ælәdʒi
genera => 'dʒenәrә
generable => 'dʒenәrәbl
general => 'dʒenәrәl
general aviation => ˈdʒenərəl ˌeivi:ˈeiʃən
general practice => ˈdʒenərəl ˈpræktis
general purpose => ˈdʒenərəl ˈpə:pəs
general theory of relativity => ˈdʒenərəl ˈθiəri ɔv ˌreləˈtiviti
generalisation => ,dʒenәrәlai'zeiʃәn;-li'z-
generalise => 'dʒenәrәlaiz
generalised => 'dʒenərəlaɪzd
generalissimo => .dʒenәrә'lisimәu
generalist => 'dʒenәrәlist
generalities => ˌdʒenəˈrælɪti:z
generality => .dʒenә'ræliti
generalizability => dʒenərəlaɪzə'bɪlɪtɪ
generalizable => 'dʒenәrәlaizәbl
generalization => ,dʒenәrәlai'zeiʃәn
generalizations => ˌdʒenərəlɪˈzeɪʃənz
generalize => 'dʒenәrәlaiz
generalized => 'dʒenәrәlaizd
generalizes => ˈdʒenərəlaiziz
generalizing => ˈdʒenərəlaizɪŋ
generally => 'dʒenәrәli
generalship => 'dʒʌnәrәlʃip
generate => 'dʒenәreit
generates => ˈdʒenəreits
generating => 'dʒenә,reitiŋ
generation => .dʒenә'reiʃәn
generation gap => ˌdʒenəˈreiʃən ɡæp
generative => 'dʒenәrәtiv
generator => 'dʒenәreitә
generatrix => 'dʒenәreitriks
generic => dʒi'nerik
generically => dʒi'nerikli
generosity => .dʒenә'rɒsiti
generous => 'dʒenәrәs
generousness => ˊdʒenәrәsnis
genesis => 'dʒenisis
genet => 'dʒenit
genetic => dʒi'netik
genetic drift => dʒiˈnetik drift
genetic fingerprint => dʒiˈnetik ˈfɪŋgəˌprɪnt
genetic load => dʒiˈnetik ləud
genetical => dʒi'netikәl
genetically modified => dʒe'netikəli ˈmɔdifaid
geneticist => dʒi'netisist
geneticists => dʒiˈnetisists
genetics => dʒi'netiks
Geneva => dʒi'ni:vә
GENEVIEVE => 'dʒenәvi:v
genial => 'dʒi:njәl
geniality => .dʒi:ni'æliti
genially => 'dʒi:njәli
genic => 'dʒenik
geniculate => dʒi'nikjulit
geniculate body => dʒiˈnikjulit ˈbɔdi
genie => 'dʒi:ni
genii => 'dʒi:niai
genista => dʒi'nistә
genital => 'dʒenitl
genitalia => dʒeni'teiliә
genitals => 'dʒenit(ә)lz
genitival => ,dʒeni'taivәl
genitive => 'dʒenitiv
genito-urinary => ˌdʒenɪtəʊ ˈjʊərɪnəri
genitor => 'dʒenitә(r)
genitourinary => ,dʒenitәu'juәrinәri
geniture => 'dʒenitʃә(r)
genius => 'dʒi:njәs
genius loci => 'dʒi:niәs'lәjsai
genlock => 'dʒenlɔk
Genoa => 'dʒenәuә
genocidal => .dʒenә'saidәl
genocide => 'dʒenәu,said
Genoese => .dʒenәu'i:z
genome => 'dʒi:nәum
genomes => d'ʒənəmz
genomic => dʒi:'ŋəʊmɪk
genomics => dʒə'nəʊmɪks
genotype => 'dʒenәtaip
genre => 'ʒɒŋrә
genre painting => ʒɑ:r ˈpeintiŋ
genres => 'ʒɑ:nrəz
gens => dʒenz
gent => dʒent
gentamicin => ,dʒentә'maisin
genteel => dʒen'ti:l
genteelism => dʒen'ti:lizm
genteelly => dʒen'ti:llɪ
gentes => 'dʒenti:z
gentian => 'dʒenʃiәn
gentians => ˈdʒenʃiənz
gentile => 'dʒentail
gentiles => 'dʒentaɪlz
gentility => dʒen'tiliti
gentle => 'dʒentl
gentlefolk => 'dʒent(ә)lfәjk
gentleman => 'dʒentlmәn
gentleman farmer => ˈdʒentlmən ˈfɑ:mə
gentleman-at-arms => d'ʒentlmən'æt'ɑ:mz
gentlemanly => 'dʒentlmәnli
gentlemen => 'dʒentlmәn
gentleness => 'dʒentlnis
gentlewoman => 'dʒentlwumәn
gently => 'dʒentli
gentoo => 'dʒentu:
gentoos => 'dʒentu:
gentrification => ˌdʒentrifiˈkeiʃən
gentrified => ˈdʒentrifaid
gentrifies => ˈdʒentrifaiz
gentrify => ˈdʒentrɪfaɪ
gentrifying => ˈdʒentrifaiŋ
gentry => 'dʒentri
genu => 'dʒenju:
genuflect => 'dʒenjuflekt
genuflected => ˈdʒenjəˌflektid
genuflecting => ˈdʒenjəˌflektɪŋ
genuflection => .dʒenju:'flekʃәn
genuflector => 'dʒenjuflektә
genuflects => ˈdʒenjəˌflekts
genuine => 'dʒenjuin
genus => 'dʒi:nәs
geo => ɡiәu
geo- => 'dʒi:әj
geobotanical => dʒi:əʊbəʊ'tænɪkəl
geobotany => .dʒi:әu'bɒtәni
geocentric => ,dʒi(:)әu'sentrik
geocentrism => ,dʒi:әj'sentrizәm
geochemical => dʒi:ɒ'kemɪkl
geochemist => dʒi:ɒ'kemɪst
geochemistry => .dʒi:ә'kemistri
geochronological => 'dʒi（:）əu,krɔnə'lɔdʒikəl
geochronology => ,dʒi(:)әukrә'nɔlәdʒi
geochronometric => ,dʒi:əu,krɔnəu'metrik
geochronometry => ,dʒi(:)әukrә'nɔmitri
geode => 'dʒi:әud
geodesic => .dʒi:әu'desik
geodesic dome => ˌdʒi:əuˈdesik dəum
geodesy => dʒi:'ɒdisi
geodetic => ,dʒi:ә'detik
geoduck => 'gu:i:dʌk
geoeconomics => 'dʒi:әj,i:kә'nɔmiks
geographer => dʒi'ɒgrәfә
geographers => dʒiˈɔgrəfəz
geographic => ,dʒiә'^ræfik
geographical => dʒiә'græfikl
geographical mile => dʒɪəˈgræfɪkɵl mail
geographies => dʒiˈɔɡrəfiz
geography => dʒi'ɒgrәfi
geoid => 'dʒi:ɔid
geologic => dʒiә'lɔdʒik
geological => .dʒiәu'lɒdʒikәl
geologically => ˌdʒi:ə'lɒdʒɪklɪ
geologies => dʒiˈɔlədʒiz
geologist => dʒi'ɔlәdʒist
geologists => dʒɪˈɔlədʒɪsts
geologize => dʒi'ɒlәdʒaiz
geology => dʒi'ɒlәdʒi
geomagnetic => .dʒi:әumæg'netik
geomagnetism => .dʒi:әu'mægnәtizm
geomancy => 'dʒi:әumænsi
geomantic => .dʒi:әu'mæntik
geometer => dʒi'ɒmitә
geometric => .dʒiәu'metrik
geometrical => .dʒiәu'metrikl
geometrically => dʒiә'metrikli
geometrician => .dʒiәumә'triʃәn
geometrics => dʒiә'metriks
geometrid => 'dʒi'ɒmitrid
geometries => dʒiˈɔmitriz
geometry => dʒi'ɒmәtri
geomorphic => ,dʒi:әu'mɔ:fik
geomorphologist => ,dʒi(:)әumɔ:'fɔlәdʒist
geomorphology => ,dʒi:әumɔ:'fɔlәdʒi
geophagy => dʒi'ɔfәdʒi
geophysical => .dʒi:әu'fizikl
geophysicist => .dʒi:әu'fizisist
geophysics => .dʒi:әu'fiziks
geopolitic => ,dʒi:әjpә'litik
geopolitical => ,dʒi(:)әupә'litikәl
geopolitician => ,dʒi(:)әu,pɔli'tiʃәn
geopolitics => .dʒi:әu'pɒlitiks
geordie => 'dʒɔ:di
george => dʒɔ:dʒ
georgetown => 'dʒɔ:dʒtaun
georgette => dʒɒ:'dʒet
Georgia => 'dʒɒ:dʒjә
Georgian => 'dʒɒ:dʒjәn
Georgiana => dʒɔ:'dʒi:nә
georgic => 'dʒɒ:dʒik
Georgie => 'dʒɔ:dʒi
Georgina => dʒɔ:'dʒi:nә
geoscience => .dʒi:әu'saiәns
geoscientist => ,dʒi(:)ә'saiәntist
geostationary => ,dʒi(:)әu'steiʃәnәri
geostrategic => ,dʒi(:)әustrә'ti:dʒik
geostrophic => ,dʒi(:)әu'strɔfik
geosynchronous => ,dʒi:әj'siŋkrәnәs
geosyncline => ,dʒi(:)әu'sinklain
geotactic => ,dʒi: әj'tæktik
geotaxis => ,dʒi:әj'tæksis
geotechnical => dʒi:əu'teknikəl
geothermal => ,dʒi(:)әu'θәmәl
geotropic => .dʒi:әu'trɒpik
geotropism => dʒi'ɒtrәpizm
ger => ɡεә
Geraint => dʒə'reint
gerald => 'dʒerәld
GERALDINE => 'dʒerәldi:n, -dain
geranial => dʒi'reiniәl
geraniol => dʒi'reiniɔl
geranium => dʒi'reiniәm
geraniums => dʒiˈreinjəmz
gerard => 'dʒerɑ:d,dʒә'rɑ:d
gerbera => 'gә:bәrә
gerbils => ˈdʒə:bilz
gerenuk => '^eәrә,nuk, ^ә'renәk
geriatric => ,dʒeri'ætrik
geriatrician => ,dʒeriә'triʃәn
geriatrics => .dʒeri'ætriks
germ => dʒә:m
germ cell => dʒə:m sel
germ line => dʒə:m lain
germ warfare => dʒə:m ˈwɔ:fɛə
Germaine => dʒe'mein
German => 'dʒә:mәn
germander => dʒә:'mændә
germander speedwell => dʒə:ˈmændə ˈspi:dwel
germane => dʒә:'mein
Germanic => dʒә:'mænik
Germanist => 'dʒә:mәnist
germanium => dʒә:'meiniәm
Germanize => 'dʒә:mәnaiz
germans => ˈdʒɜ:mənz
Germany => 'dʒә:mәni
germicidal => .dʒә:mi'saidәl
germicide => 'dʒә:misaid
germinal => 'dʒә:minәl
germinate => 'dʒә:mineit
germinated => ˈdʒɜ:məˌneɪtid
germinates => ˈdʒɜ:məˌneɪts
germinating => 'dʒә:mineitiŋ
germination => .dʒә:mi'neiʃәn
germinative => 'dʒәmineitiv
germinator => 'dʒә:mi,neitә
germplasm => 'dʒә:mplæzm
gerontic => dʒә'rɔntik
gerontocracy => .dʒerɒn'tɒkrәsi
gerontocrat => dʒi'rɔntəkræt
gerontocratic => dʒi,rɔntə'krætik
gerontology => .dʒerɒn'tɒlәdʒi
gerry => '^eri
gerrymander => 'dʒerimændә
gerrymandered => ˈdʒerimændəd
gerrymandering => ˈdʒerimændərɪŋ
gers => ʒeәr
Gershwin => '^ә:ʃwin
gertrude => 'ɡә:tru:d
gerund => 'dʒerәnd
gerundive => dʒi'rʌndiv
gerunds => ˈdʒerəndz
gesellschaft => ^ә'zelʃɑ:ft
gesso => 'dʒesәu
gessoed => 'dʒesəʊ
gestalt => ^ә'ʃtɑ:lt
gestaltist => ^ә'ʃtɑ:ltist
gestapo => ^es'tɑ:pәu
gestate => 'dʒesteit
gestated => ˈdʒesteitid
gestating => ˈdʒesteitɪŋ
gestation => dʒes'teiʃәn
geste => dʒest
gesticulate => dʒes'tikjuleit
gesticulated => dʒes'tɪkjʊleɪtɪd
gesticulates => dʒeˈstɪkjəˌleɪts
gesticulating => dʒeˈstɪkjəˌleɪtɪŋ
gesticulation => dʒe.stikju'leiʃәn
gesticulative => dʒe'stikjjleitiv
gesticulatory => dʒe'stikjjlәtəri
gestural => 'dʒestʃərəl
gesture => 'dʒestʃә
gestured => ˈdʒestʃəd
gestures => 'dʒɛstʃɚ
gesturing => ˈdʒestʃərɪŋ
get => get
get at => ɡet æt
get it => ɡet it
get it on => ɡet it ɔn
get moving => ɡet ˈmu:vɪŋ
get sick => ɡet sik
get somewhere => ɡet ˈsʌm(h)wɛə
get stuffed => ɡet stʌft
get the picture => ɡet ðə ˈpiktʃə
get-at-able => 'ɡet'æt'eɪbl
get-go => 'getˌgəʊ
get-rich-quick => '^et'ritʃ'kwik
get-together => '^ettә,^eðә(r)
get-up => ɡet ʌp
getaway => '^etә,wei
getaways => ˈgetəˌweɪz
Gethsemane => geθ'semәni
gettable => '^etәbl
getter => 'getә
gettering => '^etәriŋ
getting => '^etiŋ
Gettysburg => 'getizbә:g
geum => 'dʒi:әm
gewgaw => 'gju:gɒ:
gewgaws => 'gjuːgɔː
gey => ɡei
geyser => 'gaizә
geyserite => '^aizәrait
geysers => ˈgaɪzəz
Ghana => 'gɑ:nә
Ghanaian => ^ɑ:'neiәn
gharial => '^eәriәl
gharry => 'gæri
ghastliness => 'gɑ:stlinis
ghastly => 'gɑ:stli
ghat => ^ɔ:t
Ghats => ^ɔ:ts,^ɑ:ts
ghee => gi:
Ghent => gent
gherao => ^e'raj
gherkin => 'gә:kin
gherkins => ˈɡə:kinz
ghetto => 'getәu
ghetto blaster => ˈgetəʊ ˈblɑ:stə
ghettoization => ,^etәuai'zeiʃәn
ghettoize => 'getәuaiz
Ghibelline => '^ibilain,-li:n
ghibli => '^ibli
ghillie => '^ili:
ghost => gәust
ghost story => ɡəust ˈstɔ:ri
ghost train => ɡəust trein
ghost-write => 'ɡəʊstr'aɪt
ghostbuster => 'ɡəʊstbʌstə
ghosting => 'ɡәustiŋ
ghostlike => '^әjstlaik
ghostliness => 'gәustlinis
ghostly => 'gәustli
ghostwrite => 'gәustrait
ghostwrites => ˈɡəustraits
ghostwriting => ˈɡəustraitɪŋ
ghostwritten => 'ɡəʊstrɪtn
ghostwrote => ɡəʊst'rəʊt
ghoul => gu:l
ghoulish => 'gu:liʃ
ghoulishly => ˊguːliʃli,  ˊgauliʃli
ghouls => ɡu:lz
ghyll => gil
gi => dʒi: 'ai
giant => 'dʒaiәnt
giant clam => ˈdʒaiənt klæm
giant panda => ˈdʒaiənt ˈpændə
giant petrel => ˈdʒaiənt ˈpetrəl
giant puffball => ˈdʒaiənt ˈpʌfbɔ:l
giant salamander => ˈdʒaiənt ˈsæləmændə
giant sequoia => ˈdʒaiənt siˈkwɔiə
giant slalom => ˈdʒaiənt ˈsleiləm
giant squid => ˈdʒaiənt skwɪd
giant tortoise => 'dʒaiənt,'tɔ:təs
giant-killer => ˈdʒaiənt ˈkɪlə
giantess => 'dʒaiәntis
giantism => 'dʒaiәntizm
giantlike => 'dʒaiәntlaik
giants => 'dʒaiәnts
giaour => 'dʒauә
giardiasis => dʒiɑ:'daiәsis
gib => gib
gibber => 'dʒibә
gibbered => ˈdʒibəd
gibberellin => ,dʒibә'relin
gibbering => ˈdʒibərɪŋ
gibberish => 'dʒibәriʃ
gibbers => ˈdʒibəz
gibbet => 'dʒibit
gibbeted => 'dʒɪbɪt
gibbeting => 'dʒɪbɪt
gibbets => ˈdʒibits
gibbon => 'gibәn
gibbosity => gi'bɒsiti
gibbous => 'gibәs
gibbs => ^ibz
gibbsite => '^ibzait
gibe => dʒaib
gibed => dʒaɪbd
gibing => 'dʒaibiŋ
giblet => 'dʒiblit
giblets => 'dʒiblits
Gibraltar => dʒi'brɒltә
Gibson => '^ibsn
gibus => 'dʒaibәs
gid => ^id
giddap => ^i'dæp
giddier => ˈgɪdi:ə
giddily => 'gidili
giddiness => 'gidinis
giddy => 'gidi
Gide => ʒi:d
Gideon => 'gidiәn
gidgee => '^idʒi:
gie => ^i:, ^i
gifford => '^ifәd,'dʒifәd
gift => gift
gift certificate => ɡift səˈtifikeit
gift token => ɡift ˈtəukən
gift voucher => ɡift ˈvaʊtʃə
gift-wrap => ˈgɪftˌræp
gift-wrapping => ɡift ˈræpɪŋ
gifted => 'giftid
giftedness => ɡɪf'tɪdnəs
giftware => '^iftweә(r)
Gifu => '^i:fu:
gig => gig
giga- => '^i^ә, '^ai^ә
gigabit => 'dʒiɡә.bit
gigaflop => ˈgɪgəflɒp
gigahertz => '^i^әhә:ts
gigantic => dʒai'gæntik
gigantism => 'dʒai^æntizәm
gigantomachy => 'dʒai^æn'tɔmәki
gigawatt => 'dʒai^әwɔt
giggle => 'gigl
giggled => ˈɡiɡld
giggles => ˈɡiɡlz
giggling => ˈɡiɡlɪŋ
giggly => '^i^li
gigolo => 'dʒi^әlәu
gigolos => ˈdʒiɡələuz
gigot => 'dʒi^әt
gigue => dʒi:^
Gilbert => '^ilbәt
Gilbert and Ellice Islands => '^ilbәt әnd 'elis 'ailәndz
Gilbertese => ,^ilbә'ti:z
gild => gild
gilded => 'gildid
gilder => '^ildә(r)
gilding => '^ildiŋ
gilds => gɪldz
giles => dʒailz
gilet => dʒi'lei
gilgai => '^il,^ai
Gilgamesh => '^il^әmeʃ
gill => gil
gill cover => gɪl ˈkʌvə
gill net => gɪl net
gilled => ^ild
Gillespie => [gi'lespi]
GILLIAN => 'dʒiliәn
gillie => '^ili:
gilling => '^iliŋ
Gillingham => '^iliŋәm
Gilly => '^ili:
gillyflower => 'dʒili,flauә
Gilsonite => '^ilsәnait
gilt => gilt
gimbal => 'dʒimbәl
gimcrack => 'dʒimcræk
gimcrackery => -krækәri
gimlet => 'gimlit
gimlet-eyed => '^imlitaid
gimlets => ˈɡimlits
gimme => '^imi
gimme cap => ˈɡimi kæp
gimmick => 'gimik
gimmickry => '^imikri
gimmicks => ˈgɪmɪks
gimmicky => '^imiki
gimp => gimp
gimpy => '^impi
gin => dʒin
gin rummy => dʒɪn ˈrʌmi
gin sling => dʒɪn sliŋ
gina => 'dʒi:nә
ginger => 'dʒindʒә
ginger ale => ˈdʒindʒə eɪl
ginger beer => ˈdʒindʒə biə
ginger group => ˈdʒindʒə ɡru:p
ginger nut => ˈdʒindʒə nʌt
ginger snap => ˈdʒindʒə snæp
ginger wine => ˈdʒindʒə wain
gingerbread => 'dʒindʒәbred
gingering => 'dʒɪndʒə
gingerliness => 'dʒindʒәlinis
gingerly => 'dʒindʒәli
gingers => ˈdʒindʒəz
gingersnap => 'dʒindʒәsnæp
gingery => 'dʒindʒәri
gingham => 'giŋәm
gingili => 'dʒindʒili
gingival => dʒin'dʒaivl
gingivitis => ,dʒindʒi'vaitis
gingko => '^iŋkәu
ginglymus => 'dʒiŋ^limәs
gink => giŋk
ginned => dʒɪnd
ginnel => '^inәl,'dʒin-
ginner => 'dʒinә
ginnery => 'dʒinәri
ginning => 'dʒiniŋ
Ginny => 'dʒini
ginormous => dʒaɪˈnɔ:məs
ginseng => 'dʒinseŋ
ginzo => '^inzәj
Giorgione => dʒɔ:r'dʒɔ:ne
Giotto => 'dʒɔtәu
Giovanna => dʒɔ:'vɑ:nnɑ:
Giovanni => dʒo'vanni
gip => dʒip
gippo => 'dʒipәu
gipsy => 'dʒipsi
giraffe => dʒi'rɑ:f
giraffes => dʒəˈræfs
girandole => 'dʒirәndәul
girasol => 'dʒirә,sɔl, -,sәul
gird => gә:d
girder => 'gә:dә
girders => ˈgɜ:dəz
girding => ɡə:dɪŋ
girdle => 'gә:dl
girdled => 'ɡɜ:dld
girdles => ˈgɜ:dlz
girdling => '^ә:dliŋ
girds => ɡə:dz
girl => gә:l
girlhood => 'gә:lhud
girlie => 'gә:li
girlish => 'gә:liʃ
girly => 'ɡә:li
girn => ^ә:n
giro => 'dʒairәu
Gironde => dʒi'rɒnd
Girondist => dʒi'rɒndist
giros => ˈdʒairəuz
girt => gә:t
girth => gә:θ
girths => ɡə:θs
GIS => ^is
Giselle => dʒi'zel
gismo => '^izmәu
Gissing => '^isiŋ
gist => dʒist
git => ɡit
gite => 'ɡaɪt
gittern => 'gitә:n
give => giv
give birth => ɡiv bə:θ
give suck => ɡiv sʌk
give tongue => ɡiv tʌŋ
give up on => ɡiv ʌp ɔn
give-and-take => '^ivәn'teik
giveaway => 'givә.wei
giveaways => ˈɡivəweiz
giveback => '^ivbæk
given => 'givәn
giver => 'givә
givers => ˈɡivəz
giving => 'giviŋ
Giza => 'ɡi:zə
gizmo => 'gizmәu
gizzard => 'gizәd
gizzards => ˈɡizədz
glabella => ^lә'belә
glabrous => 'gleibrәs
glacial => 'gleiʃәl
glacial period => ˈɡleisjəl ˈpiəriəd
glaciate => 'gleiʃieit
glaciated => 'gleiʃieitid
glaciation => .gleisi'eiʃәn
glacier => 'gleiʃә
glaciers => ɡ'læsɪəz
glaciological => .gleiʃi'ɒlәdʒikl
glaciologist => .gleiʃi'ɒlәdʒist
glaciology => .gleiʃi'ɒlәdʒi
glacis => 'gleisis
glad => glæd
glad-hand => '^lædhænd
gladden => 'glædәn
gladdened => ˈglædnd
gladdening => ˈglædnɪŋ
gladdens => ˈglædnz
glade => gleid
gladed => gleɪd
glades => gleɪdz
gladiator => 'glædieitә
gladiatorial => .glædiә'tɒ:riәl
gladiators => ˈglædi:ˌeɪtəz
gladioli => ˌɡlædɪ'əʊlaɪ
gladiolus => .glædi'әulәs
gladly => 'glædli
gladness => 'glædnis
gladsome => 'glædsәm
gladstone => '^lædstәun
Glagolitic => ,^læ^әj'litik
glaikit => 'ɡleikit
glair => 'glєә
glairy => '^leәri
glaive => gleiv
glam => ɡlæm
glamor => 'glæmә
Glamorgan => ɡlə'mɔ:ɡən
glamorize => '^læmәraiz
glamorized => ˈglæməˌraɪzd
glamorizes => ɡ'læməraɪzɪz
glamorizing => ˈglæməˌraɪzɪŋ
glamorous => 'glæmәrәs
glamorously => 'glæmərəsli
glamour => 'glæmә
glamourous => '^læmәrәs
glance => 'glɑ:ns
glanced => ɡlɑ:nst
glances => ɡlɑ:nsiz
glancing => 'glɑ:nsiŋ
glancingly => 'ɡlɑːnsɪŋlɪ
gland => glænd
glanders => '^lændәz
glandular => '^lændjulә
glans => glænz
glare => glєә
glared => ɡlɛəd
glares => ɡlɛəz
glaring => 'glєәriŋ
glaringly => 'ɡleərɪŋlɪ
glary => 'glєәri
Glaser => '^leizә
glasgow => '^lɑ:s^әu
glasnost => 'glæsˌnəʊst
glass => glɑ:s
glass ceiling => ɡlɑ:s ˈsi:liŋ
glass cutter => ɡlɑ:s ˈkʌtə
glass harmonica => ɡlɑ:s hɑ:ˈmɔnɪkə
glass lizard => ɡlɑ:s ˈlɪzəd
glass snake => ɡlɑ:s sneik
glass sponge => ɡlɑ:s spʌndʒ
glass-blower => 'ɡlɑ:s,bləuə, 'ɡlæs-
glass-like => ɡ'lɑ:sl'aɪk
glass-maker => 'ɡlɑːs,meɪkə
glassblower => 'glɑ:sblauә
glassed-in => ɡ'lɑ:st'ɪn
glasses => 'glɑ:siz
glassful => 'glɑ:sful
glassfuls => 'ɡlɑːsfʊl
glasshouse => 'glɑ:shaus
glasshouses => ˈglæsˌhaʊsiz
glassily => 'glæsili
glassine => glæ'si:n
glassiness => 'glɑ:sinis
glassing => '^lɑ:siŋ
glassless => '^lɑ:slis;'^læs-
glassmaker => '^lɑ:s,meikә(r);'^læs-
glasspaper => ˈglɑ:speɪpə(r)
glassware => 'glɑ:swєә
glasswort => 'glɑ:swә:t
glassy => 'glɑ:si
glassy-eyed => '^lɑ:siaid;'^læsi-
Glaswegian => glæs'wi:dʒjәn
glaucoma => glɒ:'kәumә
glaucomatous => glɒ:'kәumәtәs
glauconite => '^lɔ:kәnait
glaucophane => '^lɔ:kә,fein
glaucous => 'glɒ:kәs
glaze => 'gleiz
glazed => ɡleizd
glazer => '^leizә(r)
glazes => ɡleiziz
glazier => 'gleiʒә
glazing => 'gleiziŋ
glazy => 'gleizi
gleam => gli:m
gleamed => ɡli:md
gleaming => ˈgli:mɪŋ
gleamingly => ɡ'li:mɪŋlɪ
gleams => ɡli:mz
gleamy => 'gli:mi
glean => gli:n
gleaned => gli:nd
gleaners => 'ɡli:nə
gleaning => 'gli:niŋ
gleanings => '^li:niŋz
gleans => gli:nz
glebe => gli:b
glee => gli:
glee club => gli: klʌb
gleeful => 'gli:ful
gleefully => 'ɡli:fəlɪ
gleeman => 'gli:mәn
gleesome => '^li:sәm
gleet => gli:t
gleety => '^li:ti
Gleichschaltung => '^laiʃ-,ʃɑ:ltjŋ
glen => glen
glenda => 'glendә
glengarry => glen'gæri
glenn => ^len
glens => ɡlenz
gley => ^lei
glia => '^laiә, '^li:ә
gliadin => '^laiәdin
glial => '^laiәl
glib => glib
glibly => 'glibli
glibness => glɪbnɪs
glide => glaid
glided => ɡlaidid
glider => 'glaidә
gliders => ˈglaɪdəz
glides => ɡlaidz
gliding => 'glaidiŋ
glim => glim
glimmer => 'glimә
glimmered => ˈglɪməd
glimmering => 'glɪmərɪŋ
glimmers => ˈglɪməz
glimpse => glimps
glimpsed => ɡlimpst
glimpses => ɡlimpsiz
glimpsing => ɡlimpsɪŋ
glint => glint
glinted => glɪntid
glinting => glɪntɪŋ
glints => glɪnts
glioma => ^lai'әumә
glissade => gli'sɑ:d
glissaded => ɡliˈsɑ:did
glissades => ɡliˈsɑ:dz
glissading => ɡliˈsɑ:dɪŋ
glissando => gli'sɑ:ndәu
glisten => 'glisn
glistened => ˈglɪsənd
glistening => '^li:sniŋ
glistens => ˈglɪsənz
glister => '^listә
glistering => ˈɡlistərɪŋ
glitch => ^litʃ
glitches => ɡlitʃiz
glitter => 'glitә
glitterati => ˌglɪtəˈrɑ:ti
glittered => ˈɡlitəd
glitteringly => 'glɪtərɪŋlɪ
glitters => ˈɡlitəz
glittery => 'glitәri
glitz => glɪts
glitzy => '^litsi
Gliwice => ^li'vi:tsә
gloaming => 'glәumiŋ
gloat => glәut
gloated => gləʊtid
gloating => '^lәutiŋ
gloatingly => ɡ'ləʊtɪŋlɪ
gloats => gləʊts
glob => ^lɔb
global => 'glәubl
global village => ˈɡləubəl ˈvilidʒ
global warming => ˈɡləubəl ˈwɔ:miŋ
globalisation => ,gləubəlai'zeiʃən
globalism => '^lәubәlizm
globalist => -list
globalization => ,^lәjbәlai'zeiʃәn;-li'z-
globalize => 'ɡlәubәlaiz
globalized => ˈɡləubəlaizd
globalizes => ˈɡləubəlaiziz
globalizing => ˈɡləubəlaizɪŋ
globe => glәub
globe artichoke => ɡləub ˈɑ:titʃəuk
globefish => 'glәubfiʃ
globeflower => 'glәubflauә
globes => ɡləubz
globetrot => 'ɡləubtrɔt
globetrotter => '^lәjbtrɔtә(r)
globetrotters => 'ɡləub,trɔtə
globigerina => ^lәu,bidʒә'rainә
globin => '^lәubin
globoid => '^lәubɔid
globose => 'glәubәus
globs => ɡlɔbz
globular => 'glɒbjulә
globular cluster => ˈɡlɔbjulə ˈklʌstə
globularity => .ɡlɔbju'lærәti
globule => '^lɔbju:l
globules => ˈɡlɔbju:lz
globulin => 'glɒbjulin
globulous => '^lɔbjulәs
glochid => '^lɔkid
glockenspiel => 'glɒkәnspi:l
glogg => ɡ'lɒɡ
glom => glɒm
glomerulonephritis => ^lәu,merju,lәunef'raitis
glomerulus => ^lәu'merjulәs
glommed => ɡlɔmd
glomming => ɡlɔmɪŋ
gloms => ɡlɔmz
gloom => glu:m
gloomed => ɡlu:md
gloomily => 'ɡlu:mɪlɪ
gloominess => 'ɡlu:mɪnəs
glooming => 'glu:mɪŋ
gloomy => 'glu:mi
glop => ^lɔp
gloppy => 'ɡlɒpɪ
gloria => '^lɔ:riә
glories => ˈɡlɔ:riz
glorification => .glɒ:rifi'keiʃәn
glorify => 'glɒ:rifai
gloriosa => ɡlɔ:'ri:əʊsə
glorious => 'glɒ:riәs
glory => 'glɒ:ri
glory-of-the-snow => '^lɔ:riәvðә,snәj,'^lәj-
gloss => glɒs
glossal => 'glɒsl
glossarial => glɒ'sєәriәl
glossaries => ˈglɔ:səri:z
glossarist => 'glɒsәrist
glossary => 'glɒsәri
glossator => ^lɔ'seitә
glossed => glɔ:st
glosses => glɔ:siz
glossily => 'glɒ:sili
glossiness => 'glɒ:sinis
glossing => ɡ'lɒsɪŋ
glossitis => glɒ'saitis
glossographer => glɒ'sɒgrәfә
glossolalia => ,^lɔsә'leiliә
glossopharyngeal nerve => ˌɡlɔsəuˌfærinˈdʒi:əl nə:v
glossy => 'glɒ:si
glost => ^lɔst
glottal => 'glɒtl
glottal stop => ˈɡlɔtl stɔp
glottis => 'glɒtis
glottochronological => 'ɡlɔtəu,krɔnə'lɔdʒikəli
glottochronology => ,^lɔtәukrә'nɔlәdʒi
gloucester => '^lɔstә
Gloucestershire => '^lɔstәʃiә
glove => glʌv
glove puppet => ɡlʌv ˈpʌpit
glovebox => ɡ'lʌvbɒks
gloved => glʌvd
glover => ^lʌvә(r)
glow => glәu
glowed => ɡləud
glower => 'glәuә
glowered => ˈglaʊəd
glowering => ˈglaʊərɪŋ
gloweringly => ɡləuə
glowers => ˈglaʊəz
glowing => 'glәuiŋ
glows => ɡləuz
glowworm => 'glәuwә:m
gloxinia => glɒk'siniә
gloze => glәuz
glucagon => '^lu:kә^ɔn
glucan => '^lu:kәn
glucocorticoid => ,^lu:kәu'kɔ:ti,kɔid
glucosamine => ^lu:kәu'sæmi:n
glucose => 'glu:kәus
glucoside => 'glu:kәusaid
glucosidic => ,ɡlu:kəu'sidik
glucuronate => ^lu'kjurәneit
glue => glu:
glue ear => ɡlu: iə
glued => ɡluːd
glues => ɡlu:z
gluey => 'glu:i
glug => ^lʌ^
glum => glʌm
glume => glu:m
glumly => 'glʌmli
glummer => glʌmə
gluon => '^lu:ɔn
gluons => 'ɡlu:ɔn
glut => glʌt
glutamate => '^lu:tәmeit
glutamic acid => ^lu:'tæmik
glutamine => 'glu:tәmi:n
glutathione => ,^lu:tә'θaiәun
gluteal => ^lu:'tiәl, '^lu:tiәl
gluten => 'glu:tn
gluteus => glu:'ti:әs
glutinous => 'glu:tinәs
glutinousness => ɡ'lu:tɪnəsnəs
gluts => glʌts
glutted => glʌtid
glutting => ɡ'lʌtɪŋ
glutton => 'glʌtn
gluttonize => 'glʌtnaiz
gluttonous => 'glʌtnәs
gluttons => ˈglʌtnz
gluttony => 'glʌtәni
glycemic => ɡlɪ'semɪk
glyceride => '^lisә,raid
glycerin => '^lisәrin
glycerine => '^lisәri:n
glycerol => '^lisә,rɔl
glyceryl => '^lisәril
glycine => '^laisi:n
glyco- => '^laikәj
glycogen => 'glaikәudʒәn
glycogenesis => '^laikәu'dʒenisis
glycogenic => '^laikәu'dʒenik
glycol => 'glaikәul
glycolysis => ^lai'kɔlisis
glycolytic => ,^laikә'litik
glycoprotein => ,^laikәu'prәuti:n
glycosaminoglycan => '^laikәjsә'mi:nәj'^laikæn
glycoside => '^laikә,said
glycosidic => ,^laikәj'sidik
glycosuria => .glaikәu'sjuriә
glycosuric => ,^laikәj'sjjәrik
Glyn => ^lin
glyph => glif
glyphic => ɡ'lɪfɪk
glyphosate => '^lifәseit
glyptic => 'gliptik
glyptodont => '^liptәdɔnt
glyptography => glip'tɒgrәfi
gnarl => nɑ:l
gnarled => nɑ:ld
gnarly => 'nɑ:li
gnash => næʃ
gnashed => næʃ
gnasher => næʃ
gnashes => næʃ
gnashing => 'næʃiŋ
gnat => næt
gnatcatcher => 'næt,kætʃә(r)
gnathic => 'næθik
gnathostomulid => næðəʊs'tɒmjʊlɪd
gnats => næts
gnaw => nɒ:
gnawing => 'nɒ:iŋ
gnaws => nɔ:z
gneiss => nais
gneissic => 'naisik
gneissose => 'naisәus
gnocchi => 'nɔki:, 'nɔ:-
gnome => nәum
gnomes => nəʊmz
gnomic => 'nәumik
gnomish => 'nәumiʃ
gnomon => 'nәumɔn
gnomonic => nəʊ'mɒnɪk
gnosis => 'nәusis
gnostic => 'nɔstik
Gnosticism => 'nɒstisizm
gnotobiotic => ,nәutәubai'ɔtik
GNP => dʒi:en'pi:
gnu => nju:
gnus => nu:z
go => gou
go around => ɡəu əˈraund
go ballistic => ɡəu bəˈlɪstɪk
go commando => ɡəu kəˈmændəʊ
go down on => ɡəu daun ɔn
go flying => ɡəu ˈflaɪɪŋ
go for it => ɡəu fɔ: it
go gold => ɡəu ɡəuld
go live => ɡəu liv
go overboard => ɡəu ˈəʊvəˌbɔ:d
go pear-shaped => ɡəu pɛə ʃeɪpt
go platinum => ɡəu ˈplætnəm
go postal => ɡəu ˈpəʊstəl
go spare => ɡəu spɛə
go walkabout => ɡəu ˈwɔ:kəbaut
go well => ɡəu wel
go with the flow => ɡəu wið ðə fləu
go-around => '^әjә,rajnd
go-between => '^әjbi,twi:n
go-by => '^әubai
go-cart => '^әukɑ:t
go-carts => 'ɡəukɑ:t
go-devil => '^әudevl
go-getter => '^әu'^etә
go-go => '^әu,^әu
go-kart => '^әu,kɑ:t
go-karting => 'ɡəʊk'ɑ:tɪŋ
go-karts => 'ɡəʊk'ɑ:ts
go-slow => '^әu'slәu
goa => 'gәuә
goad => gәud
goaded => gəʊdid
goading => gəʊdɪŋ
goads => gəʊdz
goal => gәul
goal area => ɡəul ˈɛəriə
goal kick => ɡəul kik
goal line => ɡəul lain
goalball => ˈgəʊlbɔ:l
goalie => '^әjli
goalkeeper => 'gәulki:pә
goalkeepers => ˈgəʊlki:pəz
goalkeeping => 'ɡəʊlki:pɪŋ
goalless => ˈgəʊlləs
goalmouth => ˈgəʊlmaʊθ
goalpost => 'gәulpәust
goalposts => ˈgəʊpəʊsts
goalscorer => ˈgəʊlskɔ:rə(r)
goaltender => '^әjl,tendә(r)
goaltending => ɡəʊl'tendɪŋ
Goan => '^әjәn
Goanese => ,^әjә'ni:z
goanna => '^әunә
goat => gәut
goat willow => ɡəut ˈwiləu
goatee => gәu'ti:
goateed => 'ɡəʊti:d
goatfish => '^әjtfiʃ
goatherd => 'gәuthә:d
goatherds => 'gəʊthɜːd
goatish => '^әjtiʃ
goatskin => 'gәutskin
goatskins => 'gəʊtskɪn
goatsucker => 'gәutsʌkә
goaty => '^әjti
gob => gɒb
gobbet => 'gɒbit
gobbing => 'ɡɒbɪŋ
gobble => 'gɒbl
gobbled => ˈgɔbəld
gobbledegook => ˈgɒbldigu:k
gobbledygook => 'gɒbldi.guk
gobbler => 'gɒblә
gobbles => ˈgɔbəlz
gobbling => ˈgɔbəlɪŋ
gobby => '^ɔbi
Gobelin => '^әubәlin
Gobi => '^әjbi
goblet => 'gɒblit
goblet cell => ˈgɔblɪt sel
goblets => ˈgɔblɪts
goblin => 'gɒblin
goblins => ˈgɔblɪnz
gobo => '^әubәu
gobs => gɒbz
gobsmack => ɡɒbz'mæk
gobsmacked => ˈgɒbsmækt
gobstopper => ˈgɒbstɒpə(r)
goby => 'gәubi
God => ^ɔd
god-awful => '^ɔd,ɔ:fjl
god-daughter => ˈgɔdˌdɔ:tə
Godavari => ^ә'dɑ:vәri
godchild => 'gɒdtʃaild
goddam => ˈgɒddæm
goddammit => ɡɒdæ'mɪt
goddamn => '^ɔddæm
goddamned => '^ɔddæmd
Goddard => '^ɔdә:d
goddaughter => ɡɒd'dɔ:tər
goddess => 'gɒdis
goddesses => ˈgɔdɪsiz
godet => gәu'de
godetia => ^әu'di:ʃә
godfather => 'gɒdfɑ:ðә
godfathers => ˈgɔdˌfɑ:ðəz
godfrey => '^ɔdfri
godhead => '^ɔdhed
godhood => 'gɒdhud
Godiva => ^әj'daivә
godless => 'gɒdlis
godlike => 'gɒdlaik
godliness => 'gɒdlinis
godly => 'gɒdli
godmother => 'gɒdmʌðә
godmothers => ˈgɔdˌmʌðəz
Godolphin => ^ә'dɔlfin
godown => 'gәudaun
godparent => 'gɒdperәnt
godparents => ˈgɔdˌpeərənts
gods => ɡɔdz
godsend => '^ɔdsend
godship => 'gɒdʃip
godson => 'gɒdsʌn
godsons => ˈgɔdˌsʌnz
godspeed => gɒd'spi:d
godward => '^ɔdwәd
godwards => '^ɔdwәdz
Godwin => '^ɔdwin
godwit => 'gɒdwit
Godwottery => ,^ɔd'wɔtәri
goer => 'gәuә
goes => ɡәus
goest => '^әjist
goeth => '^әjiθ
Goethe => 'gә:tә
goethite => '^әuθait
gofer => '^әjfә(r)
goffer => 'gɒfә
goffered => 'ɡəʊfəd
goffering => 'ɡəʊfəɪŋ
goffers => ˈɡəufəz
goggle => 'gɒgl
goggle-eye => 'ɡɒɡl'aɪ
goggle-eyed => '^ɔ^laid
goggled => 'ɡɒɡld
goggling => ˈɡɔɡlɪŋ
Gogol => '^ɔ^әl
Goidelic => ^ɔi'delik
going => 'gәuiŋ
going away => ˈgəʊɪŋ əˈwei
goitre => '^ɔitә(r)
goitres => ˈɡɔitəz
goitrous => '^ɔitrәs
golan => '^әj'lɑ:n
Golconda => gɒl'kɒndә
gold => gәuld
gold card => ɡəuld kɑ:d
gold dust => ɡəuld dʌst
gold leaf => ɡəuld li:f
gold medallist => ɡəuld ˈmedɵlɪst
gold mine => ɡəuld main
gold miner => ɡəuld ˈmaɪnə
gold plate => ɡəuld pleit
gold record => ɡəuld riˈkɔ:d
gold-beater => 'ɡəʊld,biːtə
gold-digger => ɡəuld ˈdiɡə
gold-plate => 'ɡəʊldpl'eɪt
gold-plated => ɡəuld ˈpleitid
gold-rimmed => 'ɡəʊldr'ɪmd
goldbrick => 'gәuldbrik
goldbricked => ˈɡəuldbrikt
goldbricking => ˈɡəuldbrikɪŋ
goldbricks => ˈɡəuldbriks
goldbug => 'gәuldbʌg
goldcrest => ˈgəʊldkrest
golden => 'gәuldn
golden ager => ˈɡəuldən ˈeidʒə
golden eagle => ˈɡəuldən ˈi:ɡl
golden goal => ˈɡəuldən ɡəul
golden goose => ˈɡəuldən ɡu:s
golden hamster => ˈɡəuldən ˈhæmstə
golden handcuffs => ˈɡəuldən ˈhændkʌfs
golden jubilee => ˈɡəuldən ˈdʒu:bəˌli:
golden oldie => ˈɡəuldən ˈəuldi
golden oriole => ˈɡəuldən ˈɔ:riəul
golden parachute => ˈɡəuldən ˈpærəʃu:t
golden retriever => ˈɡəuldən riˈtri:və
golden section => ˈɡəuldən ˈsekʃən
golden syrup => ˈɡəuldən ˈsirəp
golden wattle => ˈɡəuldən ˈwɔtl
golden wedding => ˈɡəuldən ˈwediŋ
goldeneye => 'gәuldәnai
goldenrod => 'gәuldnrɒd
goldenseal => ɡəʊl'denzi:l
goldfield => 'gәuldfi:ld
goldfinch => 'gәuldfintʃ
Goldfinger => 'ɡəuldfiŋə
goldfish => 'gәuldfiʃ
goldfish bowl => ˈgəʊldˌfɪʃ bəul
GOLDIE => '^әuldi:
goldilocks => 'gәuldilɒks
goldmines => 'gəuldmain
golds => ɡəuldz
goldsmith => 'gәuldsmiθ
goldsmiths => ˈgəʊldˌsmɪθs
goldwasser => '^әjld,vɑ:sә(r)
goldwork => 'ɡəʊldwɜ:k
golem => '^әulem
golf => gɒlf
golf ball => ɡɔlf bɔ:l
golf cart => ɡɔlf kɑ:t
golf club => ɡɔlf klʌb
golf course => ɡɔlf kɔː(r)s
golf links => ɡɔlf liŋks
golfer => 'gɒlfә
golfers => ˈgɔlfəz
golfing => ˈgɒlfɪŋ
Golgi => '^ɔ:ldʒi
goliath => gәu'laiәθ
golliwog => 'gɒliwɒg
golliwogs => 'gɒlɪwɒg
gollop => '^ɔlәp
golly => 'gɒli
GOM => ^ɔm
gombeen => ^ɔm'bi:n
Gomel => 'ɡəuməl
Gomorrah => ^ә'mɔrә
gonad => 'gәunæd
gonadal => 'gɒnædl
gonadotrophic hormone => ˌɡɔnədəˈtrɔfik ˈhɔ:ˌməʊn
gonadotrophin => ,^ɔnәdәu'trәufin
gonadotropin => ,^ɔnәdә'trɔpin,^әj'nædә-
Gond => ^ɔnd
gondola => 'gɒndәlә
gondolas => ˈɡɔndələz
gondolier => ,^ɔndә'liә
gondoliers => ,gɒndə'lɪə
Gondwana => ɡɔnd'wɑ:nə
gone => gɒn
goner => 'gɒnә
goners => ˈɡɔnəz
gonfalon => 'gɒnfәlәn
gonfalonier => .gɒnfәlә'niә
gong => gɒŋ
gongs => gɔ:ŋz
gonif => 'ɡɔnif
goniometer => .gәuni'ɒmitә
goniometric => ,^әuniә'metrik
goniometrical => ,^әuniә'metrikәl
goniometry => .gәuni'ɒmitri
gonna => 'ɡɔnә
gonococcus => .gɒnәu'kɒkәs
gonorrhea => ,^ɔnә'ri:ә
gonorrhoea => ,^ɔnә'ri:ә
gonzo => 'ɡɔnzәu
goo => gu:
goober => 'gu:bә
good => gud
good day => ɡud dei
good form => ɡud fɔ:m
good-for-nothing => '^jdfә,nʌθiŋ
good-humouredly => ,gud'hju:mədli
good-looker => 'ɡud'lukə
good-natured => ^jd'neitʃәd
goodbye => gud'bai
goodbyes => ˌɡudˈbaiz
goodfella => 'ɡʊdfelə
goodie => 'ɡudi
goodish => 'gudiʃ
goodliness => 'gudlinis
goodly => '^udli
goodman => 'gudmәn
goodness => 'gudnis
goods => guds
goodwife => 'gudwaif
goodwill => ^jd'wil
Goodwood => '^jdwjd
goody => 'gudi:
goody bag => ˈgʊdi: bæɡ
goody-goody => '^jdi'^jdi
goodyear => '^udjiә
gooey => 'gu:i
goof => gu:f
goof-up => 'ɡu:fʌp
goofed => ɡu:ft
goofing => ɡu:fɪŋ
goofs => ɡu:fs
goofus => '^u:fʌs
goofy => 'gu:fi
googly => 'gu:gli
googol => '^u:^ɔl
googolplex => '^u:^ɔlpleks
gooier => ˈɡu:iə
gook => 'guk
gooks => guːk; gʊk
gooly => 'ɡu:li
goombah => 'ɡumbɑ:
goon => gu:n
goonda => '^jndә
gooney bird => ˈɡu:ni bə:d
goons => ɡu:nz
goop => gu:p
goopy => ˈɡu:pi
goosander => ^u'sændә
goose => gu:s
goose egg => ɡu:s eɡ
goose-step => '^jsstep
gooseberries => ˈgu:sˌberi:z
gooseberry => 'gu:sbәri
goosebump => g
goosefish => 'ɡu:sfiʃ
goosefoot => 'gu:sfut
goosegog => '^jz^ɔ^,'^u:z-
gooseneck => 'gu:snek
goosey => 'gu:si
gopak => '^әjpæk
Gopher => '^әufә
gopherwood => 'ɡəufəwud
gopura => '^әupәrә
gora => '^әurә
goral => 'gɒ:rәl
Goran => ^ә'rɑ:n
gorblimey => ^ɔ:'blaimi
gorcock => 'gɒ:kɒk
gordian => '^ɔ:diәn
Gordon => '^ɔ:dn
gore => gɒ:
gored => gɔ:d
gores => gɔ:z
gorge => gɒ:dʒ
gorged => gɔ:dʒd
gorgeous => 'gɒ:dʒәs
gorges => gɔ:dʒz
gorget => 'gɒ:dʒit
gorging => gɔ:dʒɪŋ
gorgon => 'gɒ:gәn
gorgoneion => ^ɔ:'^әuniәn
Gorgonzola => .gɒ:gәn'zәulә
gorier => ˈgɔ:ri:ə
gorilla => gә'rilә
gorillas => ɡəˈriləz
gorily => '^ɔ: rili
Gorlovka => ɡɔ:'lɔvkə
gormandize => 'gɒ:mәndaiz
gormandized => ˈgɔ:mənˌdaɪzd
gormandizer => 'gɒ:mәndaizә
gormandizes => ˈgɔ:mənˌdaɪziz
gormandizing => ˈgɔ:mənˌdaɪzɪŋ
gormless => 'gɒ:mlis
gorp => ^ɔ:p
gorse => gɒ:s
gorsy => 'gɒ:si
gorton => '^ɔ:tn
gory => 'gɒ:ri
gosh => gɒʃ
goshawk => 'gɒshɒ:k
gosling => 'gɒzliŋ
goslings => 'ɡɒzlɪŋz
gospel => 'gɒspәl
gospeller => '^ɔspәlә
gospels => ˈɡɔspəlz
gosport => '^ɔspɔ:t
Goss => ^ɔs
gossamer => 'gɒsәmә
gossamery => '^ɔsәmәri
gossan => '^ɔsn
gossip => 'gɒsip
gossip column => ˈɡɔsip ˈkɔləm
gossiped => 'gɒsɪp
gossips => ˈɡɔsips
gossipy => 'gɒsipi
gossoon => ^ɔ'su:n
gossypol => '^ɔsi,pɔl
got => gɒt
gotcha => '^ɔtʃә
goth => gɒθ
Gotha => '^әuθә
gotham => 'gәutәm
Gothenburg => 'ɡɔθənbə:ɡ
gothic => 'gɒθik
Gothicism => 'gɒθisizm
goths => 'ɡɒθs
Gotland => '^ɔtlænd
gotta => '^ɔtә
gotten => 'gɒtn
gouache => ɡu'ɑ:ʃ
Gouda => 'gaudә
gouge => gaudʒ
gouged => gaʊdʒd
gouger => ˈɡaudʒə
gouges => gaʊdʒz
Gough => ^ɔf
gouging => '^audʒiŋ
goujon => 'ɡu:dʒən
goulash => 'gu:læʃ
goura => '^jәrә
gourami => '^urәmi, ^u'rɑ:mi
gourd => guәd
gourde => guәd
gourdful => '^jәdfjl
gourds => gɔ:dz
gourmand => 'guәmәnd
gourmandism => 'guәmәndizm
gourmandize => 'ɡuəməndaiz
gourmands => gʊəˈmɑ:ndz
gourmet => 'guәmei
gourmets => gʊəˈmeɪz
gout => gaut
gouts => gaʊt
goutweed => '^ajtwi:d
gouty => 'gauti
govern => 'gʌvәn
governable => 'gʌvәnәbl
governance => 'gʌvәnәns
governed => ˈɡʌvənd
governess => 'gʌvәnis
governesses => ˈgʌvənɪsiz
governessy => '^ʌvәnisi
governing => '^ʌvәniŋ
governing body => ˈɡʌvəniŋ ˈbɔdi
government => 'gʌvәnmәnt
government issue => ˈɡʌvənmənt ˈisju:
governmental => .gʌvәn'mentl
governor => 'gʌvәnә
Governor-General => 'ɡʌvənə'dʒenərəl
governorate => 'ɡʌvnɔ:reɪt
governors => ˈɡʌvənəz
governorship => '^ʌvənәʃip
governs => ˈɡʌvənz
gow => ɡau
gowan => 'gauәn
Gower => ^ɔә
gowk => gauk
gown => gaun
gowned => gaʊnd
gowns => ɡaunz
goy => gɒi
goya => '^ɔ:jɑ:
goyish => '^ɔiiʃ
grab => græb
grab bag => ɡræb bæɡ
grabber => 'græbә
grabble => 'græbl
grabby => 'græbi
graben => '^rɑ:bәn
grace => greis
grace note => ɡreis nəut
graceful => 'greisful
graceless => 'greislis
gracelessly => 'greislisli
Gracie => '^reisi
gracile => 'græsail
gracilis => '^ræsilis
gracility => ^rә'siliti
gracious => 'greiʃәs
graciousness => .ɡreiʃi:'ɔsiti
grackle => 'grækl
grad => ɡræd
gradable => '^reidәbl
gradate => grә'deit
gradated => ɡrəˈdeitid
gradates => ɡrəˈdeits
gradating => ɡrəˈdeitɪŋ
gradation => grei'deiʃәn
gradational => grei'deiʃәnl
gradationally => grәˊdeiʃәnәli
gradations => ɡrəˈdeiʃənz
grade => greid
grade crossing => ɡreid ˈkrɔsiŋ
grade point average => ɡreid pɔint ˈævəridʒ
graded => 'ɡreidid
gradely => '^reidli
grader => '^reidә
gradient => 'greidiәnt
gradients => ˈgreɪdi:ənts
grading => '^reidiŋ
gradual => 'grædʒuәl
gradualism => '^rædʒuәlizәm
gradualist => 'ɡrædʒʊəlɪst
gradually => 'grædʒuәli
gradualness => 'grædʒuәlnis
graduand => '^rædjjænd,-dʒj-
graduate => 'grædʒueit
graduates => ˈɡrædjuits
graduating => ˈɡrædjuitɪŋ
graduation => .grædʒu'eiʃәn
graduations => ˈgrædʒu:ˈeɪʃənz
gradus => 'greidәs
Graecism => '^ri:sizәm
Graeco- => '^ri:kәj
Graf => ^rɑ:f
graffitist => ^rә'fi:tist
graffito => grә'fi:tәu
grafs => ɡrɑ:f
graft => grɑ:ft
grafted => ɡrɑ:ftid
grafter => 'grɑ:ftә
grafting => '^rɑ:ftiŋ
grafts => ɡrɑ:fts
graham => 'ɡreiәm
grail => ^reil
grain => grein
grained => greind
grainer => '^reinә
graininess => 'greininis
graining => 'greiniŋ
grains => ^reinz
grainy => 'greini
gralloch => '^rælәk
gram => græm
gramicidin => ,^ræmi'saidin
graminaceous => ,^reimi'neiʃәs
graminivorous => ,^ræmi'nivәrәs
gramma => ɡ'rəmə
grammalogue => 'græmәlɒg
grammar => 'græmә
grammarian => grә'mєәriәn
grammarians => ɡvəˈmɛəriənz
grammars => ˈɡræməz
grammatical => grә'mætikl
grammaticality => ,^ræmәti'kæliti
grammaticalization => ,^ræmәtikәlai'zeiʃәn
grammaticalize => ^rә'mætikәlaiz
grammatically => ɡrə'mætɪklɪ
grammaticalness => ɡrə'mætɪklnəs
gramme => græm
Grammy => 'græmi
gramophone => 'græmәfәun
gramophones => ˈgræməˌfəʊnz
gramp => ^ræmp
Grampian => '^ræmpiәn
gramps => ^ræmps
grampus => '^ræmpәs
gran => '^ræn
Gran Chaco => '^rɑ:n'tʃɑ:kәu
grana => 'ɡrænә. 'ɡreinә
Granada => ^rɑ:'nɑ:dɑ:
granadilla => .grænә'dilә
granaries => ˈgrænəri:z
granary => 'grænәri
grand => grænd
grand duchess => ɡrænd ˈdʌtʃɪs
grand duchy => ɡrænd ˈdʌtʃi
grand duke => ɡrænd dju:k
grand finale => ɡrænd fəˈnæli:
grand jury => ɡrænd ˈdʒuəri
grand mal => '^ræn'mæl
grand manner => ɡrænd ˈmænə
grand master => ɡrænd ˈmɑ:stə
grand opera => ɡrænd ˈɔpərə
grand piano => ɡrænd piˈænəu
Grand Prix => ^rɑ:n 'pri
grand tour => ɡrænd tuə
grandad => '^rændæd
grandaddy => ɡ'rændædɪ
grandads => ˈɡrændædz
grandam => '^rændæm
grandbaby => '^rænd,beibi
grandchild => '^rændtʃaild
grandchildren => .tʃildrәn
granddaddy => ˈgrændædi
granddaughter => '^rændɔ:tә(r)
granddaughters => ˈgrænˌdɔ:təz
grande => ^rɑ:nd
grande dame => ɡrɑ:nd deɪm
grandee => græn'di:
grandees => ɡrænˈdi:z
grandeur => 'grændʒә
grandfather => 'grændfɑ:ðә
grandfather clause => ˈɡrændˌfɑ:ðə klɔ:z
grandfather clock => ˈɡrændˌfɑ:ðə klɔk
grandfatherly => '^rænd,fɑ:ðәli
grandfathers => ˈɡrændˌfɑ:ðəz
grandiflora => ɡræn'daɪflɔ:rə
grandiloquence => græn'dilәkwәns
grandiloquent => græn'dilәkwәnt
grandiose => 'grændiәus
grandiosity => .grændi'ɒsiti
grandkid => grændkid
grandly => 'grændli
grandma => 'grændmɑ:
grandmama => '^rændmә,mɑ:
grandmas => ˈɡrænmɑ:z
grandmaster => ɡ'rændm'ɑ:stə
grandmother => 'grændmʌðә
grandmotherly => '^rænd,mʌðәli
grandmothers => ˈɡrændˌmʌðəz
grandnephew => '^rænd,nevju:;-,nefju:
grandness => 'grændnis
grandniece => 'grændni:s
grandpa => '^rænpɑ:, '^rændpɑ:
grandpappy => 'ɡrænd'pæpɪ
grandparent => 'grændperәnt
grandparental => ,ɡrændpə'rentəl
grandpas => ˈɡrænpɑ:z
grands => ɡrændz
grandsire => 'grændsaiә
grandson => 'grændsʌn
grandsons => ˈgrændˌsʌnz
grandstand => 'grændstænd
grandstanding => ˈgrænstændɪŋ
grandstands => ˈgrændˌstændz
grange => 'greindʒ
granger => 'greindʒә
grangerize => '^reindʒәraiz
granges => ɡreindʒz
graniferous => grә'nifәrәs
granita => ^ræ'ni:tә
granite => 'grænit
granites => ɡ'rænɪts
graniteware => 'grænitwєә
granitic => græ'nitik
granitization => ,^ræniti'zeiʃәn
granitoid => '^rænitɔid
granivore => '^rænivɔ:(r)
granivorous => grә'nivәrәs
grannie => '^ræni
grannies => ˈgræni:z
granny => '^ræni
granny flat => ˈgræni: flæt
granny glasses => ˈgræni: ˈglɑ:sɪz
granodiorite => ,^rænәu'daiә,rait
granola => ɡrә'nәulә
granolithic => ,^rænәj'liθik
granophyre => '^rænәfaiә
grant => grænt
grant-in-aid => ,^rɑ:ntin'eid
Granta => 'ɡræntə
granted that => ˈgrɑ:ntɪd ðæt
grantee => græn'ti:
grantees => ɡrɑːn'tiː
Granth => ^rʌnt
Grantham => '^rænθәm
granting => ɡ'rɑ:ntɪŋ
grantor => 'græntә
granular => 'grænjulә
granularity => .grænju'læriti
granulate => 'grænjuleit
granulated => '^rænjuleitid
granulates => ˈgrænjəˌleɪts
granulating => '^rænjuleitiŋ
granulation => .grænju'leiʃәn
granulator => '^rænjuleitә
granule => 'grænju:l
granules => grænju:ls
granulite => '^rænjulait
granulocyte => '^rænjulәsait
granulocytic => ɡrænjʊləʊ'saɪtɪk
granuloma => ,^rænju'lәumә
granulometric => ,^rænjulә'metrik
granum => '^reinәm
grape => greip
grape hyacinth => ɡreip ˈhaiəsinθ
grapefruit => 'greipfru:t
grapefruits => ɡ'reɪpfru:ts
grapeshot => 'greipʃɒt
grapevine => 'greipvain
grapevines => ˈgreɪpˌvaɪnz
grapey => '^reipi
graph => græf
grapheme => 'græfi:m
graphemic => græ'fi:mik
graphemics => ^ræ'fi:miks
graphic => 'græfik
graphic arts => ˈɡræfik ɑ:ts
graphic design => ˈɡræfik diˈzain
graphic designer => ˈɡræfik dɪˈzaɪnə
graphic equalizer => ˈɡræfik ˈi:kwəˌlaizə
graphic novel => ˈɡræfik ˈnɔvəl
graphicacy => '^ræfikәsi
graphical => '^ræfikәl
graphics => 'græfiks
graphics card => ˈgræfɪks kɑ:d
graphite => 'græfait
graphitic => ɡræ'fɪtɪk
graphitization => ,^ræfitai'zeiʃәn
graphitize => '^ræfitaiz
graphologist => græ'fɒlәdʒist
graphology => græ'fɒlәdʒi
grapnel => 'græpnl
grapnels => 'græpn(ə)l
grappa => '^rɑ:pɑ:
grapple => græpl
grappled => ˈgræpəld
grappler => '^ræplә
grapples => ˈgræpəlz
grappling => '^ræpliŋ
grappling hook => ˈgræplɪŋ huk
grappling iron => ˈgræplɪŋ ˈaiən
graptolite => '^ræptәlait
Grasmere => '^rɑ:smiә(r)
grasp => græsp
grasped => ɡrɑ:spt
grasper => ɡ'rɑ:spə
grasping => 'græspiŋ
grasps => ɡrɑ:sps
grass => græs
grass carp => ɡrɑ:s kɑ:p
grass pea => ɡrɑ:s pi:
grass tree => ɡrɑ:s tri:
grassbox => '^rɑ:sbɔks;'^ræs-
Grasse => ɡrɑ:s
grassed => grɑ:st
grasshopper => 'græshɒpә
grasshoppers => ˈgræsˌhɔpəz
grassier => ˈgræsi:ə
grassiness => 'græsinis
grassing => ɡ'rɑ:sɪŋ
grassland => 'græslænd
grasslands => ɡ'rɑ:slændz
grassless => 'græslis
grassquit => '^rɑ:skwit;'^ræs-
grassy => 'græsi
grate => ^reit
grated => '^reitid
grateful => 'greitful
gratefully => 'greitfuli
grater => '^reitә
graters => ɡ'reɪtəz
grates => greɪts
graticule => 'grætikju:l
gratification => .grætifi'keiʃәn
gratified => ˈgrætəˌfaɪd
gratifies => ˈgrætəˌfaɪz
gratify => 'grætifai
gratifying => 'grætifaiiŋ
gratifyingly => 'grætifaiiŋli
gratin => '^rætn
grating => 'greitiŋ
gratingly => ɡ'reɪtɪŋlɪ
gratis => 'greitis
gratitude => 'grætitju:d
gratuities => grəˈtu:ɪti:z
gratuitous => grә'tju:itәs
gratuitousness => ɡrə'tju:itəs
gratuity => grә'tju:iti
graunch => ^rɔ:ntʃ
graupel => '^raupәl
grav => ^ræv
gravamen => grә'veimen
grave => greiv
grave accent => ^rɑ:v
gravedigger => 'greivdigә
gravel => 'grævәl
gravel-blind => '^rævәlblaind
gravelly => 'grævәli
gravels => ˈɡrævəlz
gravely => 'greivli
graven => 'greivәn
graven image => ˌgreɪvn ˈɪmɪdʒ
graveness => 'greivnis
Gravenstein => '^rɑ:ven,stain
graver => 'greivә
graves => ɡrɑ:v
graveside => '^reivsaid
gravestone => 'greivstәun
gravestones => ˈgreɪvˌstəʊnz
Gravettian => ^rә'vetiәn
graveyard => 'greivjɑ:d
graveyards => ˈgreɪvˌjɑ:dz
gravid => 'grævid
gravies => ˈɡreiviz
gravimeter => grә'vimitә
gravimetric => ,^rævi'metrik
gravimetry => ^rә'vimitri
graving => '^reiviŋ
graving dock => ˈɡreiviŋ dɔk
gravitas => '^rævitæs
gravitate => 'græviteit
gravitated => ˈgrævɪˌteɪtid
gravitates => ˈgrævɪˌteɪts
gravitating => ɡ'rævɪteɪtɪŋ
gravitation => .grævi'teiʃәn
gravitational => .grævi'teiʃәnәl
gravitational lens => ˌɡræviˈteiʃnəl lenz
gravitationally => ,ɡrævi'teiʃənəli
gravities => 'grævɪtɪ
graviton => '^rævitɔn
gravity => 'græviti
gravity wave => ˈɡræviti weiv
gravity-fed => ɡ'rævɪti:f'ed
gravlax => '^rævlæks
gravure => grә'vjuә
gravy => 'greivi
gravy boat => ˈɡreivi bəut
gravy train => ˈɡreivi trein
gray => grei
graybeard => 'greibiәd
grayed => greɪd
graying => '^reiiŋ
grayish => 'greiiʃ
graylag => '^reilæ^
grayling => 'greiliŋ
grayness => 'greinis
grays => ɡreiz
Grayson => '^reisn
graywacke => 'grei.wæk
graz => ^rɑ:ts
graze => greiz
grazed => ɡreizd
grazer => 'greizә
grazers => 'greizə
grazes => ɡreiziz
grazier => 'greiziә
grazing => 'greiziŋ
grease => gri:s
grease monkey => ɡri:s ˈmʌŋki
greaseball => 'ɡriːsbɔːl
greased => ^ri:zd, ^ri:st
greaseless => '^ri:slis
greasepaint => 'gri:speint
greaseproof => 'gri:spru:f
greaseproof paper => ˌgri:spru:f ˈpeɪpə(r)
greaser => '^ri:sә
greases => ɡri:siz
greasewood => 'gri:swud
greasier => ˈgri:si:ə
greasily => 'gri:zili
greasiness => 'gri:zinis
greasing => '^ri:siŋ
greasy => 'gri:zi
greasy spoon => ˈgri:si: spu:n
great => greit
great circle => ɡreit ˈsə:kl
great white shark => ɡreit hwait ʃɑ:k
great-aunt => '^reit'ɑ:nt;-'ænt
great-grandchild => ,^reit'^rændtʃaild
great-hearted => ɡ'reɪth'ɑ:tɪd
great-nephew => '^reit,nevju:;-,nefju:
great-niece => '^reitni:s
great-uncle => '^reit'ʌŋkl
greatcoat => '^reitkәjt
greatcoats => ˈɡreitkəuts
greater => '^reitә(r)
greatest => '^reitist
greatly => 'greitli
greatness => 'greitnis
greats => ɡreits
greave => gri:v
greaves => gri:vz
grebe => ^ri:b
grebo => ɡ'ri:bəʊ
Grecian => 'gri:ʃәn
Grecism => 'gri:sizm
Greco => '^rekәj
Greco- => '^ri:kәj,'^rekәj
Greco-Roman => '^ri:kәu'rәumәn
Greece => gri:s
greed => gri:d
greedier => ˈɡri:diə
greedily => 'gri:dili
greediness => 'gri:dinis
greedy => 'gri:di
greegree => '^ri:^ri:
Greek => gri:k
green => gri:n
green audit => ɡri:n ˈɔ:dit
green bean => ɡri:n bi:n
green card => ɡri:n kɑ:d
green fee => ɡri:n fi:
green monkey => ɡri:n ˈmʌŋki
green onion => ɡri:n ˈʌnjən
green pepper => ɡri:n ˈpepə
green salad => ɡri:n ˈsæləd
green thumb => ɡri:n θʌm
green turtle => ɡri:n ˈtə:tl
green woodpecker => ɡri:n ˈwʊdˌpekə
green-eyed monster => ˈgri:nˌaɪd ˈmɔnstə
green-fingered => 'ɡri:n'fiŋɡəd
greenback => 'gri:nbæk
greenbacks => ˈgri:nˌbæks
greenbelt => 'gri:nbelt
greenbottle => '^ri:n,bɔtl
greenbrier => 'gri:nbraiә
greenbul => ɡri:n'bʊl
greener => 'gri:nә
greenery => 'gri:nәri
greenfeed => '^ri:nfi:d
greenfield => ˈgri:nfi:ld
greenfinch => '^ri:nfintʃ
greenfly => 'gri:nflai
greengage => 'gri:ngeidʒ
greengages => ˈɡri:nˈɡeidʒz
greengrocer => 'gri:ngrәusә
greengrocers => ˈɡri:nɡrəusəz
greengrocery => 'gri:ngrәusәri
greenhead => 'ɡri:nhed
greenheart => 'gri:nhɑ:t
greenhorn => 'gri:nhɒ:n
greenhorns => 'griːnhɔːn
greenhouse => 'gri:nhaus
greenhouse effect => ˈɡri:nhaus iˈfekt
greenhouse gas => ˈɡri:nhaus ɡæs
greenhouses => ɡ'ri:nhaʊzɪz
greenie => '^ri:ni
greening => 'gri:niŋ
greenish => 'gri:niʃ
greenkeeper => 'gri:nki:pә
Greenland => 'gri:nlәnd
Greenlandic => ^ri:n'lændik
greenlet => 'gri:nlit
greenling => '^ri:nliŋ
greenly => 'gri:nli
greenmail => '^ri:nmeil
greenness => 'gri:nnis
greenockite => '^ri:nә,kait
greenpeace => 'gri:npi:s
greenroom => '^ri:nru:m
greensand => 'gri:nsænd
greenshank => 'gri:nʃæŋk
greenskeeper => '^ri:nz,ki:pә(r)
greenstone => 'gri:nstәun
greenstuff => '^ri:nstʌf
greensward => 'gri:nswɒ:d
greenwashing => ɡ'ri:nwɒʃɪŋ
greenway => '^ri:nwei
Greenwich => 'grinidʒ
greenwood => 'gri:nwud
greeny => 'gri:ni
greet => gri:t
greeted => ɡ'ri:tɪd
greeter => ˈgri:tə(r)
greeting => 'gri:tiŋ
greets => ɡri:ts
greg => greg
gregarine => '^re^әrain,-rin
gregarious => gre'gєәriәs
gregariousness => ɡrɪ'ɡerɪəsnəs
Gregorian => gre'gɒ:riәn
Gregorian calendar => ^ri'^ɔ:riәn
gregory => '^re^әri
greisen => '^raizn
gremlin => 'gremlin
gremlins => ˈɡremlinz
Grenada => ^rә'neidә
grenade => gri'neid
grenades => grəˈneɪdz
grenadier => ,^renә'diә
grenadiers => ˌɡrenəˈdiəz
grenadilla => ,^renә'dilә
grenadine => '^renәdi:n
Grenoble => ^rә'nәjbl
greta => '^retә
grew => gru:
grey => grei
grey matter => ɡrei ˈmætə
greybeard => ˈgreɪbɪəd
greyhen => 'ɡrei'hen
greyhound => 'greihaund
greyhounds => ˈɡreihaundz
greying => 'ɡreiiŋ
greyish => '^reiiʃ
greylag => ɡ'reɪlæɡ
greyly => ɡ'reɪlɪ
greyness => ɡreɪnəs
greys => ɡreiz
greyscale => 'ɡreɪ.skeɪl
Greystone => '^reistәjn
greywacke => '^rei,wækә,-wæk
gribble => '^ribl
Grice => ^rais
gricer => ɡrais
grid => grid
gridded => grɪd
gridder => '^ridә
griddle => 'gridl
griddlecake => ɡ'rɪdlkeɪk
griddled => ˈɡridld
griddles => ˈɡridlz
griddling => ˈɡridlɪŋ
gridiron => 'gridaiәn
gridlock => ˈgrɪdlɒk
gridlocked => 'grɪdlɒk
grids => ɡ'rɪdz
grief => gri:f
grief-stricken => '^ri:f,strikәn
grievance => 'gri:vәns
grieve => gri:v
grieves => ɡri:vz
grieving => ɡri:vɪŋ
grievous => 'gri:vәs
grievously => ˈgri:vəslɪ
Griff => ^rif
griffin => '^rifin
griffith => '^rifiθ
griffon => 'ɡrɪfən
grift => grift
grifter => '^riftә
grig => grig
grike => ^raik
grill => gril
grillade => ɡri'lɑ:d
grillage => '^rilidʒ
grille => gril
grilled => grild
grilles => grɪlz
grills => ɡrilz
grilse => grils
grim => grim
grimace => gri'meis
grimaced => ˈgrɪmɪst
grimaces => ˈgrɪmɪsiz
grimacing => grɪ'meɪsɪŋ
grimalkin => gri'mælkin
grime => graim
grimed => graɪmd
grimily => 'graimili
griminess => ɡ'raɪmɪnɪs
griming => graɪmɪŋ
grimly => 'grimli
grimm => ^rim
grimmer => ɡrimə
grimness => 'grimnis
Grimsby => 'ɡrimzbi
grimy => 'graimi
grin => grin
grinch => ɡ'rɪntʃ
grind => graind
grind away => ɡraind əˈwei
grind on => ɡraind ɔn
grinder => 'graindә
grinding => 'graindiŋ
grindingly => 'graindiŋli
grinds => ɡraindz
grindstone => 'graindstәun
grindstones => ˈgraɪndˌstəʊnz
gringa => 'ɡriŋɡə
gringo => 'griŋgәu
grins => ɡrinz
grip => grip
gripe => graip
griped => graɪpt
griper => ɡ'raɪpər
gripes => ɡraips
griping => ˈgraɪpɪŋ
grippe => grip
gripped => ɡript
gripper => '^ripә
grippy => ˈɡripi
grisaille => ^ri'zeil
Griselda => ^ri'zeldә
griseofulvin => ,^rizi:әu'fulvin
grisette => ^ri'zet
griskin => 'griskin
grisliness => 'grizlinis
grisly => 'grizli
grison => '^rizәn
grist => grist
gristle => 'grisl
gristly => '^risli
gristmill => 'gristmil
grit => grit
grits => grits
gritstone => '^ritstәun
gritted => grɪtid
gritter => '^ritә
grittier => ˈɡritiə
grittiness => 'gritinis
gritting => grɪtɪŋ
gritty => 'griti
grivet => '^rivit
grizzle => 'grizl
grizzled => 'grizld
grizzles => ˈɡrizlz
grizzlies => ˈgrɪzli:z
grizzling => ˈɡrizlɪŋ
grizzly => 'grizli
grizzly bear => ˌgrɪzli ˈbeə(r)
groan => grәun
groaned => ɡrəund
groans => ɡrəunz
groat => grәut
groats => ^rәuts
grocer => 'grәusә
grocers => ˈɡrəusəz
grocery => 'grәusәri
groceteria => ,^rәusә'tiәriә
grog => grɒg
groggier => ˈgrɔgi:ə
groggily => 'grɒdʒɪlɪ
groggy => 'grɒgi
grogram => 'grɒgrәm
groin => ^rɔin
groined => grɒɪn
groins => ɡrɔinz
grok => ^rɔk
grommet => 'grɒmit
gromwell => '^rɔmwәl
Groningen => 'ɡrəuniŋən
groom => gru:m
groomed => gru:md
grooms => ɡrumz
groomsman => 'gru:mzmәn
groove => gru:v
grooved => ɡru:vd
grooves => ɡru:vz
grooving => '^ru:viŋ
groovy => 'gru:vi
grope => grәup
groped => ɡrəupt
gropes => ɡrəups
groping => 'ɡrɔpiŋ
gropingly => 'grәupiŋli
gros => ɡrәus
gros point => ˈɡrəusˈpwæŋ
grosbeak => 'grәusbi:k
groschen => '^rәuʃәn
grosgrain => 'grәusgrein
gross => grәus
gross ton => ɡrəus tʌn
grossed => ɡrəust
grosser => 'ɡrәusә
grosses => ɡrəusiz
grossing => ɡrəusɪŋ
grossly => 'grәusli
grossness => 'grәusnis
grossular => ɡ'rəʊsjʊlə
Grosvenor => '^rәuvnә
grosz => grɒ:ʃ
grot => ^rɔt
grotesque => grәu'tesk
grotesquely => ɡrəʊ'tesklɪ
grotesquerie => grәu'teskәri
grottier => ˈɡrɔtiə
grotto => 'grɒtәu
grottos => ɡ'rɒtəʊz
grotty => '^rɔti
grouch => grautʃ
grouched => graʊtʃ
grouches => graʊtʃiz
grouchily => 'grautʃili
grouching => graʊtʃ
grouchy => 'grautʃi
ground => graund
ground ball => ɡraund bɔ:l
ground bass => ɡraund beis
ground beef => ɡraund bi:f
ground beetle => ɡraund ˈbi:tl
ground cherry => ɡraund ˈtʃeri:
ground control => ɡraund kənˈtrəul
ground cover => ɡraund ˈkʌvə
ground crew => ɡraund kru:
ground effect => ɡraund iˈfekt
ground floor => ɡraund flɔ:
ground glass => ɡraund ɡlɑ:s
ground ivy => ɡraund ˈaivi
ground out => ɡraund aut
ground pine => ɡraund pain
ground plan => ɡraund plæn
ground rent => ɡraund rent
ground sloth => ɡraund slɔ:θ
ground staff => ɡraund stɑ:f
ground stroke => ɡraund strəuk
ground tackle => ɡraund ˈtækl
ground zero => ɡraund ˈziərəu
ground-breaking => 'graʊndˌbreɪkɪŋ
groundbait => ɡraʊnd'beɪt
groundbreaking => ˈgraʊndbreɪkɪŋ
grounded => '^raundid
grounder => 'graundә
groundfish => '^rajndfiʃ
groundhog => 'graund'hɒg
grounding => 'graundiŋ
groundless => '^aundlis
groundlessly => 'graundlisli
groundling => '^raundliŋ
groundmass => '^rajndmæs
groundnut => 'graundnʌt
groundnuts => ˈɡraundnʌts
groundout => '^rajndajt
groundsel => 'graundsl
groundskeeper => 'ɡraundz,ki:pə
groundswell => ˈgraʊndswel
groundwater => 'graundwɒ:tә
groundwork => 'graundwә:k
group => gru:p
group captain => ɡru:p ˈkæptin
group therapy => ɡru:p ˈθerəpi
group work => ɡru:p wə:k
grouper => 'gru:pә
groupies => ˈgru:pi:z
grouping => 'gru:piŋ
groupthink => '^ru:pθiŋk
groupuscule => '^ru:pә,skju:l
groupy => 'ɡru:pi
grouse => graus
groused => graʊst
grouser => '^rausә
grouses => graʊsiz
grousing => graʊsɪŋ
grout => graut
grouted => ɡrautid
grouts => ɡrauts
grove => grәuv
grovel => 'grɒvl
grovelled => ˈgrɔvəld
groveller => ˊgrɒvlә
grovellingly => ˊgrɒvliŋli
grovels => ˈgrɔvəlz
Groves => grəuvz
grovy => '^rәuvi
grow => grәu
grower => 'grәuә
growing => 'grәuiŋ
growing point => ˈgrəʊɪŋ pɔint
growing season => ˈgrəʊɪŋ ˈsi:zən
growl => graul
growled => ɡrauld
growler => '^raulә
growlingly => 'grauliŋli
growls => ɡraulz
grown => grәun
grownup => 'ɡrәun.ʌp
grownups => 'ɡrəun,ʌp
grows => ɡrəuz
growth => grәuθ
growth industry => ɡrəuθ ˈindəstri
growths => ɡ'rəʊθs
groyne => grɒin
grub => grʌb
grubbed => grʌbd
grubber => '^rʌbә
grubbier => ˈɡrʌbiə
grubbing => ɡ'rʌbɪŋ
grubby => 'grʌbi
grubs => grʌbz
grubstake => '^rʌbsteik
grubstaked => ˈɡrʌbsteikt
grubstakes => ˈɡrʌbsteiks
grubstaking => ˈɡrʌbsteikɪŋ
grudge => grʌdʒ
grudges => ɡrʌdʒz
grudging => 'grʌdʒiŋ
grudgingly => 'grʌdʒiŋli
gruel => 'gru:әl
grueling => '^ruәliŋ
gruesome => 'gru:sәm
gruesomely => 'ɡru:səmlɪ
gruesomeness => ˊgruːsәmnis
gruff => grʌf
gruffly => 'grʌfli
grumble => 'grʌmbl
grumbled => ˈɡrʌmbld
grumbler => 'grʌmblә
grumbles => ˈɡrʌmblz
grumbling => '^rʌmbliŋ
grumblingly => 'grʌmbliŋli
grump => ^rʌmp
grumpier => ˈgrʌmpi:ə
grumpily => 'ɡrʌmpɪlɪ
grumpish => '^rʌmpiʃ
grumpy => 'grʌmpi
Grundy => 'grʌndi
grunge => ^rʌndʒ
grungy => '^rʌndʒi
grunion => '^rʌnjәn
grunt => grʌnt
grunted => ɡrʌntid
grunter => '^rʌntә
grunting => '^rʌntiŋ
gruntled => '^rʌntld
grunts => ɡrʌnts
gryke => ^raik
gryphon => '^rifәn
grysbok => 'graisbɒk
GT => dʒi:'ti:
guacamole => ˌgwækəˈməʊleɪ
guacharo => 'gwɑ:tʃәrәu
Guadalcanal => .gwɑ:dlkә'næl
Guadalquivir => ,^wɑ:dәl'kwivә(r)
Guadeloupe => ,^wɑ:dә'lu:p
Guadiana => ,^wɑ:di'ɑ:nә
guaiacol => '^waiәkɔl,-kәjl
Guam => 'gwɑ:m
Guamanian => ^wɑ:'meiniәn
guan => ɡwɑ:n
guanaco => gwә'nɑ:kәu
guanacos => ɡwəˈnɑ:kəuz
Guangdong => '^wɑ:ŋ'djŋ
guanidine => '^wænәdi:n
guanine => '^wɑ:ni:n
guano => 'gwɑ:nәu
guanosine => '^wɑ:nәsin
guanxi => 'ɡuæn'ʃi:
guar => 'ɡɑ:r
Guarani => .gwɑ:rә'ni:
guarantee => .gærәn'ti:
guarantees => ˌɡærənˈti:z
guarantor => 'gærәntә
guarantors => ɡærən'tɔ:z
guaranty => 'gærәnti
guard => gɑ:d
guard cell => ɡɑ:d sel
guard dog => ɡɑ:d dɔɡ
guard hair => ɡɑ:d hɛə
guardant => '^ɑ:dnt
guarded => 'gɑ:did
guardee => '^ɑ:di:
guardhouse => 'gɑ:dʒhaus
guardian => 'gɑ:diәn
guardians => 'ɡɑ:dɪənz
guardianship => 'gɑ:diәnʃip
guarding => '^ɑ:diŋ
guardrail => '^ɑ:dreil
guardroom => 'gɑ:dru:m
guardsman => 'gɑ:dzmәn
guardsmen => 'gɑːdzmən
Guarneri => ^wɑ:'neri:
Guatemala => .gwɑ:tә'mɑ:lә
Guatemalan => ,ɡwæti'mɑ:lən
guava => '^wɑ:vә
guavas => ˈɡwɑ:vəz
guayabera => ,ɡwaiə'berə
Guayaquil => ,^waiә'ki:l
guayule => gwә'ju:li
gub => 'ɡʌb
gubernatorial => .gju:bәnә'tɒ:riәl
guck => gʌk
guddle => '^ʌdl
gudgeon => 'gʌdʒәn
guelder rose => ˈɡeldə rəuz
guenon => ^ә'nәun
guerdon => 'gә:dn
guerilla => ^ә'rilә
guerillas => ɡə'rɪlə
Guernica => 'ɡwεənikə
Guernsey => '^ә:nzi
guerrilla => gә'rilә
guerrillas => ɡəˈriləz
guess => ges
guessable => '^esәbl
guessed => ɡest
guesses => ɡesiz
guessing => 'ɡesɪŋ
guesstimate => '^estimit
guesswork => 'geswә:k
guest => gest
guest beer => ɡest biə
guest house => ɡest haus
guest worker => ɡest ˈwə:kə
guesthouse => '^esthajs
guestimate => '^estimit
Guevara => ^e'vɑ:rɑ:
guff => gʌf
guffaw => gʌ'fɒ:
guffawed => gəˈfɔ:d
guffawing => gəˈfɔ:ɪŋ
guffaws => gəˈfɔ:z
Guggenheim => '^j^әnhaim
guiana => ^ai'ænә, ^i'ænә
guidable => 'gaidәbl
guidance => 'gaidns
guide => gaid
guide rope => ɡaid rəup
guidebook => 'gaidbuk
guidebooks => 'ɡaɪdbʊks
guided => 'ɡaidid
guideline => 'gaidlain
guidepost => 'gaidpәust
guider => 'ɡaɪdə(r)
guideway => '^aidwei
guiding => '^aidiŋ
Guido => '^aidәj
guidon => 'gaidɒn
Guienne => ^wi:'jen
Guignol => ɡi:'njɔl
guild => gild
guilder => 'gildә
guilders => ˈɡildəz
guildhall => '^ild,hɔ:l
guildhalls => ˈɡildˌhɔ:lz
guilds => 'ɡɪldz
guile => gail
guileful => 'gailful
guileless => 'gailis
Guilin => '^wei'lin
Guillaume => ,^i:'jәum
guillemot => 'gilimɒt
guilloche => gi'lәuʃ
guillotine => 'gilәti:n
guillotined => 'ɡɪləti:nd
guillotines => 'ɡɪləti:nz
guillotining => ɡɪlə'ti:nɪŋ
guilt => gilt
guilt-ridden => 'ɡɪltr'ɪdn
guiltier => ˈɡiltiə
guiltily => '^iltili
guiltiness => 'giltinis
guiltless => '^iltlis
guilty => 'gilti
guimpe => gimp
guinea => 'gini
guinea fowl => ˈɡini faʊl
guinea pig => '^inipi^
Guinea-Bissau => '^ini bi'sәu
Guinean => '^iniәn
guineas => 'gɪnɪ
Guinness => 'ginis
guipure => gi'pjuә
guiro => '^waiәrәj
guise => gaiz
guiser => 'ɡaizə
guises => gaɪziz
guitar => gi'tɑ:
guitarfish => ^i'tɑ:fiʃ
guitarist => gi'tɑ:rist
guitarists => ɡiˈtɑ:rists
Guiyang => '^wei'jɑ:ŋ
Guizhou => '^wei'dʒu:
Gujarat => ,ɡu:dʒe'rɑ:t
Gujranwala => ,ɡu:dʒrən'wɑ:lə
gulag => ^u:'lɑ:^
gular => '^ju:lә(r)
gulch => gʌlʃ
gulden => '^uldәn
gules => gju:lz
gulf => gʌlf
gulfweed => 'gʌlfwi:d
gull => gʌl
gulled => gʌld
gullery => 'ɡʌlərɪ
gullet => 'gʌlit
gullets => ˈɡʌlits
gulley => 'ɡʌlɪ
gullibility => .gʌli'biliti
gullible => 'gʌlibl
gullied => ˈgʌli:d
gullies => ˈgʌli:z
gulling => gʌlɪŋ
Gulliver => '^ʌlivә(r)
gully => 'gʌli
gullying => 'ɡʌli:ɪŋ
gulp => gʌlp
gulped => ɡʌlpt
gulping => ɡʌlpɪŋ
gulps => ɡʌlps
gum => gʌm
gum tree => ɡʌm tri:
gum turpentine => ɡʌm ˈtə:pəntain
gumball => '^ʌmbɔ:l
gumbo => '^ʌmbәu
gumboil => 'gʌmbɒil
gumboot => ˈgʌmbu:t
gumboots => ɡʌm'bu:ts
gumdrop => 'gʌmdrɒp
gumma => '^ʌmә
gummatous => '^ʌmәtәs
gummed => gʌmd
Gummer => '^ʌmә
gumming => 'gʌmiŋ
gummosis => ^ʌ'mәusis
gummy => 'gʌmi
gumption => '^ʌmpʃәn
gumshoe => 'gʌmʃu:
gun => gʌn
gun carriage => ɡʌn ˈkæridʒ
gun dog => ɡʌn dɔɡ
gun-shy => '^ʌnʃai
gunbattle => '^ʌn,bætl
gunboat => 'gʌnbәut
gunboats => 'ɡʌnbəʊts
guncotton => 'gʌnkɒtn
gunfight => 'gʌnfait
gunfire => 'gʌnfaiә
gung-ho => '^ʌŋ'hәu
gunge => gʌndʒ
gunk => ^ʌŋk
gunlock => 'gʌnlɒk
gunmaker => '^ʌn,meikә(r)
gunman => 'gʌnmәn
gunmen => 'ɡʌnmәn
gunmetal => 'gʌnmetl
Gunn => ^ʌn
Gunnar => '^jnɑ:(r)
gunned => ^ʌnd
gunnel => '^ʌn(ә)l
gunner => 'gʌnә
gunnera => '^ʌnәrә
gunners => ˈgʌnə(r)
gunnery => 'gʌnәri
gunnery sergeant => ˈɡʌnəri ˈsɑ:dʒənt
gunning => 'gʌniŋ
gunny => 'gʌni
gunnysack => '^ʌnisæk
gunplay => 'ɡʌnplei
gunpoint => '^ʌnpɔint
gunpowder => 'gʌnpaudә
gunroom => ɡʌn'ru:m
gunrunner => 'gʌnrʌnә
gunrunning => 'gʌnrʌniŋ
gunship => 'gʌnʃip
gunshot => 'gʌnʃɒt
gunshots => ˈgʌnˌʃɔts
gunsight => '^ʌnsait
gunslinging => '^ʌn,sliŋiŋ
gunsmith => 'gʌnsmiθ
gunstock => 'gʌnstɒk
Gunter => '^ʌntә(r)
gunther => '^jntә(r)
gunwale => '^ʌnl
gunyah => '^ʌnjɑ:
guppies => ˈɡʌpiz
guppy => '^ʌpi
Gur => ^jә(r)
gurgle => gә:gl
gurgled => ˈgɜ:gəld
gurgles => ˈgɜ:gəlz
gurjun => '^ә:dʒәn
Gurkha => 'gә:kә
Gurmukhi => '^jәmjki
gurn => ɡɜ:n
gurnard => '^ә:nәd
gurner => 'ɡɜ:nə(r)
gurney => ˈgɜ:ni
gurry => 'gә:ri
guru => 'guru:
gurus => ˈɡuru:z
gus => ^ʌs
gush => gʌʃ
gushed => ɡʌʃt
gusher => '^ʌʃә(r)
gushes => ɡʌʃiz
gushing => 'gʌʃiŋ
gushy => '^ʌʃi
gusset => '^ʌsit
gusseted => 'ɡʌsɪtɪd
gussets => 'gʌsɪt
gussied => ˈɡʌsid
gussy => '^ʌsi
gust => gʌst
gustation => gʌs'teiʃәn
gustative => '^ʌstәtiv
gustatory => 'gʌstәtәri
gustav => '^jstɑ:v,'^ʌs-
Gustavus => ^әs'tɑ:vәs
gustily => ˊgʌstili
gustiness => '^ʌstinis
gusto => 'gʌstәu
gusts => ɡʌsts
gusty => 'gʌsti
gut => gʌt
gutbucket => '^ʌtbʌkit
gutenberg => '^u:tnbә:^
Guthrie => 'ɡʌθri
gutless => 'gʌtlis
guts => ɡʌts
gutser => '^ʌtsә(r)
gutsiness => 'ɡʌtsinis
gutsy => '^ʌtsi
gutta => '^ʌtә
guttate => 'gʌteit
gutted => ˈgʌtɪd
gutter => 'gʌtә
gutter press => ˈɡʌtə pres
guttersnipe => '^ʌtәsnaip
gutting => '^ʌtiŋ
guttural => 'gʌtәrәl
gutty => 'gʌti
guv => gʌv
guvnor => 'ɡʌvnər
guy => gai
Guy Fawkes Night => 'gaɪ fɔ:ks naɪt
Guyana => gai'ænә
Guyanese => ^aiә'ni:z
Guyenne => ^wi:'jen
guyot => '^i'әu
guzzle => 'gʌzl
guzzled => ˈgʌzəld
guzzler => 'gʌzlә
guzzles => ˈgʌzəlz
guzzling => ˈgʌzəlɪŋ
Gwalior => 'ɡwɑ:liɔ:
gwen => ^wen
Gwent => ^went
gwyn => ^win
Gwynedd => '^wineð
gwyniad => '^winiæd
gybe => dʒaib
gybing => d'ʒaɪbɪŋ
gym => dʒim
gym shoe => dʒim ʃu:
gymkhana => dʒim'kɑ:nә
gymkhanas => dʒimˈkɑ:nəz
gymnasia => dʒim'neiziә
gymnasial => dʒim'neiziәl
gymnasium => dʒim'neiziәm
gymnast => 'dʒimnæst
gymnastic => dʒim'næstik
gymnastics => dʒim'næstiks
gymnasts => d'ʒɪmnæsts
gymnosophist => dʒim'nɒsәfist
gymnosperm => 'dʒimnәspә:m
gymnospermous => .dʒimnә'spә:mәs
gymnure => dʒi:mn'jʊər
gynaeceum => ,^aini'si:әm
gynaecocracy => ,dʒaini'kɔkrәsi, ^ai-
gynaecologic => ,^ainikә'lɔdʒik,,dʒai-
gynaecological => '^ainikә'lɔdʒikəl,,dʒai-
gynaecologist => ,^aini'kɔlәdʒist,,dʒai-
gynaecology => ,dʒaini'kɔlәdʒi,, ^ai-
gynaecomastia => ,dʒinәkәu'mæstiә
gynandromorph => ^ai'nændrәjmɔ:f,dʒai'n-
gynandrous => gai'nændrәs
gynarchy => 'dʒinɑ:ki, 'dʒai-
gynecologic => ,^ainikә'lɔdʒik,,dʒai-
gynecological => ,^ainikә'lɔdʒikəl,,dʒai-
gynecologist => .gaini'kɒlәdʒist
gynecology => .gaini'kɒlәdʒi
gynocentric => ,dʒinəu'sentrik
gynoecium => gai'ni:siәm
gyp => dʒip
gypped => dʒipt
gypping => dʒipɪŋ
gyppo => 'dʒɪpəʊ
gyppy tummy => 'dʒipi'tʌmi
gyps => d'ʒɪps
gypsies => ˈdʒɪpsi:z
gypsiferous => dʒip'sifərәs
gypsophila => dʒip'sɒfilә
gypsum => 'dʒipsәm
gypsum board => ˈdʒɪpsəm bɔ:d
gypsy => 'dʒipsi
gypsy moth => ˈdʒɪpsi: mɔθ
gyral => 'dʒaiәrәl
gyrate => 'dʒaireit
gyrated => ˈdʒaɪˌreɪtid
gyrates => ˈdʒaɪˌreɪts
gyrating => ˈdʒaɪˌreɪtɪŋ
gyration => dʒai'reiʃәn
gyrations => dʒaɪ'reɪʃ(ə)n
gyrator => 'dʒaiәreitә
gyratory => 'dʒaiərәtəri
gyre => 'dʒaiә
gyri => 'dʒairai
gyro => 'dʒaiәrәu
gyrocompass => 'dʒairәu.kʌmpәs
gyrocopter => ,dʒairә'kɔptә
gyromagnetic => ,dʒaiәrәumæ^'netik, ,dʒair-
gyron => 'dʒaiərәn
gyronny => dʒai'rɔni
gyropilot => 'dʒairәpailәt
gyroplane => 'dʒairәplein
gyroscope => 'dʒairәskәup
gyroscopes => d'ʒaɪrəskəʊps
gyroscopic => .dʒairәs'kɒpik
gyrostabilizer => 'dʒairәu'steibә,laizә
gyrus => 'dʒairәs
gyttja => 'jittʃɑ:
gyve => dʒaiv