O => әu
o'clock => ә'klɔk
o'er => ɔ:(r)
o-o => əʊ əʊ
O-ring => 'əu,riŋ
oaf => әuf
oafish => 'әufiʃ
oak => әuk
oak apple => əuk ˈæpl
oak fern => əuk fɜ:n
oak wilt => əuk wɪlt
oaken => 'әukәn
oakland => 'әuklәnd
oakley => 'әukli
oaks => әuks
oakum => 'әukәm
oap => ˌəʊ eɪ ˈpi:
oar => ɒ:
oared => 'ɔ:d
oarfish => 'ɔ:fiʃ
oarless => 'ɔ:lis;'әjr-
oarlock => 'ɔ:lɔk;'әjr-
oars => ɔ:z. әuz
oarsman => 'ɒ:zmәn
oarsmanship => 'ɔ:zmәnʃip;'әjrz-
oarswoman => 'ɔ:zwumәn
oarweed => 'ɔ:wi:d;'әjr-
oases => әu'eisis. 'әuәsi:z
oasis => әu'eisis
oast => әust
oast house => ˈəʊst haʊs
oat => әut
oat grass => əut ɡrɑ:s
oatcake => 'әutkeik
oaten => 'әutn
oater => 'әutә
Oates => әuts
oath => әuθ
oatmeal => 'әutmi:l
ob => әub, ɔ:b
ob- => ɔb
ob-gyn => ˈəʊ bi: ˌdʒi: waɪ ˈen
oba => 'ɔ:bɑ:,-bә
Obadiah => .әubә'daiә
obbligato => .ɒbli'gɑ:tәu
obconical => ɔb'kɔnikәl
obcordate => ɔb'kɔ:deit
obduct => ɔb'dʌkt
obduracy => 'ɒbdjurәsi
obdurate => 'ɒbdjurit
obdurately => 'ɒbdjərətlɪ
OBE => ,əu bi: 'i:
obeah => 'әubiә
obedience => ә'bi:djәns
obedient => ә'bi:djәnt
obedientiary => әj,bi:di'enʃәri
obediently => әu'bi:diәntli
obeisance => әu'beisns
obeisances => əʊˈbeɪsənsiz
obeli => əʊ'belaɪ
obelia => әj'bi:ljә
obelisk => 'ɒbәlisk
obelisks => ˈɔbilisks
obelize => 'ɒbәlaiz
obelus => 'ɒbilәs
Oberammergau => əubə'æməɡau
Oberhausen => 'әjbәr,hajzәn
Oberon => 'әubәrɒn
obese => әu'bi:s
obesity => әu'bi:siti
obey => ә'bei
obeyed => əuˈbeid
obeying => əuˈbeiŋ
obeys => əuˈbeiz
obfuscate => ɒb'fʌskeit
obfuscated => ˈɔbfəˌskeɪtid
obfuscates => ˈɔbfəˌskeɪts
obfuscating => ˈɔbfəˌskeɪtɪŋ
obfuscation => .ɒbfʌ'skeiʃәn
obi => 'әubi
obit => 'ɔbit, 'әubit
obiter => 'ɔbitә
obituaries => əʊˈbɪtʃu:ˌeri:z
obituarist => ә'bitjuәrist
obituary => ә'bitjuәri
object => 'ɒbdʒekt
object ball => ˈɔbdʒikt bɔ:l
object-glass => 'əbdʒektɡl'ɑ:s
objected => ˈɔbdʒiktid
objectification => əbˌdʒektɪfɪˈkeɪʃn
objectified => əbˈdʒektifaid
objectifies => əbˈdʒektifaiz
objectify => ɒb'dʒektifai
objectifying => əbˈdʒektifaiŋ
objecting => ˈɔbdʒiktɪŋ
objection => әb'dʒekʃәn
objectionable => әb'dʒekʃәnәbl
objective => әb'dʒektiv
objectively => әb'dʒektivli,ɔb-
objectives => əbd'ʒektɪvz
objectivism => әb'dʒektivizәm,ɔb-
objectivist => əb'dʒektivist
objectivity => ,ɔbdʒek'tivәti
objectivize => әb'dʒektivaiz,ɔb-
objectless => 'ɒbdʒektlis
objector => әb'dʒektә
objectors => əbˈdʒektəz
objet d'art => ˌɒbʒeɪ ˈdɑ:
objurgate => 'ɒbdʒә:geit
objurgated => 'ɒbdʒəgeɪt
objurgating => 'ɒbdʒəgeɪt
objurgation => .ɒbdʒә:'geiʃәn
objurgatory => әb'dʒә:gәtәri
oblast => 'ɔblɑ:st
oblate => 'ɒbleit
oblation => әu'bleiʃәn
oblatory => 'ɒblәtәri
obligate => 'ɒbligeit
obligated => ˈɒblɪgeɪtɪd
obligates => ˈɔblɪˌgeɪts
obligating => ˈɔblɪˌgeɪtɪŋ
obligation => .ɒbli'geiʃәn
obligato => ,ɔbli'^ɑ:tәu
obligatory => ɒb'ligәtәri
oblige => ә'blaidʒ
obligee => .ɒbli'dʒi:
obliges => əˈblaidʒz
obliging => ә'blaidʒiŋ
obligingly => ə'blaɪdʒɪŋlɪ
obligingness => әˊblaidʒiŋnis
obligor => .ɒbli'gɒ:
oblique => ә'bli:k
obliques => əʊˈbli:ks
obliquities => əˈblikwitiz
obliquity => ә'blikwәti
obliterate => ә'blitәreit
obliterated => ə'blɪtəreɪtɪd
obliterates => əˈblɪtəˌreɪts
obliterating => əˈblɪtəˌreɪtɪŋ
obliteration => ә.blitә'reiʃәn
obliterative => ə'blitəreitiv
oblivion => ә'bliviәn
oblivious => ә'bliviәs
obliviousness => ə'bliviəsnis
oblong => 'ɒblɒŋ
oblongs => ˈɔbˌlɔ:ŋz
obloquy => 'ɒblәkwi
obnoxious => әb'nɒkʃәs
obnoxiously => əb'nɒkʃəslɪ
obnoxiousness => əbnɒkʃəs'nəs
obnubilate => əb'nʌbɪleɪt
obnubilation => ɔb,njubi'leiʃәn
oboe => 'әubәu
oboes => ˈəʊbəʊz
oboist => 'әubәuist
obol => 'ɒbl
obovate => ɔb'әuveit
obscene => ɒb'si:n
obscenely => əb'si:nli
obscenities => ɔbˈsenɪti:z
obscenity => ɒb'si:niti
obscurant => әb'skjurәnt
obscurantism => әb'skjurәntizm
obscurantist => ,ɔbskjjә'ræntist,әb'skjjәrәn-
obscuration => .ɒbskjuә'reiʃәn
obscure => әb'skjuә
obscurer => əbˈskjuəə
obscures => əbˈskjuəz
obscuring => əbˈskjuərɪŋ
obscurity => әb'skjuәriti
obsecration => .ɒbsi'kreiʃәn
obsequies => 'ɒbsikwiz
obsequious => әb'si:kwiәs
obsequiously => əb'si:kwiəsli
obsequiousness => əb'si:kwɪəsnəs
observable => әb'zә:vәbl
observance => әb'zә:vәns
observances => əbˈzɜ:vənsiz
observant => әb'zә:vәnt
observation => .ɒbzә:'veiʃәn
observation car => ˌɔbzə:ˈveiʃən kɑ:
observational => ,ɔbzә'veiʃәnәl
observationally => ɒbzә(ː)ˊveiʃәnli
observatories => əbˈzɜ:vəˌtɔ:ri:z
observatory => әb'zә:vәtәri
observe => әb'zә:v
observer => әb'zә:vә
observers => əb'zɜ:vəz
observes => əbˈzə:vz
observing => әb'zә:viŋ
obsess => әb'ses
obsesses => əbˈsesiz
obsessing => əbˈsesɪŋ
obsession => әb'seʃәn
obsessional => әb'seʃәnәl
obsessions => əbˈseʃənz
obsessive => әb'sesiv,ɔb-
obsidian => ɒb'sidiәn
obsolesce => ,ɔbsә'les
obsolesced => ˌɔbsəˈlest
obsolescence => .ɒbsә'lesәns
obsolescent => .ɒbsә'lesәnt
obsolesces => ˌɔbsəˈlesiz
obsolescing => ˌɔbsəˈlesɪŋ
obsolete => 'ɒbsәli:t
obsoleteness => 'ɒbsəli:tnes
obsoletism => 'ɒbsәli:tizm
obstacle => 'ɒbstәkl
obstacles => 'ɒbstəklz
obstetric => ɒb'stetrik
obstetrical => ɔbs'tetrikәl
obstetrician => .ɒbste'triʃәn
obstetricians => ˌɔbsteˈtriʃənz
obstetrics => әb'stetriks
obstinacy => 'ɒbstinәsi
obstinate => 'ɒbstinit
obstinately => 'ɒbstɪnətlɪ
obstipation => ,ɔbsti'peiʃәn
obstreperous => әb'strepәrәs
obstruct => әb'strʌkt
obstruction => әb'strʌʃәn
obstructionism => әb'strʌkʃәnizәm,ɔb-
obstructionist => әb'strʌkʃә'nistik,ɔb-
obstructions => əbst'rʌkʃnz
obstructive => әb'strʌktiv
obstructively => əbst'rʌktɪvlɪ
obstructiveness => әbˊstrʌktivnis
obstructor => әb'strʌktә
obstructs => əbˈstrʌkts
obstruent => 'ɔbstruәnt
obtain => әb'tein
obtainable => әb'teinәbl. ɔb-
obtains => əbˈteinz
obtect => ɔb'tekt
obtrude => әb'tru:d
obtruded => ɔbˈtru:did
obtrudes => ɔbˈtru:dz
obtruding => ɔbˈtru:dɪŋ
obtrusion => әb'tru:ʒәn
obtrusive => әb'tru:siv
obtrusively => əb'tru:sɪvlɪ
obtund => әb'tʌnd
obturate => 'ɒbtjuәreit
obturated => ˈɔbtjuəreitid
obturates => ˈɔbtjuəreits
obturating => ˈɔbtjuəreitɪŋ
obturation => .ɒbtjuә'reiʃәn
obturator => 'ɒbtjuәreitә
obtuse => әb'tju:s
obtusely => əbt'ju:slɪ
obtuseness => əb'tju:snəs
obverse => 'ɒbvә:s
obversion => ɒb'vә:ʃәn
obvert => әb'vә:t
obviate => 'ɒbvieit
obviated => ˈɔbvi:ˌeɪtid
obviates => ˈɔbvi:ˌeɪts
obviating => ˈɔbvi:ˌeɪtɪŋ
obviation => .ɒbvi'eiʃәn
obvious => 'ɒbviәs
obviously => 'ɔbviәsli
obviousness => 'ɑbvɪəs
oc- => ɔk,әk
oca => 'əukə
ocarina => .ɒkә'ri:nә
occam => 'ɔkәm
occasion => ә'keiʒәn
occasional => ә'keiʒәnl
occasional table => əˈkeiʒənəl ˈteibl
occasionalism => ә'keiʒәnәlizәm,әj-
occasionality => ә,keiʒә'næliti
occasionally => ә'keiʒәnli
occasions => əˈkeiʒənz
occidental => .ɒksi'dentәl
occidentalize => .ɒksi'dentәlaiz
occipital => ɒk'sipitl
occipital condyle => ɔkˈsipitl ˈkɔndil
occipital lobe => ɔkˈsipitl ləʊb
occiput => 'ɒksipʌt
occlude => ә'klu:d
occluded => əˈklu:did
occluded front => əˈklu:dɪd
occludes => əˈklu:dz
occluding => əˈklu:dɪŋ
occlusal => ә'klu:sәl,ɔ-
occlusion => ә'klu:ʒәn
occlusive => ә'klu:siv
occult => ә'kʌlt
occultation => .ɒkʌl'teiʃәn
occulted => əˈkʌltid
occulting => əˈkʌltɪŋ
occultism => ә'kʌltizm
occultist => 'ɔkәltist,-kʌl-,ә'kʌl-
occults => əˈkʌlts
occupancy => 'ɒkjupәnsi
occupant => 'ɒkjupәnt
occupation => .ɒkju'peiʃәn
occupational => .ɒkju'peiʃәnl
occupational therapist => ˌɔkjəˈpeɪʃənəl ˈθerəpɪst
occupational therapy => ˌɔkjəˈpeɪʃənəl ˈθerəpi
occupations => ˌɒkjʊ'peɪʃnz
occupier => 'ɔkjjpaiә(r)
occupiers => 'ɒkjʊpaɪəz
occupy => 'ɒkjupai
occupying => ˈɔkjupaiŋ
occur => ә'kә:
occurrence => ә'kʌrәns
occurrences => ə'kʌrənsɪz
occurrent => ә'kʌrәnt
occurring => ә'kә:riŋ
ocean => 'әuʃәn
ocean trench => ˈəuʃən trentʃ
ocean-going => ˈəuʃən ˈgəʊɪŋ
oceanarium => ,әuʃә'neәriәm
oceanfront => 'әjʃәnfrʌnt
oceangoing => 'әuʃәngәuiŋ
Oceania => .әuʃi'æniә
Oceanian => .әuʃi'æniәn
oceanic => .әuʃi'ænik
oceanic bonito => ˌəuʃiˈænik bəˈni:təu
oceanics => .әuʃi'æniks
Oceanid => әu'si:әnid
oceanographer => .әuʃiә'nɒgrәfә
oceanographic => ,әjʃiәnәj'^ræfik
oceanographical => əʊʃjənəʊɡ'ræfɪkəl
oceanography => .әuʃiә'nɒgrәfi
oceanologist => ,әjʃiә'nɔlәdʒist
oceanology => ,әuʃә'nɔlәdʒi
Oceanus => әu'si:әnәs
ocellar => əʊ'seləər
ocellated => 'ɒsileitid
ocellus => әu'selәs
ocelot => 'әusilɒt
och => ɒk
ocher => 'әjkә(r)
ochlocracy => ɒk'lɒkrәsi
ochlocrat => 'ɔklәkræt
ochlocratic => .ɒklә'krætik
ochone => ә'hәun
ochre => 'әukә
ochrea => 'ɔkriә
ochreous => 'әjkriәs,'әjkәrәs
ochroid => 'әukrɔid
Ocker => 'ɔkә(r)
ocotillo => ,әjkә'ti:ljәj
oct- => ɔkt
octa- => 'ɔktә
octad => 'ɒktæd
octagon => 'ɒktәgɒn
octagonal => ɒk'tægәnәl
octagonally => ɒkˊtægәnli
octagons => 'ɒktəɡənz
octahedral => .ɒktә'hi:drәl
octahedron => .ɒktә'hi:drәn
octal => 'ɒktәl
octamerous => ɔk'tæmәrәs
octameter => ɒk'tæmitә
octan => 'ɒktәn
octane => 'ɒktein
octangular => ɔk'tæŋ^julә
Octans => 'ɔktænz
octant => 'ɒktәnt
octastyle => 'ɔktәstail
octavalent => ,ɔktә'veilәnt,ɔk'tævә-
octave => 'ɔkteiv, -tiv
octaves => 'ɒktɪvz
octavia => ɔk'teiviә
octavo => ɒk'teivәu
octennial => ɔk'teinjәl, -niәl
octet => ɔk'tet
October => ɒk'tәubә
Octobrist => ɔk'tәubrist
octocentenary => ,ɔktәjsen'ti:nәri,-sen'te-
octodecimo => .ɒktәu'desimәu
octogenarian => .ɒktәudʒә'nєәriәn
octogenarians => ˌɔktədʒəˈneəri:ənz
octonary => 'ɒktәnәri
octopamine => ,ɔktәu'pæmin
octopod => 'ɔktәpɔd
octopus => 'ɒktәpәs
octoroon => .ɒktә'ru:n
octosyllabic => .ɒktәusi'læbik
octosyllable => 'ɒktәu.silәbl
octothorp => 'ɔktәjθɔ:p
octroi => 'ɔktrwɑ:
octuple => 'ɔktju(:)pl
octyl => 'ɔktәl
ocular => 'ɒkjulә
ocularist => 'ɔkjulәrist
oculist => 'ɒkjulist
oculists => 'ɒkjʊlɪst
oculomotor => .ɒkjulәu'mәutә
oculomotor nerve => ˌɔkjuləuˈməutə nə:v
OD => ɒd
odalisque => 'әjdәlisk
odd => ɒd
odd-job man => ɔd dʒɔb mæn
oddball => 'ɒdbɒ:l
oddballs => ˈɔdbɔ:lz
odder => ɔdə
Oddfellow => 'ɔdfelәu
oddish => 'ɒdiʃ
oddities => ˈɔdɪti:z
oddity => 'ɒditi
oddly => 'ɒdli
oddment => 'ɒdmәnt
oddments => ˈɒdməntz
oddness => 'ɒdnis
odds => ɒdz
oddsmaker => 'ɔdzmeikə
ode => әud
Odense => 'әuðәnsei
odeon => әj'di:ɔn
oder => 'әjdә(r)
Odessa => әu'desә
Odets => әu'dets
Odette => әu'det
odeum => әu'di:әm
Odin => 'әudin
odious => 'әudiәs
odiously => 'əʊdɪəslɪ
odiousness => ˊoudjәsnis
odium => 'әudiәm
odometer => ɒ'dɒmitә
odonate => 'әjdәneit,әj'dɔ-
odontalgia => ,ɔdɔn'tældʒiә
odontalgic => ,әjdɔn'tældʒik,,ɔ-
odonto- => әj'dɔntәj,ɔ-
odontoblast => ɔ'dɔntәblɑ:st
odontocete => əu'dɔntəsi:t
odontoid => ɒ'dɒntɒid
odontologist => ,әudɔn'tɔlәdʒist
odontology => .әudɒn'tɒlәdʒi
odontophore => әu'dɔntәfɔ:
odor => 'әudә
odorant => 'әudәrәnt
odoriferous => .әudә'rifәrәs
odorize => 'әjdәraiz
odorless => 'әudәlis
odorous => 'әudәrәs
odors => ˈəudəz
odour => 'әudә
odourless => 'әjdәlis
odours => ˈəudəz
Odra => 'ɔ:drә,'ɔ:drɑ:
ods => ˈəʊˈdi:z
odysseus => ә'disju:s
Odyssey => 'ɒdisi
odysseys => ˈɔdɪsi:z
oecology => i:'kɔlәdʒi
oecumenical => ,i:kju:'menikәl
oedema => i:'di:mә
oedematous => 'i:demətəs
oedipal => 'i:dipәl, 'edi-
Oedipus => 'i:dipәs
Oedipus complex => 'i:dipәs
oeil-de-boeuf => 'əʊɪld'əb'u:f
OEM => ,әj,i:'em
oenologist => 'əʊnɒlədʒɪst
oenology => i:'nɒlәdʒi
Oenone => i:'nәjni:
oenophile => 'i:nәfail
oenophilist => i:'nɔfilist
oersted => 'ә:sted
oesophageal => i:,sɔfә'dʒi(:)әl
oesophagitis => i:sɔfә'dʒaitis
oesophagoscope => i:'sɔfә^әskәup
oesophagus => i:'sɔfә^әs
oestradiol => ,i:strә'daiɔl,,es-
oestriol => 'i:striɔl
oestrogen => 'i:strәdʒәn
oestrone => 'i:strәjn,'es-
oestrous => 'i:strәs,'es-
oestrus => 'i:strәs
oeuvre => 'ә:vr
of => ɒv
of the essence => ɔv ðə ˈesns
ofay => 'әufei
off => ɒf
off day => ɔf dei
off the hook => ɔf ðə huk
off-air => ɔf eə(r)
off-brand => 'ɔfbrænd,'ɔ:-
off-Broadway => 'ɔfbrɔ:dwei,'ɔ:-
off-campus => 'ɔfkæmpəs
off-centre => ɔf ˈsentə
off-cut => 'ɔ:fk'ʌt
off-diagonal => 'ɔ:fdaɪ'æɡənl
off-glide => 'ɔfɡlaɪd
off-island => 'ɔf,ailәnd,'ɔ:-
off-label => 'ɔ:fl'eɪbl
off-message => 'ɔ:fm'esɪdʒ
off-patent => 'ɔf'peitənt
off-piste => ˈɔ:fˈpi:st, ˈɔf-
off-price => 'ɔ:fpr'aɪs
off-putting => ˈɔ:fˌpʊtɪŋ, ˈɔf-
off-ramp => ɔf ræmp
off-road => 'ɔfrәud. 'ɔ:-
off-roading => 'ɔfrodɪŋ
off-screen => ɔf skri:n
off-the-cuff => 'ɔfðә'kʌf,'ɔ:-
off-the-peg => 'ɔfðә'pe^,'ɔ:-
off-the-rack => 'ɔ:fðər'æk
off-the-shelf => ɒf ðə ʃelf
off-the-wall => 'ɔ:fðə'wɔ:l
off-year => ɔf jə:
offal => 'ɒfәl
Offaly => 'ɔfәli,'ɔ:-
offbeat => 'ɒfbi:t
offcut => ˈɒfkʌt
offenbach => 'ɔ:fәnbɑ:k
offence => ә'fens
offences => ə'fensɪz
offend => ә'fend
offendedly => ә'fendidli
offender => ә'fendә
offenders => əˈfendəz
offending => ә'fendiŋ
offends => əˈfendz
offense => ә'fens
offenses => əˈfensiz
offensive => ә'fensiv
offensiveness => ə'fensivnis
offensives => ə'fensɪvz
offer => 'ɒfә
offering => 'ɒfәriŋ
offertory => 'ɒfәtәri
offhand => 'ɒf'hænd
offhanded => 'ɔ:f'hændid, 'ɔf-
offhandedly => ˌɒf'hændɪdlɪ
office => 'ɒfis
office lady => ˈɔfis ˈleidi
office-bearer => 'ɔfis,beәrә(r),'ɔ:-
officeholder => 'ɔfis,hәjldә(r),'ɔ:-
officeholders => 'ɒfɪshəʊldəz
officer => 'ɒfisә
official => ә'fiʃәl
officialdom => ә'fiʃәldәm
officialese => ә.fiʃә'li:z
officialism => ә'fiʃәlizm
officialize => ә'fiʃәlaiz
officially => ә'fiʃәli
officials => ə'fɪʃls
officiant => ә'fiʃiәnt
officiate => ә'fiʃieit
officiated => əˈfɪʃi:ˌeɪtid
officiates => əˈfɪʃi:ˌeɪts
officiating => əˈfɪʃi:ˌeɪtɪŋ
officinal => ɒ'fisinl
officious => ә'fiʃәs
officiously => ə'fɪʃəslɪ
offing => 'ɒ:fiŋ
offish => 'ɒ:fiʃ
offload => 'ɔflәjd, ɔf'lәjd; (?@) 'ɔ:flәjd
offloaded => ˈɔfləudid
offloading => ˈɔfləudɪŋ
offloads => ˈɔfləudz
offprint => 'ɒ:fprint
offscourings => 'ɔfskauәriŋz
offset => 'ɒ:fset
offsets => ˈɔfsets
offsetting => 'ɔ:f,setiŋ
offshoot => 'ɒ:fʃu:t
offshoots => ˈɔ:fˌʃu:ts
offshore => ɒ:f'ʃɒ:
offside => 'ɒ:f'said
offsider => ɒfˈsaɪdə(r)
offsides => ɒf'saɪd
offspring => 'ɒ:fspriŋ
offtake => 'ɒ:fteik
oft => ɒ:ft
oft-times => 'ɒftt'aɪmz
often => 'ɒ:fn
oftener => 'ɒf(tə)n
oftentimes => 'ɒ:fntaimz
ofttimes => 'ɔft,taimz, 'ɔ:-
ogam => 'ɔ^әm
Ogbomosho => ,ɔ^bә'mәjʃәj
ogden => 'ɔ:^dәn
ogdoad => 'ɔ^dәu,æd
ogee => 'әudʒi:
ogee arch => ˈəudʒi: ɑ:tʃ
ogham => 'ɔ^әm
ogival => әu'dʒaivl
ogive => 'әudʒaiv
ogle => 'әugl
ogled => ˈəʊgəld
ogles => ˈəʊgəlz
Oglethorpe => 'әu^lθɔ:p
ogling => ˈəʊgəlɪŋ
ogre => 'әugә
ogreish => 'әugәriʃ
ogres => ˈəʊgəz
ogress => 'әugris
oh => әu
Ohio => әu'haiәu
Ohioan => әu'haiәun
ohm => әum
ohmic => 'әumik
ohmmeter => 'әummi:tә
ohms => əʊmz
oho => әu'hәu
ohone => әj'hәjn
oidium => әu'idiәm
oik => ɔɪk
oil => ɒil
oil colour => ɔil ˈkʌlə
oil gland => ɔil ɡlænd
oil lamp => ɔil læmp
oil painting => ɔil ˈpeintiŋ
oil palm => ɔil pɑ:m
oil rig => ɔil riɡ
oil slick => ɔil slik
oil well => ɔil wel
oil-bearing => 'ɔil,beәriŋ
oil-burning => 'ɔɪlb'ɜ:nɪŋ
oilbird => 'ɔilb\\\\:d
oilcan => 'ɒilkæn
oilcloth => 'ɒilklɒθ
oiled => ɒild
oiler => 'ɒilә
oilfield => ˈɔɪlfi:ld
oilfields => ˈɔilfi:ldz
oilfish => 'ɔɪlfɪʃ
oilier => ˈɔɪli:ə
oilily => 'ɒilili
oiliness => 'ɒilinis
oiling => 'ɔiliŋ
oilman => 'ɒilmәn
oilmen => 'ɒɪlmən
oilseed => 'ɔilsi:d
oilseed rape => ˌɔɪlsiːd 'reɪp
oilseeds => 'ɔɪlsi:dz
oilskin => 'ɔilskin
oilskins => 'ɔɪlskɪnz
oilstone => 'ɒilstәun
oily => 'ɒili
oink => ɒiŋk
oinked => ɔiŋkt
oinking => ɔiŋkɪŋ
oinks => ɔiŋks
ointment => 'ɒintmәnt
ointments => ˈɔɪntmənts
Oireachtas => 'eәrәkθәs
OK => 'әu'kei
okapi => әu'kɑ:pi
okay => әj'kei
okayed => ˌəuˈkeid
okaying => ˌəuˈkeiŋ
okays => ˌəuˈkeiz
oke => әuk
okey-doke => ˌəʊki ˈdəʊk
Okhotsk => әu'kɔtsk
Okie => 'әuki
okinawa => ,әuki'nɑ:wә
Oklahoma => .әuklә'hәumә
Oklahoman => .әuklә'hәumәn
okra => 'әukrә
olaf => 'әulәf, 'ɔl-
old => әuld
old age => əuld eidʒ
old boy => əuld bɔi
old boy network => əuld bɔi ˈnetwə:k
old country => əuld ˈkʌntri
old flame => əuld fleim
old girl => əuld ɡə:l
old lady => əuld ˈleidi
old maid => əuld meid
old man => əuld mæn
old master => əuld ˈmɑ:stə
old rose => əuld rəuz
old school tie => əuld sku:l tai
old stager => əuld ˈsteidʒə
old witch grass => əuld witʃ ɡrɑ:s
old woman => əuld ˈwumən
old-age pension => əuld eidʒ ˈpenʃən
old-fashioned => 'әjld'fæʃәnd
old-line => 'әjld'lain
old-maidish => ,әjld'meidiʃ
olde => əʊld
olde worlde => ˌəʊldi ˈwɜ:ldi
olden => әuldn
Oldenburg => 'əuldənbə:ɡ; -buk
older => 'әuldә
oldest => 'әuldist
oldie => 'әjldi
oldies => 'əʊldi:z
oldish => 'әuldiʃ
Oldowan => 'ɔldәwәn
oldster => 'әuldstә
oldy => 'әuldi
oleaceous => ,әjli'eiʃәs
oleaginous => .әuli'ædʒinәs
oleander => .әuli'ændә
oleanders => ˌəuliˈændəz
oleaster => .әuli'æstә
oleate => 'әulieit
olecranon => әu'lekrәnɔn,, әuli'kreinɔn
olefin => 'әulifin
olefins => 'əʊlɪfɪnz
oleiferous => әu'lifәrәs
oleo => 'әuliәu
oleo- => 'әjliәj
oleograph => 'әuliәugrɑ:f
oleomargarine => .әuliәu'mɑ:dʒәrin
oleoresin => .әuliәu'rezin
oleum => 'әuliәm
olfaction => ɒl'fækʃәn
olfactive => ɔl'fæktiv
olfactometer => ,ɔlfæk'tɔmitә
olfactory => ɒl'fæktәri
olfactory nerve => ɔlˈfæktəri: nə:v
olga => 'ɔl^ә
olibanum => әu'libәnәm
oligaemia => ,ɔli'dʒi:miә
oligarch => 'ɒligɑ:k
oligarchic => ,ɔli'^ɑ:kik
oligarchical => 'ɒlɪɡɑ:kɪkəl
oligarchies => ˈɔlɪˌgɑ:ki:z
oligarchy => 'ɒligɑ:ki
oligo => ɒ'li:ɡəʊ
oligo- => 'ɔli^әj,ә'li-
Oligocene => 'ɒligәusi:n
oligochaete => 'ɔli^әuki:t
oligoclase => 'ɔli^әu,kleis
oligodendrocyte => 'ɔli^әj'dendrәsait, ә,li-
oligodendroglia => 'ɔli^әjden'drɔ^liә, ә'li-
oligomer => 'ɔli^әumә
oligomerous => ɒlɪ'ɡɒmərəs
oligonucleotide => ,ɔli^әj'nju:kliәjtaid,-tid,ә,li-
oligopolist => ɒlɪɡɒ'pəlɪst
oligopoly => .ɒli'gɒpәli
oligopsony => ,ɔli:'^ɔpsәni
oligosaccharide => ,ɔli^әu'sækәraid
oligotrophic => ,ɔli^әu'trɔfik
oliguria => ,ɔli'^juәriә
olingo => 'ɔliŋ^әj
olio => 'әuliәu
Oliphant => 'ɔlifәnt
olivaceous => .ɒli'veiʃәs
olivary => 'ɒlivәri
olive => 'ɒliv
olive brown => ˈɔliv braun
oliver => 'ɒlivә
olivia => 'ɔliviә
Olivier => əu'liviə
olivine => .ɒli'vi:n
olla podrida => 'ɔlә pɔ'dri:dә
Ollie => 'ɔli
olm => ɔlm,әjlm
Olmec => 'ɔlmek
ology => 'ɒlәdʒi
oloroso => ,ɔlә'rәjsәj,,әj-
Olympia => әu'limpiә
olympiad => әu'limpiæd
olympian => әu'limpiәn
olympians => əuˈlimpiənz
Olympic => әu'limpik
olympics => әu'limpiks
Olympus => әu'limpәs
omadhaun => 'ɔmәdɔ:n
Omagh => 'әjmә,әj'mɑ:
omaha => 'әumәhɑ:
Oman => әu'mɑ:n
Omani => -ni:
omar => 'әjmɑ:(r)
omasum => әu'meisәm
ombre => 'ɔmbrei
ombudsman => 'ɒmbudzmæn
ombudsmen => 'ɒmbʊdzmen
Omdurman => ,ɔmdә:'mɑ:n
omega => 'әumigә
omelet => 'ɔmlit, -let
omelette => 'ɒmlit
omelettes => ˈɔməlɪts
omen => 'әumәn
omened => 'əʊmən
omening => 'əʊmən
omens => ˈəʊmənz
omental => әu'mentәl
omentum => әu'mentәm
omeprazole => əʊ'meprəˌzəʊl
Omer => 'әumә
omerta => ,әjmә'tɑ:,ɔ:'mertɑ:
omicron => ɒ'maikrɒn
omigod => 'әjmi'^ɔd
ominous => 'ɒminәs
ominously => 'ɒmɪnəslɪ
omissible => әu'misibl
omission => әu'miʃәn
omissions => ə'mɪʃnz
omissive => әu'misiv
omit => әu'mit
omits => əuˈmits
omitting => əuˈmitɪŋ
ommatidium => ,ɔmә'tidiәm
ommatophore => ә'mætәfɔ:
omni- => 'ɔmni
omnibus => 'ɒmnibәs
omnicompetence => ,ɔmni'kɔmpitənt
omnicompetent => .ɒmni'kɒmpitәnt
omnidirectional => .ɒmnidi'rekʃәnәl
omnifarious => .ɒmni'fєәriәs
omnipotence => ɒm'nipәtәns
omnipotent => ɒm'nipәtәnt
omnipotently => ɒm'nɪpətəntlɪ
omnipresence => .ɒmni'prezәns
omnipresent => .ɒmni'prezәnt
omnirange => 'ɒmnireindʒ
omniscience => ɒm'niʃәns
omniscient => ɒm'niʃәnt
omnisexual => ,ɔmni'seksjjәl,-ʃjәl
omnisexuality => 'ɔmni,seksju'æliti
omnivore => 'ɒmnivɒ:
omnivorous => ɒm'nivәrәs
omnivorously => ɒmˊnivәrәsli
omnivorousness => ɒmˊnivәrәsnis
omophagy => әj'mɔfәdʒi
omphalo => ɒm'fələʊ
omphalocele => 'ɔmfәlәjsi:l
omphalos => 'ɒmfәlɒs
Omsk => ɔmsk
on => ɒn
on a roll => ɔn ə rəul
on a silver platter => ɔn ə ˈsilvə ˈplætə
on dit => jŋ'di:
on draught => ɔn drɑ:ft
on hold => ɔn həuld
on horseback => ɔn ˈhɔ:sˌbæk
on it => ɔn it
on report => ɔn riˈpɔ:t
on song => ɔn sɔŋ
on target => ɔn ˈtɑ:ɡit
on the go => ɔn ðə ɡəu
on the spur of the moment => ɔn ðə spə: ɔv ðə ˈməumənt
on to => ɔn tu:
on track => ɔn træk
on-air => ˈɔnˈeə, ˈɔ:n-
on-board => ɔn bɔ:d
on-chip => 'əntʃ'ɪp
on-message => 'ənm'esɪdʒ
on-off => 'ɔnɔf,'ɔ:nɔ:f
on-screen => ɒn skri:n
on-street => ɔn stri:t
onager => 'ɒnәdʒә
onanism => 'әunәnizm
onboard => 'ɒn'bɒ:d
once => wʌns
once-over => 'wʌnsәuvә
oncer => 'wʌnsә
oncogene => 'ɔnkә,dʒi:n
oncogenesis => ,ɔŋkә'dʒenisis
oncogenic => ,ɔŋkәj'dʒenik
oncogenicity => ,ɒŋkəʊdʒɪ'nɪsətɪ
oncology => ɒŋ'kɒlәdʒi
oncoming => 'ɒnkʌmiŋ
oncost => 'ɔŋ'kɔst
ondansetron => ɒn'dænstrɒn
one => wʌn
one time => wʌn taim
one-acter => 'wʌn'æktә(r)
one-armed bandit => ˈwʌnˌɑ:md
one-dimensional => 'wʌndə'menʃənəl
one-horse town => ˈwʌnˈhɔ:s taun
one-liner => ˈwʌnˈlaɪnə
one-man band => ˈwʌnˌmæn bænd
one-night stand => ˈwʌnˌnaɪt
one-nighter => 'wʌn'naitə
one-parent => 'wʌn'pεərənt
one-parent family => wʌn ˈpɛərənt ˈfæmili
one-shot => 'wʌnʃɔt
one-sided => ,wʌn'saidid
one-sidedness => 'wʌnsaɪd'ɪdnɪs
one-star => wʌn stɑ:
one-step => 'wʌnstep
one-stepping => wʌn ˈstepiŋ
one-stop => ˈwʌnˌstɔp
one-touch => wʌn tʌtʃ
one-track mind => ˈwʌnˈtræk maind
one-two => 'wʌnt'u:
one-woman => wʌn ˈwumən
one-worldism => 'wʌn'wə:ldizəm
onefold => 'wʌn'fәuld
oneiric => әu'naiәrik
oneiromancy => әu'nairәumænsi
oneness => 'wʌnnis
oner => 'wʌnә
onerous => 'ɒnәrәs
oneself => wʌn'self
onflow => 'ɒnflәu
ongoing => 'ɒngәuiŋ
onion => 'ʌnjәn
onion dome => ˈʌnjən dəum
onionskin => 'ʌnjәnskin
oniony => 'ʌnjәni
onkus => 'ɔŋkəs
onliest => 'әjnlist,'ɔ:n-
onlooker => 'ɔnljkә(r)
onlookers => 'ɒnlʊkəz
only => 'әunli
only-begotten => 'əunlibi'ɡɔtən
onomasiology => ,ɔnәumәsi'ɔlәdʒi
onomastic => .ɒnәu'mæstik
onomastics => .ɒnәu'mæstiks
onomatopoeia => .ɒnәumætәu'pi:ә
onomatopoeic => ˌɒnəˌmætə'pi:ɪk
Onondaga => ,ɔnәn'dɔ:^ә, -әun-; -'dɑ:-
onrush => 'ɒnrʌʃ
onrushing => 'ɔn,rʌʃiŋ
onscreen => ɒnsk'ri:n
onsen => 'ɒnsen
onset => 'ɒnset
onshore => 'ɒnʃɒ:
onside => 'ɒn'said
onslaught => 'ɒnslɒ:t
onslaughts => ˈɔnˌslɔ:ts
onstage => 'ɔn'steidʒ
Ontarian => ɔn'teәriәn
ontario => ɔn'teәriәu
ontic => 'ɒntik
onto => 'ɒntu:
ontogenesis => .ɒntәu'dʒenisis
ontogenetic => ɔntәudʒә'netik
ontogenic => ,ɔntәj'dʒenik
ontogeny => ɒn'tɒdʒini
ontological => .ɒntә'lɒdʒikl
ontologist => ɒn'tɒlәdʒist
ontology => ɒn'tɒlәdʒi
onus => 'әunәs
onward => 'ɒnwәd
onwards => 'ɔnwә:dz
onychophoran => ,ɔni'kɔfәrәn
onymous => 'ɒnimәs
onyx => 'ɒniks
onyx marble => ˈɔniks ˈmɑ:bl
oo => 'әu'әu
oo- => 'әjә
oocyst => 'әuә,sist
oocyte => 'әuәsait
oodles => 'u:dlz
oof => u:f
oofy => 'u:fi
oogamous => әu'ɔ^әmәs
oogamy => әj'ɔ^әmi
oogenesis => ,әuә'dʒenisis
oogonium => ,әuә'^әuniәm
ooh => u:
oolite => 'әuәlait
oolith => 'әjәjliθ
oolitic => ,әjәj'litik
oologist => əu'ɔlədʒist
oology => әu'ɒlәdʒi
oolong => 'u:lɒ:ŋ
oom => u:m
oompah => ˈʊmpɑ:
oomph => umf
oophorectomy => ,әuәfә'rektәmi
oophoritis => ,әuәfә'raitis
oops => u:ps
oops-a-daisy => ˈʊpsə deɪzi
oosphere => 'әuә,sfiә
oospore => 'әuәspɔ:
Oostende => әj'stendә
ootheca => ,әuә'θi:kә
ootid => 'әuәtid
ooze => u:z
oozed => u:zd
oozes => u:ziz
oozing => 'u:zɪŋ
oozy => 'u:zi
OP => 'әjp
op art => ɔp
op- => ɔp
op-amp => 'ɒp'æmp
opacification => әupæsifi'keiʃәn
opacified => 'əʊpæsɪfaɪd
opacifier => әu'pæsifaiә
opacifies => əuˈpæsifaiz
opacify => әu'pæsifai
opacifying => əʊpæsɪ'faɪɪŋ
opacity => әu'pæsiti
opah => 'әupә
opal => 'әupәl
opalescence => .әupә'lesns
opalescent => .әupә'lesnt
opaline => 'әupәlain
opals => əʊplz
opaque => әu'peik
opaquely => ə'peɪklɪ
ope => әup
OPEC => 'әjpek
open => 'әupәn
open bar => ˈəupən bɑːr
open day => ˈəupən dei
open door => ˈəupən dɔ:
open letter => ˈəupən ˈletə
open market => ˈəupən ˈmɑ:kit
open marriage => ˈəupən ˈmæridʒ
open sandwich => ˈəupən ˈsænwidʒ
open slather => ˈəupən ˈsleiðə
open society => ˈəupən səˈsaiəti
open to => ˈəupən tu:
open-air => 'әjpən'eә(r)
open-door => 'әjpən'dɔ:(r)
open-eyed => 'əʊpən'aɪd
open-faced => 'әjpən'feist
open-heart surgery => ˈəʊpənˈhɑ:t
open-hearth process => ˈəʊpənˈhɑ:θ ˈprəuses
open-mindedness => 'əupən'maindidnis
open-mouthed => ˈəʊpənˈmaʊðd, -ˈmaʊθt
open-necked => ˈəupən nekt
open-plan => ˈəupən plæn
open-top => ˈəupən tɔp
openable => 'әupәnәbl
opencast => 'әupәnkɑ:st
opener => 'әupәnә
openers => 'əʊpənəz
opening => 'әupәniŋ
opening night => ˈəupəniŋ nait
opening time => ˈəupəniŋ taim
openly => 'әjpәnli
openness => 'әupәnnis
openwork => 'әupәnwә:k
opera => 'ɒpәrә
opera buffa => 'ɔpərə'bu:fə
opera cloak => ˈɔpərə kləuk
opera glasses => ˈɔpərə ˈglɑ:sɪz
opera hat => ˈɔpərə hæt
opera house => ˈɔpərə haus
opera seria => 'ɔpәrә 'siәriә
operable => 'ɒpәrәbl
operand => 'ɔpә,rænd
operant => 'ɔpәrənt
operas => 'ɒprəz
operate => 'ɒpәreit
operates => ˈɔpəreits
operatic => .ɒpә'rætik
operatically => ɒpәˊrætikәli
operating => 'ɔpәreitiŋ
operating theatre => ˈɔpəˌreɪtɪŋ ˈθiətə
operation => .ɒpә'reiʃәn
operational => .ɒpә'reiʃәnl
operationalism => ,ɔpә'reiʃәnlizm
operationalist => ɒpə'reɪʃnəlɪst
operationalization => ˌɒpə'reɪʃənəlaɪzeɪʃəŋ
operationalize => ,ɔpә'reiʃәnlaiz
operative => 'ɒpәrәtiv
operatives => ˈɔpərətɪvz
operator => 'ɒpәreitә
operators => 'ɒpəreɪtəz
opercular => әu'pә:kjulә
operculate => 'əʊpəkjʊleɪt
operculum => әu'pә:kjulәm
operculums => ə(ʊ)'pɜːkjʊləm
operetta => .ɒpә'retә
operettas => ˌɔpəˈretəz
operon => 'ɔpә,rɔn
operose => 'ɒpәrәus
Ophelia => әu'fi:liә
ophicleide => 'ɒfiklaid
ophidian => әu'fidiәn
ophiolite => 'ɔfiәlait,'әj-
Ophir => 'әufә
Ophiuchus => 'ɔfiju:kәs, 'әufi-
ophiuroid => ,ɔfi'jjәrɔid,,әj-
ophthalmia => ɒf'θælmiә
ophthalmic => ɒf'θælmik
ophthalmic optician => ɔfˈθælmik ɔpˈtɪʃən
ophthalmitis => ,ɔfθæl'maitis,,ɔp-
ophthalmological => ɒf.θælmә'lɒdʒikl
ophthalmologist => .ɒfθæl'mɒlәdʒist
ophthalmology => .ɒfθæl'mɒlәdʒi
ophthalmoplegia => ,ɔfθælmә'pli:dʒiә
ophthalmoscope => ɒf'θælmәskәup
ophthalmoscopy => ,ɔfθæl'mɔskәpi,ɔp-
opiate => 'әupiit
opiates => ˈəʊpi:ɪts
opine => әu'pain
opined => əuˈpaind
opines => əuˈpainz
opining => əuˈpainɪŋ
opinion => ә'pinjәn
opinion poll => əˈpinjən pəul
opinionate => ə'pɪnjəneɪt
opinionated => ә'pinjәneitid
opioid => əʊ'pi:əʊɪd
opisthobranch => ә'pisθәbræŋk
opium => 'әupjәm
opium den => ˈəʊpi:əm den
opium poppy => ˈəʊpi:əm ˈpɔpi:
opopanax => ә'pɒpәnæks
Oporto => әu'pɔ:tu:
opossum => ә'pɒsәm
opossum shrimp => əˈpɔsəm ʃrimp
opossums => əˈpɔsəmz
Oppenheim => 'ɔpәnhaim
Oppenheimer => 'ɔpәnhaimә
oppo => 'ɔpәu
opponens => ә'pәunenz
opponent => ә'pәunәnt
opportune => .ɒpә'tju:n
opportunism => .ɒpә'tju:nizm
opportunist => .ɒpә'tju:nist
opportunistic => .ɒpәtju:'nistik
opportunists => ˌɔpəˈtu:nɪsts
opportunities => ˌɒpə'tju:nɪtɪs
opportunity => .ɒpә'tju:niti
opposable => ә'pәuzәbl
oppose => ә'pәuz
opposed => ә'pәuzd
opposes => əˈpəuziz
opposing => ә'pәuziŋ
opposite => 'ɒpәzit
opposite number => ˈɔpəzit ˈnʌmbə
opposites => 'ɑpəzɪt
opposition => .ɒpә'ziʃәn
oppositional => ,ɔpә'ziʃənәl
oppositionist => ,ɔpә'ziʃənist
oppress => ә'pres
oppresses => əˈpresiz
oppressing => əˈpresɪŋ
oppression => ә'preʃәn
oppressions => əˈpreʃənz
oppressive => ә'presiv
oppressively => ə'presɪvlɪ
oppressor => ә'presә
oppressors => ə'presəs
opprobrious => ә'prәubriәs
opprobrium => ә'prәubriәm
oppugn => ә'pju:n
oppugnant => ә'pʌ^nәnt
oppugned => əˈpju:nd
oppugning => əˈpju:nɪŋ
oppugns => əˈpju:nz
ops => ɔps
opsimath => 'ɔpsimæθ
opsin => 'ɔpsin
opsonic => ɒp'sɒnik
opsonin => 'ɒpsәnin
opsonize => 'ɔpsәnaiz
opsonized => ˈɔpsənaizd
opsonizes => ˈɔpsənaiziz
opsonizing => ˈɔpsənaizɪŋ
opt => ɒpt
opt out => ɔpt aut
opt-out => ɔpt aut
optative => 'ɒptәtiv
opted => ɔptid
optic => 'ɒptik
optic axis => ˈɔptɪk ˈæksis
optic chiasma => ˈɔptɪk kaiˈæzmə
optic lobe => ˈɔptɪk ləʊb
optic tract => ˈɔptɪk trækt
optical => 'ɒptikl
optical art => ˈɔptikəl ɑ:t
optician => ɒp'tiʃәn
opticians => ɔpˈtɪʃənz
optics => 'ɒptiks
optima => 'ɔptimә
optimal => 'ɒptimәl
optimality => ,ɔpti'mæliti
optimally => 'əptəməli
optimisation => ɒptɪmaɪ'seɪʃən
optimise => 'ɒptɪmaɪz
optimism => 'ɒptimizm
optimist => 'ɔptimist
optimistic => .ɒpti'mistik
optimists => ˈɔptəmɪsts
optimization => .ɒptimai'zeiʃәn
optimize => 'ɒptimaiz
optimizes => ˈɔptəˌmaɪziz
optimum => 'ɒptimәm
opting => ɔptɪŋ
option => 'ɒpʃәn
optional => 'ɒpʃәnl
optionality => 'ɒpʃənælɪtɪ
optoelectronic => ,ɔptәuilek'trɔnik
optoelectronics => 'ɔptәji,lek'trɔniks
optometer => ɒp'tɒmitә
optometrist => ɒp'tɒmitrist
optometrists => ɔpˈtɔmitrists
optometry => ɒp'tɒmitri
optronics => ɔp'trɔniks
opts => ɔpts
opulence => 'ɒpjulәns
opulent => 'ɒpjulәnt
opulently => 'ɒpjələntlɪ
opuntia => ɒ'pʌnʃiә
opus => 'әupәs
opuscule => ɒ'pʌskju:l
or => ɒ:
or whatever => ɔ: hwɔtˈevə
or wherever => ɔ: hwɛəˈevə
ora => 'әurә
orache => 'ɔ:rәtʃ
oracle => 'ɒ:rәkl
oracles => ˈɔ:rəkəlz
oracular => ɒ:'rækjulә
oracy => 'ɔ:rәsi,'ɔ-
oral => 'ɒ:rәl
oral history => ˈɔrəl ˈhistəri
oral sex => ˈɔrəl seks
oralism => ˈɔ:rəlɪzəm
oralist => -ɪst
orality => ɔ:'rælɪtɪ
orals => ɔ:'rəlz
oran => ɔ:'rɑ:n
orang => 'ɔ:rәŋ. ɔ:'ræŋ
orange => 'ɒ:rindʒ
orange pekoe => ˈɔrindʒ ˈpi:kəu
orange squash => ˈɔrindʒ skwɔʃ
orangeade => .ɒ:rindʒ'eid
Orangeism => 'ɔrindʒizəm;'ɔ:-
orangeman => 'ɔrin'dʒmәn
orangery => 'ɒ:rindʒәri
orangey => 'ɔrindʒi;'ɔ:-
orangish => 'ɔ:rɪnɡɪʃ
orangutan => .ɒ:ræŋ'u:tæn
orate => 'ɒ:reit
orated => ɔ:ˈreitid
orates => ɔ:ˈreits
orating => ɔ:ˈreitɪŋ
oration => ɒ:'reiʃәn
orations => ɔ:ˈreɪʃənz
orator => 'ɒ:rәtә
oratorial => ,ɔrә'tɔ:riәl
Oratorian => ,ɔrә'tɔ:riәn;,ɔ:-
oratorical => .ɒ:rә'tɒ:rikl
oratories => ˈɔ:rəˌtɔ:ri:z
oratorio => ,ɔrә'tɔriәu
oratorios => ˌɔ:rəˈtɔ:ri:ˌəʊz
orators => ˈɔ:rətəz
oratory => 'ɔrәtәri
orb => ɒ:b
orb web => ɔ:b web
orbed => ɔ:bd
orbicular => ɒ:'bikjulә
orbing => ɔːb
orbit => 'ɒ:bit
orbital => 'ɒ:bitәl
orbited => ˈɔ:bitid
orbiter => 'ɒ:bitә
orbitosphenoid => ɔ:bɪtɒs'fi:nəʊɪd
orbits => ˈɔ:bits
orbs => ɔ:bz
orc => ɔ:k
orca => ɔ:kә
orcadian => ɔ:'keidiәn, -djәn
orcein => 'ɔ:si:in
orchard => 'ɒ:tʃәd
orchard grass => ˈɔ:tʃəd ɡrɑ:s
orchardist => 'ɒ:tʃәdist
orchards => ˈɔ:tʃədz
orchestra => 'ɒ:kistrә
orchestra pit => ˈɔ:kistrə pit
orchestral => ɒ:'kestrәl
orchestras => ˈɔ:kistrəz
orchestrate => 'ɒ:kistreit
orchestrated => ˈɔ:kɪˌstreɪtid
orchestrates => ˈɔ:kɪˌstreɪts
orchestrating => ˈɔ:kɪˌstreɪtɪŋ
orchestration => .ɒ:kes'treiʃәn
orchestrations => ˌɔ:kiˈstreiʃənz
orchestrion => ɔ:'kestriәn
orchid => 'ɒ:kid
orchidaceous => .ɒ:ki'deiʃәs
orchidectomy => ,ɔ:ki'dektәmi
orchidist => 'ɒ:kidist
orchids => ˈɔ:kɪdz
orchil => 'ɒ:tʃil
orchis => 'ɒ:kis
orchitis => ɒ:'kaitis
orcinol => 'ɔ:sinәul, -nɔl
ordain => ɒ:'dein
ordained => ɔ:ˈdeɪnd
ordaining => ɔ:ˈdeɪnɪŋ
ordains => ɔ:ˈdeɪnz
ordeal => ɒ:'di:l
ordeals => ɔ:ˈdi:lz
order => 'ɒ:dә
order arms => ˈɔ:də ɑ:mz
ordering => 'ɔ:dәriŋ
orderliness => 'ɒ:dәlinis
orderly => 'ɒ:dәli
ordinal => 'ɒ:dinәl
ordinance => 'ɒ:dinәns
ordinand => .ɒ:di'nænd
ordinands => 'ɔ:dinænd, ,ɔ:di'nænd
ordinaries => ˈɔ:dinəriz
ordinarily => 'ɒ:dinәrili
ordinary => 'ɒ:dinәri
ordinary seaman => ˈɔ:dinəri ˈsi:mən
ordinate => 'ɒ:dineit
ordination => .ɒ:di'neiʃәn
ordinations => ˌɔ:dinˈeɪʃənz
ordnance => 'ɒ:dnәns
ordo => 'ɔ:dәu
ordonnance => 'ɒ:dәnәns
Ordovician => .ɒ:dәu'viʃәn
ordure => 'ɒ:.djuә
Ordzhonikidze => ,ɔrdʒɔni'ki:dze
ore => ɒ:
oread => 'ɔ:riæd
orebody => 'ɔ:,bɔdi
orectic => ɒ'rektik
oregano => ɔ:'re^әnәu, ә-
Oregon => 'ɒ:rigɒn
Oregonian => .ɒ:ri'gәuniәn
Orel => ɔ'rjɔl
Orestes => ɔ'resti:z
orfe => ɔ:f
organ => 'ɒ:gәn
organ loft => ˈɔ:ɡən lɔ:ft
organ stop => ˈɔ:ɡən stɔp
organdie => 'ɔ:^әndi, ɔ:'^ændi
organdy => 'ɔ:^әndi
organelle => .ɒ:gә'nel
organic => ɒ:'gænik
organically => ɒ:'gænikli
organisation => ,ɔ: ^әnaizeiʃən; - ni'z-
organisations => ,ɔːɡənaɪ'zeɪʃən
organise => 'ɒ:gәnaiz
organism => 'ɒ:gәnizm
organismal => ɔ:^ә'nizmәl
organisms => 'ɔrgən,ɪzəm
organist => 'ɒ:gәnist
organists => ˈɔ:ɡənists
organizable => 'ɒ:gәnaizәbl
organization => .ɒ:gәnai'zeiʃәn
organization man => ˌɔ:ɡənaiˈzeiʃən mæn
organizational => .ɒ:gәnai'zeiʃәnәl
organize => 'ɒ:gәnaiz
organized => 'ɔ:^әnaizd
organized crime => ˈɔ:ɡənaizd kraɪm
organizer => 'ɒ:gәnaizә
organizers => 'ɔ:ɡənaɪzəz
organizes => ˈɔrɡəˌnaɪziz
organochlorine => ,ɔ:^әnәj'klɔ:ri:n,ɔ:,^ænә-
organogenesis => ,ɔ:^әnәu'dʒenisis
organogeny => ,ɔ:^ә'nɔdʒәni
organogram => ɔ:ˈgænəgræm
organoleptic => ,ɔ:^әnәu'leptik
organometallic => ɔː,gænəʊmɪ'tælɪk
organon => 'ɒ:gәnɒn
organophosphate => ,ɔ:^әnәu'fɔsfeit
organophosphorus => ,ɔ:^әnәu'fɔsfәrәs
organotherapeutic => ,ɔ:^әnәuθerә'pju:tik
organotherapy => .ɒgәnәu'θerәpi
organum => 'ɒ:gәnәm
organza => ɒ:'gænzә
organzine => 'ɒ:gәnzi:n
orgasm => 'ɒ:gæzm
orgasmic => ɔ:ˈgæzmɪk
orgastic => ɒ:'gæstik
orgeat => 'ɒ:ʒɑ:
orgiastic => .ɒ:dʒi'æstik
orgies => ˈɔ:dʒi:z
orgone => 'ɔ:^әjn
orgulous => 'ɒ:gjulәs
orgy => 'ɔ:dʒi
oribi => 'ɔ:ribi
orichalc => 'ɔrikælk
Oriel => 'ɔ:riәl
orient => 'ɒ:riәnt
oriental => .ɒ:ri'entl
orientalize => .ɒ:ri'entәlaiz
orientals => ˌɔ:riˈentəlz
orientate => 'ɔ:rienteit
orientated => ˈɔ:ri:enˌteɪtid
orientates => ˈɔ:ri:enˌteɪts
orientating => ˈɔ:ri:enˌteɪtɪŋ
orientation => .ɒ:rien'teiʃәn
orientation course => ˌɔ:rienˈteiʃən kɔː(r)s
orientational => ɔ:rɪen'teɪʃənl
orientations => ɔ:rɪen'teɪʃnz
oriented => 'ɒ:rientid
orienteer => ,ɔ:rien'tiә(r),,әj-
orienteering => .ɒ:rien'tiәriŋ
orients => ɔ:rɪənst
orifice => 'ɒrifis
orifices => ˈɔ:rəfɪsiz
oriflamme => 'ɒriflæm
origami => ,ɔ:ri'^ɑ:mi
origanum => ә'ri^әnәm
origin => 'ɒridʒin
original => ә'ridʒәnl
originality => ә.ridʒә'næliti
originally => ә'ridʒәnli
originals => ә'ridʒәnәlz
originate => ә'ridʒineit
originated => əˈridʒineitid
originates => əˈridʒineits
origination => ә.ridʒi'neiʃәn
origination fee => əˌrldʒəneitiv fi:
originator => ә'ridʒәneitә(r)
originators => əˈrɪdʒəˌneɪtəz
Orinoco => ,ɔri'nәjkәj
oriole => 'ɒ:riәul
orioles => ˈɔ:riəulz
Orion => әu'raiәn
orison => 'ɒ:rizn
Orissa => ɔ'risә
Oriya => ɔ'ri:jə; əu'ri:jɑ:
orkney => 'ɔ:kni
orlando => ɔ:'lændәu
orle => ɔ:l
Orleanist => ɔ:'liənist; 'ɔ:liənist
orleans => ɔ:'liәnz, 'ɔ:l-
Orlon => 'ɒ:lɒn
orlop => 'ɒ:lɒp
Ormazd => 'ɒ:mәzd
ormer => 'ɒ:mә
ormolu => 'ɒ:mәlu:
Ormuz => 'ɔ:mәz, ɔ:'mu:z
ornament => 'ɒ:nәmәnt
ornamental => .ɒ:nә'mentl
ornamentalist => ,ɔ:nә'mentәlist
ornamentally => ˌɔ:nə'mentəlɪ
ornamentation => ,ɔ:nәmen'teiʃәn
ornamented => 'ɔ:nəməntɪd
ornamenting => ˈɔ:nəməntɪŋ
ornate => ɒ:'neit
ornately => ɔ:'neitli
ornery => 'ɒ:nәri
ornithine => 'ɔ:niθi:n
ornithischian => ,ɔ:ni'θiskiәn
ornitho- => 'ɔ:niθәj
ornithological => .ɒ:niθә'lɒdʒikl
ornithologist => .ɒ:ni'θɒlәdʒist
ornithology => .ɒ:ni'θɒlәdʒi
ornithopod => 'ɔ:niθәpɔd
ornithopter => ,ɔ:ni'θɔptә
ornithosis => ,ɔ:ni'θәusis
orogen => 'ɔ:rәdʒin
orogenesis => ,ɔrә'dʒenisis
orogenic => ,ɔ:rә'dʒenik
orogeny => ɒ:'rɒdʒini
orographic => ˌɒrəˈgræfɪk
oropharyngeal => 'ɔ:rәj,færin'dʒi:әl, ,ɔ:rәjfә'rindʒiәl
oropharynx => ,әurә'færiŋks
orotund => 'ɒ:rәutʌnd
orphan => 'ɒ:fәn
orphan drug => ˈɔ:fən drʌɡ
orphanage => 'ɒ:fәnidʒ
orphanages => ˈɔ:fənɪdʒz
orphaned => ˈɔ:fənd
orphanhood => 'ɒ:fәnhud
orphans => 'ɔrfən
orpharion => ɔ:'færiәn
Orphean => ɒ:'fi:әn
Orpheus => 'ɒ:fiәs
Orphic => 'ɒ:fik
Orphism => 'ɔ:fizәm
orphrey => 'ɒ:fri
orpiment => 'ɒ:pimәnt
orpine => 'ɔ:pin
Orpington => 'ɒ:piŋtәn
orra => 'ɔ:rә
orrery => 'ɒ:rәri
orris => 'ɒ:ris
Orsk => ɔrsk
Orson => 'ɔ:sәn
ort => ɒ:t
ortanique => ɔ:'tænik
ortho- => 'ɔ:θәj
orthochromatic => .ɒ:θәukrәu'mætik
orthoclase => 'ɒ:θәukleis
orthodontia => ,ɔ:θәu'dɔnʃiә
orthodontics => ,ɔ:θәu'dɔntiks
orthodontist => ,ɔ:θәj'dɔntist
orthodox => 'ɒ:θәdɒks
orthodoxies => ˈɔ:θəˌdɔksi:z
orthodoxy => 'ɒ:θәdɒksi
orthodromic => ,ɔ:θә'drɔmik
orthoepic => ,ɔ:θәj'epik
orthoepist => ɒ:'θәuepist
orthoepy => ɒ:'θәuepi
orthogenesis => .ɒ:θәu'dʒenisis
orthognathous => ɔ:θɔ^'neiθәs
orthogonal => ɒ:'θɒgәnl
orthogonality => ɔ:θɔ^ә'næliti
orthographer => ɔ:'θɔ^rәfә(r)
orthographic => ,ɔ:θә'^ræfik
orthographical => ,ɔ:θә'^ræfikәl
orthography => ɒ:'θɒgrәfi
orthomolecular => ,ɔ:θәjmәj'lekjjlә(r)
orthomorphic => ɔ:θә'mɔ:fik
orthonormal => ,ɔ:θә'nɔ:mәl
orthonormality => ,ɔ:θәunɔ:'mæliti
orthonormalization => ɔ:θәu,nɔ:mәlai'zeiʃәn
orthopaedic => ,ɔ:θәu'pi:dik
orthopaedics => ,ɔ:θәu'pi:diks
orthopaedist => ,ɔ:θәj'pi:dist
orthopedic => ,ɔ:θәu'pi:dik
orthopedics => ,ɔ:θәu'pi:diks
orthopedist => ,ɔ:θәj'pi:dist
orthophosphate => ,ɔ:θәu'fɔsfeit
orthopsychiatrist => ɔ:thɒpsaɪ'kɪætrɪst
orthopsychiatry => .ɒ:θәusai'kaiәtri
orthopter => ɒ:'θɒptәrә
orthopteran => ɒ:'θɒptәrәn
orthopteroid => ɔ:'θɔptәrɔid
orthopterous => ɒ:'θɒptәrәs
orthoptic => ɒ:'θɒptik
orthoptist => ɔ:'θɔptist
orthorhombic => ,ɔ:θә'rɔmbik
orthoses => 'ɔ:thəʊsɪz
orthostatic => ,ɔ:θәu'stætik
orthostichy => ɔ:'θɔstiki
orthotic => ɔ:'θɔtik
orthotics => 'ɔ:θәtiks
orthotist => 'ɔ:θәtist
orthotropic => ,ɔ:θәu'trɔpik
ortolan => 'ɔ:tәlәn
Oruro => әu'rurәu
Orvieto => ,ɔ:vi'eitәj
orville => 'ɔ:vil
orwell => 'ɔ:wәl
Orwellian => ɔ:'weliәn
oryx => 'ɒ:riks
orzo => 'ɔ:zәu
os => ɒs
Osage => әu'seidʒ
Osaka => әu'sɑ:kә
Osbert => 'ɔzbә:t
osborn => 'ɔzbәn
Oscan => 'ɒskәn
Oscar => 'ɔskә
oscars => ˈɒskəs
oscillate => 'ɒsileit
oscillated => ˈɔsəˌleɪtid
oscillates => ˈɔsəˌleɪts
oscillation => ɒsi'leiʃәn
oscillator => 'ɒsileitә
oscillatory => 'ɒsilәtәri
oscillogram => ә'silәgræm
oscillograph => ɒ'silәugrɑ:f
oscillography => ɔsi'lɔ^rәfi
oscilloscope => ɒ'silәuskәup
oscine => 'ɒsin
Osco-Umbrian => 'ɔskəu'ʌmbriən
oscula => 'ɔskjulә
osculant => 'ɒskjulәnt
oscular => 'ɒskjulә
osculate => 'ɒskjuleit
osculated => ˈɔskjuleitid
osculates => ˈɔskjuleits
osculating => 'ɔskjuleitiŋ
osculation => .ɒskju'leiʃәn
osculatory => 'ɒskjulәtәri
osculum => 'ɒskjulәm
osier => 'әuʒә
osiers => ˈəuʒəz
Osiris => әu'sairis
Oslo => 'ɒzlәu
Osman => ɔz'mɑ:n, ɔs-
Osmanli => ɒz'mænli
osmic => 'ɒzmik
osmium => 'ɒzmiәm
osmolality => ,ɔsmә'læliti
osmolarity => ɔzmә'læriti
osmometer => ɔz'mɔmitә
osmometry => ɔz'mɔmitri,ɔs-
osmoregulation => ,ɔzmәu,re^ju'leiʃәn
osmoregulatory => ,ɔzmәj're^jjlәtəri, ,ɔs-
osmose => 'ɒzmәus
osmosis => ɒz'mәusis
osmotic => ɒz'mɒtik
osmunda => 'ɔzmәndә
osnaburg => 'ɔznәbә:^
osprey => 'ɒspri
Ossa => 'ɔsә
osseous => 'ɒsiәs
Ossete => 'ɔsi:t
Ossetia => ɔ'setiә
Ossetic => ɔ'setik
Ossian => 'ɔsiәn
ossicle => 'ɒsikl
ossicular => ɔ'sikjulə
Ossie => 'ɔzi
ossification => .ɒsifi'keiʃәn
ossified => 'ɔsifaid
ossify => 'ɒsifai
ossuary => 'ɒsjuәri
osteitis => ɔsti:'aitis
osteitis deformans => di'fɔ:məns
Ostend => ɔ'stend, 'ɔstend
ostensible => ɒs'tensibl
ostensive => ɔs'tensiv
ostensory => ɒs'tensәri
ostentation => .ɒsten'teiʃәn
ostentatious => .ɒsten'teiʃәs
ostentatiously => ˌɒsten'teɪʃəslɪ
osteo- => 'ɔstiәj
osteoarthritis => .ɒstiәuɑ:'θraitәs
osteoblast => 'ɒstiәblæst
osteoclast => 'ɔstiәklɑ:st
osteocyte => 'ɔstiәsait
osteogenesis => ,ɔstiә'dʒenisis
osteogenetic => ɔstiәudʒә'netik
osteoid => 'ɔstiɔid
osteological => .ɒstiә'lɒdʒikәl
osteologist => ,ɔsti'ɔlәdʒist
osteology => .ɒsti'ɒlәdʒi
osteolysis => ,ɔsti'ɔlisis
osteomalacia => ,ɔstiәumә'leiʃ(i)ә
osteomalacic => ,ɔstiәumә'læsik
osteomyelitis => ,ɔstiәu,maiә'laitis
osteonecrosis => ɔstiәune'krәusis
osteopath => 'ɒstiәpæθ
osteopathic => .ɒstiә'pæθik
osteopaths => ˈɔstiəupæθs
osteopathy => .ɒsti'ɒpәθi
osteopenia => ɒsti:əʊ'pi:nɪə
osteophyte => 'ɔstiәufait
osteoporosis => .ɒstiәupә'rәusis
osteosarcoma => ,ɔstiәusɑ:'kәumә
osteotome => 'ɔstiәutәum
osteotomy => .ɒsti'ɒtәmi
osteria => ,ɔstә'ri:ә
ostinato => ,ɔsti'nɑ:tәu
ostiole => 'ɒstiәul
ostium => 'ɒstiәm
ostler => 'ɔslә
ostracise => 'ɔstrәsaiz
ostracism => 'ɒstrәsizm
ostracize => 'ɒstrәsaiz
ostracized => ˈɔstrəˌsaɪzd
ostracizes => ˈɔstrəˌsaɪziz
ostracizing => ˈɔstrəˌsaɪzɪŋ
ostracod => 'ɔstrә,kɔd
ostracoderm => 'ɔstrәkәj,d\\\\:m, ɔs'trækә-
ostracon => 'ɔstrәkɔn
Ostrava => 'ɔ:strәvә
ostrich => 'ɒstritʃ
ostriches => ˈɔstrɪtʃiz
Ostrogoth => 'ɒstrәgɒθ
Ostwald => 'әustwɔ:ld
oswald => 'ɔzwәld
otalgia => әu'tældʒiә
Othello => әu'θelәu
other => 'ʌðә
other half => ˈʌðə(r hɑ:f
other woman => ˈʌðə(r ˈwumən
other-worldly => ˈʌðə(r ˈwɜ:ldli:
otherness => 'ʌðәnis
otherwhere => 'ʌðә(h)weә
otherwise => 'ʌðәwaiz
otherworld => 'ʌðә'wә:ld
otherworldliness => 'ʌðә'wә:ldlinis
otherworldly => 'ʌðә'wә:ldli
Othman => ɔθ'mɑ:n
otic => 'әutik
otiose => 'әuʃiәus
otis => 'әutis
otitis => әu'taitis
oto- => 'әjtәj
otocyst => 'әutәsist
otolaryngology => ,әutәu,læriŋ'^ɔlәdʒi
otolith => 'әutәliθ
otological => əʊtɒ'lɒdʒɪkəl
otologist => әu'tɒlәdʒist
otology => әu'tɒlәdʒi
otorhinolaryngology => 'әutәu,rainәu,læriŋ'^ɔlәdʒi
otorrhea => ,әutә'ri:ә
otosclerosis => ,әutәuskliә'rәusis
otoscope => 'әutәskәup
ototoxic => ,әjtә'tɔksik
Otranto => ɔ'træntәu, 'ɔ:trɑ:ntɔ:
ottava rima => ә'tɑ:vә'ri:mә
Ottawa => 'ɔtәwә
otter => 'ɒtә
otters => ˈɔtəz
otto => 'ɒtәu
ottoman => 'ɔtәmәn
ottomans => 'ɒtəmənz
Otway => 'ɔtwei
ouabain => wɑ:'beiin
Ouagadougou => ,wɑ:^ә'du:^u:
ouananiche => ,wɑ:nɑ:'ni:ʃ
oubliette => .u:bli'et
ouch => autʃ
oud => u:d
Oudh => aud
ought => ɒ:t
oughtn't => 'ɔtnt
ouguiya => 'u:kwjә
oui => wi:
ouija => 'wi:dʒɑ:
Ouija board => 'wi:dʒə bɔ:d
Oulu => 'aulu
ounce => auns
ounces => aunsiz
our => 'auә
ours => 'auәz
ourself => .auә'self. .ɑ:-
ourselves => .auә'selvz
ousel => 'u:zl
oust => aust
ousted => austid
ouster => 'ajstә(r)
ousting => austɪŋ
ousts => austs
out => aut
out loud => aut laud
out of touch => aut ɔv tʌtʃ
out of whack => aut ɔv hwæk
out to lunch => aut tu: lʌntʃ
out tray => aut trei
out- => ajt
out-and-out => 'autәndaut
out-and-outer => 'autәndautә
out-group => 'autɡru:p
out-of-body experience => aʊt ʌv ˈbɑdi ɪkˈspɪriəns
out-of-date => 'autәv'deit
out-of-pocket => 'autәv'pɔkit
out-of-the-way => autәvðә'wei
out-of-town => 'autәv'taun
out-take => 'autteik
out-talk => ,aʊt'tɔːk
out-turn => 'aʊttɜːn
outa => 'u:tə
outact => .aut'ækt
outage => 'autidʒ
outages => ˈaʊtɪdʒz
outback => 'aut'bæk
outbalance => .aut'bælәns
outbid => .aut'bid
outbidding => aʊtˈbɪdɪŋ
outbids => aʊtˈbɪdz
outboard => 'autbɒ:d
outbound => 'autbaund
outbox => 'autbɒks
outbrave => aut'breiv
outbreak => 'autbreik
outbreaks => ˈautbreiks
outbreed => .aut'bri:d
outbreeding => 'autbri:diŋ
outbuilding => 'aut.bildiŋ
outbuildings => aʊt'bɪldɪŋz
outburst => 'autbә:st
outbursts => ˈaʊtˌbɜ:sts
outcast => 'autkæst
outcaste => 'autkæst
outcasts => ˈaʊtˌkæsts
outclass => .aut'klɑ:s
outclassed => autˈklɑ:st
outclasses => autˈklɑ:siz
outclassing => autˈklɑ:sɪŋ
outcome => 'autkʌm
outcomes => ˈautkʌmz
outcries => ˈaʊtˌkraɪz
outcrop => 'autkrɒp
outcropping => aʊtk'rɒpɪŋ
outcrops => ˈautkrɔps
outcross => aut'krɔs
outcrossing => 'autkrɔsiŋ
outcry => 'autkrai
outcurve => 'autkә:v
outdate => .aut'deit
outdated => .aut'deitid
outdid => aut'did
outdistance => aut'distәns
outdistanced => aʊtˈdɪstənst
outdistances => aʊtˈdɪstənsiz
outdistancing => aʊtˈdɪstənsɪŋ
outdo => .aut'du:
outdoes => ˌaʊtˈdʌz
outdoing => aʊtˈdu:ɪŋ
outdone => aut'dʌn
outdoor => 'autdɒ:
outdoors => 'aut'dɒ:z
outdoorsman => .aut'dɔ:zmәn
outdoorsy => ,ajt'dɔ:zi
outdraw => aut'drɔ:
outdrawn => ,aut'drɔ:n
outdrew => ,aut'dru:
outdrink => aut'driŋk
outdrive => aut'draiv
outed => autid
outer => 'autә
outer planet => ˈautə ˈplænit
outer space => ˈautə speis
outermost => 'autәmәust
outerwear => 'ajtәweә(r)
outface => .aut'feis
outfaced => aʊtˈfeɪst
outfaces => aʊtˈfeɪsiz
outfacing => aʊtˈfeɪsɪŋ
outfall => 'autfɒ:l
outfield => 'autfi:ld
outfielder => 'ajtfi:ldә(r)
outfielders => ˈautfi:ldəz
outfight => .aut'fait
outfighting => 'autfaitiŋ
outfit => 'autfit
outfitted => ˈautfitid
outfitter => 'autfitә
outfitters => ˈautfitəz
outfitting => ˈautfitɪŋ
outflank => .aut'flæŋk
outflanked => autˈflæŋkt
outflanking => autˈflæŋkɪŋ
outflanks => autˈflæŋks
outflow => 'autflәu
outflowing => 'aʊtfləʊɪŋ
outflows => ˈautfləuz
outflung => 'autflʌŋ
outfought => aut'fɔ:t
outfox => .aut'fɒks
outfoxed => aʊtˈfɔkst
outfoxes => aʊtˈfɔksiz
outfoxing => aʊtˈfɔksɪŋ
outga => 'aʊtɡə
outgas => .aut'gæs
outgeneral => .aut'dʒenәrәl
outgo => .aut'gәu
outgoes => autˈɡəuz
outgoing => 'autgәuiŋ
outgone => aut'^ɔn
outgrow => .aut'grәu
outgrowth => 'autgrәuθ
outgrowths => ˈaʊtˌgrəʊθs
outguess => .aut'ges
outguessed => autˈɡest
outguesses => autˈɡesiz
outguessing => autˈɡesɪŋ
outgun => aut'^ʌn
outhaul => 'authɔ:l
outhit => .aut'hit
outhouse => 'authaus
outhouses => ˈauthausiz
outing => 'autiŋ
outjockey => .aut'dʒɒki
outlaid => ,ajt'leid
outlander => 'autlәndә
outlandish => aut'lændiʃ
outlandishly => aut'lændiʃli
outlast => .aut'lɑ:st
outlasted => autˈlɑ:stid
outlasting => autˈlɑ:stɪŋ
outlasts => autˈlɑ:sts
outlaw => 'autlɒ:
outlawries => 'aʊtlɔːrɪ
outlawry => 'autlɔ:ri
outlaws => 'aʊtlɔ:z
outlay => 'autlei
outlays => ˈaʊtˌleɪz
outlet => 'autlet
outlet pass => ˈautlet pɑ:s
outlier => 'autlaiә
outline => 'autlain
outlined => ˈautlaind
outlive => aut'liv
outlived => aʊtˈlɪvd
outlives => aʊtˈlɪvz
outliving => aʊtˈlɪvɪŋ
outlook => 'autluk
outlooks => ˈautluks
outlying => 'aut.laiiŋ
outman => ,aut'mæn
outmaneuver => ajtmә'nu:vә(r)
outmaneuvered => autməˈnu:vəd
outmaneuvering => autməˈnu:vərɪŋ
outmaneuvers => autməˈnu:vəz
outmatch => .aut'mætʃ
outmatched => autˈmætʃt
outmatches => autˈmætʃiz
outmatching => autˈmætʃɪŋ
outmeasure => ,ajt'meʒә(r), -'mei-
outmoded => .aut'mәudid
outmost => 'autmәust
outmuscle => aut'mʌsəl
outnumber => .aut'nʌmbә
outnumbered => aʊtˈnʌmbəd
outnumbering => 'aʊtnʌmbərɪŋ
outnumbers => aʊtˈnʌmbəz
outpace => .aut'peis
outpaced => autˈpeist
outpaces => autˈpeisiz
outpacing => autˈpeisɪŋ
outpatient => 'autpeiʃәnt
outperform => .autpә'fɔ:m
outperformance => ,autpə'fɔ:məns
outperformed => ˌaʊtpəˈfɔ:md
outperforming => ˌaʊtpəˈfɔ:mɪŋ
outperforms => ˌaʊtpəˈfɔ:mz
outplacement => ˈaʊtpleɪsmənt
outplay => .aut'plei
outplayed => autˈpleid
outplaying => autˈpleiŋ
outplays => autˈpleiz
outpoint => .aut'pɒint
outpoll => aut'pәul
outport => 'autpɔ:t
outpost => 'autpәust
outposts => ˈaʊtˌpəʊsts
outpouring => .aut'pɒ:riŋ
outpourings => ˈautpɔ:riŋz
output => 'autput
outrace => .aut'reis
outrage => 'autreidʒ
outrageous => aut'reidʒәs
outrageously => aʊt'reɪdʒəslɪ
outrages => ˈautreidʒz
outraging => ˈautreidʒɪŋ
outran => ,aut'ræn
outrank => aut'ræŋk
outranked => autˈræŋkt
outranking => autˈræŋkɪŋ
outranks => autˈræŋks
outreach => aut'ri:tʃ
outridden => aʊt'rɪdn
outride => .aut'raid
outrider => 'aut,raidә
outriders => ˈautˌraidəz
outrigged => 'ajtri^d
outrigger => 'autri^ә
outright => 'autrait
outrival => .aut'raivl
outro => 'u:trəʊ
outrode => aut'rәud
outrun => .aut'rʌn
outrunning => aʊtˈrʌnɪŋ
outruns => aʊtˈrʌnz
outrush => 'autrʌʃ
outsail => .aut'seil
outsailed => ,ant'seil
outsailing => ,ant'seil
outsails => ,ant'seil
outsat => aut'sæt
outscore => aut'skɔ:
outscored => autˈskɔ:d
outscores => autˈskɔ:z
outscoring => autˈskɔ:ɪŋ
outsell => .aut'sel
outselling => autˈselɪŋ
outsells => autˈselz
outsert => 'autsə:t
outset => 'autset
outshine => .aut'ʃain
outshines => aʊtˈʃaɪnz
outshining => aʊtˈʃaɪnɪŋ
outshoot => aut'ʃu:t
outshout => ,aut'ʃaut
outside => 'aut'said
outside broadcast => ˌautˈsaid ˈbrɔ:dkɑ:st
outsider => ' aut'saidә
outsiders => aʊt'saɪdəz
outsides => ˌautˈsaidz
outsing => ,aut'siŋ
outsize => 'autsaiz
outsized => 'aʊtsaɪzd
outskirts => 'autskә:ts
outsmart => .aut'smɑ:t
outsmarted => autˈsmɑ:tid
outsmarting => autˈsmɑ:tɪŋ
outsmarts => autˈsmɑ:ts
outsold => aut'sәuld
outsole => 'autsәul
outsource => aut'sɔ:s
outsourced => autˈsɔ:st
outsources => autˈsɔ:siz
outsourcing => 'ajt,sɔ:siŋ
outspan => .aut'spæn
outspans => 'aʊtspæn
outspeed => aut'spi:d
outspend => aut'spend
outspoken => .aut'spәukәn
outspokenly => ,aut'spəukənli
outspokenness => ,aut'spəukənnis
outspread => 'autspred
outstanding => .aut'stændiŋ
outstandingly => aʊtˈstændɪŋli
outstare => aut'steә
outstation => 'aut.steiʃәn
outstay => .aut'stei
outstep => .aut'step
outstretch => aut'stretʃ
outstretched => .aut'stretʃt
outstrip => .aut'strip
outstripped => aʊtˈstrɪpt
outstripping => aʊtˈstrɪpɪŋ
outstrips => aʊtˈstrɪps
outswing => 'ajtswiŋ
outswinger => 'autswiŋ^ә
outta => ˈaʊtə
outtake => 'autteik
outthink => aut'θiŋk
outturn => 'auttә:n
outvalue => .aut'vælju:
outvote => .aut'vәut
outwalk => aut'wɔ:k
outward => 'autwәd
outwardly => 'ajtwәdli
outwardness => 'ajtwәdnis
outwards => 'autwәdz
outwash => 'autwɔ:ʃ, -wɔʃ
outwatch => aut'wɔtʃ
outwear => aut'weә
outwearing => autˈwɛərɪŋ
outwears => autˈwɛəz
outweigh => .aut'wei
outweighed => aʊtˈweɪd
outweighing => aʊtˈweɪŋ
outweighs => aʊtˈweɪz
outwent => aut'went
outwit => .aut'wit
outwith => 'ajtwið, -wiθ
outwits => aʊtˈwɪts
outwitted => aʊtˈwɪtid
outwitting => aʊtˈwɪtɪŋ
outwore => aut'wɔ:
outwork => 'autwә:k
outworker => 'autwә:kә
outworn => aut'wɔ:n
outyield => aut'ji:ld
ouzel => 'u:zәl
ouzo => 'u:zәj
ova => 'әuvә
oval => 'әuvәl
ovalbumin => ,әuvæl'bju:mәn
ovality => әu'væliti
ovals => əʊvzl
ovarian => әu'vєәriәn
ovariectomy => әu,veәri'ektәmi
ovaries => əʊvərɪz
ovariotomy => әu.vєәri'ɒtәmi
ovaritis => .әuvә'raitis
ovary => 'әuvәri
ovate => 'әuveit
ovation => әu'veiʃәn
ovations => əʊˈveɪʃənz
oven => 'ʌvәn
oven-ready => ˈʌvən ˈredi
ovenbird => 'ʌvәnbә:d
ovenproof => 'ʌvәn,pru:f
ovens => 'ʌvnz
ovenware => 'ʌvәnwєә
over => 'әuvә
over easy => ˈəuvə ˈi:zi
over the counter => ˈəuvə ðə ˈkauntə
over the top => ˈəuvə ðə tɔp
over- => 'әjvә(r)
over-abundance => 'əʊvərəb'ʌndəns
over-age => 'əʊvər'eɪdʒ
over-exposure => 'əʊvərɪksp'əʊʒər
over-refine => 'əʊvərrɪf'aɪn
over-represent => 'əuvə,repri'zent
over-the-counter => 'әuvәðә'kauntә
overabundance => 'әuvәrә'bʌndәns
overachieve => ˌəʊvərəˈtʃi:v
overachieved => ˌəuvərəˈtʃi:vd
overachievement => 'әuvәrә'tʃi:vmәnt
overachiever => 'әuvәrә'tʃi:vә
overachieves => ˌəuvərəˈtʃi:vz
overachieving => ˌəuvərəˈtʃi:vɪŋ
overact => 'әuvәr'ækt
overacted => ˌəʊvəˈæktid
overacting => 'əʊvəræktɪŋ
overactive => 'әuvә'ræktiv
overactivity => 'әuvәræk'tiviti
overacts => ˌəʊvəˈækts
overage => 'әuvәr'eidʒ
overall => 'әuvәrɒ:l
overalled => 'әuvә,rɔ:ld
overambitious => 'әuvәæm'biʃәs
overanxiety => 'әuvәræŋ'zaiәti
overanxious => əʊvə'ræŋkʃəs
overarch => .әuvәr'ɑ:tʃ
overarched => ˌəʊvəˈɑ:tʃt
overarches => ˌəʊvəˈɑ:tʃiz
overarching => ˌəʊvərˈɑ:tʃɪŋ
overarm => 'әuvәrɑ:m
overate => 'әuvә'et
overawe => .әuvәr'ɒ:
overawed => ˌəʊvəˈɔ:d
overawes => ˌəʊvəˈɔ:z
overawing => ˌəʊvəˈɔ:ɪŋ
overbalance => .әuvә'bælәns
overbalanced => ˌəuvəˈbælənst
overbalances => ˌəuvəˈbælənsiz
overbalancing => ˌəuvəˈbælənsɪŋ
overbear => .әuvә'bєә
overbearing => .әuvә'bєәriŋ
overbid => .әuvә'bid
overbidding => ˌəuvəˈbidɪŋ
overbids => ˌəuvəˈbidz
overbite => 'әuvәbait
overblouse => 'әuvәblaus
overblown => .әuvә'blәun
overboard => 'әuvәbɒ:d
overbold => 'әuvә,bәuld
overbook => .әuvә'buk
overbooked => əuvəˈbukt
overboot => 'әuvә,bu:t
overbore => ,әuvә'bɔ:
overborne => ,әuvә'bɔ:n
overbought => ,әuvә'bɔ:t
overbridge => 'әuvәbridʒ
overbrim => .әuvә'brim
overbuild => .әuvә'bild
overburden => .әuvә'bә:dn
overburdened => ˌəuvəˈbə:dnd
overburdening => ˌəuvəˈbə:dnɪŋ
overburdens => ˌəuvəˈbə:dnz
overburdensome => 'әjvә'b\\\\:dәnsәm
overbusy => 'әuvә'bizi
overbuy => .әuvә'bai
overcall => .әuvә'kɒ:l
overcame => ,әuvә'keim
overcapacity => .әuvәkә'pæsәti
overcapitalization => 'әjvә,kæpitәlai'zeiʃәn; -li'z-
overcapitalize => .әuvә'kæpitәlaiz
overcapitalized => ˌəuvəˈkæpitəlaizd
overcareful => 'әuvә'kєәful
overcast => 'әuvәkɑ:st
overcasting => 'əʊvəˌkæstɪŋ
overcasts => ˈəʊvəˌkæsts
overcaution => 'әuvә,kɔ:ʃәn
overcautious => әjvә'kɔ:ʃәs
overcharge => .әuvә'tʃɑ:dʒ
overcharged => 'əʊvə'tʃa:dʒd
overcharges => ˌəʊvəˈtʃɑ:dʒz
overcharging => ˌəʊvəˈtʃɑ:dʒɪŋ
overcheck => 'әuvә,tʃek
overclass => әuvә'klɑ:s
overclock => əʊvək'lɒk
overcloud => .әuvә'klaud
overcoat => 'әuvәkәut
overcoats => ˈəuvəkəuts
overcome => .әuvә'kʌm
overcomes => ˌəuvəˈkʌmz
overcoming => ˌəuvəˈkʌmɪŋ
overcommit => ,әjvәkә'mit
overcommitment => əʊvəkə'mɪtmənt
overcompensate => ,әuvә'kɔmpәnseit
overcompensated => ˌəuvəˈkɔmpənseitid
overcompensates => ˌəuvəˈkɔmpənseits
overcompensating => ˌəuvəˈkɔmpənseitɪŋ
overcompensation => 'әjvә,kɔmpen'seiʃәn
overconfidence => .әuvә'kɒnfidәns
overconfident => .әuvә'kɒnfidәnt
overcook => 'әuvә'kuk
overcooked => ,әjvә'kjkt
overcooking => ,əuvə'kuk
overcooks => ,əuvə'kuk
overcritical => .әuvә'kritikl
overcrop => .әuvә'krɒp
overcropping => ,əuvə'krɔpiŋ
overcrowd => .әuvә'kraud
overcrowded => ˌəʊvəˈkraʊdɪd
overcrowds => ˌəʊvəˈkraʊdz
overcuriosity => 'әjvә,kjjәri'ɔsәti
overcurious => 'әuvә'kjuәriәs
overdamp => әuvә'dæmp
overdate => 'әuvәdeit
overdelicacy => 'әuvә'delikәsi
overdelicate => 'әuvә'delikit
overdetermination => 'әuvәditә:mi'neiʃәn
overdetermine => ,әjvәdi't\\\\:min
overdetermined => 'әuvә,di'tә:mind
overdevelop => .әuvәdi'velәp
overdeveloped => ˌəʊvədɪˈveləpt
overdo => .әuvә'du:
overdoes => ˌəʊvəˈdʌz
overdoing => ˌəʊvəˈdu:ɪŋ
overdone => 'әuvә'dʌn
overdosage => 'әjvә'dәjsidʒ
overdose => 'әuvәdәus
overdosed => ˈəʊvəˈdəʊst
overdoses => ˈəʊvəˈdəʊsiz
overdosing => ˈəʊvəˈdəʊsɪŋ
overdraft => 'әjvәdrɑ:ft; (?@) -dræft
overdrafts => ˈəʊvəˌdræfts
overdramatize => ,әjvә'dræmәtaiz
overdraw => .әuvә'drɒ:
overdrawn => ,әjvә'drɔ:n
overdress => .әuvә'dres
overdressed => ˌəʊvəˈdrest
overdressing => ˈəuvəˈdresɪŋ
overdrink => .әuvә'driŋk
overdrive => .әuvә'draiv
overdrives => ˈəuvəˈdraivz
overdriving => ˈəuvəˈdraivɪŋ
overdry => ,әjvә'drai
overdub => 'әuvә,dʌb
overdue => 'әuvә'dju:
overeager => 'әuvә'i:^ә
overeat => .әuvәr'i:t
overeating => ˌəʊvər'i:tɪŋ
overeats => ˌəuvərˈi:ts
overemphasis => .әuvәr'emfәsis
overemphasise => ,əuvər'emfəsis
overemphasize => .әuvәr'emfәsaiz
overemphasized => əʊvə'remfəsaɪzd
overemphasizes => ˈəuvəˈemfəsaiziz
overemphasizing => ˈəuvəˈemfəsaizɪŋ
overenthusiastic => 'әuvәrinθju:zi'æstik
overestimate => .әuvәr'estimeit
overestimated => ˌəʊvəˈestəˌmeɪtid
overestimates => ˌəʊvəˈestəˌmeɪts
overestimating => ˌəʊvəˈestəˌmeɪtɪŋ
overexcite => әjvәri^'sait
overexcited => ˌəʊvərɪkˈsaɪtɪd
overexcitement => əʊvərɪk'saɪtmənt
overexert => әjvәri^'z\\\\:t
overexerted => əuvəriɡˈzə:tid
overexerting => əuvəriɡˈzə:tɪŋ
overexertion => ,әjvәri^'z\\\\:ʃәn
overexerts => əuvəriɡˈzə:ts
overexploitation => 'әjvәr,eksplɔi'teiʃәn
overexpose => .әuvәrik'spәuz
overexposure => .әuvәrik'spәuʒә
overexpression => əʊvərɪksp'reʃn
overextend => .әuvәrik'stend
overextended => ˌəʊvərɪkˈstendɪd
overextending => ˌəʊvərɪkˈstendɪŋ
overextends => ˌəʊvərɪkˈstendz
overfall => 'әuvәfɔ:l
overfatigue => .әuvәfә'ti:g
overfeed => .әuvә'fi:d
overfeeds => ˈəuvəˈfi:dz
overfill => .әuvә'fil
overfilled => əʊvə'fɪld
overfilling => 'әuvә,filiŋ
overfills => ˈəuvəˈfilz
overfish => 'әuvәfiʃ
overfished => ˈəuvəfiʃt
overfishing => ˌəʊvəˈfɪʃɪŋ
overflew => ,әuvә'flu:
overflies => ˌəuvəˈflaiz
overflight => 'әuvәflait
overflow => .әuvә'flәu
overflowing => ,әuvә'flәuiŋ
overflows => ˌəuvəˈfləuz
overfly => ,әuvә'flai
overflying => ˌəuvəˈflaiŋ
overfold => 'әuvәfәuld
overfond => ˌəʊvəˈfɒnd
overfulfil => .әuvәful'fil
overfulfilment => .әuvәful'filmәnt
overfull => 'әuvә'ful
overfunding => 'əʊvəfʌndɪŋ
overgarment => 'әuvә^ɑ:mәnt
overgeneralization => ˌəʊvəðʒenrəlaɪ'zeɪʃn
overglaze => 'әuvәgleiz
overgraze => .әuvә'ɡreiz
overgrazed => ˈəuvəˈɡreizd
overgrazing => ˈəuvəˈɡreizɪŋ
overgrew => 'әuvә'^ru:
overground => 'әuvәgraund
overgrow => .әuvә'grәu
overgrowing => ˈəuvəˈɡrəuɪŋ
overgrown => .әuvә'grәun
overgrows => ˈəuvəˈɡrəuz
overgrowth => 'әuvәgrәuθ
overhand => 'әuvәhænd
overhand knot => ˈəuvəhænd nɔt
overhang => .әuvә'hæŋ
overhanging => əʊvə'hæŋɪŋ
overhangs => ˌəʊvəˈhæŋz
overhasty => 'әuvә'heisti
overhaul => .әuvә'hɒ:l
overhauled => ˌəʊvəˈhɔ:ld
overhauling => ,әuvә'hɔ:liŋ
overhauls => ˌəʊvəˈhɔ:lz
overhead => 'әuvәhed
overhead projector => ˈəuvəhed prəˈdʒektə
overhear => .әuvә'hiә
overhears => ˌəuvəˈhiəz
overheat => .әuvә'hi:t
overheated => ˌəʊvəˈhi:tɪd
overheats => ˌəʊvəˈhi:ts
overhit => ,әjvә'hit
overhung => ,әuvә'hʌŋ
Overijssel => ,әjvәr'aisәl
overindulge => .әuvәrin'dʌldʒ
overindulged => ˈəuvərinˈdʌldʒd
overindulgence => .әuvәrin'dʌldʒәns
overindulges => ˈəuvərinˈdʌldʒz
overindulging => ˈəuvərinˈdʌldʒɪŋ
overinflated => 'әuvәrin'fleitid
overinsurance => 'әuvәrin'ʃuәrәns
overissue => 'әuvәr'isju:
overjoy => .әuvә'dʒɒi
overjoyed => әjvә'dʒɔid
overkill => 'әuvәkil
overladen => .әuvә'leidn
overlaid => ,әuvә'leid
overlain => ,әuvә'lein
overland => 'әuvәlænd
overlap => .әuvә'læp
overlapped => əʊvə'læpt
overlapping => 'әuvә'læpiŋ
overlaps => ˌəuvəˈlæps
overlarge => əʊvə'lɑ:dʒ
overlay => .әuvә'lei
overlayer => 'əuvəleiə
overlaying => 'əʊvəleɪɪŋ
overleaf => 'әuvәli:f
overleap => .әuvә'li:p
overleaping => ˌəuvəˈli:pɪŋ
overleaps => ˌəuvəˈli:ps
overlie => ,әuvә'lai
overlies => ˌəʊvəˈlaɪz
overload => .әuvә'lәud
overloading => 'әuvә'lәudiŋ
overloads => ˌəʊvəˈləʊdz
overlong => 'әuvәlɔŋ
overlook => .әuvә'luk
overlooked => ˌəuvəˈlukt
overlooking => ˌəuvəˈlukɪŋ
overlooks => ˌəuvəˈluks
overlord => 'әuvәlɒ:d
overlords => ˈəʊvəˌlɔ:dz
overly => 'әuvәli
overlying => ,әuvә'laiiŋ
overman => 'әuvәmәn
overmantel => 'әuvәmæntl
overmaster => .әuvә'mɑ:stә
overmastered => ˈəuvəˈmɑ:stəd
overmastering => ˌəuvəˈmɑ:stəriŋ
overmasters => ˈəuvəˈmɑ:stəz
overmatch => .әuvә'mætʃ
overmatched => ˌəuvəˈmætʃt
overmuch => 'әuvә'mʌtʃ
overnice => 'әuvә'nais
overnight => 'әuvәnait
overnighter => .әuvә'naitә
overpack => 'әuvә'pæk
overpaid => 'әuvә'peid
overpaint => əʊvə'peɪnt
overpainting => 'әuvәpeintiŋ
overparted => 'әjvә'pɑ:tid
overpass => 'әuvәpɑ:s
overpasses => ˈəuvəpɑ:siz
overpay => .әuvә'pei
overpayments => ,əuvə'peimənt
overpitch => ,әuvә'pitʃ
overplay => ,әuvә'plei
overplayed => ˌəuvəˈpleid
overplaying => ˌəuvəˈpleiŋ
overplays => ˌəuvəˈpleiz
overplus => 'әuvәplʌs
overpopulate => ,әuvә'pɔpju,leit
overpopulation => әjvәpɔpjj'leiʃ(ә)n
overpower => .әuvә'pauә
overpowered => ˌəʊvəˈpaʊəd
overpowering => .әuvә'pauәriŋ
overpowers => ˌəʊvəˈpaʊəz
overpraise => .әuvә'preiz
overpraised => ˈəuvəˈpreizd
overpraising => ˈəuvəˈpreizɪŋ
overprescribe => 'әuvәpri'skraib
overprescription => ,әjvәpri'skripʃәn
overpressure => 'әuvә'preʃә
overprice => ,әuvә'prais
overpriced => ˌəʊvəˈpraɪst
overpricing => ˌəuvəˈpraisɪŋ
overprint => .әuvә'print
overprinted => əʊvə'prɪnt
overprints => əʊvə'prɪnt
overproduce => .әuvәprә'dju:s
overproduction => .әuvәprә'dʌkʃәn
overproof => .әuvә'pru:f
overprotect => .әuvәprә'tekt
overprotecting => ,əʊvəprə'tekt
overprotection => .әuvәprә'tekʃәn
overprotects => ,əʊvəprə'tekt
overqualified => ˌəʊvəˈkwɒlɪfaɪd
overran => ,әuvә'ræn
overrate => .әuvә'reit
overrated => ˌəʊvəˈreɪtid
overrates => ˌəʊvəˈreɪts
overrating => əʊvə'reɪtɪŋ
overreach => .әuvә'ri:tʃ
overreached => ˌəʊvəˈri:tʃt
overreaches => ˌəʊvəˈri:tʃiz
overreaching => ˌəʊvəˈri:tʃɪŋ
overreact => ,әuvәri'ækt
overreacted => ˌəʊvəri:ˈæktid
overreacting => ˌəʊvəri:ˈæktɪŋ
overreacts => ˌəʊvəri:ˈækts
override => .әuvә'raid
overrider => əʊvə'raɪdə
overrides => ˌəuvəˈraidz
overripe => 'әuvә'raip
overruff => ,әjvә'rʌf
overrule => .әuvә'ru:l
overruled => ˌəʊvəˈru:ld
overrules => ˌəʊvəˈru:lz
overruling => ˌəʊvəˈru:lɪŋ
overrun => .әuvә'rʌn
overrunning => 'әnvә'rʌniŋ
overruns => ˌəʊvəˈrʌnz
overs => 'әuvәz
oversail => 'әuvәseil
oversailing => ,әjvә'seiliŋ
oversaw => 'әuvә'sɔ:
overscrupulous => 'әuvә'skru:pjulәs
overseas => 'әuvә'si:z
oversee => .әuvә'si:
overseer => .әuvә'si:ә
overseers => ˈəʊvəˌsi:əz
oversell => .әuvә'sel
oversensitive => 'әuvә'sensitiv
overset => .әuvә'set
oversew => .әuvә'sәu
oversewing => ˈəuvəsəuɪŋ
oversews => ˈəuvəsəuz
oversexed => .әuvә'sekst
overshadow => .әuvә'ʃædәu
overshadowed => ˌəʊvəˈʃædəʊd
overshadowing => əʊvə'ʃædəʊɪŋ
overshadows => ˌəʊvəˈʃædəʊz
overshirt => 'әjvәʃ\\\\:t
overshoe => 'әuvәʃu:
overshoes => əʊvə'ʃu:z
overshoot => .әuvә'ʃu:t
overshooting => 'әuvә'ʃu:tiŋ
overshoots => ˌəʊvəˈʃu:ts
overshot => 'әuvәʃɒt
overside => 'әuvәsaid
oversight => 'әuvәsait
oversights => ˈəʊvəˌsaɪts
oversimplified => ˌəʊvər'sɪmplɪfaɪd
oversimplify => .әuvә'simplifai
oversize => 'әuvә'saiz
oversized => 'әuvә'saizd
overskirt => 'әuvәskә:t
overslaugh => 'әuvәslɒ:
oversleep => .әuvә'sli:p
oversleeping => ˌəʊvəˈsli:pɪŋ
oversleeps => ˌəʊvəˈsli:ps
oversleeve => 'әuvәsli:v
overslept => .әuvә'slept
oversold => 'әuvә'sәuld
oversolicitous => ,əuvəsə'lisitəs
oversoul => 'әuvәsәul
overspecialization => 'әuvәspeʃәlai'zeiʃәn
overspecialize => əʊvəs'peʃəlaɪz
overspend => .әuvә'spend
overspending => ˌəuvəˈspendiŋ
overspends => ˌəʊvəˈspendz
overspill => 'әuvәspil
overspin => 'əʊvəspɪn
overspray => 'әuvәsprei
overspread => .әuvә'spred
overspreading => ˈəuvəˈspredɪŋ
overspreads => ˈəuvəˈspredz
overstaff => 'әuvә'stɑ:f
overstaffed => ˌəʊvəˈstɑ:ft
overstate => .әuvә'steit
overstated => ˌəʊvəˈsteɪtid
overstates => ˌəʊvəˈsteɪts
overstating => ˌəʊvəˈsteɪtɪŋ
overstay => 'әuvә'stei
overstayed => ˈəuvəˈsteid
overstaying => əʊvəs'teɪɪŋ
overstays => ˈəuvəˈsteiz
oversteer => 'әuvәstiә
overstep => .әuvә'step
overstepped => ˈəuvəstept
overstepping => ˈəuvəstepɪŋ
oversteps => ˈəuvəsteps
overstimulation => əʊvəstɪmjʊ'leɪʃən
overstock => .әuvә'stɒk
overstocked => 'əʊvəst'ɒkt
overstocking => 'əʊvəst'ɒkɪŋ
overstocks => ˌəuvəˈstɔks
overstory => 'әuvә'stɔ:ri
overstrain => .әuvә'strein
overstrained => əʊvəst'reɪnd
overstraining => ˈəuvəˈstreinɪŋ
overstrains => ˈəuvəˈstreinz
overstress => 'әuvә'stres
overstressing => 'әuvә'stresiŋ
overstretch => 'әuvә'stretʃ
overstretched => ˈəuvəˈstretʃt
overstretches => ˈəuvəˈstretʃiz
overstretching => əʊvəst'retʃɪŋ
overstrike => ,әuvә'straik
overstriking => 'әuvә'straikiŋ
overstrung => 'әuvә'strʌŋ
overstudy => .әuvә'stʌdi
overstuff => 'әuvә'stʌf
overstuffing => ˈəuvəˈstʌfɪŋ
overstuffs => ˈəuvəˈstʌfs
oversubscribe => .әuvәsәb'skraib
oversubscribed => ˌəʊvəsəbˈskraɪbd
oversubtle => 'әuvә'sʌtl
oversupplied => ˈəuvəsəˈplaid
oversupply => .әuvәsә'plai
oversupplying => ˈəuvəsəˈplaiŋ
oversweet => 'әuvәswi:t
overt => 'әuvә:t
overtake => .әuvә'teik
overtaken => .әuvә'teikn
overtakes => ˌəuvəˈteiks
overtaking => ˌəʊvə'teɪkɪŋ
overtask => .әuvә'tɑ:sk
overtax => .әuvә'tæks
overtaxation => ,əuvə'tæk'seiʃən
overtaxed => ,əuvə'tæksd
overtaxes => ˌəuvəˈtæksiz
overtaxing => ˌəuvəˈtæksɪŋ
overthrew => .әuvә'θru:
overthrow => .әuvә'θrәu
overthrowing => ˌəuvəˈθrəuɪŋ
overthrown => .әuvә'θrәun
overthrows => ˌəuvəˈθrəuz
overthrust => 'әuvәθrʌst
overtime => 'әuvәtaim
overtire => 'әuvә'taiә
overtired => ˌəʊvəˈtaɪəd
overtiring => əʊvəˈtaɪərɪŋ
overtly => 'әuvә:tly. әu'vә:tly
overtone => 'әuvәtәun
overtones => 'əʊvəˌtəʊnz
overtook => ,әuvә'tuk
overtop => .әuvә'tɒp
overtopped => 'əʊvətɒpt
overtopping => əʊvə'tɒpɪŋ
overtrade => 'әuvә'treid
overtrain => .әuvә'trein
overtrick => 'әuvәtrik
overtrump => 'әuvә'trʌmp
overture => 'әuvә.tʃuә
overturn => .әuvә'tә:n
overturned => 'əʊvətɜ:nd
overturns => ˌəuvəˈtə:nz
overuse => .әuvәr'ju:z
overused => ˌəʊvəˈju:zd
overuses => ˌəʊvəˈju:ziz
overusing => ˌəʊvəˈju:zɪŋ
overvaluation => ,әuvәvælju'eiʃәn
overvalue => .әuvә'vælju:
overvalued => ˌəʊvə'væljʊd
overvalues => ˌəʊvəˈvælju:z
overvaluing => ˌəʊvəˈvælju:ɪŋ
overview => 'әuvәvju:
overviews => ˈəʊvəˌvju:z
overwater => 'әuvә'wɔ:tә
overwear => ,әuvә'weә
overweening => .әuvә'wi:niŋ
overweight => 'әuvә'weit
overweighted => .әuvә'weitid
overwhelm => .әuvә'hwelm
overwhelmed => ,əʊvə'welmd
overwhelming => .әuvә'hwelmiŋ
overwhelmingly => .әuvә'hwelmiŋli
overwhelms => ˌəuvəˈhwelmz
overwind => .әuvә'waind
overwinter => .әuvә'wintә
overwintered => ˈəuvəˈwintəd
overwintering => 'əʊvəwɪntərɪŋ
overwinters => ˈəuvəˈwintəz
overwork => .әuvә'wә:k
overworking => ˌəʊvəˈwɜ:kɪŋ
overworks => ˌəʊvəˈwɜ:ks
overwound => 'әuvә'waund
overwrap => 'әuvә'ræp
overwrite => .әuvә'rait
overwrites => ˈəuvəˈraits
overwriting => əʊvə'raɪtɪŋ
overwrought => 'әuvә'rɔ:t
overzealous => 'әjvә'zelәs
ovi- => 'әjvi
Ovid => 'ɒvid
Ovidian => әu'vidiәn
oviduct => 'әuvidʌkt
oviform => 'әuvifɒ:m
ovine => 'әuvain
oviparity => ,әuvi'pæriti
oviparous => әu'vipәrәs
oviposit => .әuvi'pɒzit
oviposited => ˌəuviˈpɔzitid
ovipositing => ,əʊvɪ'pɒzɪt
oviposition => ,әuvipɔ'ziʃәn
ovipositor => .әuvi'pɒzitә
ovoid => 'әuvɒid
ovolo => 'әuvәlәu
ovotestis => ,әuvә'testis
ovoviviparous => .әuvәuvai'vipәrәs
ovular => 'әuvjulә
ovulate => 'әuvjuleit
ovulated => ˈəuvjuleitid
ovulates => ˈəuvjuleits
ovulating => ˈəuvjuleitɪŋ
ovulation => ,ɔvjj'leiʃәn,,әj-
ovulatory => 'ɔvjjlәtәri,'әj-
ovule => 'әuvju:l
ovum => 'әuvәm
ow => au
owe => әu
owen => 'әuin
owing => 'әuiŋ
owl => aul
owl monkey => aul ˈmʌŋki
owlet => 'aulit
owlish => 'auliʃ
owls => aulz
own => әun
own goal => əun ɡəul
owner => 'әunә
owner-occupier => ˈəʊnə(r) ˈɒkjupaɪə(r)
ownerless => 'әjnәlis
ownership => 'әunәʃip
owning => əunɪŋ
owt => aʊt
ox => ɒks
ox- => 'ɒks
ox-eye => ɔks ai
oxacillin => ɔk'sæsilin
oxalate => 'ɒksәleit
oxalic acid => ɔk'sælik
oxalis => 'ɒksәlis
oxazole => 'ɔksәzәul
oxbow => ˈɒksbəʊ
oxbow lake => ˈɔksˌbəʊ leik
Oxbridge => 'ɔksbridʒ
oxcart => 'ɒkskɑ:t
oxcarts => ˈɔkskɑ:ts
oxen => 'ɔksәn
oxer => 'ɔksә
Oxfam => 'ɔksfæm
Oxford => 'ɒksfәd
Oxfordshire => 'ɒksfәdʃiә
oxherd => 'ɒkshә:d
oxhide => 'ɒkshaid
oxidant => 'ɒksidәnt
oxidase => 'ɔksideis
oxidation => .ɒksi'deiʃәn
oxidative => 'ɔksideitiv
oxide => 'ɒksaid
oxides => 'ɒksaɪdz
oxidise => 'ɔksidaiz
oxidised => 'ɔksidaiz
oxidizable => 'ɔksidaizәbl
oxidization => ,ɔksidai'zeiʃәn;-di'z-
oxidize => 'ɒksidaiz
oxidized => 'ɑksə,daɪz
oxidizer => 'ɒksidaizә
oxidizes => ˈɔksɪˌdaɪziz
oximeter => ɔk'simitә
oxlip => 'ɒkslip
oxo => 'ɔksәu
Oxon => 'ɔksɔn
Oxonian => ɒk'sәuniәn
oxpecker => 'ɔks,pekә(r)
oxtail => 'ɒksteil
oxter => 'ɒkstә
oxy- => 'ɔksi
oxyacetylene => .ɒksiә'setili:n
oxyacid => .ɒksi'æsid
oxyanion => ɒksɪ'əænɪən
oxygen => 'ɒksәdʒәn
oxygenate => 'ɔksidʒineit
oxygenated => .ɔksidʒәn'eitid
oxygenates => 'ɒksɪdʒəneɪts
oxygenating => ˈɔksidʒineitɪŋ
oxygenation => .ɒksidʒә'neiʃәn
oxygenator => 'ɔksidʒәneitә
oxygenize => 'ɔksidʒinaiz
oxygenized => 'ɒksɪdʒənaɪz
oxygenizes => 'ɒksɪdʒənaɪz
oxygenizing => 'ɒksɪdʒənaɪz
oxygenous => ɒk'sidʒәnәs
oxymoron => .ɒksi'mәurɒn
oxytetracycline => ,ɔksi,tetrә'saiklin, -klain
oxytocin => .ɒksi'tәusin
oxytone => 'ɒksitәun
oy => ɔi
oyer => 'ɒiә
oyez => әj'jes
oyster => 'ɒistә
oyster mushroom => ˈɔistə ˈmʌʃrum
oyster plant => ˈɔistə plɑ:nt
oyster sauce => ˈɔistə sɔ:s
oystercatchers => ˈɔɪstəˌkætʃəz
oystering => 'ɔistəriŋ
Ozalid => 'ɔzәlid
ozone => 'әuzәun
ozone hole => ˈəuzəun həul
ozone-friendly => ˈəuzəun ˈfrendli
ozonic => әu'zɒnik
ozonide => 'әuzәunaid
ozonize => 'әuzәnaiz
ozonized => ˈəuzənaizd
ozonizer => 'әuzәnaizә
ozonizes => ˈəuzənaiziz
ozonizing => ˈəuzənaizɪŋ
ozonosphere => әu'zәunәsfiә