Z => zed; (?@) zi:
zabaglione => .zɑ:bәl'jәuni
Zabrze => 'zɑ:bʒe
Zacatecas => ,sɑ:kɑ:'teikәs
Zach => zæk
zachary => 'zækәri
zack => zæk
Zadar => 'zɑ:dɑ:
zaffre => ˊzæfә
zaftig => 'zɑ:ftig
zag => zæ^
Zagazig => ,zɑ:^ɑ:'zi:^
zagreb => 'zɑ:^reb
zaibatsu => zai'bɑ:tsu:
Zaire => zә'i:rә
Zairean => ,zai'iәriәn
zakat => 'zɑ:kɑ:t
Zakopane => zɑ:kɔ'pɑ:ne
zalcitabine => 'zælsaɪtæbɪn
zambezi => zæm'bi:zi
Zambia => 'zæmbiә
Zambian => 'zæmbiәn
Zamboanga => sɑ:mbәu'ɑ:ŋ^ɑ:
zambra => 'zæmbrә
zamia => 'zeimiә
zamindar => zә.mi:n'dɑ:
zamindari => zә,mi:n'dɑ:ri,,zæmin-,,zemin-
ZANDER => 'zændә
zanier => ˈzeɪni:ə
Zante => 'zɑ:nti:, -tei
ZANU => 'zɑ:nu:
zany => 'zeini
Zanzibar => ,zænzi'bɑ:
Zanzibari => ,zænzi'bɑ:ri
zap => zæp
zapateado => .zɑ:pәti'ɑ:dәu
Zapotec => 'zɑ:pә,tek
zapped => zæpt
zapper => 'zæpә
zapping => 'zæpiŋ
zappy => 'zæpi
zaps => zæps
ZAPU => 'zɑ:pu:
Zaqaziq => 'zækәzik,,zɑ:kɑ:'zi:k
zara => 'zɑ:rɑ:,'dzɑ:-
Zaragoza => ,θɑ:rɑ:'^ɔ:θɑ:,,sɑ:rɑ:'^ɔ:sɑ:
Zarathustra => ,zærә'θu:strә
zariba => zә'ri:bә
zarzuela => zɑ:'zweilә
zax => zæks
zazen => 'zɑ:'zen
zeal => zi:l
zealand => 'zi:lәnd
zealot => 'zelәt
zealotry => 'zelәtri
zealots => 'zeləts
zealous => 'zelәs
zeaxanthin => ziә'zænθin
zebec => 'zi:bek
Zebedee => 'zebidi
zebra => 'zi:brә
zebrawood => 'zi:brәwud
zebu => 'zi:bju:
Zebulun => 'zebjulən; zə'bju:-
Zechstein => 'zekʃtain
zed => zed
zedoary => 'zedәuәri
zee => zi:
Zeebrugge => 'zi:bru^ә
zein => 'zi:in
zeiss => zais
zeitgeist => 'tsait^aist
zelda => 'zeldә
zemindar => 'zimindɑ:
Zen => zen
Zena => 'zenә
zenana => ze'nɑ:nә
Zend => zend
Zener => 'zi:nә(r),'ze-
zenith => 'zeniθ. 'zi:-
zenithal => 'zi:niθәl
Zeno => 'zi:nәu
Zenobia => zi'nәubjә
zeolite => 'zi:әlait
zeolitic => zɪə'lɪtɪk
zephyr => 'zefә
zeppelin => ,tsepә'li:n
zeppelins => 'zɛpəlɪn
zero => 'ziәrәu
zero in => ˈziərəu in
zero tolerance => ˈziərəu ˈtɔlərəns
zero-based => 'zɪərəʊb'eɪst
zero-coupon bond => ˈziərəu ˈku:pɔn bɔnd
zero-emission => 'zɪərəʊɪm'ɪʃn
zero-sum => 'ziәrәj'sʌm,'zi:-
zero-sum game => ˈziərəuˈsʌm ɡeim
zeroed => ˈziərəud
zeroing => ziәrәuiŋ
zeros => 'zɪərəʊ
zeroth => 'ziәrәjð,-rәjθ,'zi:-
zest => zest
zested => zestid
zester => ˈzestə(r)
zestful => 'zestful
zesting => zestɪŋ
zests => zests
zesty => 'zesti
zeta => 'zi:tә. 'zei-
zetetic => zi'tetik
zeugma => 'zju:gmә
zeugmatic => zju:g'mætik
Zeus => zju:s
Zeuxis => 'zu:ksis
Zhanjiang => 'ʒɑ:ŋ'dʒjɑ:ŋ
Zhdanov => 'ʒdɑ:nәf
Zhejiang => 'dʒe'dʒjɑ:ŋ
Zhengzhou => 'dʒeŋ'dʒәj
Zhitomir => ʒi'tɔ:miә(r)
zho => ʒәj,zәj
zhou => dʒәj
zidovudine => zɪdəʊv'jʊdɪnə
ziegler => 'zi:^lә
ziff => zif
zig => zig
ziggurat => 'zi^әræt
zigzag => 'zigzæg
zigzagged => 'zɪɡzæɡd
zigzagging => 'zɪɡzæɡɪŋ
zigzags => ˈziɡzæɡz
zilch => ziltʃ
zilla => ˈzɪlə
zillion => 'ziljәn
zillionaire => ,ziljә'neә
Zimbabwe => zim'bɑ:bwei
Zimbabwean => zim'bɑ:bwiәn
zimmer => 'zimә(r)
zimmerman => 'zimәmәn
zinc => ziŋk
zinced => 'zɪŋkt
zincing => 'zɪŋkɪŋ
zincite => 'ziŋkait
zinco => 'ziŋkәu
zincs => ziŋks
zindabad => 'zindɑ:bɑ:d
zineb => 'zineb
zing => ziŋ
zinger => 'ziŋә
zingy => 'ziŋi
Zinjanthropus => zin'dʒænθrәpәs,,zindʒæn'θrәj-
zinnia => 'ziniә
zion => 'zaiәn
Zionism => 'zaiәniz(ә)m
zionists => ˈzaiənists
zip => zip
zipless => 'ziplis
zipper => 'zipә
zippers => 'zɪpəz
zipping => 'zɪpɪŋ
zippy => 'zipi
zips => zips
zircaloy => 'zә:kәlɔi
zircon => 'zә:kɒn
zirconia => zә'kәuniә
zirconium => zә:'kәuniәm
zit => zit
zither => 'ziθә
zitherist => 'ziθәrist
ziti => 'zi:ti
zits => 'zɪts
zizz => ziz
zloty => 'zlɒti
zoantharian => ,zәuæn'θeәriәn
zodiac => 'zәudiæk
zodiacal => zәu'daiәkәl
zoe => 'zәui
zoetrope => 'zәuitrәup
zoftig => 'zɔfti^
Zohar => 'zәuhɑ:
zokor => 'zəʊkəʊər
Zola => 'zәulә
Zollverein => 'tsɔlfәrain
zombie => 'zɔmbi
zombify => 'zɒmbɪfaɪ
zonal => 'zәunl
zonation => zәu'neiʃәn
zone => zәun
zone out => zəun aut
zoned => zәund
zoning => 'zәuniŋ
zonk => 'zəʊŋk
zonked => zɒŋkt
zonule => 'zәunju:l
zoo => zu:
zoo-keeper => 'zu:ki:pə
zoogeographer => .zәuәdʒi'ɒgrәfә
zoogeographic => ,zәuәdʒiә'^ræfikl
zoogeographical => ,zәuәdʒiә'^ræfiklәl
zoogeography => .zәuәdʒi'ɒgrәfi
zooid => 'zәuɔid
zookeeper => 'zu:,ki:pә(r)
zoolatry => zәu'ɒlәtri
zoological => .zәuә'lɒdʒikl
zoologist => zәu'ɒlәdʒist
zoology => zәu'ɒlәdʒi
zoom => zu:m
zoomed => zu:md
zooming => 'zu:miŋ
zoomorphic => zәuәu'mɔ:fik
zoomorphism => .zәuә'mɒ:fizm
zooms => zu:mz
zoonosis => .zәuә'nәusis
zoophile => 'zәuәfail
zoophilia => ,zәjәj'filiә
zoophilic => ,zәjәj'filik
zoophyte => 'zәuәfait
zooplankton => ,zәuә'plæŋktәn
zoos => zu:z
zoospore => 'zәuәspɒ:
zoot suit => zu:t'sju:t
zooxanthella => ,zәuәzæn'θelә
zori => 'zәuri
Zoroastrian => zɔrәu'æstriәn
Zoroastrianism => ,zɔrәj'æstriәnizәm
zorro => zɔ:rɔ
zoster => 'zɒstә
Zouave => zu:'ɑ:v,zwɑ:v
zouk => 'zaʊk
zounds => zaundz
zowie => 'zaui
zoysia => 'zɔisiә
Zsigmondy => 'ʒi^mɔ:ndi
zu => zu:
zucchetto => zu:'ketәu
zucchini => zu:'ki:ni
zugzwang => 'tsu:ktsvɑ:ŋ
zulu => 'zu:lu:
Zululand => 'zu:lu:lænd
Zuni => 'zu:ni, 'su:-
zuppa inglese => ˈtsu:pəiŋˈɡleizei
Zurich => 'zuәrik
Zwickau => 'tsvikaj
Zwinglian => 'zwiŋ^liәn,'tsviŋl-
zwitterion => 'tsvitәr.aiәn
zwitterionic => ,zwitәrai'ɔnik,,tsvi-
Zwolle => 'zvɔlə
zydeco => 'zaidikәj
zygodactyl => ,zai^әu'dæktil
zygodactylous => ,zai^ә'dæktilәs
zygoma => zai'gәumә
zygomatic => .zaigәu'mætik
zygomorphic => ,zai^әu'mɔ:fik
zygomorphy => ,zai^әu'mɔ:fi
zygospore => zai'gәuspɒ:
zygote => 'zaigәut
zygotene => 'zai^ә,ti:n, 'zi^ә-
zymase => 'zaimeis
zymo- => 'zaimәj
zymogen => 'zaimәdʒәn
zymurgy => 'zaimә:dʒi