pongee => pɒn'dʒi:
pongid => 'pɔndʒid
pongo => 'pɔŋgәu
pongs => pɔŋz
poniard => 'pɔnjәd
poniarded => ˈpɔnjədid
poniarding => ˈpɔnjədɪŋ
poniards => ˈpɔnjədz
ponies => ˈpəuniz
pons => pɔnz
pons asinorum => ˈpɔnzˌæsəˈnɔ:rəm, -ˈnəʊrəm
pont => pɔnt
pontes => 'pɒntɪz
Pontiac => 'panti,æk
Pontianak => ,pɔnti'ɑ:næk
pontifex => 'pɔnti,feks
pontiff => 'pɒntif
pontiffs => ˈpɔntifs
pontifical => pɒn'tifikl
pontificate => pɒn'tifikit
pontificated => pɔnˈtifikitid
pontificates => pɔnˈtifikits
pontificating => pɔnˈtifikitɪŋ
pontifices => pɔn'tifisi:z
pontil => 'pɔntil
pontine => 'pɒntain
pontoon => pɒn'tu:n
pontoon bridge => pɔnˈtu:n bridʒ
pontooning => pɒn'tuːn
pontoons => pɔnˈtu:nz
Pontus => 'pɔntәs
pony => 'pәuni
ponytail => 'pәuniteil
ponytails => ˈpəʊni:ˌteɪlz
poo-poo => 'pu:p'u:
pooch => pu:tʃ
poodle => 'pu:dl
poodles => ˈpu:dlz
poof => puf
poofs => pufs
poofter => 'pʊftə(r)
poofy => 'pjfi, 'pu:-
pooh => pu:
pooh-bah => 'pu:'bɑ:
pooh-pooh => 'pu:'pu:
poohed => pu:d
pooja => 'pu:dʒә
pooka => 'pu:kә
pool => pu:l
poole => pu:l
poolroom => 'pu:lrum
poolside => 'pu:lsaid
poon => pu:n
Poona => 'pu:nә
poontang => 'pu:ntæŋ
poop => pu:p
poop deck => pu:p dek
poop out => pu:p aut
pooped => pu:pt
poops => pu:ps
poor => puә. pɒ:
poor box => puə bɔks
poor relation => puə riˈleiʃən
poor white => puə hwait
poorhouse => 'puәhaus
poorly => 'puәli
poorness => 'puәnis
poort => pjәt,pɔ:t
poorwill => 'puəwil
poot => pu:t
pooter => 'pu:tər
pop => pɒp
pop fly => pɔp flai
pop music => pɔp ˈmju:zik
pop quiz => pɔp kwiz
pop-eyed => 'pɔpaid
pop-top => 'pɔp,tɔp
popcorn => 'pɒpkɒ:n
pope => pәup
pope's nose => pəʊps
popedom => 'pәjpdәm
popery => 'pәupәri
Popeye => 'pɔpai
popgun => 'pɔp^ʌn
popinjay => 'pɒpindʒei
popish => 'pәupiʃ
poplar => 'pɒplә
poplars => ˈpɔpləz
poplin => 'pɒplin
popliteal => pɒp'litiәl
popover => 'pɒp.әuvә
poppa => 'pɒpә
poppadom => ˈpɒpədəm
popped => pɔpt
popper => 'pɒpә
poppers => ˈpɒpəz
poppet => 'pɒpit
poppets => 'pɒpɪt
poppied => 'pɔpid
poppies => ˈpɔpi:z
popping => 'pɔpiŋ
popple => 'pɒpl
poppy => 'pɒpi
poppycock => 'pɒpikɒk
poppyseed => 'pɒpisi:d
pops => pɔps
popsicle => 'pɒpsikl
popster => 'pɔpstә(r)
popstrel => 'pɔpstrel
popsy => 'pɔpsi
populace => 'pɒpjulәs
popular => 'pɒpjulә
popular music => ˈpɔpjulə ˈmju:zik
popularisation => ,pɔpjjlәrai'zeiʃәn;-ri'z-
popularise => 'pɔpjjlәraiz
popularity => .pɒpju'læriti
popularize => 'pɒpjulәraiz
popularized => ˈpɔpjələˌraɪzd
popularizer => 'pɔpjjlәraizә(r)
popularizes => ˈpɔpjələˌraɪziz
popularizing => ˈpɔpjələˌraɪzɪŋ
popularly => 'pɒpjulәli
populate => 'pɔpjuleit
populates => ˈpɔpjəˌleɪts
population => .pɒpju'leiʃәn
populations => pɒpjʊ'leɪʃnz
Populism => 'pɒpjulizm
Populist => 'pɔpjulist
populous => 'pɒpjulәs
populousness => ˊpɒpjulәsnis
porbeagle => 'pɒ:.bi:gl
porcelain => 'pɒ:slin
porcellanous => pɔ:'selәnәs,'pɔ:sәlәnәs
porch => pɒ:tʃ
porches => pɔ:tʃiz
porcine => 'pɒ:sain
porcini => pɔ:'tʃi:ni
porcupine => 'pɒ:kjupain
porcupine fish => ˈpɔ:kjəˌpaɪn fiʃ
porcupines => ˈpɔ:kjəˌpaɪnz
pore => pɒ:
porgy => 'pɒ:gi
Pori => 'pɔ:ri
poriferan => pɒ:'rifәrәn
pork => pɒ:k
pork barrel => pɔ:k ˈbærəl
pork pie => pɔ:k pai
porker => 'pɒ:kә
porkling => 'pɒ:kliŋ
porkpie => 'pɒ:kpai
porky => 'pɒ:ki
porn => pɔ:n
porno => 'pɔ:nәu
pornographer => pɒ:'nɒgrәfә
pornographic => .pɒ:nә'græfik
pornography => pɔ:'nɔ^rәfi
porosity => pɒ:'rɒsiti
porous => 'pɒ:rәs
porousness => 'pɔ:rəsnəs
porphyria => pɔ'fiәriә
porphyries => ˈpɔ:firiz
porphyrin => 'pɒ:fәrin
porphyrins => 'pɔ:fɪrɪnz
porphyritic => .pɒ:fi'ritik
porphyroblast => 'pɔ:firәblɑ:st
porphyry => 'pɒ:firi
porpoise => 'pɒ:pәs
porpoises => ˈpɔ:pəsiz
porridge => 'pɒ:ridʒ
porringer => 'pɒ:rindʒә
Porsches => 'pɔːskɪ
port => pɒ:t
Port Harcourt => pɔ:t'hɑ:kәt
Port Louis => 'pɔ:t 'lu(:)i(s)
Port Moresby => pɔ:t'mɔ:zbi
Port Said => 'pɔ:t'said
Port Sudan => 'pɔ:t su(:)'dɑ:n
Port Vila => pɔ:t'vi:lә
Port-au-Prince => ,pɔ:təu'prins; 'pəut-
porta => 'pɔ:tә
portability => .pɒ:tә'biliti
portable => 'pɒ:tәbl
portables => 'pɔ:təblz
portacabin => 'pɔ:tә,kæbin
portage => 'pɒ:tidʒ
portakabin => ˈpɔ:təkæbɪn
portal => 'pɒ:tl
portamento => .pɒ:tә'mentәu
portcullis => .pɒ:t'kʌlis
portcullised => pɔːt'kʌlɪs
Porte => pɒ:t
portend => pɒ:'tend
portended => pɔ:ˈtendid
portending => pɔ:ˈtendɪŋ
portends => pɔ:ˈtendz
portent => 'pɒ:tent
portentous => pɒ:'tentәs
portentously => pɔ:'tentəsli
portentousness => pɔ:'tentəsnis
portents => ˈpɔ:ˌtents
porter => 'pɒ:tә
porterage => 'pɒ:tәridʒ
porterhouse => 'pɔ:tәhajs
porterhouse steak => ˈpɔ:təhaus steik
portering => 'pɔːtə
porters => ˈpɔ:təz
portfire => 'pɒ:tfaiә
portfolio => pɒ:t'fәuliәu
portfolios => pɔ:tˈfəʊli:ˌəʊz
porthole => 'pɒ:thәul
portholes => ˈpɔ:tˌhəʊlz
portia => 'pɔ:ʃiә
portico => 'pɒ:tikәu
porticos => ˈpɔ:tɪˌkəʊz
porting => 'pɔ:tɪŋ
portion => 'pɒ:ʃәn
portioning => 'pɔ:ʃnɪŋ
portionless => 'pɔ:ʃәnlis,'pәj-
portions => ˈpɔ:ʃənz
Portland => 'pɒ:tlәnd
Portland cement => 'pɔ:tlәnd
portlier => ˈpɔ:tli:ə
portliness => 'pɒ:tlinis
portly => 'pɒ:tli
portmanteau => pɒ:t'mæntәu
portmanteau word => pɔ:tˈmæntəu wə:d
portmanteaus => pɔ:tˈmæntəuz
porto => 'pɔ:tu
portobello => ,pɔːtə'beləʊ
portrait => 'pɒ:treit
portraitist => 'pɒ:treitist
portraits => 'pɔ:trɪts
portraiture => 'pɒ:tritʃә
portray => pɒ:'trei
portrayal => pɔ:'treiәl
portrayals => pɔ:ˈtreɪəlz
portrayed => pɔ:ˈtreid
portrayer => pɒ:'treiә
portraying => pɔ:ˈtreiŋ
portrays => pɔ:ˈtreiz
portsmouth => 'pɔ:tsmәθ
Portugal => 'pɒ:tʃugl
Portuguese => .pɒ:tju'gi:z
posada => pәu'sɑ:ðɑ:
pose => pәuz
Poseidon => pɒ'saidn
Posen => 'pəuzən
poser => 'pәuzә
posers => ˈpəʊzəz
poses => pəuziz
poseur => pәu'zә:
poseurs => pəʊˈzɜ:rs
poseuse => pәj'z\\\\:z
posey => 'pəusi:
posh => pɒʃ
posher => pɔʃə
posho => 'pɔʃɔ
posies => ˈpəʊzi:z
posit => 'pɒzit
posited => ˈpɔzɪtid
positif => 'pɔsitif
position => pә'ziʃәn
position paper => pəˈziʃən ˈpeipə
positional => pә'ziʃәnl
positioner => pә'ziʃәnә
positioning => pә'ziʃәniŋ
positive => 'pɒzitiv
positive discrimination => ˈpɔzitiv dɪˌskrimiˈneiʃən
positives => ˈpɔzitivz
positivism => 'pɒzitivizm
positivist => 'pɒzitivist
positivity => .pɒzi'tiviti
positron => 'pɒzitrɒn
posits => ˈpɔzɪts
posology => pәu'sɔlәdʒi
poss => pɔs
posse => 'pɒsi
posses => 'pɒsɪ
possess => pә'zes
possessed => pә'zest
possesses => pəˈzesiz
possessing => pəˈzesɪŋ
possession => pә'zeʃәn
possessive => pә'zesiv
possessive pronoun => pəˈzesɪv ˈprəunaun
possessiveness => pə'zesɪvnəs
possessives => pəˈzesɪvz
possessor => pә'zesә
possessors => pəˈzesəz
possessory => pә'zesәri
posset => 'pɔsit
possibilities => ˌpɔsəˈbilitiz
possibility => .pɒsә'biliti
possible => 'pɒsәbl
possibly => 'pɒsәbli
possie => 'pɔsi
possum => 'pɒsәm
possums => ˈpɔsəmz
post => pәust
post exchange => pəust iksˈtʃeindʒ
post hoc => 'pәusthɔk
post horn => pəust hɔ:n
post room => pəust ru:m
post-classical => 'pəʊstkl'æsɪkl
post-coital => ˌpəʊst ˈkɔɪtl
post-feminist => 'pəʊstf'emɪnɪst
post-haste => pəust heist
post-industrial => pəust inˈdʌstriəl
post-modernism => 'pəʊstm'ɒdənɪzəm
post-op => 'pəʊst'ɒp
post-operative => pəust ˈɔpərətɪv
post-paid => ˈpəʊstˈpeɪd
post-partum => ˌpəʊst ˈpɑ:təm
post-production => pəust prəˈdʌkʃən
post-structuralism => 'pəʊststr'ʌktʃərəlɪzəm
post-war => ˌpəustˈwɔ:
postage => 'pәustidʒ
postage meter => ˈpəustidʒ ˈmi:tə
postal => 'pәustl
postal code => ˈpəʊstəl kəud
postal vote => ˈpəʊstəl vəut
postauricular => pəʊstɔ:'rɪkjʊlə
postbag => 'pәustbæg
postbox => 'pәustbɒks
postcard => 'pәustkɑ:d
postcards => ˈpəustkɑ:dz
postcode => 'pәustkәud
postcodes => ˈpəustkəudz
postcolonial => ,pәjstkә'lәjnjәl,-ni-
postdate => .pәust'deit
postdated => ˈpəustˈdeitid
postdates => ˈpəustˈdeits
postdating => ˈpəustˈdeitɪŋ
postdoc => pәjst'dɔk
postdoctoral => pәust'dɒktәrәl
poste restante => pәjst 'restɑ:nt; (?@) res'tænt
poster => 'pәustә
poster boy => ˈpəustə bɔi
poster paint => ˈpəustə peint
posterior => pɒ'stiәriә
posteriority => pɒ.stiәri'ɒriti
posteriors => pɒs'tɪərɪəz
posterity => pɒ'steriti
posterization => ,pәustәrai'zeiʃәn
posterize => 'pәjstәraiz
postern => 'pәustәn
posters => 'pəʊstəz
postface => 'pәustefis
postfeminist => pəʊstfe'mɪnɪst
postfix => 'pәustfiks
postfrontal => pәust'frʌntәl
postglacial => pәust'gleiʃәl
postgrad => ˈpəʊstgræd
postgraduate => 'pәust'^rædjuit, 'pәust'^rædʒuit
postgraduates => pəʊstɡ'rædʒʊəts
posthole => 'pәusthәul
posthumous => 'pɒstjumәs
posthypnotic => 'pәusthaip'nɔtik
postie => 'pәjsti
postil => 'pɒstil
postilion => pɔs'tiljәn
posting => 'pәustiŋ
postlude => 'pәustlju:d
postman => 'pәustmәn
postmark => 'pәustmɑ:k
postmarked => 'pəʊstmɑːkt
postmarks => ˈpəʊstˌmɑ:ks
postmaster => 'pәust.mɑ:stә
postmasters => ˈpəʊstˌmæstəz
postmillennial => 'pәustmi'leniәl
postmillennialism => ,pәustmi'leniәlizәm
postmistress => 'pәustmistris
postmodern => pәust'mɔdәn
postmodernism => ˌpəʊstˈmɒdənɪzəm
postmodernist => pəʊst'mɒdənɪst
postmortem => pәust'mɒ:tәm
postmultiplication => 'pәustmʌltipli'keiʃәn
postmultiply => pәjst'mʌltiplai
postnatal => pәust'neitl
postnuptial => pәust'nʌpʃәl
postoperative => pәust'ɒpәrәtiv
postorbital => pәust'ɒ:bitl
postpaid => 'pәust'peid
postpartum => pәust'pɑ:tәm
postpon => pəs'pɒn
postpone => pәust'pәun
postponed => ˌpəʊst'pəʊnd
postponement => pәust'pәunmәnt
postponements => pəustˈpəunmənts
postponer => pəs'pəʊnər
postpones => ˌpəustˈpəunz
postponing => 'pəʊst'pəʊnɪŋ
postpose => 'pəʊstpəʊz
postposition => .pәustpә'ziʃәn
postpositive => 'pәust'pɔzitiv
postprandial => pәust'prændiәl
postscript => 'pәustskript
postscripts => ˈpəustskripts
postseason => pəʊst'si:zn
poststructuralism => pəʊst'rʌktʃərəlɪzəm
postsurgical => 'pəʊsɜ:dʒɪkəl
postsynaptic => pәustsi'næptik
posttest => 'pəʊstɪst
postulant => 'pɒstʃәlәnt
postulate => 'pɒstjuleit
postulated => ˈpɔstʃəˌleɪtid
postulates => ˈpɔstʃəˌleɪts
postulating => ˈpɔstʃəˌleɪtɪŋ
postulation => .pɒstʃә'leiʃәn
postulator => 'pɒstʃәleitә
postural => 'pɒstʃәrәl
posture => 'pɒstʃә
postured => ˈpɔstʃəd
posturer => 'pɔstʃәrә
postures => ˈpɔstʃəz
posturing => ˈpɒstʃərɪŋ
postvocalic => .pәustvәu'kælik
postwar => 'pәust'wɒ:
postwoman => 'pәjst,wjmәn
posy => 'pәuzi
pot => pɒt
pot belly => pɔt ˈbeli
pot luck => pɔt lʌk
pot plant => pɔt plɑ:nt
pot-au-feu => 'pɒt'əʊfj'u:
pot-belly => 'pɒtb'elɪ
pot-house => 'pɒthaʊs
pot-hunter => 'pɒth'ʌntər
pot-valiant => 'pɔt,væljәnt
potability => pəʊtə'bɪlɪtɪ
potable => 'pәutәbl
potage => pɔ'tɑ:ʒ
potamology => ,pɔtә'mɔlәdʒi
potash => 'pɔtæʃ
potassic => pәj'tæsik
potassium => pә'tæsiәm
potassium-argon dating => pəˌtæsi:əmˈɑ:ˌgɔn
potation => pәu'teiʃәn
potato => pә'teitәu
potato blight => pəˈteitəu blaɪt
potato crisp => pəˈteitəu krisp
potato salad => pəˈteitəu ˈsæləd
potato vine => pəˈteitəu vaɪn
potbellied => 'pɒtbelid
potbelly => 'pɒtbeli
potboiler => 'pɒtbɒilә
potbound => pɒt'baʊnd
potch => 'pɔtʃ
poteen => pәu'ti:n
potence => 'pәutәns
potency => 'pәutәnsi
potent => 'pәutnt
potentate => 'pәutәnteit
potentates => ˈpəʊtnˌteɪts
potential => pә'tenʃәl
potentialities => pəˌtenʃiˈælitiz
potentiality => pәu.tenʃi'æliti
potentialize => pә'tenʃәlaiz
potentially => pә'tenʃәli
potentials => pə'tenʃlz
potentiate => pә'tenʃieit
potentiated => pəuˈtenʃieitid
potentiates => pəuˈtenʃieits
potentiating => pəuˈtenʃieitɪŋ
potentiation => pә,tenʃi'eiʃәn
potentilla => ,pәutәn'tilә
potentiometer => pә.tenʃi'ɒmitә
potentiometric => pəˌtenfɪə'metrɪk
potentiometry => pә,tenʃi'ɔmitri
potently => 'pəutəntli
potful => 'pɔtfjl
pothead => 'pɔt,hed
potheen => 'pәu'θi:n
pother => 'pәuðә
pothered => ˈpɔðəd
pothering => ˈpɔðərɪŋ
pothers => ˈpɔðəz
potholder => 'pɔt,hәjldә(r)
pothole => 'pɒthәul
potholed => 'pɒthəʊld
potholer => 'pɒthəʊlə(r)
potholers => 'pɔthəulə
potholes => 'pɒthəʊlz
pothunter => 'pɒthʌntә
potion => 'pәuʃәn
potions => ˈpəʊʃənz
Potiphar => 'pɔtifә(r)
potlatch => 'pɒtlætʃ
potluck => 'pɒtlʌk
potman => 'pɔtmәn
potomac => pә'tәumәk
potoo => pə'tu:
potoroo => ,pɔtә'ru:,,pәj-
potpie => 'pɒtpai
potpourri => pәu'puri(:)
potpourris => ˌpəʊpʊˈri:z
potrero => pә'trerәu
Potsdam => 'pɒtsdæm
Potsdamer => 'pɔtsdæm; 'pɔ:tsdɑ:m
potsherd => 'pɒtʃә:d
potshot => 'pɒtʃɒt
potshots => ˈpɔtʃɔts
pottage => 'pɔtidʒ
potted => 'pɒtid
potter => 'pɒtә
pottered => ˈpɔtəd
potteries => ˈpɔtəriz
pottering => ˈpɔtərɪŋ
pottery => 'pɒtәri
potties => ˈpɔtiz
potting => 'pɔtiŋ
potting shed => ˈpɔtiŋ ʃed
pottle => 'pɔtl
potto => 'pɔtәu
potty => 'pɒti
pouch => pautʃ
pouched => 'pautʃt
pouches => paʊtʃiz
pouchy => 'pajtʃi
pouf => pu:f
pouffe => pu:f
poult => pәult
poulterer => 'pәultәrә
poultice => 'pәultis
poulticed => 'pəʊltɪs
poultices => ˈpəultisiz
poulticing => 'pəʊltɪs
poultry => 'pәultri
pounce => pauns
pounced => paʊnst
pounces => paʊnsiz
pound => paund
pound cake => paund keik
pound sign => paund sain
poundage => 'paundidʒ
poundal => 'paundl
pounder => 'paundә
pounders => 'paʊndə
pounding => 'pәundiŋ
pounds => paundz
pour => pɒ:
pourable => 'pɔ:rәbl
pourboire => 'puәbwɑ:
poured => pɔ:d
pourer => 'pɔ:rә
pouring => 'pɔ:riŋ
pours => pɔ:z
Poussin => pu:'sæŋ
pout => paut
pouted => paʊtid
pouter => 'pautә
pouting => paʊtɪŋ
pouts => paʊts
pouty => 'pauti
poverty => 'pɒvәti
poverty line => ˈpɔvəti lain
poverty trap => ˈpɔvəti træp
pow => pau
pow-wow => 'paʊw'aʊ
powan => 'pajәn,'pәj-
powder => 'paudә
powder flask => ˈpaudə flɑ:sk
powder horn => ˈpaudə hɔ:n
powder keg => ˈpaudə keg
powder monkey => ˈpaudə ˈmʌŋki
powder puff => ˈpaudə pʌf
powder snow => ˈpaudə snəu
powdered => 'paudәd
powdering => 'paudәriŋ
powders => ˈpaudəz
powdery => 'paudәri
powdery mildew => ˈpaʊdəri: ˈmɪlˌdu:
powell => 'pәuәl, 'pauәl
power => 'pauә
power base => ˈpauə beis
power breakfast => ˈpauə ˈbrekfəst
power dive => ˈpauə daiv
power drill => ˈpauə dril
power forward => ˈpauə ˈfɔ:wəd
power law => ˈpauə lɔ:
power play => ˈpauə pleɪ
power point => ˈpauə pɔint
power politics => ˈpauə ˈpɔlitiks
power shovel => ˈpauə ˈʃʌvl
power train => ˈpauə trein
power-assisted => ,pauərə'sistid
power-up => ˈpauə ʌp
powerboat => 'pauәbәut
powered => 'pauәd
powerful => 'pauәful
powerfulness => ˊpauәfulnis
powerhouse => 'pauәhaus
powerhouses => ˈpaʊəˌhaʊsiz
powering => 'pauәriŋ
powerless => 'pauәlis
powerlessly => 'paʊəlɪslɪ
powerlessness => 'paʊələsnəs
powerlifter => 'pajә,liftә(r)
powerlifting => 'pajә,liftiŋ
powerplant => 'paʊərplɑ:nt
powwow => 'pauwau
powwowed => ˈpauwaud
powwowing => ˈpauwauɪŋ
powwows => ˈpauwauz
Powys => 'pәuis
pox => pɒks
poxed => pɒks
poxvirus => 'pɔks,vaiәrәs
poxy => ˈpɒksi
Poznan => 'pauznæn
Pozsony => 'pɔ:ʒɔ:njә,'pәjʒәj-
pozzolana => ,pɔtsә'lɑ:nә
practicability => .præktikә'biliti
practicable => 'præktikәbl
practicably => 'præktikәbli
practical => 'præktikl
practicalities => ˌpræktɪˈkælətɪz
practicality => .prækti'kæliti
practically => 'præktikli
practicals => ˈpræktikəlz
practice => 'præktis
practiced => 'præktist
practices => ˈpræktisiz
practician => præk'tiʃәn
practicing => 'præktisiŋ
practicum => 'præktikәm
practise => 'præktis
practised => 'præktist
practises => ˈpræktisiz
practitioner => præk'tiʃәnә
practitioners => prækˈtiʃənəz
prad => præd
prado => 'prɑ:dәu
praecipe => 'pri:sipi
praemunire => ,pri:mju'naiәri
praenomen => pri:'nәumen
praepostor => .pri:'pɒstә
Praesepe => pri:'si:pi
praesidium => pri'sidiәm
praetor => 'pri:tә
praetorial => pri'tɔ:ri:əl
praetorian => pri:'tɔ:riәn
praetorians => priː'tɔːrɪən
praetorship => 'pri:tәʃip
pragmatic => præ^'mætik
pragmatically => præg'mætikəli
pragmatics => præg'mætiks
pragmatism => 'prægmәtizm
pragmatist => 'prægmәtist
pragmatistic => .prægmә'tistik
Prague => prɑ:g
prahu => 'prɑ:hu:
Praia => 'praiɑ:
Prairial => pre'rjɑ:l
prairie => 'prєәri
prairie dog => ˈprɛəri dɔɡ
prairie oyster => ˈprɛəri ˈɔistə
prairie schooner => ˈprɛəri ˈsku:nə
prairie wolf => ˈprɛəri wulf
praise => preiz
praiseful => 'preizful
praiseworthily => p'reɪzwɜ:ðɪlɪ
praiseworthiness => 'preiz,wə:ðinis
praiseworthy => 'preizwә:ði
prajna => 'prjdʒnә,-njɑ:
Prakrit => 'prɑ:krit
praline => 'prɑ:li:n
pralltriller => 'prɑ:l,trilә(r)
pram => præm
prams => p'ræmz
prance => prɑ:ns
pranced => p'rɑ:nst
prances => prænsiz
prancing => prænsɪŋ
prandial => 'prændiәl
prang => præŋ
prank => præŋk
pranked => præŋk
pranking => præŋk
prankish => 'præŋkiʃ
pranks => præŋks
prankster => 'præŋkstә
pranksters => ˈpræŋkstəz
prase => preiz
praseodymium => .preiziәu'dimiәm
prat => præt
prate => preit
prated => preɪtid
prates => preɪts
pratfall => 'prætfɒ:l
pratie => 'preiti
pratincole => 'prætiŋkәul, 'prætn-
prating => preɪtɪŋ
pratique => 'præti:k
prats => præts
pratt => præt
prattle => 'prætl
prattled => ˈprætld
prattler => 'prætlә
prattles => ˈprætlz
prattling => ˈprætlɪŋ
prau => prau
Pravda => 'prɑ:vdә
prawn => prɒ:n
prawns => prɔ:nz
praxis => 'præksis
Praxiteles => præk'sitəli:z
pray => prei
prayed => preid
prayer => prєә. 'preiә
prayer book => prɛə buk
prayer mat => prɛə mæt
prayer wheel => prɛə hwi:l
prayerful => 'preәful
praying => preiŋ
praying mantis => ˈpreɪɪŋ
pre-Christian => 'pri:'kristjәn, 'pri:'kristʃәn
pre-Columbian => 'pri:kә'lʌmbiәn
pre-echo => ,pri:'ekәu
pre-embryo => p'ri:'embri:əʊ
pre-eminence => ,pri:'eminəns, pri-
pre-eminent => pri:ˈemɪnənt,prɪ'ɛmənənt
pre-empt => priˈempt
pre-emptive => priˈemptɪv
pre-exist => pri:i^'zist
pre-exposure => p'ri:ɪksp'əʊʒər
pre-industrial => p'ri:ɪnd'ʌstrɪəl
pre-op => p'ri:'ɒp
pre-pack => priː'pæk
pre-plan => priː'plæn
pre-process => p'ri:pr'əses
Pre-Raphaelitism => ,pri:'ræfiəla-itizəm; -'rei-
pre-release => p'ri:rɪl'i:s
pre-school => 'pri:sku:l
pre-selection => p'ri:sɪl'ekʃn
pre-stressed => p'ri:str'est
pre-war => ˌpri:ˈwɔ:
pre-wash => pri:ˈwɔʃ
preach => pri:tʃ
preached => pri:tʃt
preacher => 'pri:tʃә
preachers => ˈpri:tʃəz
preaches => pri:tʃiz
preachify => 'pri:tʃifai
preaching => 'pri:tʃiŋ
preachment => 'pri:tʃmәnt
preachy => 'pri:tʃi
preadaptation => 'pri:,ædæp'teiʃәn
preamble => 'pri:æmbl
preambles => ˈpri:ˌæmbəlz
preamp => ˈpri:æmp
preamplifier => pri:'æmplifaiә
prearranged => ˌpri:əˈreɪndʒd
prearrangement => pri:ə'reɪndʒmənt
prebake => pri:'beɪk
prebend => 'prebәnd
prebendal => pri'bendәl
prebendary => 'prebәndәri
prebiotic => ,pri:bai'ɔtik
prebuttal => ˈpri:bʌtl
Precambrian => pri:'kæmbriәn
precancerous => pri:'kænsәrәs
precarious => pri'kєәriәs
precariousness => pri'kɛəriəsnis
precast => pri:'kɑ:st
precatory => 'prekәtәri
precaution => pri'kɒ:ʃәn
precautionary => pri'kɒ:ʃәnәri
precautions => priˈkɔ:ʃənz
precede => .pri:'si:d
preceded => ˌpriˈsi:did
precedence => pri'si:dns
precedent => 'presidәnt
precedential => ,presi'denʃәl
precedes => ˌpriˈsi:dz
preceding => .pri:'si:diŋ
precent => pri'sent
precentor => pri'sentә
precept => 'pri:sept
preceptive => pri'septiv
preceptor => pri'septә
preceptorial => .pri:sep'tɒ:riәl
preceptorship => pri:'septəʃɪp
precess => pri'ses
precessed => priˈsest
precesses => priˈsesiz
precessing => priˈsesɪŋ
precession => pri'seʃәn
precessional => prɪ'seʃənl
precinct => 'pri:siŋkt
preciosity => .preʃi'ɒsiti
precious => 'preʃәs
precious metal => ˈpreʃəs ˈmetl
precipice => 'presipis
precipices => ˈpresəpɪsiz
precipitable => pri'sipitәbl
precipitance => pri'sipitәns
precipitancy => pri'sipitәnsi
precipitant => pri'sipitәnt
precipitate => pri'sipiteit
precipitated => prɪ'sɪpɪteɪtɪd
precipitately => prɪ'sɪpɪˌteɪtlɪ
precipitates => priˈsipiteits
precipitating => pri'sipiteitiŋ
precipitation => pri.sipi'teiʃәn
precipitator => pri'sipiteitә
precipitin => pri'sipitin
precipitous => pri'sipitәs
precipitously => prɪ'sɪpɪtəslɪ
precipitousness => priˊsipitәsnis
precise => pri'sais
precised => 'preɪsi
precisely => pri'saisli
preciseness => pri'saisnis
precises => 'preɪsi
precisian => pri'siʒәn
precising => 'preɪsi
precision => pri'siʒәn
preclinical => pri:'klinikәl
preclude => pri'klu:d
precluded => priˈklu:did
precludes => priˈklu:dz
precluding => priˈklu:dɪŋ
preclusion => pri'klu:ʒәn
preclusive => pri'klu:siv
precocial => pri'kәuʃәl
precocious => pri'kәuʃәs
precociously => prɪ'kəʊʃəslɪ
precociousness => prɪ'kəʊʃəsnəs
precocity => pri'kɒsiti
precognition => .pri:kɒg'niʃәn
precoital => pri'kәjitәl
precolonial => ,pri:kә'lәjniәl
preconceive => .pri:kәn'si:v
preconceives => ,priːkən'siːv
preconceiving => ,priːkən'siːv
preconception => .pri:kәn'sepʃәn
preconceptions => pri:kən'sepʃnz
preconcert => .pri:kәn'sә:t
precondition => .pri:kәn'diʃәn
preconditions => ˈprikənˈdiʃənz
preconization => ,priːkənaɪ'zeɪʃən
preconize => 'pri:kәnaiz
preconquest => 'pri:kɔŋkwest
preconscious => pri:'kɒnʃәs
precook => pri:'kuk
precooked => ˌpri:ˈkʊkt
precooking => pri:'kʊkɪŋ
precordial => 'pri:'kɔ:djәl
precordium => 'pri:'kɔ:djәm
precursor => .pri:'kә:sә
precursors => pri:'kɜ:səz
precursory => .pri:'kә:sәri
predacity => pri'dæsәti
predate => 'pri:'deit
predated => ˈpri:ˈdeitid
predates => ˈpri:ˈdeits
predating => ˈpri:ˈdeitɪŋ
predation => pri'deiʃәn
predator => 'predәtә
predators => p'redətəz
predatory => 'predәtәri
predatory pricing => ˈpredəˌtɔ:ri: ˈpraisiŋ
predawn => pri:'dɒ:n
predecease => .pri:di'si:s
predeceased => ˈpri:diˈsi:st
predeceases => ˈpri:diˈsi:siz
predeceasing => ˈpri:diˈsi:sɪŋ
predecessor => .predi'sesә
predecessors => ˈpri:disesəz
predella => pri'delә
predestinarian => pri(:),desti'neәriәn
predestinate => pri:'destineit
predestinated => priː'destɪneɪt
predestinates => priː'destɪneɪt
predestinating => priː'destɪneɪt
predestination => pri:desti'neiʃ(ә)n
predestine => pri:'destin
predestined => ˌpri:ˈdestɪnd
predestines => pri:ˈdestɪnz
predestining => pri:ˈdestɪnɪŋ
predeterminate => .pri:di'tә:minit
predetermination => 'pri:di,t\\\\:mi'neiʃәn
predetermine => .pri:di'tә:min
predeterminer => ˌpri:dɪˈtɜ:mɪnə(r)
predetermines => ˌpri:dɪˈtɜ:mɪnz
predetermining => ˌpri:dɪˈtɜ:mɪnɪŋ
predial => 'pri:diәl
predicability => .predikә'biliti
predicable => 'predikәbl
predicament => pri'dikәmәnt
predicaments => prɪ'dɪkəmənts
predicant => 'predikәnt
predicate => 'predikәt
predicated => 'predikeitid
predicating => 'predikeitɪŋ
predication => .predi'keiʃәn
predicative => 'predikeitiv
predicatively => prɪ'dɪkətɪvlɪ
predict => pri'dikt
predictability => pri.diktә'biliti
predictable => pri'diktәbl
predicted => priˈdiktid
prediction => pri'dikʃәn
predictions => prɪ'dɪkʃnz
predictive => pri'diktiv
predictively => priˊdikәtivli
predictor => pri'diktә
predicts => priˈdikts
predigest => .pri:di'dʒest
predigested => ˌpri:daɪˈdʒestɪd
predigesting => ˈpri:diˈdʒestɪŋ
predigestion => .pri:di'dʒestʃәn
predigests => ˈpri:diˈdʒests
predikant => ,predi'kænt,-'kɑ:nt
predilection => .pri:di'lekʃәn
predilections => ˌpredlˈekʃənz
predispose => .pri:di'spәuz
predisposes => ˌpri:dɪˈspəʊziz
predisposition => pri:,dispә'ziʃәn
predispositions => ˌpri:dɪspəˈzɪʃənz
prednisolone => pred'nisәlәun
prednisone => 'prednisәun
predoctoral => pri:'dɔktәrәl
predominance => pri'dɒminәns
predominant => pri'dɒminәnt
predominate => pri'dɒmineit
predominated => prɪˈdɔməˌneɪtid
predominately => prɪ'dɒmɪnətlɪ
predominates => prɪˈdɔməˌneɪts
predominating => prɪˈdɔməˌneɪtɪŋ
predoom => 'pri:'du:m
predynastic => ,pri:di'næstik,-dai-
Preece => pri'is
preemie => 'pri:mi:
preeminence => pri:'eminәns
preeminent => pri:'eminәnt
preeminently => p'ri:maɪnəntlɪ
preempt => pri:'empt
preempted => pri:ˈemptid
preempting => pri:ˈemptɪŋ
preemptory => ,pri:'emptəri; pri-
preempts => pri:ˈempts
preen => pri:n
preen gland => pri:n ɡlænd
preened => pri:nd
preening => pri:nɪŋ
preens => pri:nz
preexist => .pri:ig'zist
preexisted => ˈpri:iɡˈzistid
preexistence => .pri:ig'zistәns
preexistent => -tənt
preexisting => ˈpri:iɡˈzistɪŋ
preexists => ˈpri:iɡˈzists
prefab => 'pri:fæb
prefabricate => pri:'fæbrikeit
prefabricated => ˌpri:ˈfæbrɪkeɪtɪd
prefabs => ˈpri:ˈfæbz
preface => 'prefis
prefaced => ˈpref.ɪs
prefaces => ˈprefisiz
prefacing => ˈpref.ɪs
prefatory => 'prefәtәri
prefect => 'pri:fekt
prefectorial => .pri:fek'tɒ:riәl
prefects => ˈpri:ˌfekts
prefectural => pri:'fektʃәrәl
prefecture => 'pri:fek.tjuә
prefer => pri'fә:
preferable => 'prefәrәbl
preferably => 'prefәrәbli
preference => 'prefәrәns
preferential => .prefә'renʃәl
preferentially => ,prefə'renʃəli
preferment => pri'fә:mәnt
preferred => pri'fә:d
prefers => priˈfə:z
prefetch => 'pri:'fetʃ
prefiguration => .pri:figju'reiʃәn
prefigurative => pri:'figjurәtiv
prefigure => pri:'figә
prefigured => pri:ˈfɪgjəd
prefigures => pri:ˈfɪgjəz
prefiguring => pri:ˈfɪgjərɪŋ
prefix => 'pri:fiks
prefixation => pri:fɪk'seɪʃn
prefixed => 'priːfɪkst
prefixes => ˈpri:fiksiz
preflight => 'pri:'flait
prefocus => 'pri:'fәukәs
preform => pri:'fɒ:m
preformation => .pri:fɒ:'meiʃәn
preformed => 'pri:'fɔ:md
preforming => pri'fɔ:miŋ
preforms => ˈpri:ˈfɔ:mz
prefrontal => pri:'frʌntl
pregame => 'pri:'^eim
pregenital => 'pri:'dʒenitl
preggers => 'pre^әz
preglacial => pri:'gleiʃәl
pregnable => 'pregnәbl
pregnancies => ˈpreɡnənsiz
pregnancy => 'preɡnәnsi
pregnant => 'pregnәnt
preheat => pri:'hi:t
preheated => ˌpri:ˈhi:tid
preheating => 'pri:hi:tiŋ
preheats => ˌpri:ˈhi:ts
prehensile => pri'hensail
prehension => pri'henʃәn
prehistorian => ,pri:hi'stɔ:riәn
prehistoric => 'pri:his'tɔrik
prehistorically => ˊpriːhisˊtɒrikәli
prehistory => .pri:'histәri
prehuman => pri:'hju:mәn
prejudge => pri:'dʒʌdʒ
prejudged => ˈpri:ˈdʒʌdʒd
prejudges => ˈpri:ˈdʒʌdʒz
prejudging => ˈpri:ˈdʒʌdʒɪŋ
prejudgments => pri:'dʒʌdʒmənt
prejudice => 'predʒudis
prejudiced => 'predʒәdist
prejudices => ˈpredʒudisiz
prejudicial => .predʒu'diʃәl
prejudicially => predʒuˊdiʃәli
prejudicing => 'predʒʊdɪs
prelacy => 'prelәsi
prelapsarian => ,pri:læp'seәriәn
prelate => 'prelit
prelates => ˈprelits
prelatic => pri'lætik
prelatical => prɪ'lɑtɪkl
prelature => 'prelәtʃә(r)
prelim => 'pri:lim
preliminaries => prɪ'lɪmɪnərɪz
preliminarily => prɪ'lɪməˌnerelɪ
preliminary => pri'liminәri
prelims => 'prɪlɪmz
preliterate => pri:'litәrәt
preload => 'pri:'lәud
prelude => 'prelju:d
preludes => ˈprelˌju:dz
preludial => pri'lju:diәl
preluding => 'preljuːd
premade => pri:'meɪd
premalignant => ,pri:mә'li^nәnt
premarital => pri:'mæritl
premaster => ˌpri:'mɑ:ste(r)
premature => .premә'tjuә
prematurely => 'premətʃə(r)lɪ
prematurity => .premә'tjuәrәti
premaxillary => -'mæk-silәri
premedical => pri:'medikl
premeditate => pri'mediteit
premeditated => pri'mediteitid
premeditates => pri(:)ˈmediteits
premeditating => pri(:)ˈmediteitɪŋ
premeditation => 'pri:,medi'teiʃən,pri-
premenopausal => p'ri:mɪnəpɔ:zl
premenstrual => pri:'menstruәl
premia => 'premiə
premier => 'pri:mjә
premiere => pri'miә
premiered => prɪˈmɪəd
premieres => prɪˈmɪəz
premiering => prɪˈmɪərɪŋ
premiers => ˈpremiəz
premiership => 'premjәʃip;pri'miә-,'pri:m-
premillennial => 'pri:mi'leniәl
premillennialism => ,pri:mi'leniәlizəm
premise => 'premis
premised => ˈpremɪst
premising => 'premɪs
premiss => 'premis
premissed => 'premis
premisses => 'premis
premissing => 'premis
premium => 'pri:miәm
premiums => ˈpri:miəmz
premix => pri:'miks
premixed => p'remɪkst
premodifier => ˌpri:ˈmɒdɪfaɪə(r)
premolar => pri:'mәulә
premonition => .pri:mә'niʃәn
premonitions => ˌpri:məˈnɪʃənz
premonitory => pri'mɒnitәri
Premonstratensian => pri,mɔnstrә'tenʃən
premultiplication => pri:,mʌltipli'keiʃәn
prenatal => .pri:'neitl
prenatally => ,pri:'neitəli
prenominal => pri:'nɔminәl
prentice => 'prentis
prenup => priː'nʌp
prenuptial => pri(:)'nʌpʃәl
prenuptial agreement => pri:ˌnʌpʃl əˈgri:mənt
preoccupation => pri:.ɒkju'peiʃәn
preoccupations => pri:ˌɔkjəˈpeɪʃənz
preoccupied => pri:'ɒkjupaid
preoccupies => priˈɔkjupaiz
preoccupy => pri:'ɒkjupai
preoccupying => priˈɔkjupaiŋ
preocular => pri:'ɔkjjlә(r)
preoperative => pri:'ɒpәrәtiv
preorbital => p'rɔ:bɪtl
preordain => .pri:ɒ:'dein
preordained => ˌpri:ɔ:ˈdeɪnd
preordaining => ˌpri:ɔ:ˈdeinɪŋ
preordains => ˌpri:ɔ:ˈdeinz
prep => prep
prep school => prep sku:l
prepackage => pri(:)'pækidʒ
prepacked => pri:'pækt
prepaid => .pri:'peid
preparation => .prepә'reiʃәn
preparations => prepə'reɪʃnz
preparative => pri'pærәtiv
preparatory => pri'pærәtәri
preparatory school => prɪˈpærəˌtɔ:ri: sku:l
prepare => pri'pєә
prepared => pri'pєәd
preparedness => pri'pєәdnis
preparer => pri'peәrә
prepares => priˈpɛəz
preparing => pri'peәriŋ
prepay => .pri:'pei
prepayable => ,pri:'peiәbl
prepayment => 'pri:'peimәnt
prepense => pri'pens
prepensely => prɪ'penslɪ
preponderance => pri'pɒndәrәns
preponderant => pri'pɒndәrәnt
preponderantly => pri'pɔndərəntli
preponderate => pri'pɒndәreit
preponderated => prɪˈpɔndəˌreɪtid
preponderates => prɪˈpɔndəˌreɪts
preponderating => prɪ'pɒndəreɪtɪŋ
prepose => pri:'pәuz
preposition => .prepә'ziʃәn
prepositional => .prepә'ziʃәnl
prepositional object => ˌprepəˈzɪʃənəl ˈɔbdʒikt
prepositional phrase => ˌprepəˈzɪʃənəl freiz
prepositions => prepə'zɪʃnz
prepositive => pri'pɒzitiv
prepossessing => .pri:pә'zesiŋ
prepossession => ,pri:pә'zeʃәn
preposterous => pri:'pɒstәrәs
preposterously => prɪ'pɒstərəslɪ
prepostor => pri:'pɔstә
prepotency => pri:'pәutnsi
prepotent => pri:'pәutnt
prepping => 'prepiŋ
preprandial => pri:'prændjәl
prepreg => 'pri:pre^
preproduction => pri:prә'dʌkʃәn
preprogram => pri'prәu^ræm
prepuce => 'pri:pju:s
prequel => 'pri:kwәl
prerecord => .pri:ri'kɒ:d
prerecorded => ˈpri:riˈkɔ:did
prerecording => ˈpri:riˈkɔ:dɪŋ
prerecords => ˈpri:riˈkɔ:dz
preregistration => 'pri:,redʒi'streiʃən
prerequisite => pri:'rekwizit
prerequisites => pri:'rekwɪzɪts
prerogative => pri'rɒgәtiv
prerogatives => prɪˈrɔgətɪvz
presage => 'presidʒ
presaged => ˈpresɪdʒd
presages => ˈpresɪdʒz
presaging => ˈpresɪdʒɪŋ
presbyopia => .prezbi'әupiә
presbyopic => .prezbi'ɒpik
presbyter => 'prezbitә
presbyteral => prez'bitәrәl,pres-
presbyterate => prez'bitәrit
presbyterial => .prezbi'tiәriәl
presbyterian => .prezbi'tiәriәn
Presbyterianism => ,prezbi'tiәriәnizəm,,pres-
presbytery => 'prezbitәri
preschool => 'pri:'sku:l
preschoolers => p'resku:lərz
prescience => 'presiәns
prescient => 'presiәnt
prescind => pri'sind
prescott => 'preskәt
prescribe => pris'kraib
prescriber => prɪsk'raɪbə
prescribes => priˈskraibz
prescribing => priˈskraibɪŋ
prescript => 'pri:skript
prescription => pri'skripʃәn
prescriptive => pri'skriptiv
prescriptivism => pris'kriptivizm
preseason => 'pri:'si:zn
preselect => .pri:si'lekt
presence => 'prezns
presences => ˈprezənsiz
presenile => pri'si:nail
present => 'preznt
present arms => ˈprezənt ɑ:mz
presentability => pri.zentә'biliti
presentable => pri'zentәbl
presentably => prɪ'zentəblɪ
presentation => .prezәn'teiʃәn
presentational => ,prezən'teiʃənәl,,pri:-
presentations => ˌprezənˈteiʃənz
presentative => pri'zentәtiv
presented => ˈprezəntid
presentee => .prezәn'ti:
presenteeism => ˌpreznˈti:ɪzəm
presenter => pri'zentә
presenters => prɪˈzentəz
presentient => pri'senʃiәnt, -ʃәnt
presentiment => pri'zentimәnt
presentiments => priˈzentimənts
presenting => ˈprezəntɪŋ
presentism => prɪ'sentɪzəm
presently => 'prezntli
presentment => pri'zentmәnt
preservable => pri'zә:vәbl
preservation => .prezә'veiʃәn
preservation order => ˌprezəˈveiʃən ˈɔ:də
preservationist => ,prezә'veiʃәnist
preservative => pri'zә:vәtiv
preservatives => prɪ'zɜ:vətɪvz
preserve => pri'zә:v
preserver => pri'z\\\\:vә(r)
preservers => priˈzə:vəz
preset => pri:'set
presets => pri:ˈsets
preside => pri'zaid
presided => priˈzaidid
presidencies => ˈprezɪdənsi:z
presidency => 'prezidәnsi
president => 'prezidәnt
president-elect => 'prezidənti'lekt
presidential => .prezi'denʃәl
presidentially => prezɪ'denʃəlɪ
presidents => p'rezɪdənts
presider => pri'zaidә
presides => priˈzaidz
presiding => pri'zaidiŋ
presiding officer => priˈzaidiŋ ˈɔfisə
presidio => pri'sidiәu
presidium => pri'sidiәm
presidiums => prɪˈsɪdi:əmz
presley => 'presli,'prezli
presoak => pri:'sәuk
press => pres
press corps => pres kɔ:
press cutting => pres ˈkʌtɪŋ
press gallery => pres ˈɡæləri
press office => pres ˈɔfis
press secretary => pres ˈsekrətəri
press stud => pres stʌd
pressboard => 'presbɒ:d
Pressburg => 'presbjrk
pressed => prest
pressing => 'presiŋ
pressingly => p'resɪŋlɪ
pressman => 'presmәn
pressmark => 'presmɑ:k
pressor => 'presә
pressroom => 'presru:m
pressure => 'preʃә
pressure cooker => ˈpreʃə ˈkukə
pressure point => ˈpreʃə pɔint
pressure-cook => 'preʃәkjk
pressure-cooked => 'preʃə'kuk
pressure-cooking => 'preʃə'kuk
pressure-cooks => 'preʃə'kuk
pressured => 'preʃəd
pressures => ˈpreʃəz
pressurization => ,preʃәrai'zeiʃәn
pressurize => 'preʃәraiz
pressurized => 'preʃәraizd
pressurizes => ˈpreʃəˌraɪziz
pressurizing => 'preʃәraiziŋ
presswork => 'preswә:k
prest => prest
Prestel => pres'tel; 'prestel
prestidigitation => 'presti,didʒi'teiʃәn
prestidigitator => ,presti'didʒiteitә(r)
prestige => pre'sti:ʒ
prestigious => pre'stidʒiәs
prestissimo => pres'tisimәu
presto => 'prestәu
preston => 'prestәn
presumable => pri'zu:mәbl
presumably => pri'zu:mәbli
presume => pri'zu:m
presumes => priˈzju:mz
presuming => pri'zu:miŋ
presumption => pri'zʌmpʃәn
presumptions => prɪˈzʌmpʃənz
presumptive => pri'zʌmptiv
presumptuous => pri'zʌmptʃuәs
presumptuously => prɪ'zʌmptʃʊəslɪ
presuppose => .pri:sә'pәuz
presupposed => ˌpri:səˈpəʊzd
presupposes => ˌpri:səˈpəʊziz
presupposing => ˌpri:səˈpəʊzɪŋ
presupposition => .pri:sʌpә'ziʃәn
presuppositions => ˌpri:sʌpəˈziʃnz
presynaptic => prisi'næptik
preteen => 'pri:'ti:n
pretence => pri'tens
pretences => ˈpri:ˌtensiz
pretend => pri'tend
pretend to => priˈtend tu:
pretended => pri'tendid. pri:-
pretender => pri'tendә
pretenders => priˈtendəz
pretends => priˈtendz
pretense => pri'tens
pretension => pri'tenʃәn
pretensions => prɪˈtenʃənz
pretentious => pri'tenʃәs
preter- => 'pri:tә(r)
preterite => 'pretәrit
preterition => .pretә'riʃәn
preterm => ˌpri:'tɜ:m
pretermission => .pri:tә'miʃәn
pretermit => .pri:tә'mit
pretermits => ˌpri:tə(:)ˈmits
pretermitted => pri:tə'mɪtɪd
pretermitting => pri:tə'mɪtɪŋ
preternatural => .pri:tә'nætʃәrәl
preternaturalism => ,pri:tə'nætʃərəlizəm
preternaturally => ,pri:tə'nætʃərəli
pretest => 'pri:test
pretext => 'pri:tekst
pretexts => ˈpri:teksts
pretoria => pri'tɔ:riә
pretreat => 'pri:'tri:t
pretreatment => pri:'tri:tmәnt
pretrial => 'pri:'traiәl
prettiest => p'rɪtɪɪst
prettification => .pritifi'keiʃәn
prettified => ˈpritifaid
prettifies => ˈpritifaiz
prettify => 'pritifai
prettifying => ˈpritifaiŋ
prettily => 'pritili
prettiness => 'pritinis
pretty => 'priti
pretty boy => ˈpriti bɔi
prettyish => 'pritiiʃ
pretzel => 'pretsәl
pretzeled => 'prets(ə)l
pretzels => ˈpretsəlz
prevail => pri'veil
prevailed => priˈveild
prevailing => pri'veiliŋ
prevailing wind => prɪˈveɪlɪŋ wind
prevails => priˈveilz
prevalence => 'prevәlәns
prevalent => 'prevәlәnt
prevaricate => pri'værikeit
prevaricated => prɪˈværɪˌkeɪtid
prevaricates => prɪˈværɪˌkeɪts
prevaricating => prɪˈværɪˌkeɪtɪŋ
prevarication => pri.væri'keiʃәn
prevaricator => pri'værikeitә
prevenient => pri'vi:njәnt
prevent => pri'vent
preventability => pri,ventә'biliti
preventable => pri'ventәb(ә)l
preventative => pri'ventәtiv
prevented => priˈventid
preventer => pri'ventә
preventing => priˈventɪŋ
prevention => pri'venʃәn
preventive => pri'ventiv
preview => 'pri:vju:
previewed => ˌpri:ˈvju:d
previewing => pri:'vju:iŋ
previews => ˌpri:ˈvju:z
previous => 'pri:viәs
previously => 'pri:vju:sli
previse => pri'vaiz
prevised => prɪ'vaɪz
prevising => prɪ'vaɪz
prevision => .pri:'viʒәn
previsional => pri(ː)viʒәnl
prevocalic => ,pri:vәu'kælik
prewar => 'pri:'wɒ:
prexy => 'preksi
prey => prei
preyed => preid
preyer => 'preɪə
preying => 'preiiŋ
preys => preiz
prez => prez
prezzie => ˈprezi
Priam => 'praiәm
priapic => prai'æpik
priapism => 'praiәpizm
priapulid => praɪəp'jʊlɪd
Priapus => prai'eipәs
price => prais
price point => prais pɔint
price-earnings ratio => ˈpraɪsˈɜ:nɪŋz
price-sensitive => p'raɪss'ensətɪv
priced => praist
priceless => 'praislis
pricey => 'praisi
Prichard => 'pritʃəd
pricier => ˈpraisiə
pricing => 'praisiŋ
prick => prik
pricked => prikt
pricker => 'prikә
pricket => 'prikit
pricking => 'prikiŋ
prickle => 'prikl
prickled => ˈprɪkəld
prickles => ˈprɪkəlz
prickly => 'prikli
prickly ash => ˈprɪkli: æʃ
pricks => priks
pricy => 'praisi
pride => praid
prided => praidid
prideful => 'praidful
prides => praidz
priding => praidɪŋ
prie-dieu => 'pri:djә:
pried => praɪd
priest => pri:st
priestcraft => 'pri:stkræft
priestess => 'pri:stis
priestesses => ˈpri:stɪsiz
priesthood => 'pri:sthud
Priestley => 'pri:stli
priestlike => 'pri:stlaik
priestliness => p'ri:stlɪnəs
priestly => 'pri:stli
priests => pri:sts
prig => prig
priggery => 'prigәri
priggish => 'prigiʃ
priggishly => priɡ
prigs => prɪgz
prill => pril
prim => prim
prima => 'pri:mә
prima ballerina => 'pri:mә
prima donna => pri:mә 'dɔnә
prima facie => 'praimә 'feiʃii:
primacy => 'praimәsi
primaeval => prai'mi:vәl
primal => 'praiml
primal therapy => ˈpraiməl ˈθerəpi
primaquine => 'praimә'kwi:n
primarily => 'praimәrili
primary => 'praimәri
primary care => ˈpraiməri kɛə
primary colour => ˈpraiməri ˈkʌlə
primary feather => ˈpraiməri ˈfeðə
primary health care => ˈpraiməri helθ kɛə
primary school => ˈpraiməri sku:l
primary stress => ˈpraiməri stres
primate => 'praimit
primatial => prai'meiʃәl
primatological => ,praimətə'lɔdʒikəl
primatology => .praimә'tɒlәdʒi
primavera => .pri:mә'veәrә
prime => praim
prime factor => praim ˈfæktə
prime meridian => praim məˈrɪdi:ən
prime rate => praim reit
prime time => praim taim
primed => praimd
primer => 'praimә
primers => p'raɪməz
primeur => pri:'mә:
primeval => prai'mi:vl
primevally => praɪ'mi:vəlɪ
primigravida => ,praimi'^rævәdә
priming => 'praimiŋ
primipara => prai'mipәrә
primiparous => prai'mipәrәs
primitive => 'primitiv
primitively => 'primitivli
primitiveness => 'prɪmətɪvnəs
primitives => p'rɪmɪtɪvz
primitivism => 'primitivizәm
primly => prɪmlɪ
primmed => prɪmd
primmer => prɪmə
primming => prɪmɪŋ
primness => p'rɪmnəs
primo => 'pri:mәu
primogenitary => ,praimә'dʒenitәri
primogenitor => .praimәu'dʒenitә
primogeniture => ,praimә'dʒenitʃә
primordial => prai'mɒ:diәl
primordially => praɪ'mɔ:dɪəlɪ
primordium => prai'mɔ:diәm
primp => primp
primped => prɪmpt
primping => prɪmpɪŋ
primps => prɪmps
primrose => 'primrәuz
primrose yellow => ˈprɪmˌrəʊz ˈjeləu
primroses => p'rɪmrəʊzɪz
primula => 'primjulә
primulaceous => ,primju'leiʃәs
primulas => ˈprimjuləz
primum mobile => 'praimʌm'mɔbili:
primus => 'praimәs
prince => prins
prince consort => prins ˈkɔnˌsɔ:t
princedom => 'prinsdәm
princeliness => 'prinslinis
princely => 'prinsli
princess => 'prinsis
princesse => prin'ses
princesses => prinˈsesiz
Princeton => 'prinstәn
principal => 'prinsipәl
principal boy => ˈprinsəpəl bɔi
principalities => ˌprinsiˈpælitiz
principality => ,prinsi'pæliti
principally => 'prinsәpәli
principals => p'rɪnsəplz
principalship => p'rɪnsəpəlʃɪp
principate => 'prinsipeit
Principe => 'prinsipi:
principia => prɪn'sɪpɪə
principle => 'prinsipl
principle of parsimony => ˈprinsəpl ɔv ˈpɑ:səˌməʊni:
principled => 'prinsәpld
prink => priŋk
prinked => priŋkt
prinking => priŋkɪŋ
prinks => priŋks
print => print
print run => print rʌn
printable => 'printәbl
printed => 'printid
printer => 'printә
printery => 'printәri
printing => 'printiŋ
printmaker => 'print,meikә(r)
printmaking => 'print,meikiŋ
printout => 'printaut
printouts => ˈprɪntˌaʊts
printwork => prɪnt'wɜ:k
printworks => 'printwә:ks
prion => ˈpri:ɒn
prior => 'praiә
priorate => 'praiәrit
prioress => 'praiәris
priories => ˈpraiəriz
priorities => praiˈɔritiz
prioritise => praɪ'ɒrəˌtaɪz
prioritised => prai'ɔrə,taiz
prioritize => 'praiәritaiz
prioritized => praiˈɔritaizd
prioritizes => praiˈɔritaiziz
prioritizing => praiˈɔritaizɪŋ
priority => prai'ɒriti
priors => ˈpraiəz
priorship => 'praiәʃip
priory => 'praiәri
Priscian => 'priʃiәn
priscilla => pri'silә
prise => praiz
prism => 'prizm
prismatic => priz'mætik
prismatically => priz'mætikli
prismoid => 'prizmɔid
prisms => 'prɪzəmz
prison => 'prizn
prison visitor => ˈprizən ˈvizitə
prisoner => 'priznә
prisoners => ˈprizənəz
prisons => ˈprizənz
prissy => 'prisi
pristine => 'pristi:n
prithee => 'priði
privacies => ˈpraivəsiz
privacy => 'praivәsi
private => 'praivit
private bill => ˈpraivit bil
private enterprise => ˈpraivit ˈentəpraiz
private eye => ˈpraivit ai
private investigator => ˈpraivit ɪnˈvestɪˌgeɪtə
private member => ˈpraivit ˈmembə
private nuisance => ˈpraivit ˈnju:səns
private patient => ˈpraivit ˈpeiʃənt
private school => ˈpraivit sku:l
private sector => ˈpraivit ˈsektə
private view => ˈpraivit vju:
privateer => .praiә'tiә
privateering => .praivә'tiәriŋ
privateersman => ,praivә'tiәzmәn
privates => 'praivitz
privation => prai'veiʃәn
privations => praɪ'veɪʃ(ə)n
privatisation => ˌpraɪvətaɪ'zeɪʃən
privatise => p'rɪvətɪs
privatism => 'praivәtizm
privative => 'privәtiv
privatized => ˈpraɪvəˌtaɪzd
privatizes => ˈpraɪvəˌtaɪziz
privatizing => ˈpraɪvəˌtaɪzɪŋ
privet => 'privit
privilege => 'privilidʒ
privileged => 'privilidʒd
privileges => ˈprivilidʒz
privileging => 'privilidʒiŋ
privily => 'privili
privity => 'priviti
privy => 'privi
privy purse => ˈprivi pə:s
prix => pri:
prix fixe => 'pri:'fi:ks
prize => praiz
prizefight => 'praizfait
prizefighter => 'praizfaitә
prizefighting => 'praizfaitiŋ
prizegiving => praɪz'ɡɪvɪŋ
prizeman => 'praizmәn
prizemen => 'praɪzmən
prizes => praiziz
prizewinner => 'praizwinә
prizing => praizɪŋ
pro => prәu
pro bono publico => 'prәj'bәjnәj'pʌblikәj
pro forma => prәu'fɔ:mә
pro rata => prәj 'rɑ:tә
pro tanto => prәu'tæntәu
pro-abortionist => ,prəʊə'bɔːʃənɪst
pro-am => ˈprəʊˌæm
pro-choice => prəuˈtʃɔis
pro-choicer => ,prəu'tʃɔis
pro-democracy => prɒ 'dɪmɒkrəsɪ
pro-family => p'rəʊf'æməlɪ
pro-life => prəuˈlaif
pro-lifer => p'rəʊl'aɪfər
pro-vice-chancellor => pro vaɪs ˈtʃænsəlɚ
proa => 'prәuә
proactive => ,prәu'æktiv
proactively => ˌprəʊˈæktɪvlɪ
probabilistic => ,prɔbәbi'listik
probabilities => ˌprɔbəˈbilitiz
probability => .prɒbә'biliti
probable => 'prɒbәbl
probably => 'prɒbәbli
proband => 'prәubænd
probang => 'prәubæŋ
probate => 'prәubeit
probated => ˈprəʊˌbeɪtid
probates => ˈprəʊˌbeɪts
probating => ˈprəʊˌbeɪtɪŋ
probation => prәu'beiʃәn
probationary => prәj'beiʃәnәri
probationer => prә'beiʃәnә(r)
probationers => prəˈbeiʃənəz
probative => 'prәubәtiv
probe => prәub
probed => prəubd
probenecid => ,prә'benәsid
prober => 'prәubә
probes => prəubz
probing => 'prәubiŋ
probiotic => prә,bai'ɔtik
probit => 'prɔbit
probity => 'prәubәti
problem => 'prɒblәm
problematic => prɔblә'mætik
problematically => prɒblə'mætɪklɪ
proboscidean => .prәubɒ'sidiәn
proboscis => prәu'bɒsis
proboscis monkey => prəʊˈbɔsɪs ˈmʌŋki
procaine => 'prәukein, prәu'kein
procaryote => prә'kæriәut
procedural => prә'si:dʒәrәl
procedurally => prə'si:dʒərəlɪ
procedure => prә'si:dʒә
proceed => prәu'si:d
proceeded => prəˈsi:did
proceeding => prәu'si:diŋ
proceeds => 'prәusi:dz
process => 'prɒses
processable => 'prәjsesәbl; 'prɔ-
processing => prәu'sesiŋ
procession => prә'seʃәn
processional => prә'seʃәnl
processions => prəˈseʃənz
processor => prә'sesә
prochlorperazine => ,prә,klɔ:'perәzi:n
proclaim => prә'kleim
proclaimed => prəˈkleimd
proclaiming => prəˈkleimɪŋ
proclaims => prəˈkleimz
proclamation => .prɒklә'meiʃәn
proclamations => ˌprɔkləˈmeɪʃənz
proclamatory => prә'klæmәtәri
proclitic => prәu'klitik
proclivities => prəʊˈklɪvɪti:z
proclivity => prә'kliviti
Procne => 'prɔkni
procoagulant => ,prәukәu'æ^julәnt
proconsul => .prәu'kɒnsl
proconsular => .prәu'kɒnsәlә
proconsulate => ,prәj'kɔnsjjlәt, -sә-
proconsulship => ,prәj'kɔnsәlʃip
Procopius => prəu'kəupi:əs; 'sə-
procrastinate => prәu'kræstineit
procrastinated => prəʊˈkræstəˌneɪtid
procrastinates => prəʊˈkræstəˌneɪts
procrastinating => prəʊˈkræstəˌneɪtɪŋ
procrastination => prәu,kræsti'neiʃәn
procrastinator => prәj'kræstineitә(r)
procrastinatory => prəu'kræstənə,təri
procreant => 'prәukriәnt
procreate => 'prәukrieit
procreated => ˈprəʊkri:ˌeɪtid
procreates => ˈprəʊkri:ˌeɪts
procreating => ˈprəʊkri:ˌeɪtɪŋ
procreation => .prәukri'eiʃәn
procreative => 'prәukrieitiv
procreator => 'prәukrieitә
Procrustean => prәu'krʌstiәn
Procrustes => prә'krʌsti:z
Procter => 'prɔktə
proctitis => prɔk'taitis
proctocolectomy => prɒktɒkə'lektəmɪ
proctology => prɒk'tɒlәdʒi
proctor => 'prɒktә
proctored => ˈprɔktəd
proctorial => prɒk'tɒ:riәl
proctoring => ˈprɔktərɪŋ
proctors => ˈprɔktəz
proctorship => 'prɒktәʃip
proctoscope => 'prɒktәskәup
procumbent => prәu'kʌmbәnt
procurable => prәu'kjurәbl
procuracies => prə'kjʊərəsɪ
procuracy => 'prɔkjurәsi
procuration => .prɒkju'reiʃәn
procurator => 'prɒkjureitә
procuratorial => .prɒkjurә'tɒ:riәl
procurators => prɒkjʊ'reɪtəz
procuratorship => 'prɔkjjә,reitәʃip
procure => prәu'kjuә
procured => prəʊˈkjʊəd
procurement => prә'kjuәmәnt
procurer => prәu'kjuәrә
procurers => prə'kjʊərə
procures => prəʊˈkjʊəz
procuress => prәu'kjuәris
procuresses => prəʊ'kjʊərɪs
procuring => prəʊˈkjʊərɪŋ
prod => prɒd
prodded => prɔdid
prodder => p'rɒdər
prodding => ˈprɒdɪŋ
prodigal => 'prɒdigl
prodigality => ,prɔdi'^æliti
prodigally => 'prɒdɪglɪ
prodigies => ˈprɔdidʒiz
prodigious => prәu'didʒәs
prodigiously => prə'dɪdʒəslɪ
prodigy => 'prɒdidʒi
prodromal => prәj'drәjmәl, 'prәjdrәj-
prodrome => 'prәudrәum
prodromic => prәj'drɔmik
produce => prә'dju:s
produced => prәu'dju:st
producer => prә'dju:sә
producers => prəˈdu:səz
producibility => prә.dju:sә'biliti
producible => prә'dju:sәbl
producing => prә'dju:siŋ
product => 'prɒdʌkt
product placement => ˈprɔdʌkt ˈpleɪsmənt
production => prә'dʌkʃәn
production number => prəˈdʌkʃən ˈnʌmbə
productions => prəˈdʌkʃənz
productive => prә'dʌktiv
productivity => .prәudʌk'tiviti
proem => 'prәuem
proenzyme => prәu'enzaim
Prof => prɒf
profanation => ,prɔfә'neiʃәn
profane => prә'fein
profaned => prəʊˈfeɪnd
profanely => prə'feɪnlɪ
profaneness => p'rəfeɪnnəs
profanes => prəʊˈfeɪnz
profaning => prəʊˈfeɪnɪŋ
profanity => prә'fæniti
profess => prә'fes
professed => prә'fest
professedly => prә'fesidli
professes => prəˈfesiz
professing => prəˈfesɪŋ
profession => prә'feʃәn
professional => prә'feʃәnl
professional foul => prəˈfeʃənəl faul
professionalism => prә'feʃәnә,lizәm
professionalization => prəˌfeʃənəlaɪz'eɪʃn
professionalize => prә'feʃәnәlaiz
professionalized => prəˈfeʃənəlaizd
professionalizes => prəˈfeʃənəlaiziz
professionalizing => prəˈfeʃənəlaizɪŋ
professor => prә'fesә
professorate => prә'fesәrit
professorial => .prәufi'sɒ:riәl
professoriate => .prәufi'sɒ:riit
professors => prə'fesəz
professorship => prә'fesәʃip
professorships => prəˈfesəʃɪps
proffer => 'prɒfә
proffered => ˈprɔfəd
proffering => ˈprɔfərɪŋ
proffers => ˈprɔfəz
proficiency => prә'fiʃәns
proficient => prә'fiʃәnt
profile => 'prәufail
profiler => 'prәufailә
profiling => 'prәufailiŋ
profit => 'prɒfit
profitability => .prɒfitә'biliti
profitable => 'prɒfitәbl
profitably => 'prɒfitәbli
profited => ˈprɑfɪtid
profiteer => .prɒfi'tiә
profiteering => .prɒfi'tiәriŋ
profiteers => ˈprɔfɪˈtɪəz
profiterole => prә'fitә,rәul
profiting => ˈprɑfɪtɪŋ
profitless => 'prɒfitlis
profligacy => 'prɒfligәsi
profligate => 'prɒfligit
proforma invoice => prəfɔ:mə ˈɪnˌvɔɪs
profound => prә'faund
profoundly => prә'fajndli
profoundness => prə'faundnis
profundities => prəˈfʌndɪti:z
profundity => prә'fʌndәti
profuse => prә'fju:s
profusely => prәj'fju:sli
profuseness => prəf'ju:snəs
profusion => prә'fju:ʒәn
prog => prɒg
progenitive => prәu'dʒenitiv
progenitor => prәu'dʒenitә
progenitors => prəʊˈdʒenɪtəz
progeniture => prәu'dʒenitʃә
progeny => 'prɒdʒәni
progeria => prәu'dʒiәriә
progesterone => prәu'dʒestәrәun
progestin => prәu'dʒestin
progged => prɔɡd
proglottid => prәu'^lɔtid
prognathic => prɔ^'næθik
prognathism => 'prɔ^nәθizәm, prɔ^'nei-
prognathous => 'prɒgnәθәs
prognose => prɔ^'nәus
prognosis => prɒg'nәusis
prognostic => prɒg'nɒstik
prognosticate => prɒg'nɒstikeit
prognosticated => prɔgˈnɔstɪˌkeɪtid
prognosticates => prɔgˈnɔstɪˌkeɪts
prognosticating => prɔgˈnɔstɪˌkeɪtɪŋ
prognostication => prɒg.nɒsti'keiʃәn
prognosticator => prɒg'nɒstikeitә
prograde => prәj'^reid
program => 'prәugræm
programmability => 'prәu.ɡræmә'bilәti. -ɡrә-
programmable => 'prәugræmәbl
programmatic => .prәugrә'mætik
programme => 'prәugræm
programmed => 'prәuɡræmd. -ɡrәmd
programmed cell death => ˈprəʊˌgræmd sel deθ
programmer => 'prәugræmә
programmers => ˈprəʊˌgræməz
programmes => p'rəʊɡræmz
programming => 'prәugræmiŋ
progress => 'prәugres
progressed => ˈprəuɡrest
progresses => prəɡ'resɪz
progressing => prəɡ'resɪŋ
progression => prә'greʃәn
progressional => prә'greʃәnl
progressionist => prә'greʃәnist
progressions => prəˈgreʃənz
progressive => prә'gresiv
progressiveness => prə'gresɪvnɪs
progressives => prəɡ'resɪvz
progressivism => prә'gresivizm
progressivity => prəɡ'res'ɪvɪtɪ
proguanil => prә'^wænil
prohibit => prә'hibit
prohibiter => prәj'hibitә(r)
prohibiting => prəˈhibitɪŋ
prohibition => .prәuhi'biʃәn
prohibitionists => ,prəʊhɪ'bɪʃənɪst
prohibitions => ˌprəʊəˈbɪʃənz
prohibitive => prә'hibitiv
prohibitor => prәj'hibitә(r)
prohibitory => prә'hibitәri, prәu-
prohibits => prəˈhibits
proinsulin => ,prәu'insjulin
project => 'prɒdʒekt
projectile => prә'dʒektil
projectiles => prəd'ʒektaɪlz
projecting => prә'dʒektiŋ
projection => prә'dʒekʃәn
projectionist => prә'dʒekʃәnist
projectionists => prəˈdʒekʃənists
projective => prә'dʒektiv
projective geometry => prəˈdʒektiv dʒiˈɔmitri
projective test => prəˈdʒektiv test
projectively => prәˊdʒektivli
projector => prә'dʒektә
projectors => prəd'ʒektəz
prokaryote => prәu'kæriәut
prokaryotic => prәj,kæri'ɔtik
Prokopyevsk => prɔ'kɔ:piefsk
prolactin => prә'læktin
prolapse => 'prәulæps
prolapsed => ˈprəulæpst
prolapses => ˈprəulæpsiz
prolapsing => ˈprəulæpsɪŋ
prolapsus => prәu'læpsәs
prolate => 'prәuleit
prole => prәul
proleg => 'prәuleg
prolegomenon => .prәule'gɒminәn
prolegomenous => ,prəulə'gɔ:minəs
prolepsis => prә'lepsis
proleptic => prә'leptik
proles => 'prәuli:z
proletarian => .prәuli'tєәriәn
proletarianism => ,prәjli'teәriәnizәm
proletarianization => 'prәjli,teәriәnai'zeiʃәn;-ni'z-
proletarianize => ,prәuli'teәriәnaiz
proletarians => prəʊlɪ'teərɪənz
proletariat => .prәuli'tєәriәt
proliferate => prәәu'lifәreit
proliferated => prəuˈlifəreitid
proliferates => prəuˈlifəreits
proliferation => .prәulifә'reiʃәn
proliferous => prәu'lifәrәs
prolific => prәu'lifik
prolificacy => prәu'lifikәsi
prolifically => prәu'lifikli
proline => 'prәuli:n
prolix => 'prәuliks
prolixity => prәu'liksiti
prolixly => p'rəʊlɪkslɪ
prolocutor => prәu'lɒkjutә
prolog => 'prәulɔ^
prologue => 'prәulɒ:g
prologues => ˈprəʊˌlɔ:gz
prolong => prәu'lɒŋ
prolongation => .prәulɒŋ'geiʃәn
prolonged => prә'lɔŋd
prolonging => prəˈlɔŋɪŋ
prolongs => prəˈlɔŋz
prolusion => prәu'lju:ʒәn
prom => prɔm
promenade => .prɒmi'neid
promenade concert => ˌprɔməˈneɪd ˈkɔnsət
promenade deck => ˌprɔməˈneɪd dek
promenaded => ˌprɔməˈneɪdid
promenader => prɒmɪ'nɑ:də
promenades => ˌprɔməˈneɪdz
promenading => ˌprɔməˈneɪdɪŋ
promethazine => prәu'meθә,zi:n
Promethean => prәu'mi:θiәn
Prometheus => prә'mi:θju:s
prominence => 'prɒminәns
prominences => 'prɔminәnsis
prominency => 'prɔminәnsi
prominent => 'prɒminәnt
prominently => 'prɔminәntli
promiscuity => .prɒmi'skju:iti
promiscuous => prә'miskjuәs
promiscuously => prə'mɪskjʊəslɪ
promiscuousness => prəu'miskjuəs
promise => 'prɒmis
promised => ˈprɔmist
promised land => ˈprɔmɪst
promisee => .prɒmi'si:
promiser => 'prɒmisә
promising => 'prɒmisiŋ
promisingly => 'prɒmɪsɪŋli
promisor => .prɒmi'sɒ:
promissory => 'prɒmisәri
promo => 'prәumәu
promontories => ˈprɔməntəriz
promontory => 'prɒmәntәri
promotability => prəʊ,məʊtə'bɪlətɪ
promotable => prəu'məutəbl
promote => prәu'mәut
promoter => prә'mәutә
promoters => prə'məʊtəz
promotes => prəˈməuts
promoting => prəˈməutɪŋ
promotion => prәu'mәuʃәn
promotional => prәu'mәuʃәnl
promotive => prәu'mәutiv
prompt => prɒmpt
prompt box => prɔmpt bɔks
prompt side => prɔmpt said
prompter => 'prɒmptә
prompting => 'prɒmptiŋ
promptitude => 'prɒmptitju:d
promptly => 'prɒmptli
promptness => 'prɒmptnis
proms => prɔmz
promulgate => prә'mʌlgeit
promulgated => ˈprɔməlˌgeɪtid
promulgates => ˈprɔməlˌgeɪts
promulgating => ˈprɔməlˌgeɪtɪŋ
promulgation => .prәumʌl'geiʃәn
promulgator => prә'mʌlgeitә
promulge => prәu'mʌldʒ
pronaos => prәu'neiɔs
pronate => prәu'neit
pronated => ˈprəuneitid
pronates => ˈprəuneits
pronating => ˈprəuneitɪŋ
pronation => prәu'neiʃәn
pronator => prәu'neitә
prone => prәun
proneness => 'prәunnis
prong => prɒŋ
pronged => prɒŋd
pronghorn => 'prɒŋhɒ:n
prongs => prɔŋz
pronominal => prә'nɒminl
pronominalize => prәj'nɔminәlaiz
pronoun => 'prәunaun
pronounce => prә'nauns
pronounceable => prә'naunsәbl
pronounced => prә'naunst
pronouncedly => prәˊnaunstli
pronouncement => prә'naunsmәnt
pronouncements => prəˈnaunsmənts
pronounces => prəˈnaunsiz
pronouncing => prә'naunsiŋ
pronto => 'prɒntәu
Prontosil => 'prɔntәsil
pronuclear => prәj'nju:kliә(r)
pronucleus => prәu'nju:kliәs
pronunciamento => prә.nʌnsiә'mentәu
pronunciation => prәu.nʌnsi'eiʃәn
pronunciations => prənʌns'ɪeɪʃnz
proof => pru:f
proof-reader => p'ru:fr'i:dər
proofing => 'pru:fiŋ
proofread => 'pru:fri:d
proofreader => 'pru:fri:dә
proofreaders => 'pru:f,ri:də
proofreading => p'ru:fri:dɪŋ
proofreads => ˈpru:fˌri:dz
prop => prɒp
prop forward => prɔp ˈfɔ:wəd
propaedeutic => .prәupi'dju:tik
propaganda => .prɒpә'gændә
propagandism => ,prɔpә'^ændizәm
propagandist => .prɒpә'gændist
propagandistic => prɒpəgæn'dɪstɪk
propagandistically => ,prɔpə'ɡændizəm
propagandists => ˌprɔpəˈɡændists
propagandize => .prɒpә'gændaiz
propagandized => ˌprɔpəˈɡændaizd
propagandizes => ˌprɔpəˈɡændaiziz
propagandizing => ˌprɔpəˈɡændaizɪŋ
propagate => 'prɒpәgeit
propagated => ˈprɔpəɡeitid
propagates => ˈprɔpəɡeits
propagation => .prɒpә'geiʃәn
propagator => 'prɒpәgeitә
propagule => 'prɔpә^ju:l
propane => 'prәupein
propanone => 'prәupәnәun
propel => prәu'pel
propellant => prәu'pelәnt
propellants => prə'pelənts
propeller => prә'pelә
propellers => prə'peləz
propels => prəˈpelz
propene => 'prәupi:n
propensities => prəˈpensɪti:z
propensity => prә'pensәti
proper => 'prɒpә
proper noun => ˈprɔpə naun
properdin => 'prәupәdin
properly => 'prɒpәli
propertied => 'prɔpәtid
property => 'prɒpәti
property man => ˈprɔpəti mæn
prophase => 'prәufeiz
prophecies => ˈprɔfisiz
prophecy => 'prɒfәsi
prophesied => ˈprɔfɪˌsaɪd
prophesies => ˈprɔfɪˌsaɪz
prophesy => 'prɒfәsai
prophesying => ˈprɔfɪˌsaɪŋ
prophet => 'prɒfit
prophetess => 'prɒfitis
prophethood => 'prɒfɪthʊd
prophetic => prә'fetik
prophetical => prә'fetikәl
prophetically => prəu'fetikəli
prophets => ˈprɔfits
prophylactic => .prәufi'læktik
prophylactics => ˌprəʊfəˈlæktɪks
prophylaxis => .prәufi'læksis
propinquity => prә'piŋkwiti
propionate => 'prəʊpɪəneɪt
propitiate => prә'piʃieit
propitiated => prəʊˈpɪʃi:ˌeɪtid
propitiates => prəʊˈpɪʃi:ˌeɪts
propitiating => prəʊˈpɪʃi:ˌeɪtɪŋ
propitiator => prә'piʃieitә
propitiatory => prә'piʃiәtәri
propitious => prә'piʃәs
propitiously => prə'piʃəsli
propolis => 'prɔpәlis
proponent => prә'pәunәnt
proponents => prəˈpəʊnənts
Propontis => prə'pɔntis
proportion => prә'pɒ:ʃәn
proportionable => prә'pɒ:ʃәnәbl
proportionably => prə'pɔ:ʃnəblɪ
proportional => prә'pɒ:ʃәnl
proportional representation => prəˈpɔ:ʃənəl ˌreprɪzenˈteɪʃən
proportionality => prә,pɔ:ʃә'næliti
proportionally => prə'pɔ:ʃənlɪ
proportionate => prә'pɒ:ʃәnit
proportionately => prə'pɔ:ʃənətlɪ
proportioning => ,prә'pɔ:ʃәniŋ
proposal => prә'pәuzl
proposals => prə'pəʊzlz
propose => prә'pәuz
proposer => prә'pәuzә
proposes => prəˈpəuziz
proposing => prəˈpəuzɪŋ
proposition => .prɒpә'ziʃәn
propositions => ˌprɔpəˈziʃənz
propound => prә'paund
propounded => prəˈpaʊndid
propounding => prəˈpaʊndɪŋ
propounds => prəˈpaʊndz
propoxyphene => prәj'pɔksifi:n
propped => prɔpt
propping => 'prɔpiŋ
propranolol => prәj'prænәlɔl
propria => 'prəʊpri:ə
proprietary => prә'praiәtәri
proprietor => prә'praiәtә
proprietorial => -'tɔ:riәl
proprietors => prəp'raɪətəz
proprietorship => prә'praiәtәʃip
proprietress => prә'praiәtris
propriety => prә'praiәti
proprioception => ,prәupriә'sepʃәn
proprioceptive => ,prәjpriәj'septiv
proprioceptor => .prәupriәu'septә
props => prɔps
proptosis => prɔp'tәusis
propulsion => prә'pʌlʃәn
propulsive => prә'pʌlsiv
propulsor => prә'pʌlsә
propyl => 'prәupil
propylaeum => .prɒpi'li:әm
propylene => 'prәupili:n
propylon => 'prɔpilɔn
prorate => prәu'reit
prorated => prəuˈreitid
prorates => prəuˈreits
prorating => prəuˈreitɪŋ
prorogation => .prәurә'geiʃәn
prorogue => prә'rәu^
prorogued => prəʊˈrəʊgd
prorogues => prəʊˈrəʊgz
proroguing => prəʊˈrəʊgɪŋ
prosaic => prәu'zeiik
prosaically => prәu'zeiikli
prosaism => 'prәuzeiizm
prosaist => 'prәuzeiist
prosauropod => prәu'sɔ:rәpɔd
proscenium => prәu'si:njәm
proscenium arch => prəuˈsi:niəm ɑ:tʃ
prosciutto => prә'ʃu:tәu
proscribe => prәu'skraib
proscribed => prəʊˈskraɪbd
proscribes => prəʊˈskraɪbz
proscribing => prəʊˈskraɪbɪŋ
proscription => prәu'skripʃәn
proscriptive => prәu'skriptiv
prose => prәuz
prose poem => prəuz ˈpəuim
prosector => prәj'sektә(r)
prosecute => 'prɒsikju:t
prosecuted => 'prɒsɪkju:tɪd
prosecutes => ˈprɔsikju:ts
prosecution => .prɒsi'kju:ʃәn
prosecutions => ˌprɔsɪˈkju:ʃənz
prosecutor => 'prɒsikju:tә
prosecutorial => prɒsɪkju:'tɔ:rɪəl
prosecutors => p'rɒsɪkju:təz
proselyte => 'prɒslait
proselytise => 'prɔsilitaiz
proselytism => 'prɒsilitizm
proselytize => 'prɒsilitaiz
proselytized => ˈprɔsəlɪˌtaɪzd
proselytizes => ˈprɔsəlɪˌtaɪziz
proselytizing => ˈprɔsəlɪˌtaɪzɪŋ
prosencephalon => ,prɔsen'sefәlɔn, -lәn
prosenchyma => prɒs'eŋkimә
proser => 'prәuzә
Proserpina => prәj's\\\\:pinә
proses => prəuziz
prosier => 'prəʊzɪ
prosiest => 'prəuzi
prosily => 'prәuzili
prosimian => prәj'simiәn
prosiness => 'prәuznis
prosing => prəʊz
prosit => 'prәusit, 'prәuzit
prosobranch => 'prɔsә,bræŋtʃ
prosocial => prәj'sәjʃәl
prosodic => prәj'sɔdik
prosodist => 'prɒsәdist
prosody => 'prɒsәdi
prosoma => prәu'sәumә
prosopographical => ,prɔsəu'pɔɡræfikəl
prosopography => ˌprɔsəuˈpɔɡrəfi
prosopopoeia => .prɒsәpә'pi:ә
prospect => 'prɒspekt
prospecting => prәs'pektiŋ
prospective => prәs'pektiv
prospector => 'prɒspektә
prospectors => ˈprɔsˌpektəz
prospectus => prәs'pektәs
prosper => 'prɒspә
prospered => ˈprɔspəd
prosperity => prɒs'periti
Prospero => 'prɔspәrәj
prosperous => 'prɒspәrәs
prosperously => p'rɒspərəslɪ
prospers => ˈprɔspəz
prost => prәust
prostacyclin => ,prɔstә'saiklin
prostaglandin => ,prɔstә'^lændin
prostate => 'prɒsteit
prostate-specific antigen => ˈprɑsˌtet spɪˈsɪfɪk ˈæntɪdʒən
prostatectomy => prɔstә'tektәmi
prostates => ˈprɔsteits
prostatitis => .prɒstә'taitis
prosthesis => 'prɔsθi:sis
prosthetic => prɔs'θetik
prosthetics => prɒs'θetiks
prosthodontics => ,prɔsθә'dɔntiks
prostitute => 'prɒstitju:t
prostituted => ˈprɔstɪˌtu:tid
prostitutes => ˈprɔstɪˌtu:ts
prostituting => ˈprɔstɪˌtu:tɪŋ
prostitution => ,prɔsti'tju:ʃәn
prostrate => 'prɒstreit
prostrated => ˈprɔsˌtreɪtid
prostrates => ˈprɔsˌtreɪts
prostrating => p'rɒstreɪtɪŋ
prostration => prɒ'streiʃәn
prostyle => 'prәustail
prosy => 'prәuzi
protactinium => .prәutæk'tiniәm
protagonist => prәu'tægәnist
protagonists => prəʊˈtægənɪsts
protamine => 'prәjtәmi:n,-min
protandrous => prәj'tændrәs
protandry => prәu'tændri
protanope => 'prәutәnәup
protanopia => ,prәutә'nәupiә
protasis => 'prɒtәsis
protean => 'prәutiәn
protease => 'prәutieis
protect => prә'tekt
protectant => prә'tektәnt
protecting => prəˈtektɪŋ
protection => prә'tekʃәn
protectionism => prә'tekʃәnizm
protectionist => prә'tekʃәnist
protectionists => prə'tekʃənɪsts
protections => prə'tekʃnz
protective => prә'tektiv
protectively => prəˈtektɪvlɪ
protectiveness => prə'tɛktɪvnɪs
protector => prә'tektә
protectorate => prә'tektәrit
protectorates => prəˈtektərɪts
protectors => prəˈtektəz
protectorship => prə'tektəʃɪp
protectress => prә'tektris
protects => prəˈtekts
protege => 'prәutәʒei
protegee => 'prәutәʒei
proteges => 'prəuteʒei
protein => 'prәuti:in
proteinaceous => ,prәjti:'neiʃәs,-ti:i-
proteinase => 'prәutineis
proteins => p'rəʊti:nz
proteinuria => ,prәuti:n'juәriә, ,prәutiin-
proteoglycan => prәutiә'^laikæn
proteolysis => ,prәuti'ɔlisis
proteolytic => prәutiә'litik
proteome => p'rəʊti:əʊm
proteomic => p'rəʊti:əʊmɪk
proteomics => p'rəʊti:əʊmɪks
Proterozoic => .prɒtәrә'zәuik
protest => prә'test
Protestant => 'prɒtistәnt
Protestantism => 'prɒtistәntizm
Protestantize => 'prɒtistәntaiz
protestants => ˈprɔtistənts
protestation => .prәute'steiʃәn
protestations => ˌprɔtɪˈsteɪʃənz
protesters => prəˈtestə(r)
protesting => ˈprəutestɪŋ
protestor => prәj'testә(r)
protests => ˈprəutests
proteus => 'prәutju:s
prothalamium => prəʊθæ'leɪmjəm
prothallus => prәu'θælәs
prothesis => 'prɔθisis
prothonotary => prәu'θɔnәtәri, ,prәuθә'nәutәri
prothoracic => ,prәjθә'ræsik
prothorax => prәu'θɒ:ræks
prothrombin => prәu'θrɒmbin
protist => 'prәutist
protistan => prәj'tistәn
protistology => ,prәjtis'tɔlәdʒi
protium => 'prәutiәm
Proto-Indo-European => 'prəutəu,indəu,juərə'pi:ən
protocol => 'prәutәkɒl
protogalaxy => ,prәutә'^ælәksi
protogynous => p'rəʊtəʊdʒɪnəs
protogyny => prәu'tɔdʒini
protohuman => ,prәutәu'hju:mәn
protolanguage => ,prәutә'læŋ^widʒ
protomartyr => .prәutәu'mɑ:tә
proton => 'prәutɒn
protonate => 'prәutә,neit
protonation => ,prәutә'neiʃәn
protonotary => prәu'tɒnәtәri
protons => ˈprəʊˌtɔnz
protopathic => prәutәu'pæθik
protoplanet => ,prәutә'plænit
protoplasm => 'prәutәplæzm
protoplasmic => .prәutә'plæzmik
protoplast => 'prәutәplæst
protopodite => prәu'tɔpә,dait
protostar => 'prәutә,stɑ:
protostome => 'prәutәstәum
prototherian => ,prәjtәj'θiәriәn
prototype => 'prәutәtaip
Protozoa => prәutәu'zәuә
protozoal => ,prәjtәj'zәjәl
protozoan => .prәutәu'zәuәn
protozoon => ,prәutә'zәuɔn
protract => prәu'trækt
protracted => prәu'træktid
protractile => prәu'træktil
protracting => prəʊˈtræktɪŋ
protraction => prәu'trækʃәn
protractor => prәu'træktә
protractors => prəˈtræktəz
protracts => prəʊˈtrækts
protrude => prәu'tru:d
protruded => prəʊˈtru:did
protrudes => prəʊˈtru:dz
protruding => prə'tru:diŋ
protrusible => prəʊ'truːdəbl
protrusion => prәu'tru:ʒәn
protrusions => prəˈtru:ʒənz
protrusive => prәu'tru:siv
protuberance => prәu'tju:bәrәns
protuberances => prət'ju:bərənsɪz
protuberant => prәu'tju:bәrәnt
proturan => prә'tjurәn
proud => praud
proudest => praʊd
proudly => 'praudli
Proust => pru:st
provable => 'pru:vәbl
prove => pru:v
proven => 'pru:vn
provenance => 'prɒvәnәns
Provence => 'prɒvens
provender => 'prɒvәndә
provenience => prәu'vi:niәns, -'vi:njәns
proventriculus => ,prәuvin'trikjulәs
proverb => 'prɒvә:b
proverbial => prә'vә:biәl
proverbially => prә'vә:biәli
proves => pru:vz
provide => prә'vaid
provided => prә'vaidid
providence => 'prɒvidәns
provident => 'prɒvidәnt
providential => .prɒvi'denʃәl
providentially => ˌprɒvɪ'denʃəlɪ
provider => prә'vaidә
providers => prə'vaɪdəz
provides => prəˈvaidz
province => 'prɒvins
provincial => prә'vinʃәl
provincialism => prә'vinʃәlizm
provincialist => prә'vinʃәlist
provinciality => prә,vinʃi'æliti
provincially => prə'vɪnʃəlɪ
provincials => prəˈvɪnʃəlz
proving => 'pru:viŋ
proving ground => ˈpru:viŋ ɡraund
proviral => prәj'vaiәrәl
provirus => prәj'vaiәrәs
provision => prә'viʒәn
provisional => prә'viʒәnl
provisionality => prә.viʒә'næliti
Provisionals => prə'vɪʒ(ə)n(ə)l
provisioner => prә'viʒәnә
proviso => prә'vaizәu
provisor => prә'vaizә
provisory => prә'vaizәri
provisos => prəˈvaɪzəʊz
provitamin => prәu'vaitәmin
provo => 'prәuvәu
provocation => .prɒvә'keiʃәn
provocations => ˌprɔvəˈkeɪʃənz
provocative => prә'vɒkәtiv
provokable => 'prɔvәkәbl
provoke => prә'vәuk
provoked => prəˈvəukt
provokes => prəˈvəuks
provoking => prә'vәukiŋ
provolone => ,prәuvә'lәuni, ,prɔvә-
provost => 'prɒvәst
provost marshal => prә'vәj
provosts => ˈprɔvəsts
provostship => p'rɒvəstʃɪp
prow => prau
prowess => 'prauis
prowl => praul
prowled => praʊld
prowler => 'praulә
prowlers => ˈpraʊlə(r)
prowling => praʊlɪŋ
prowls => praʊlz
prows => praʊz
proxemics => prɔk'si:mi:ks
proxies => ˈprɔksi:z
proximal => 'prɒksiml
proximate => 'prɒksimeit
proximately => 'prɒksɪmeɪtlɪ
proxime accessit => 'prɔksimiæk'sesit
proximity => prɒk'simiti
proximo => 'prɒksimәu
proxy => 'prɒksi
prozone => 'prәuzәun
prude => pru:d
prudence => 'pru:dns
prudent => 'pru:dnt
prudential => pru:'denʃәl
prudentially => pru:'denʃəlɪ
prudery => 'pru:dәri
prudes => pru:dz
Prudhoe => 'pru:dhәj
prudish => 'pru:diʃ
Prue => pru:
pruinose => 'pru:inәus
prune => pru:n
prunella => pru(:)'nelә
prunes => pru:nz
pruning => 'pru:niŋ
pruning knife => ˈpru:niŋ naif
prurience => 'pruәriәns
pruriency => 'prjәriәnsi
prurient => 'pruәriәnt
pruriently => p'rʊərɪəntlɪ
pruriginous => pru'ridʒinәs
prurigo => pru'raigәu
pruritic => pru'ritik
pruritus => pru'raitәs
Prussia => 'prʌʃә
Prussian => 'prʌʃәn
prussiate => 'prʌʃiit
Prut => pru:t
pry => prai
pry bar => prai bɑ:
prying => 'praiiŋ
psalm => sɑ:m
psalmist => 'sɑ:mist
psalmodic => sæl'mɒdik
psalmodist => 'sælmәdist
psalmody => 'sælmәdi
psalter => 'sɒ:ltә
psalteries => 'sɔːlt(ə)rɪ; 'sɒl-
psalterium => sɔl'tiәriәm
psaltery => 'sɒ:ltәri
psephological => ,psefə'lɔdʒikəl; psi-
psephology => si:'fɒlәdʒi
pseudepigrapha => ,sju:di'pi^rәfә, ,su:-
pseudo => 'sju:dәu
pseudobulb => '(p)sju:dәu'bʌlb
pseudocarp => 'sju:dәkɑ:p
pseudocholinesterase => ,sju:dәukәulә'nestәreis
pseudocopulation => ,(p)sju:dәu,kɔpju'leiʃәn
pseudocyesis => '(p)sju:dәusai'i:sis
pseudocyst => '(p)sju:dәusist
pseudogene => 'psju:dәjdʒi:n
pseudomembrane => '(p)sju:dәu'membrein
Pseudomonas => (p)sju:'dɔmәnәs
pseudomorph => 'psju:dәmɔ:f
pseudomorphism => sju:dəʊ'mɔ:fɪzəm
pseudomorphous => sju:dəʊ'mɔ:fəs
pseudonym => 'sju:dәnim
pseudonymity => .sju:dә'nimiti
pseudonymous => sju:'dɒnәmәs
pseudonyms => ˈsu:dnˌɪmz
pseudopod => 'sju:dәpɒd
pseudopodium => .sju:dә'pәudiәm
pseudopregnancy => ,psju:dәu'pre^nәnsi
pseudorabies => '(p)sju:dәu'reibi:z
pseudorandom => ,psju:dәj'rændәm
pseudoscience => .sju:dәu'saiәns
pseudoscorpion => ,psju:dәj'skɔ:piәn
pseudouridine => ,sju:dәu'juәridi:n
pshaw => ʃɒ:
psi => sai
psilocybin => .sailә'saibin
Psion => 'psaiɔn; psi-
psittacine => 'psitәsain, -sin
psittacosis => .sitә'kәusis
psoas => 'psәuәs
psocid => 'psәusid
psocopteran => psәu'kɔptәrәn
psoralen => 'sɔ:rәlәn
psoriasis => psɔ(:)'raiәsis
Psst => pst
psych => saik
psyche => 'psaiki
psyched => saɪkt
psychedelia => ,saiki'di:liә
psychedelic => .saikә'delik
psyches => saɪkiz
psychiatric => saiki'ætrik; (?@) si-
psychiatrist => sai'kaiәtrist
psychiatrists => ˌsaɪ'kaɪətrɪsts
psychiatry => sai'kaiәtri
psychic => 'saikik
psychical => 'saikikәl
psychically => 'saikikli
psychics => 'saikiks
psyching => saikɪŋ
psycho => 'saikәu
psychoacoustic => ,psaikәjә'ku:stik, -'kajs-
psychoacoustics => ,saikәuә'ku:stiks
psychoactive => ,saikәu'æktiv
psychoanalyse => ,psaikәj'ænәlaiz
psychoanalyses => ,psaikəuə'nælisi:z
psychoanalysis => .saikәuә'nælәsis
psychoanalyst => .saikәu'ænәlist
psychoanalysts => saɪkə'ʊænəlɪsts
psychoanalytic => 'psaikәj,ænә'litik
psychoanalytically => ,saikəu,ænə'litikli
psychoanalyze => .saikәu'ænәlaiz
psychobabble => ,psaikәj'bæbl
psychobiological => ,psaɪkəʊbaɪ'ɒlədʒɪkəl
psychobiology => .psaikәubai'ɔlәdʒi
psychodrama => 'saikәu.drɑ:mә
psychodynamic => ,saikәudai'næmik
psychodynamics => .saikәudai'næmiks
psychoeducational => 'psaikәj,edju:'keiʃәnәl
psychogenesis => .saikәu'dʒenәsis
psychogenic => ,psaikәj'dʒenik
psychogeriatric => 'psaikәj,dʒeri'ætrik
psychogeriatrics => 'psaikәj,dʒeri'ætriks
psychohistorian => ,psaikәjhi'stɔ:riәn
psychohistorical => ,psaikәjhi'stɔrikәl
psychohistory => ,psaikәj'histәri
psychokinesis => .saikәuki'ni:sis
psycholinguist => ,psaikәj'liŋ^wist
psycholinguistic => ˌsaɪkəʊlɪŋ'ɡwɪstɪk
psycholinguistics => ,saikәuliŋ'^wistiks
psychological => .saikә'lɒdʒikәl
psychological moment => ˌsaikəˈlɔdʒikəl ˈməumənt
psychological warfare => ˌsaikəˈlɔdʒikəl ˈwɔ:fɛə
psychologically => ,psaikә'lɔdʒikәli
psychologies => saiˈkɔlədʒiz
psychologism => sai'kɒlәdʒizm
psychologist => sai'kɒlәdʒist
psychologists => saɪˈkɔlədʒɪsts
psychologize => sai'kɒlәdʒaiz
psychology => sai'kɒlәdʒi
psychometric => ,psaikәj'metrik
psychometrics => ,saikә'metriks
psychometry => sai'kɒmitri
psychomotor => .saikә'mәutә
psychoneuroimmunology => saɪkəʊnju:rɔɪmjʊ'nɒlɒɡ
psychoneurosis => .saikәunju'rәusis
psychopath => 'saikәpæθ
psychopathic => .saikә'pæθik
psychopathological => saɪkəʊpæθə'lɒdʒɪkl
psychopathology => .saikәupә'θɒlәdʒi
psychopaths => 'saɪkəʊpæθs
psychopathy => sai'kɒpәθi
psychopharmacologist => 'psaikәj,fɑ:mә'kɔlәdʒist
psychopharmacology => ,saikәu,fɑ:mә'kɔlәdʒi
psychophysics => .saikәu'fiziks
psychophysiological => saɪkəʊfɪzɪəlɒd'ʒɪkl
psychophysiology => 'saikәu,fizi'ɔlәdʒi
psychopomp => 'saikəupɔmp
psychos => ˈsaɪkəʊz
psychosexual => ,saikәu'sekʃuәl
psychosis => sai'kәusis
psychosocial => ,saikәu'sәuʃәl
psychosomatic => .saikәsәu'mætik
psychosurgery => ,saikәu'sә:dʒәri
psychosurgical => ,psaɪkəʊ'sɜːdʒɪkəl
psychosynthesis => ,saikәu'sinθisis
psychotherapeutic => 'psaikəu,θerə'pju:tik
psychotherapist => .saikәu'θerәpist
psychotherapists => ˈsaikəuˈθerəpists
psychotherapy => .saikәu'θerәpi
psychotic => sai'kɒtik
psychotics => saɪˈkɔtɪks
psychotomimetic => sai,kɔtәumi'metik
psychotropic => ,saikәu'trɔpik
psychrometer => sai'krɒmitә
psyllid => 'psilid
Ptah => ptɑ:, ptɑ:h
ptarmigan => 'tɑ:migәn
pteridological => ,pterədə'lɔdʒikəl
pteridology => .teri'dɒlәdʒi
pteridophyte => 'teridәufait
pteridosperm => '(p)teridәuspә:m
ptero- => 'pterәj
pterodactyl => .terәu'dæktil
pterodactyls => ,terə'dæktɪl
pteropod => '(p)terәpɔd
pterosaur => 'terәsɒ:
pterygoid process => ˈ(p)teriɡɔid ˈprəuses
pterygote => '(p)teri^әut
Ptolemaic => tɔlә'meiik
Ptolemy => 'tɔlimi
ptomaine => 'tәumein
ptosis => 'tәusis
ptyalin => 'taiәlin
pub => pʌb
pub crawl => pʌb krɔ:l
puberty => 'pju:bәti
pubes => 'pju:bi:z
pubescence => pju:'besns
pubescent => pju:'besnt
pubic => 'pju:bik
pubis => 'pju:bis
public => 'pʌblik
public company => ˈpʌblik ˈkʌmpəni
public convenience => ˈpʌblik kənˈvi:njəns
public housing => ˈpʌblik ˈhauziŋ
public prosecutor => ˈpʌblik ˈprɔsɪˌkju:tə
public school => ˈpʌblik sku:l
public sector => ˈpʌblik ˈsektə
public speaking => ˈpʌblik ˈspi:kɪŋ
public spirit => ˈpʌblik ˈspirit
public television => ˈpʌblik ˈteliˌviʒən
public transport => ˈpʌblik trænsˈpɔ:t
public-spirited => 'pʌblik'spiritid
publican => 'pʌblikәn
publicans => ˈpʌblikənz
publication => .pʌbli'keiʃәn
publicise => 'pʌblisaiz
publicised => 'pʌblɪsaɪz
publicist => 'pʌblisist
publicists => ˈpʌblɪsɪsts
publicity => pʌb'lisiti
publicize => 'pʌblisaiz
publicizes => ˈpʌblɪˌsaɪziz
publicizing => ˈpʌblɪˌsaɪzɪŋ
publicly => 'pʌblikli
publish => 'pʌbliʃ
publishable => 'pʌbliʃәbl
publisher => 'pʌbliʃә
publishes => ˈpʌbliʃiz
publishing => 'pʌbliʃiŋ
Puccini => pu:'tʃi:ni:
puccoon => pә'ku:n
puce => pju:s
puck => pʌk
pucka => 'pʌkә
pucker => 'pʌkә
puckered => ˈpʌkəd
puckering => 'pʌkərɪŋ
puckers => 'pʌkəz
puckery => 'pʌkәri
puckish => 'pʌkiʃ
pud => pʌd
pudding => 'pudiŋ
pudding basin => ˈpudiŋ ˈbeisn
puddings => ˈpudiŋz
puddingy => 'pudiŋi
puddle => 'pʌdl
puddle jumper => ˈpʌdl ˈdʒʌmpə
puddled => 'pʌd(ə)l
puddler => 'pʌdlә
puddles => ˈpʌdlz
puddling => 'pʌdliŋ
puddly => 'pʌdli
pudendum => pju:'dendәm
pudge => pʌdʒ
pudgy => 'pʌdʒi
puds => pʌdz
pudu => 'pudu
Puebla => 'pweblɑ:; pju'eblə
pueblo => pu'eblәu
puerile => 'pjuәrail
puerilely => p'jʊəraɪlɪ
puerility => pjuә'riliti
puerperal => pju:'ә:pәrәl
puerperium => .pju:ә'piәriәm
Puerto Rican => ,pw\\\\:tәj 'ri:kәn
Puerto Rico => 'pwә:tәu'ri:kәu
puff => pʌf
puff pastry => pʌf ˈpeistri
puff-puff => 'pʌfpʌf
puffball => 'pʌfbɒ:l
puffballs => ˈpʌfbɔ:lz
puffbird => 'pʌfb\\\\:d
puffer => 'pʌfә
pufferfish => 'pʌfəfɪʃ
puffery => 'pʌfәri
puffier => ˈpʌfɪə
puffin => 'pʌfin
puffiness => 'pʌfɪnəs
puffins => ˈpʌfinz
puffy => 'pʌfi
pug => pʌg
pug nose => pʌɡ nəuz
pug-nosed => 'pʌ^nәjzd
puggaree => 'pʌ^әri
pugged => pʌg
pugh => pju:
pugilism => 'pju:dʒilizm
pugilist => 'pju:dʒilist
pugilistic => .pju:dʒi'listik
Puglia => 'pu:ljɑ:
pugnacious => pʌg'neiʃәs
pugnacity => pʌg'næsiti
pugs => pʌɡz
Pugwash => 'pʌ^wɔʃ
puisne => 'pju:ni
puissance => 'pju:isns
puissant => 'pju:isnt
puja => 'pu:dʒɑ:
puka => 'pu:kә
puke => pju:k
puked => pju:kt
pukeko => pu:'kekәj
pukes => pju:ks
pukka => 'pʌkә
puku => 'pu:ku:
pul => pul
pula => 'pu:lɑ:
pulaski => pʊ'læskɪ
pulchritude => 'pʌlkritju:d
pulchritudinous => ,pʌlkri'tju:dinәs
pule => pju:l
puled => pju:ld
pules => pju:lz
puli => 'pu:li
puling => 'pju:liŋ
pulitzer => 'pulitsә
pull => pul
pull the plug => pul ðə plʌɡ
pull up stakes => pul ʌp steiks
pull-apart => 'pʊləp'ɑ:t
pull-in => 'pjlin
pull-ins => 'pul,in
pull-off => 'pʊl'ɔ:f
pull-on => 'pjlɔn, -ɔ:n
pull-out => pul aut
pull-tab => 'pʊlt'æb
pullback => 'pulbæk
puller => 'pulә
pullet => 'pulit
pullets => 'pʊlɪt
pulley => 'puli
pulleys => ˈpʊliz
pulling => 'puliŋ
Pullman => 'pulmәn
pullout => 'pulaut
pullover => 'pul.әuvә
pullovers => ˈpʊlˌəʊvəz
pulls => pulz
pullulate => 'pʌljuleit
pullulated => ˈpʌljəˌleɪtid
pullulates => ˈpʌljəˌleɪts
pullulating => ˈpʌljəˌleɪtɪŋ
pullulation => .pʌlju'leiʃәn
pulmonaria => pʌlmə'nɑ:rɪə
pulmonary => 'pʌlmәnәri
pulmonary artery => ˈpʊlməˌneri: ˈɑ:təri
pulmonary vein => ˈpʊlməˌneri: vein
pulmonate => 'pʌlmәneit
pulmonic => pʌl'mɒnik
pulmonologist => pʌl'mənɒlədʒɪst
pulp => pʌlp
pulp cavity => pʌlp ˈkæviti
pulped => 'pʌlpt
pulpiness => 'pʌlpinis
pulpit => 'pulpit
pulpits => 'pʊlpɪts
pulps => pʌlps
pulpwood => 'pʌlpwud
pulpy => 'pʌlpi
pulque => 'pulki
pulsar => 'pʌlsɑ:
pulsatance => 'pʌlsətəns
pulsate => 'pʌlseit
pulsated => ˈpʌlˌseɪtid
pulsates => ˈpʌlˌseɪts
pulsatile => 'pʌlsәtail
pulsation => pʌl'seiʃәn
pulsator => pʌl'seitә
pulsatory => 'pʌlsәtәri
pulse => pʌls
pulse oximeter => pʌls ɔkˈsimitə
pulsed => pʌlst
pulseless => 'pʌlslis
pulses => pʌlsiz
pulsing => 'pʌlsiŋ
pulverise => 'pʌlvәraiz
pulverization => .pʌlvәrai'zeiʃәn
pulverize => 'pʌlvәraiz
pulverizer => 'pʌlvәraizә
pulverizes => ˈpʌlvəˌraɪziz
pulverizing => 'pʌlvəraɪzɪŋ
pulverulent => pʌl'verjulәnt
pulvinus => pʌl'vainәs
puma => 'pju:mә
pumas => ˈpju:məz
pumice => 'pʌmis
pumiced => ˈpʌmɪst
pumiceous => pju:'miʃәs
pumices => ˈpʌmɪsiz
pumicing => 'pʌmɪsɪŋ
pummel => 'pʌml
pummeled => 'pʌm(ə)l
pummeling => 'pʌm(ə)l
pummelled => ˈpʌməld
pummelling => ˈpʌməlɪŋ
pummelo => 'pʌmilәu
pummels => ˈpʌməlz
pump => pʌmp
pump iron => pʌmp ˈaiən
pump-priming => ˈpʌmpˌpraɪmɪŋ
pumped => pʌmpt
pumper => 'pʌmpә
pumpernickel => 'pʌmpәnikl
pumping => 'pʌmpiŋ
pumpkin => 'pʌmpkin
pumpkinseed => pʌmpkɪn'zi:d
pun => pʌn
puna => 'pu:nɑ:
punch => pʌntʃ
punch bowl => pʌntʃ bəul
punchbag => ˈpʌntʃbæg
punchbags => 'pʌn(t)ʃbæg
punchball => ˈpʌntʃbɔ:l
punchboard => 'pʌntʃbɒ:d
puncheon => 'pʌntʃәn
puncher => 'pʌntʃә
punches => pʌntʃiz
punchier => ˈpʌntʃi:ə
puncta => 'pʌŋktә
punctate => 'pʌŋkteit
punctation => 'pʌnkˌteɪʃən
punctilio => pʌŋk'tiliәu
punctilios => pʌŋkˈtiliəuz
punctilious => pʌŋk'tiliәs
punctiliously => pʌŋk'tiliəsli
punctiliousness => pʌŋk'tiliəsnis
punctual => 'pәŋktʃuәl
punctuality => .pʌŋktʃu'æliti
punctuate => 'pʌŋktjueit
punctuated => ˈpʌŋktʃu:ˌeɪtid
punctuated equilibrium => ˈpʌŋktʃu:ˌeɪtɪd
punctuates => ˈpʌŋktʃu:ˌeɪts
punctuating => ˈpʌŋktʃu:ˌeɪtɪŋ
punctuation => .pʌŋktʃu'eiʃәn
punctuational => ,pʌŋktjj'eiʃənәl,-tʃj-
punctum => 'pʌŋktәm
puncture => 'pʌŋktʃә
punctures => ˈpʌŋktʃəz
puncturing => ˈpʌŋktʃərɪŋ
pundit => 'pʌndit
punditry => 'pʌnditri
pundits => ˈpʌndɪts
pungency => 'pʌndʒәnsi
pungent => 'pʌndʒәnt
pungently => 'pʌndʒəntlɪ
punic => 'pju:nik
punier => ˈpju:ni:ə
punily => 'pju:nili
puniness => 'pju:ninis
punish => 'pʌniʃ
punishable => 'pʌniʃәbl
punisher => 'pʌniʃә
punishes => ˈpʌniʃiz
punishment => 'pʌniʃmәnt
punishments => 'pʌnɪʃmənts
punitive => 'pju:nitiv
punitively => 'pju:nətivli
punitiveness => p'ju:nɪtɪvnəs
Punjab => pʌn'dʒɑ:b
Punjabi => .pʌn'dʒɑ:bi
punk => pʌnk
punkah => 'pʌŋkә
punker => ˈpʌŋkə
punks => pʌŋks
punky => 'pʌŋkɪ
punned => pʌnd
punnet => 'pʌnit
punnets => ˈpʌnets
punning => pʌnɪŋ
punningly => 'pʌniŋli
puns => pʌnz
punster => 'pʌnstә
punt => pʌnt
punted => pʌntid
punter => 'pʌntә
punters => ˈpʌntəz
punts => pʌnts
punty => 'pʌnti
puny => 'pju:ni
pup => pʌp
pup tent => pʌp tent
pupa => 'pju:pә
pupae => 'pju:pi:
pupal => 'pju:pl
puparium => pju:'peәriәm
pupate => 'pju:peit
pupating => p'ju:pətɪŋ
pupfish => 'pʌpfiʃ
pupil => 'pju:pl
pupils => 'pju:plz
pupiparous => pju:'pipәrәs
pupped => pʌp
puppet => 'pʌpit
puppeteer => .pʌpi'tiә
puppeteering => pʌpɪ'tɪə
puppeteers => pʌpiˈtiəz
puppetmaster => 'pʌpətmɑːstə
puppetry => 'pʌpitri
puppets => ˈpʌpits
pupping => pʌp
Puppis => 'pʌpis
puppy => 'pʌpi
puppy fat => ˈpʌpi fæt
puppyhood => 'pʌpihjd
puppyish => 'pʌpiiʃ
pups => pʌps
pur => pә:
purblind => 'pә:blaind
Purcell => 'pә:sl
purchasable => 'pә:tʃәsәbl
purchase => 'pә:tʃәs
purchaser => 'pә:tʃәsә
purchasing power => 'p\\\\:tʃәsiŋ
purdah => 'pә:dɑ:
pure => pjuә
pure mathematics => pjuə ˌmæθiˈmætiks
pure-bred => pjuə bred
pureblooded => ˌpjuəˈblʌdid
purebred => 'pjuәbred
pured => pjʊə
puree => 'pjjәrei
pureed => ˈpjuəreid
pureeing => ˈpjuəreiŋ
purees => ˈpjuəreiz
purely => 'pjuәli
pureness => 'pjuәnis
purest => ˈpjʊərɪst
purfle => 'pә:fl
purfling => 'pɝpl
purgation => pә:'geiʃәn
purgative => 'pә:gәtiv
purgatives => ˈpɜ:gətɪvz
purgatorial => .pә:gә'tɒ:riәl
purgatory => 'pә:gәtәri
purge => pә:dʒ
purged => pə:dʒd
purger => 'pә:dʒә
purges => pə:dʒz
purging => 'pә:dʒiŋ
puri => 'pu:ri
purification => .pjurifi'keiʃәn
purificatory => 'pjuәrifikәtәri
purifier => 'pjuәrifaiә
purify => 'pjuәrifai
purifying => 'pjuәrifaiiŋ
purine => 'pjuәri:n
purism => 'pjuәrizm
purist => 'pjuәrist
puristic => pjʊə'rɪstɪk
purists => ˈpjuərists
puritan => 'pjuәritn
puritanical => ,pjuәri'tænikәl
puritanism => 'pjuәritәnizm
puritans => p'jʊərɪtənz
purity => 'pjuәrәti
purl => pә:l
purler => 'pә:lә
purlieu => 'pә:lju:
purlin => 'pә:lin
purling => 'pә:liŋ
purloin => pә:'lɒin
purloined => pəˈlɔɪnd
purloining => pəˈlɔɪnɪŋ
purloins => pəˈlɔɪnz
purls => pɜːl
puro => 'pjraj
puromycin => .pjuәrәu'maisin
purple => 'pә:pl
purple patch => ˈpə:pl pætʃ
purples => 'pә:plz
purpling => 'pә:pliŋ
purplish => 'pә:pliʃ
purport => 'pә:pɒ:t
purported => pә:'pɔ:tid. 'pә:p-. 'pә:pә-
purportedly => p\\\\:'pɔ:tidli,'p\\\\:p-,'p\\\\:pәt-
purporting => pəˈpɔ:tɪŋ
purports => pəˈpɔ:ts
purpose => 'pә:pәs
purpose-built => 'p\\\\:pәsbilt
purpose-made => 'pɜ:pəsm'eɪd
purposeful => 'pә:pәsful
purposefulness => 'pɜ:pəsflnəs
purposeless => 'pә:pәslis
purposelessness => 'pɜ:pəsləsnəs
purposely => 'pә:pәsli
purposive => 'pә:pәsiv
purposively => 'pə:pəsiv
purpura => 'pә:pjurә
purpure => 'pә:pjuә
purpuric => pә:'pjuәrik
purpurin => 'pә:pjurin
purr => pә:
purred => pɜ:d
purrs => pɜ:z
purse => pә:s
purse seine => pə:s seɪn
purser => 'pә:sә
pursers => ˈpɜ:səz
purses => pə:siz
pursiness => 'pә:sinis
purslane => 'pә:slin
pursuable => pә'sju:әbl
pursuance => pә'sju:әns
pursuant => pә'sju:әnt
pursue => pә'sju:
pursued => pəˈsju:d
pursuer => pә'sju:ә
pursuers => pəˈsju:əz
pursues => pəˈsju:z
pursuing => pəˈsju:ɪŋ
pursuit => pә'sju:t
pursuits => pəˈsju:ts
pursuivant => 'pә:sivәnt
pursy => 'pә:si
purulent => 'pjuәrjulәnt
purvey => pә'vei
purveyance => pә'veiәns
purveyed => pəˈveɪd
purveying => pəˈveɪŋ
purveyor => pә'veiә
purveyors => pəˈveiəz
purveys => pəˈveɪz
purview => 'pә:vju:
pus => pʌs
pusey => 'pju:zi
Puseyism => 'pju:ziizm
Puseyite => 'pju:ziait
push => puʃ
push-pull => 'pjʃ'pjl
push-start => puʃ stɑ:t
push-ups => 'pʊʃ'ʌps
pushback => 'pʊʃbæk
pushbike => ˈpʊʃbaɪk
pushcart => 'puʃkɑ:t
pushchair => 'puʃtʃєә
pushchairs => ˈpuʃtʃeəz
pusher => 'puʃә
pushers => ˈpuʃəz
pushes => puʃiz
pushful => 'puʃful
pushier => ˈpuʃiə
pushily => 'pʊʃɪlɪ
pushiness => 'pʊʃɪnəs
pushing => 'puʃiŋ
Pushkin => 'pu:ʃkin
pushover => 'puʃ.әuvә
pushovers => ˈpuʃəuvəz
pushpin => 'puʃpin
pushrod => 'pʊshrəʊd
Pushtu => 'pʌʃtu:
pushy => 'puʃi
pusillanimity => .pju:silә'nimiti
pusillanimous => .pju:si'lænimәs
pusillanimously => p'ju:sɪlænɪməslɪ
puss => pus
pusses => pʊs
pussies => ˈpʊsi:z
pussy => 'pusi
pussy willow => ˈpʊsi: ˈwiləu
pussycat => 'pusikæt
pussycats => ˈpusikæts
pussyfoot => 'pusifut
pussyfooter => 'pjsi,fjtә(r)
pustular => 'pʌstjulә
pustulate => 'pʌtʃjuleit
pustulation => .pʌstʃә'leiʃәn
pustule => 'pʌstju:l
pustules => ˈpʌstju:lz
put => put
put-downs => put daʊnz
put-off => 'pjtɔf,-ɔ:f
put-put => 'pʌtpʌt
put-up job => ˈpʊtˌʌp dʒɔb
put-you-up => 'pjtjj,ʌp
puta => 'putә
putamen => pju:'teimәn
putative => 'pju:tәtiv
putatively => 'pju:tətɪvlɪ
putlog => 'pʌtlɔ^,'pjt-;lɔ:^
putonghua => pu:'tʊŋhwɑ:
putrefaction => .pju:tri'fækʃәn
putrefactive => .pju:tri'fæktiv
putrefied => p'ju:trɪfaɪd
putrefies => ˈpju:trəˌfaɪz
putrefy => 'pju:trifai
putrefying => p'ju:trɪfaɪɪŋ
putrescence => pju:'tresns
putrescent => pju:'tresnt
putrescible => pju:'tresibl
putrid => 'pju:trid
putridity => pju:'triditi
putridly => p'ju:trɪdlɪ
putridness => pju:t'rɪdnəs
putsch => 'putʃ
putsches => pʊtʃiz
putt => pʌt
putted => pʌtid
puttee => 'pʌti
putter => 'putә. 'pʌtә
puttered => ˈputəd
puttering => ˈputərɪŋ
putters => ˈputəz
puttied => ˈpʌti:d
putties => ˈpʌti:z
putting => 'putiŋ
putting green => ˈputiŋ ɡri:n
putto => 'pu:(t)tәu
putts => pʌts
putty => 'pʌti
puttying => 'pʌtɪɪŋ
putz => puts, pʌts
puzzle => 'pʌzl
puzzlement => 'pʌzlmәnt
puzzler => 'pʌzlә
puzzling => 'pʌzliŋ
puzzlingly => 'pʌzlɪŋlɪ
pya => pja:
pyaemia => pai'i:miә, -mjә
pyaemic => pa'ɪi:mɪk
pycnocline => 'piknәklain
PYE => pai
pye-dog => 'paidɔ^
pyelitis => .paiә'laitis
pyelogram => 'paiәlә^ræm
pyelography => ,paiә'lɔ^rәfi
pyelonephritic => ,paiələuni'fritik
pyelonephritis => ,paiәlәuni'fraitis
pyemia => pai'i:miә
pygidium => pai'dʒidiәm
Pygmalion => pig'meiljәn
pygmean => pig'mi:әn
pygmies => ˈpɪgmi:z
pygmy => 'pigmi
pygostyle => 'pai^ә,stail
pyinkado => pi'iŋkә,dәu
pyjama => pә'dʒɑ:mә, pi-
pyjamas => pә'dʒɑ:mәs
pyknic => 'piknik
Pyle => pail
pylon => 'pailɒn
pylons => 'paɪlɒnz
pylori => pai'lɔ:rai,pi-
pyloric => pai'lɒ:rik
pylorus => pai'lɒ:rәs
Pym => pim
pyoderma => ,paiәu'dә:mә
pyogenic => ,paiә?'dʒenik
Pyongyang => 'pjɔŋ'jæŋ
pyorrhoea => ,paiә'riә
pyracantha => ,piәrә'kænθә, ,pairә-
pyralid => 'pirәlid
pyramid => 'pirәmid
pyramidal => pi'ræmidl
pyramidic => perә'midik
pyramidical => perә'midikәl
pyramiding => 'pirәmidiŋ
pyramids => ˈpirəmidz
pyrargyrite => pai'rɑ:dʒirait
pyre => 'paiә
pyrene => 'pairi:n
Pyrenean => .pirә'ni:әn
Pyrenees => ,pirә'ni:z
pyres => paɪəz
pyrethrin => pai'ri:θrin
pyrethroid => pai'ri:θrɔid
pyrethrum => pai'ri:θrәm
pyretic => pai'retik
Pyrex => 'paireks
pyrexia => pai'reksiә
pyrexic => pai'reksik
pyridine => ,pirә'dainә
pyridoxal => ,piri'dɔksæl
pyriform => 'pirifɒ:m
pyrimethamine => ,paiəri'meθәmi:n,,pi-
pyrimidine => pai'rimidi:n
pyrite => 'pairait
pyrites => pai'raiti:z
pyritic => pai'ritik
pyro => 'pairәu
pyroclast => paɪərəʊk'læst
pyroclastic => ,paiərә?'klæstik,,pi-
pyroelectric => .pairәui'lektrik
pyroelectricity => ,paiәrәuilek'trisiti
pyrogallol => ,paiәrәu'^ælәul, -^ә'lәul
pyrogen => 'paiәrәudʒin
pyrogenic => ,paiərә?'dʒenik,,pi-
pyrography => pai'rɒgrәfi
pyrolusite => ,paiәrәu'lu:sait
pyrolyse => 'paiərәlaiz,'pi-
pyrolysis => pai'rɒlisis
pyromania => .pairә'meiniә
pyromaniac => .pairә'meiniæk
pyromaniacal => ,paiərəu'mə'naiəkəl; ,pi-
pyrometallurgical => paɪrɒmɪtæ'lɜ:dʒɪkəl
pyrometallurgy => ,paiərә?me'tælәdʒi,,pi-
pyrometer => pai'rɒmitә
pyrometric => paɪrəʊ'metrɪk
pyrometrically => ,paiərəu'metrikəli; ,pi-
pyrometry => ,paiə'rɔmitri,pi-
pyromorphite => ,paiәrә?'mɔ:fait,,pi-
pyrope => 'pairәup
pyrophoric => ,paiərә?'fɔrik,,pi-
pyrophosphate => ,pairәu'fɔsfeit
pyrosis => pai'rәusis
pyrotechnic => ,pairәu'teknik
pyrotechnical => ,pairәu'teknikәl
pyrotechnics => .pairә'tekniks
pyrotechnist => .pairә'teknist
pyroxene => pai'rɔksi:n
pyroxenite => pai'rɔksinait
Pyrrha => 'pirә
pyrrhic => 'pirik
Pyrrho => 'pirәu
Pyrrhonism => 'pirәnizm
Pyrrhonist => 'pirәnist
pyrrhotite => 'piәrәutait
Pyrrhus => ˊpirәs
pyrrole => 'paiәrәul
pyrrolidine => pi'rәuli,di:n
pyruvate => pai'ru:veit
Pythagoras => pi'θægәræs
Pythagorean => pi.θægә'ri:әn
Pythia => 'piθiә
Pythian => 'piθiәn, -θjәn
Pythias => 'piθiæs,-әs
python => 'paiθɒn
pythoness => 'paiθәnes,'pi-
pythonic => pai'θɒnik
pythons => ˈpaɪˌθɔnz
pyuria => pai'juәriә
pyx => piks
pyxidium => pik'sidiәm