p => pi:
p-type => 'pi:t'aɪp
PA => pɑ:
Pablo => 'pæblәu
pablum => 'pæblәm
pabulum => 'pæbjulәm
PAC => pæk
paca => 'pækә, 'pɑ:kә
pace => peis
pace bowler => peis ˈbəʊlə
pace car => peis kɑ:
paced => peist
pacemake => 'peɪsmeɪk
pacemaker => 'peis.meikә
pacemakers => 'peɪsmeɪkəz
pacemaking => 'peis.meikiŋ
pacer => 'peisә
pacesetting => 'peis,setiŋ
pacha => 'pɑ:ʃә, pә'ʃɑ:
pachinko => pә'tʃiŋkәu
pachisi => pә'tʃi:zi
pachuco => pә'tʃu:kәu
pachyderm => 'pækidә:m
pachydermal => ,pæki'dəməl
pachydermatous => .pæki'dә:mәtәs
pachyderms => ˈpækɪˌdɜ:mz
pachysandra => ,pæki'sændrә
pachytene => 'pækiti:n
pacific => pә'sifik
pacifically => pә'sifikli
pacification => .pæsifi'keiʃәn
pacificatory => pә'sifikәtәri
pacified => ˈpæsəˌfaɪd
pacifier => 'pæsifaiә
pacifiers => ˈpæsəˌfaɪəz
pacifies => ˈpæsəˌfaɪz
pacifism => 'pæsifizm
pacifist => 'pæsifist
pacifistic => .pæsi'fistik
pacifists => ˈpæsɪfɪsts
pacify => 'pæsifai
pacifying => ˈpæsəˌfaɪŋ
pack => pæk
pack animal => pæk ˈæniməl
pack ice => pæk ais
pack rat => pæk ræt
packable => 'pækəbl
package => 'pækidʒ
package holiday => ˈpækidʒ ˈhɔlədi
package store => ˈpækidʒ stɔ:
packaging => 'pækidʒiŋ
packed lunch => pækt lʌntʃ
packed out => pækt aut
packer => 'pækә
packers => ˈpækəz
packet => 'pækit
packet boat => ˈpækit bəut
packet-switching => 'pækit,switʃiŋ
packeted => 'pækɪt
packeting => 'pækɪt
packhorse => 'pækhɒ:s
packing => 'pækiŋ
packinghouse => 'pækiŋhajs
packman => 'pækmәn
packsack => 'pæksæk
packsaddle => 'pæksædl
pact => pækt
pacts => pækts
pacy => 'peɪsɪ
pad => pæd
Padang => 'pædæŋ
padauk => pә 'dauk
padded cell => ˈpædid sel
paddies => 'pædɪz
padding => 'pædiŋ
paddington => 'pædiŋtәn
paddle => 'pædl
paddle steamer => ˈpædl ˈsti:mə
paddle tennis => ˈpædl ˈtenɪs
paddleball => 'pædlbɔ:l
paddled => ˈpædld
paddlefish => 'pædlfiʃ
paddler => 'pædlɚ
paddles => ˈpædlz
paddling pool => ˈpædlɪŋ pu:l
paddock => 'pædәk
paddocks => ˈpædəks
paddy => 'pædi
paddy field => ˈpædi fi:ld
paddymelon => 'pædi,melәn
pademelon => 'pædi,melәn
padlock => 'pædlɒk
padlocked => 'pædlɒkt
padlocking => ˈpædˌlɔkɪŋ
padlocks => ˈpædˌlɔks
Padova => 'pɑ:dɔ:vɑ:
padre => 'pɑ:dri
padres => ˈpɑ:driz
padrone => pә'drәuni
Padua => 'pædjjә,-dʒjә
paduasoy => 'pædjʊəsɔɪ
paean => 'pi:әn
paeans => ˈpi:ənz
paederast => 'pedəræst
paediatric => .pi:di'ætrik
paediatrician => .pi:diә'triʃәn
paediatricians => ˌpi:diəˈtriʃənz
paediatrics => ,pi:di'ætriks
paedogenesis => ,pi:dәu'dʒenisis
paedomorphic => ,pi:də'mɔ:fik
paedomorphosis => pi:dә,mɔ:'fәusis
paedophile => ˈpi:dəʊfaɪl
paedophilia => ˌpi:dəˈfɪliə
paedophiliac => ,pi:də'filiæk
paella => pɑ:'elә
paeon => 'pi:әn
paeony => 'piә ni
pagan => 'peigәn
paganish => 'peigәniʃ
paganism => 'peigәnizm
paganize => 'peigәnaiz
paganized => 'peɪ'ɡənaɪz
paganizing => 'peɪ'ɡənaɪz
pagans => ˈpeɪgənz
page => peidʒ
page proof => peidʒ pru:f
page-turner => peidʒ ˈtə:nə
pageant => 'pædʒәnt
pageantry => 'pædʒәntri
pageants => ˈpædʒənts
pageboy => 'peidʒbɒi
pageboys => ˈpeɪdʒˌbɔɪz
pager => 'peidʒә(r)
pagers => ˈpeɪdʒəz
paginal => 'pædʒinәl
paginate => 'pædʒineit
paginated => ˈpædʒineitid
paginates => ˈpædʒineits
pagination => .pædʒi'neiʃәn
paging => 'peidʒiŋ
pagoda => pә'gәudә
pagoda tree => pəˈgəʊdə tri:
pagodas => pə'ɡəʊdəz
pah => pɑ:
Pahang => pə'hʌŋ
Pahlavi => 'pɑ:lәvi:
pahoehoe => pɑ:'hәui,hәui
paid => peid
pail => peil
pailful => 'peilful
paillasse => .pæli'æs
paillette => pæl'jet
pails => peɪlz
pain => pein
pain barrier => pein ˈbæriə
pained => peind
painful => 'peinful
painfully => 'peinfuli
painfulness => 'peinfulnis
painkiller => 'pein,kilә(r)
painkillers => ˈpeɪnˌkɪləz
painkilling => 'peɪn,kɪlɪŋ
painless => 'peinlis
painstaking => 'peinzteikiŋ
paint => peint
paint stripper => peint ˈstripə
paintable => 'peɪntəbl
paintball => 'peintbɔ:l
paintbox => 'peintbɒks
paintbrush => 'peintbrʌʃ
paintbrushes => ˈpeɪntˌbrʌʃiz
painted => 'peintid
painted lady => ˈpeintid ˈleidi
painter => 'peintә
painterly => 'peintәli
painters => 'peɪntəz
painting => 'peintiŋ
paintless => 'peɪntlɪs
painty => 'peinti
pair => pєә
pair-bond => pɛə bɔnd
pairing => 'peәriŋ
pairs => pεәz
pairwise => peər'waɪz
paisa => 'paisæ
paisano => 'peɪzənəʊ
paisley => 'peizli
Paiute => 'paiju:t, pai'ju:t
pajamas => pә'dʒɑ:mәs
pakeha => 'pɑ:kihә
Pakistan => .pɑ:ki'stɑ:n
Pakistani => .pɑ:ki'stɑ:ni
pal => pæl
palace => 'pælis
palaces => 'pælɪsɪz
paladin => 'pælәdin
Palaearctic => ,peili'ɑ:ktik
palaeo- => ˈpæliəʊ
palaeoanthropology => 'pæliәu,ænθrә'pɔlәdʒi
palaeobiology => pæli:əb'ɪɒlədʒɪ
palaeobotany => 'pæliәu'bɔtәni
Palaeocene => 'peiliәusi:n, 'pæli-
palaeoclimate => pæli:ək'laɪmət
palaeoclimatology => 'pæliәj,klaimә'tɔlәdʒi;'pei-
palaeoecology => pæli:əʊ'kɒlədʒɪ
palaeoenvironment => pæli':əʊnvaɪərənmənt
palaeoethnobotany => 'pæliәj,eθnәj'bɔtәni;'pei-
Palaeogene => 'pæliәdʒi:n;'pәi-
palaeogeography => 'pæli:ədʒɪəɡrəfɪ
palaeography => ,pæli'ɔ^rәfi
palaeolatitude => 'pæli:əlætɪtju:d
Palaeolithic => ,pæliәu'liθik
palaeomagnetism => ,pæliәj'mæ^nitizәm; ,pei-
palaeontological => pælɪɒntə'lɒdʒɪkəl
palaeontology => ,pæliɔn'tɔlәdʒi
palaeopathology => pæli:əpæ'θɒlədʒɪ
palaeozoic => ,pæliәu'zәuik
palaestra => pә'lestrә
palais de danse => pæ'lei dә 'dɑ:ns
palanquin => pæ'lənki:n
palapa => pæ'ləpɑ:
palatability => 'pælətəbəlɪtɪ
palatable => 'pælәtәbl
palatably => 'pælətəblɪ
palatal => 'pælәtәl
palatalization => .pælәtәlai'zeiʃәn
palatalize => 'pælәtәlaiz
palate => 'pælit
palates => 'pæləts
palatial => pә'leiʃәl
Palatinate => pә'lætinәt,-neit
palatine => 'pælәtain
Palau => pɑ:'laj
palaver => pә'lɑ:vә
palavered => pəˈlævəd
palavering => pəˈlævərɪŋ
palavers => pəˈlævəz
Palawan => pɑ:'lɑ:vɑ:n,-wɑ:n
palazzo => pɑ:'lɑ:tsәu
palazzo pants => pəˈlætsəʊ pænts
palazzos => pɑ:'lɑ:tsәuz
pale => peil
pale ale => peil eɪl
palea => 'peiliә
Palearctic => ,peili'ɑ:ktik
paled => peild
paleface => 'peilfeis
palely => 'peili
Palembang => ,pɑ:lem'bɑ:ŋ
paleness => 'peilnis
paleoanthropologist => pæli:əʊənθrə'pɒlədʒɪst
paleontological => ,pæliɔntə'lɔdʒikl, 'pei-
paleontologist => .pæliɒn'tɒlәdʒist
paleontology => .pæliɒn'tɒlәdʒi
palermo => pә'lә:mәu
pales => peilz
Palestine => 'pælәstain
Palestinian => ,pælis'tiniәn
palestra => pә'lestrә
Palestrina => ,pæli'strinə
palette => 'pælit
palette knife => ˈpælɪt naif
palettes => ˈpælɪts
PALEY => 'peili
palfrey => 'pɒ:lfri
Palgrave => 'pɔ:l^reiv, 'pæl-
Pali => 'pɑ:li
palimony => ˈpælɪməni
palimpsest => 'pælimpsest
palindrome => 'pælindrәum
palindromes => ˈpælindrəumz
palindromist => ,pælɪn'drɒmɪst
paling => 'peiliŋ
palingenesis => .pælin'dʒenәsis
palingenetic => .pælindʒә'netik
palinode => 'pælinәud
palisade => .pæli'seid
palisaded => ,pælɪ'seɪd
palisades => pælɪ'seɪdz
palisading => ,pælɪ'sed
palish => 'peiliʃ
pall => pɒ:l
pall-mall => 'pel'mel, 'pæl'mæl
palladia => pәˊleidiә
palladian => pә'leidjәn
palladium => pә'leidiәm
Pallas => 'pælæs
pallasite => 'pælә,sait
pallbearer => 'pɒ:lbєәrә
pallbearers => ˈpɔ:lbeərəz
palled => 'pæld
pallet => 'pælit
palletize => 'pæli,taiz
pallets => ˈpælits
pallia => 'pæliә
pallial => 'pæliәl
palliasse => pæl'jæs, 'pæljæs
palliate => 'pælieit
palliated => ˈpæli:ˌeɪtid
palliates => ˈpæli:ˌeɪts
palliating => ˈpæli:ˌeɪtɪŋ
palliation => .pæli'eiʃәn
palliative => 'pælieitiv
palliatives => ˈpæliətivz
pallid => 'pælid
pallidly => 'pælɪdlɪ
palling => 'pælɪŋ
pallium => 'pæliәm
pallor => 'pælә
palls => pɔ:lz
pally => 'pæli
palm => pɑ:m
palm civet => pɑ:m ˈsivit
palm reading => pɑ:m ˈri:diŋ
palm tree => pɑ:m tri:
palma => 'pɑ:lmɑ:
palmar => 'pælmә
palmate => 'pælmit
palmated => 'pælmeitid
palmcorder => 'pɑ:mkɔ:də(r)
palmer => 'pɑ:mә
Palmerston => 'pɑ:mәstәn
palmette => pæl'met
palmetto => pæl'metәu
palmful => 'pɑ:mfjl,'pɑ:lm-
palming => pɑ:mɪŋ
palmist => 'pɑ:mist
palmistry => 'pɑ:mistri
palmitate => 'pɑ:lmiteit, pæ-
palmtop => 'pɑ:m'tɔp
palmy => 'pɑ:mi
palmyra => pæl'maiәrә
Paloma => pə'ləumə
palomino => .pælә'mi:nәu
palominos => ˌpæləˈmi:nəuz
palooka => pә'lu:kә
Palouse => pə'lu:s
paloverde => ,pælәu'vә:d
palp => pælp
palpability => .pælpә'biliti
palpable => 'pælpәbl
palpal => 'pælpәl
palpate => 'pælpeit
palpated => ˈpælpeitid
palpates => ˈpælpeits
palpating => ˈpælpeitɪŋ
palpebral => 'pælpibrәl
palpitant => 'pælpitәnt
palpitate => 'pælpiteit
palpitated => ˈpælpɪˌteɪtid
palpitates => ˈpælpɪˌteɪts
palpitating => ˈpælpɪˌteɪtɪŋ
palpitation => .pæpi'teiʃәn
palpitations => ˌpælpɪˈteɪʃnz
palpus => 'pælpәs
palsgrave => 'pɒ:lzgreiv
palsied => 'pɒ:lzid
palsies => ˈpɔ:lziz
palstave => 'pɔ:lsteiv
palsy => 'pɒ:lzi
palsy-walsy => 'pælzi'wælzi
palsying => ˈpɔ:lziŋ
palter => 'pɒ:ltә
paltered => ˈpɔ:ltəd
paltering => ˈpɔ:ltərɪŋ
palters => ˈpɔ:ltəz
paltriness => 'pɒ:ltrinis
paltry => 'pɒ:ltri
paludal => pә'lju:dl
Paludrine => 'pæljjdri:n,-drin
paly => 'peili
palynological => ,pælinə'lɔdʒikl
palynology => ,pæli'nɔlәdʒi
PAM => pæm
Pama-Nyungan => 'pɑ:mə'njəŋɡən
pamela => 'pæmilә, 'pæmәlә
pampa => 'pæmpә
pampas => 'pæmpәs
pampas grass => ˈpæmpəs ɡrɑ:s
pamper => 'pæmpә
pampered => 'pæmpəd
pampering => ˈpæmpərɪŋ
pampero => pɑ:m'peәrәu
pampers => ˈpæmpəz
pamphlet => 'pæmflit
pamphleteer => .pæmfli'tiә
pamphleteers => ˌpæmfliˈtiəz
pamphlets => 'pæmflɪts
Pamplona => pɑ:m'pləunɑ:
pan => pæn
pan-Arab => pæn'ærəb
pan-fry => 'pænfrai
panacea => .pænә'siә
panaceas => ˌpænəˈsi:əz
panache => pә'næʃ
panada => pә'nɑ:dә
Panadol => 'pænәdɔl
Panama => .pænә'mɑ:
Panamanian => .pænә'meiniәn
panatella => .pænә'telә
Panay => pɑ:'nai
pancake => 'pænkeik
pancake landing => ˈpænˌkeɪk ˈlændɪŋ
pancakes => 'pænkeɪks
pancetta => pæn'setə
panchayat => pʌn'tʃaiәt
panchromatic => .pænkrәu'mætik
pancreas => 'pæŋkriәs
pancreatectomy => ,pæŋkriә'tektәmi, ,pæn-
pancreatic => .pæŋkri'ætik
pancreatin => 'pæŋkriәtin
pancreatitis => ,pæŋkriә'taitis
pancreozymin => ,pæŋkriә'zaimin
pancytopenia => ,pænsaitә'pi:niә
panda => 'pændә
panda car => ˈpændə kɑ:
pandal => 'pændl
pandanus => pæn'deɪnəs
Pandarus => 'pændәrәs
pandas => 'pændəz
pandect => 'pændekt
pandemic => pæn'demik
pandemics => pænˈdemɪks
pandemonium => pændi'mәjniәm
pander => 'pændә
pandered => ˈpændəd
pandering => ˈpændərɪŋ
panders => ˈpændəz
pandit => 'pʌndit
pandits => 'pændɪt
Pandora => pæn'dɒ:rә
Pandora's box => pæn'dɔ:rәz
pandowdy => pæn'daudi
Pandy => 'pændi
pane => pein
paneer => pæˈnɪə(r)
panegyric => .pæni'dʒirik
panegyrical => ,pæni'dʒirikәl,-'dʒai-
panegyrics => ˌpænəˈdʒɪrɪks
panegyrist => .pæni'dʒirist
panegyrize => 'pænidʒiraiz
panel => 'pænl
panel game => ˈpænəl ɡeim
panel heating => ˈpænəl ˈhi:tɪŋ
panel van => ˈpænəl væn
paneling => 'pænәliŋ
panelist => 'pænәlist
panelists => 'pænəlɪst
panelled => 'pænəld
panelling => 'pænәliŋ
panellist => 'pænәlist
panellists => ˈpænəlists
panels => 'pænl
panentheism => pæ'nenθiizәm
panettone => ,pæni'tәun
panforte => pɑ:n'fɔ:tei
panful => 'pænfjl
panfuls => 'pænfʊl
pang => pæŋ
panga => 'pæŋgә
Panglossian => pæŋ'^lɔsiәn,pæn-
pangolin => pæŋ'gәulin
pangram => 'pæŋ^ræm
pangs => pæŋz
panhandle => 'pænhændl
panhandled => ˈpænˌhændld
panhandler => 'pænhændlә
panhandles => ˈpænˌhændlz
panhandling => ˈpænˌhændlɪŋ
Panhellenic => .pænhe'lenik
panic => 'pænik
panic attack => ˈpænik əˈtæk
panicky => 'pæniki
panicle => 'pænikl
panicled => pə'nɪkjəlɪt
panics => ˈpæniks
Panini => 'pɑ:nini:
Panjabi => pәn'dʒæbi
panjandrum => pæn'dʒændrәm
Pankhurst => 'pæŋkhә:st
panmictic => pæn'miktik
panmixia => pæn'miksiә
pannage => 'pænidʒ
panne => pæn
pannier => 'pæniә
panniers => ˈpæniəz
pannikin => 'pænikin
panning => 'pæniŋ
Pannonia => pə'nəuni:ə
pannus => 'pænәs
panoplied => 'pænәplid
panoply => 'pænәpli
panoptic => pæ'nɒptik
panopticon => pæ'nɒptikɒn
panorama => .pænә'rɑ:mә
panoramas => ˌpænəˈrɑ:məz
panoramic => .pænә'ræmik
panoramically => pænәˊræmiәli
panpsychism => pæn'saikizәm
pansexual => pæn'seksjjәl
pansexuality => pæn,sekʃʊ'ælɪtɪ
pansies => ˈpænziz
pansified => 'pænzifaid
pansy => 'pænzi
pant => pænt
pantalettes => .pæntә'lets
pantaloon => .pæntә'lu:n
pantalooned => 'pæntəlu:nd
pantaloons => ˌpæntəˈlu:nz
pantechnicon => pæn'teknikɒn
pantechnicons => pæn'teknɪk(ə)n
panted => pæntid
Pantelleria => pɑ:n,telle'ri:ɑ:
Panthalassa => ,pænθә'læsә
pantheism => 'pænθi:izm
pantheist => 'pænθi:ist
pantheistic => ,pænθi:'istik
pantheon => 'pænθiәn
pantheons => ˈpænθi:ˌɔnz
panther => 'pænθә
panthers => ˈpænθəz
panties => 'pænti
pantile => 'pæntail
panting => 'pæntiŋ
panto => 'pæntәu
panto- => 'pæntәj
pantograph => 'pæntә^rɑ:f; (?@) -^ræf
pantomime => 'pæntәmaim
pantomimes => ˈpæntəˌmaɪmz
pantomimic => pæntə'mɪmɪk
pantos => ˈpæntəʊz
pantothenate => ,pæntә'θeneit
pantoum => pæn'tu:m
pantries => ˈpæntri:z
pantry => 'pæntri
pantryman => 'pæntrimәn
pants => pænts
pantsuit => 'pæntsju:t
pantun => pæn'tu:n
panty => 'pænti
panty girdle => ˈpænti ˈgɜ:dl
pantyhose => 'pæntihәuz
pantywaist => 'pæntiweist
panzer => 'pæntsә
panzers => 'pænzə
Paolo => 'pɑ:ɔ:lɔ:
pap => pæp
papa => pә'pɑ:
papacy => 'peipәsi
Papago => ,pæpә'^әu
papain => pә'peiin, -'paiin
papal => 'peipl
papalist => 'peipәlist
paparazzi => .pɑ:pә'rɑ:tsi:
paparazzo => ˌpæpəˈrætsəʊ
papas => 'pɑ:pɑ:s
papaveraceous => pә.peivә'reiʃәs
papaverine => pә'pævәrin
papaw => 'pɑ:pɔ:
papaya => pә'paiә
papayas => pəˈpaiəz
Papeete => ,pɑ:pi'eitei
paper => 'peipә
paper bag => ˈpeipə bæɡ
paper birch => ˈpeipə bɜ:tʃ
paper chase => ˈpeipə tʃeis
paper feed => ˈpeipə fi:d
paper mulberry => ˈpeipə ˈmʌlˌberi:
paper nautilus => ˈpeipə ˈnɔ:tiləs
paper round => ˈpeipə raund
paper shop => ˈpeipə ʃɔp
paper towel => ˈpeipə ˈtauəl
paper trail => ˈpeipə treil
paper wasp => ˈpeipə wɔsp
paper-thin => 'peipә'θin
paperback => 'peipәbæk
paperbacked => 'peipәbækt
paperbacks => ˈpeipəbæks
paperbark => 'peipәbɑ:k
paperboard => 'peipbɒ:d
paperboy => 'peɪpərbɔɪ
paperclip => 'peɪpəklɪp
papered => ˈpeipəd
paperer => 'peɪpə
paperhanger => 'peipә.hæŋә
paperknife => ˈpeɪpənaɪf
paperless => 'peipәlis
papermaker => 'peipә,meikә(r)
paperweight => 'peipәweit
paperweights => ˈpeɪpəˌweɪts
paperwork => 'peipәwә:k
papery => 'peipәri
papilionaceous => pә.piliә'neiʃәs
papilla => pә'pilә
papillary => pә'pilәri
papillate => pә'pileit,'pæ-
papilloma => ,pæpi'lәumә
papillomavirus => pæpɪləʊ'mævaɪrəs
papillon => 'pæpilɒn
papillose => 'pæpilәus
papism => 'peipizәm
papist => 'peipist
papistical => pə'pɪstɪkəl
papistry => 'peipistri
papoose => pә'pu:s
papovavirus => pә'pәjvә,vaiәrәs
pappus => 'pæpәs
pappy => 'pæpi
paprika => pæ'pri:kә
Papua => 'pæpjuә
Papuan => 'pæpjuәn
papular => 'pæpjjlә(r)
papule => 'pæpju:l
papulose => pæpjʊ'ləʊs
papulous => pæp'jʊləs
papyri => pəˈpaɪri:
papyrologist => ,pæpə'rɒlədʒɪst
papyrology => pəpɪ'rɒlədʒɪ
papyrus => pә'paiәrәs
par => pɑ:
par avion => pɑ:r æ'vjɔŋ
par excellence => pɑ:r eksә'lɔŋs
par- => pær
para => 'pɑ:rә
parabasis => pә'ræbәsis
parabiosis => ,pærәbai'әusis
parable => 'pærәbl
parables => 'pærəblz
parabola => pә'ræbәlә
parabolas => pəˈræbələz
parabolic => ,pærә'bɔlik
parabolical => ,pærә'bɔlikәl
paraboloid => pә'ræbәlɒid
paraboloidal => pəræ'bəlɔɪdl
paracentesis => ,pærәsәn'ti:sis
parachronism => pә'rækrәnizәm
parachute => 'pærәʃu:t
parachuted => ˈpærəʃu:tid
parachutes => 'pærə,ʃʊt
parachuting => 'pærəʃu:tɪŋ
parachutist => 'pærәʃu:tist
parachutists => 'pærəʃu:tɪsts
paraclinical => ˌpærəˈklɪnɪkl
paracrystal => ,pærә'kristәl
parade => pә'reid
parade ground => pəˈreid ɡraund
paraded => pəˈreidid
parader => pә'reidә
parades => pə'reidz
paradiddle => 'pærәdidl
paradigm => 'pærәdaim
paradigm shift => ˈpærəˌdaɪm ʃift
paradigmatic => .pærәdig'mætik
paradigms => ˈpærəˌdaɪmz
parading => pəˈreidɪŋ
paradisal => ,pærә'daisәl,-zәl,'pærәd-
paradise => 'pærәdais
paradisiacal => ,pærә'disiæk, ,pærәdi'saiәkәl
parador => ,pɑ:rɑ:'ðɔ:(r)
parados => 'pærәdɒs
paradox => 'pærәdɒks
paradoxes => 'pærədɒksɪz
paradoxical => .pærә'dɒksikl
paradrop => 'pærәdrɒp
paradropper => ,pærә'drɔpә
paraesthesia => ,pæres'θi:zjә
paraffin => 'pærәfin
parafoil => 'pærәfɔil
paragenesis => ,pærә'dʒenisis
paragenetic => ,pærәdʒi'netik
paraglide => pærɑ:ɡ'laɪd
paraglider => 'pærә,^laidә
paragon => 'pærәgәn
paragons => ˈpærəˌgɔnz
paragraph => 'pærәgrɑ:f
paragraphic => .pærә'græfik
Paraguay => 'pærәgwai
Paraguayan => ,pærә'^waiәn, -'^wei-
parainfluenza => ,pærә,influ'enzә
parakeet => 'pærәki:t
parakeets => ˈpærəˌki:ts
paralanguage => ,pærә'læŋ^widʒ
paraldehyde => pә'rældi,haid
paralegal => ,pærә'li:^әl,'pærәl-
paralinguistics => .pærәliŋ'gwistiks
paralipomena => ,pærәli'pɔminә
paralipsis => ,pærә'lipsis
parallactic => 'pærәlæktik
parallax => 'pærәlæks
parallel => 'pærәlel
parallel bars => ˈpærəlel bɑ:z
parallel ruler => ˈpærəlel ˈru:lə
parallel turn => ˈpærəlel tə:n
paralleled => 'pærəˌleld
parallelepiped => .pærәle'lepiped
paralleling => lelɪŋ
parallelism => 'pærәlelizm
parallelistic => ,pærəle'listik
parallelize => 'pærәlelaiz
parallelled => ˈpærəleld
parallelogram => .pærә'lelәgræm
parallelograms => ˌpærəˈleləˌgræmz
parallels => 'pærәlels
paralogism => pә'rælәdʒizm
paralogy => pә'rælәdʒi
Paralympic => pærəˈlɪmpɪk
Paralympics => .pærә'limpiks
paralyse => 'pærәlais
paralysing => 'pærəlaɪzɪŋ
paralysis => pә'rælisis
paralytic => .pærә'litik
paralyze => 'pærәlaiz
paralyzes => ˈpærəˌlaɪziz
paralyzing => ˈpærəˌlaɪzɪŋ
paramagnetic => .pærәmæg'netik
paramagnetism => .pærә'mægnitizm
Paramaribo => ,pærә'mæribәj
paramatta => .pærә'mætә
paramecium => .pærә'mi:siәm
paramedic => 'pærәmedik
paramedical => ,pærә'medikәl
paramedics => pærə'medɪks
parameter => pә'ræmitә
parameterize => pә'ræmitәraiz
parametric => ,pærә'metrik
paramilitaries => ˌpærəˈmɪlɪˌteri:z
paramilitary => .pærә'militәri
paramnesia => ,pæræm'ni:ziә
paramo => 'pærәmәu
paramoecium => ,pærә'mi:siәm
paramos => 'pærәmɔs
paramount => 'pærәmaunt
paramountcy => 'pærәmauntsi
paramour => 'pærә.muә
paramours => ˈpærəmuəz
paramyxovirus => ,pærә,miksә'vaiәrәs
parang => 'pɑ:rɑ:ŋ
paranoia => .pærә'nɒiә
paranoiac => pærә'nɒiæk
paranoiacs => ,pærə'nɔiæk
paranoid => 'pærәnɔid
paranoids => ˈpærəˌnɔɪdz
paranormal => .pærә'nɒ:mәl
paraparesis => ,pærәpә'ri:sis
parapet => 'pærәpit
parapeted => 'pærәpitid,-pet-
parapets => ˈpærəpits
paraph => 'pærәf
parapharyngeal => pærəfə'rɪndʒi:əl
paraphasia => .pærә'feiziә
paraphernalia => .pærәfә'neiliә
paraphilia => ,pærә'filiә
paraphrasable => 'pærə,freɪzəbl
paraphrase => 'pærәfreiz
paraphrased => ˈpærəˌfreɪzd
paraphrases => ˈpærəˌfreɪziz
paraphrastic => .pærә'fræstik
paraphysis => pә'ræfisis
paraplegia => .pærә'pli:dʒiә
paraplegic => .pærә'pli:dʒik
parapodial => ,pærə'pəudiəl
parapodium => ,pærә'pәudiәm
paraprofessional => .pærәprә'feʃәnl
paraprotein => ,pærә'prәuti:n
parapsychological => ,pærə,saikə'lɔdʒikəl
parapsychology => .pærәsai'kɒlәdʒi
paraquat => 'pærә,kwæt
paras => ˈpærəz
parasail => 'pærәseil
parasailing => 'pærә,seiliŋ
parascending => ˈpærəsendɪŋ
paraselene => .pærәsi'li:ni
parasite => 'pærәsait
parasitic => ,pærә'sitik
parasitical => ,pærә'sitikәl
parasiticide => .pærә'sitisaid
parasitism => 'pærәsaitizәm
parasitize => 'pærәsaitaiz
parasitoid => ,pærә'saitɔid
parasitologist => ,pærәsai'tɔlәdʒist
parasitology => .pærәsai'tɒlәdʒi
parasol => 'pærәsɒl
parasols => ˈpærəˌsɔ:lz
paraspinal => pæ'rɑ:spɪnl
parastatal => ,pærә'steitәl
parastichy => pә'ræstiki
parasuicide => pærəz'ju:ɪsaɪd
parasympathetic => ,pærә,simpә'θetik
parasynthesis => .pærә'sinθisis
parasynthetic => ,pærəsin'θetik
paratactic => .pærә'tæktik
parataxis => .pærә'tæksis
parathion => ,pærә'θaiɔn
parathormone => ,pærә'θɔ:mәun
parathyroid => .pærә'θairɒid
paratroop => 'pærәtru:p
paratrooper => 'pærәtru:pә
paratroopers => ˈpærətru:pəz
paratroops => 'pærәtru:ps
paratuberculosis => ,pærәtju,bә:kju'lәusis
paratyphoid => .pærә'taifɒid
paravane => 'pærәvein
paraventricular => pɑ:rəvent'rɪkjʊlə
parawing => 'pærәwiŋ
paraxial => pæ'ræksiәl
parboil => 'pɑ:bɒil
parboiling => 'pɑ:bɔɪlɪŋ
parbuckle => 'pɑ:bʌkl
Parcae => 'pɑ:si:
parcel => 'pɑ:sl
parcel bomb => ˈpɑ:səl bɔm
parcels => ˈpɑ:səlz
parch => pɑ:tʃ
parched => pɑ:tʃt
parches => pɑ:tʃiz
parching => 'pɑ:tʃiŋ
parchment => 'pɑ:tʃmәnt
parchments => ˈpɑ:tʃmənts
parclose => 'pɑ:klәuz
pard => pɑ:d
pardner => 'pɑ:dnә
pardon => 'pɑ:dn
pardonable => 'pɑ:dnәbl
pardonably => 'pɑ:dnəblɪ
pardoned => ˈpɑ:dənd
pardoner => 'pɑ:dәnә(r)
pardoning => ˈpɑ:dənɪŋ
pardons => ˈpɑ:dənz
pare => pєә
pared => peəd
paregoric => .pærә'gɒ:rik
parenchyma => pә'reŋkimә
parenchymal => ,pæreŋ'kimətəs
parent => 'perәnt
parent-teacher association => ˈpɛrənt ˈtitʃɚ əˌsosiˈeʃən
parentage => 'perәntidʒ
parental => pә'rentәl
parentally => 'pərentəlɪ
parenteral => pæ'rentәrәl
parentheses => pә'renθisi:s
parenthesis => pә'renθisis
parenthesize => pә'renθisaiz
parenthetic => ,pærәn'θetik
parenthetical => ,pærәn'θetikәl
parenthetically => ˌpærən'θetɪklɪ
parenthood => 'perәnthud
parenting => 'pεәrәntiŋ
parentless => 'peәrәntlis
parergon => pæ'rә:gɒn
pares => peəz
paresis => 'pærisis
paresthesia => ,pæris'θi:ʒiә
paretic => pә'retik
pareu => 'pɑ:rei,u:
pareve => 'pɑ:rivә, -ve
parfait => pɑ:'fei
parfleche => 'pɑ:,fleʃ, pɑ:'fleʃ
parget => 'pɑ:dʒit
pargeted => ˈpɑ:dʒitid
Pargeter => 'pɑːdʒɪt
pargeting => 'pɑ:dʒɪtɪŋ
parhelion => pɑ:'hi:ljәn
pari-mutuel => ,pæri'mju:tjuәl
pariah => pә'raiә
pariah dog => pəˈraɪə dɔɡ
pariahs => pəˈraɪəz
Parian => 'pєәriәn
parietal => pә'raiitәl
parietal bone => pəˈraiətəl bəun
parietal cell => pəˈraiətəl sel
parietal lobe => pəˈraiətəl ləʊb
paring => 'pєәriŋ
parings => ˈpeərɪŋz
Paris => 'pæris
parish => 'pæriʃ
parish clerk => ˈpærɪʃ klɑ:k
parish council => ˈpærɪʃ ˈkaunsl
parishes => ˈpærɪʃiz
parishioner => pә'riʃәnә
parishioners => pəˈriʃənəz
Parisian => pә'rizjәn
parisians => pəˈrizjənz
Parisienne => pәrizi'en
parison => 'pærisәn
parity => 'pærәti
park => pɑ:k
parka => 'pɑ:kә
parkade => pɑ:ˈkeɪd
parkas => ˈpɑ:kəz
parker => 'pɑ:kә
parkerizing => 'pɑ:kәraiziŋ
Parkin => 'pɑ:kin
parking => 'pɑ:kiŋ
parking garage => ˈpɑ:kɪŋ ˈɡærɑ:ʒ
parking lot => 'pɑ:kiŋ
parkinson => 'pɑ:kinsәn
Parkinson's disease => 'pɑ:kins(ә)nz
parkland => 'pɑ:k.lænd
parkway => 'pɑ:kwei
parkways => ˈpɑ:kˌweɪz
parky => 'pɑ:ki
parlance => 'pɑ:lәns
parlando => pɑ:'lɑ:ndәu
parlay => 'pɑ:li
parlayed => ˈpɑ:lid
parlaying => ˈpɑ:liŋ
parlays => ˈpɑ:liz
parlement => 'pɑ:lәmәnt
parley => 'pɑ:li
parleyed => 'pɑːlɪ
parleying => 'pɑːlɪ
parleys => ˈpɑ:li:z
parliament => 'pɑ:lәmәnt
parliamentarian => 'pɑ:lәmen'teәriәn
parliamentarians => ˈpɑ:ləmenˈteəriənz
parliamentary => .pɑ:lә'mentәri
parliaments => ˈpɑ:ləmənts
parlor => 'pɑ:lә
parlor car => ˈpɑ:lə kɑ:
parlors => ˈpɑ:ləz
parlour => 'pɑ:lә
parlour game => ˈpɑ:lə ɡeim
parlourmaid => ˈpɑːləmeɪd
parlours => ˈpɑ:ləz
parlous => 'pɑ:lәs
Parma => 'pɑ:mә
Parmenides => pɑ:'menidi:z
Parmentier => 'pɑ:mәn,tjei,pɑ:rmɔŋ'tje
Parmesan => 'pɑ:mizæn
Parnassian => pɑ:'næsiәn
Parnassus => pɑ:'næsәs
Parnell => pɑ:'nel
parochial => pә'rәukiәl
parochial school => pəˈrəʊki:əl sku:l
parochialism => pә'rәjkiәlizәm
parodic => pə'rɔdik
parodied => ˈpærədi:d
parodies => ˈpærədi:z
parodist => 'pærәdist
parodists => 'pærədɪst
parody => 'pærәdi
parodying => ˈpærədi:ɪŋ
parol => pә'rәul
parole => pә'rәul
paroled => pəˈrəʊld
parolee => pә,rәu'li:
paroles => pəˈrəʊlz
paroling => pəˈrəʊlɪŋ
paronomasia => .pærәnәu'meiʒiә
paronym => 'pærәnim
paronymous => pә'rɔnimәs
paronymy => pə'rɒnəmɪ
Paros => 'peәrɔs
parotid => pә'rɒtid
parotid gland => pəˈrɔtid ɡlænd
parotitis => .pærә'taitis
Parousia => ,pɑ:ru:'siә, pә'ru:ziә
paroxysm => 'pærәksizәm
paroxysmal => ,pærәk'sizmәl
paroxysms => ˈpærəkˌsɪzəmz
paroxytone => pæ'rɒksitәun
parpen => 'pɑ:pәn
parquet => pɑ:'kei
parquetry => 'pɑ:kitri
parr => pɑ:
parrakeet => 'pærәki:t
parramatta => ,pærә'mætә
parred => pɑ:d
parricidal => .pæri'saidl
parricide => 'pærisaid
parricides => 'pærɪsaɪd
parried => ˈpæri:d
parries => ˈpæri:z
parring => pɑ:ɪŋ
parrish => 'pæriʃ
parrot => 'pærәt
parrot-fashion => ˈpærət ˈfæʃən
parroted => ˈpærətid
parrotfish => 'pærәtfiʃ
parroting => ˈpærətɪŋ
parrotlet => 'pærәtlit, -let
parrots => ˈpærəts
parry => 'pæri
parrying => ˈpæri:ɪŋ
pars => pɑ:z
parse => pɑ:s
parsec => 'pɑ:sek
parsed => pɑ:st
Parsee => pɑ:'si:, 'pɑ:'si:
parser => 'pɑ:sә
parses => pɑ:siz
Parsifal => 'pɑ:sifәl,-fɑ:l
parsimonious => ,pɑ:si'mәunjәs, -niәs
parsimoniously => paːsiˊmounjәsli
parsimony => 'pɑ:simәni
parsing => 'pɑ:ziŋ
parsley => 'pɑ:sli
parsnip => 'pɑ:snip
parsnips => ˈpɑ:snips
parson => 'pɑ:sn
parson's nose => ˈpɑ:sənz
parsonage => pɑ:snidʒ
parsonages => pɑ:snidʒz
parsonic => pɑ:'sɒnik
part => pɑ:t
part exchange => pɑ:t iksˈtʃeindʒ
part of speech => pɑ:t ɔv spi:tʃ
part with => pɑ:t wið
part-exchange => pɑ:t iksˈtʃeindʒ
partake => pɑ:'teik
partaker => pɑ:'teikә
partakes => pɑ:ˈteɪks
partaking => pɑ:ˈteɪkɪŋ
parted => 'pɑ:tid
parterre => pɑ:'teә
parthenocarpy => 'pɑ:θinәu,kɑ:pi
parthenogenesis => ,pɑ:θinәu'dʒenisis
parthenogenetic => ,pɑ:θinәjdʒi'netik
Parthenon => 'pɑ:θinәn
parthenote => pɑ:θɪ'nəʊt
Parthia => 'pɑ:θiә
Parthian => 'pɑ:θiәn
Parthian shot => 'pɑ:θiәn
parti => pɑ:'ti:
parti pris => par'ti:'pri:
partial => 'pɑ:ʃәl
partial fraction => ˈpɑ:ʃəl ˈfrækʃən
partiality => .pɑ:ʃi'æliti
partially => 'pɑ:ʃәli
partials => 'pɑ:ʃәlz
partibility => ,pɑ:ti'biliti
partible => 'pɑ:tibl
participant => pɑ:'tisipәnt
participants => pɑ:'tɪsɪpənts
participate => pɑ:'tisipeit
participated => pɑ:ˈtisipeitid
participates => pɑ:ˈtisipeits
participation => .pɑ:tisi'peiʃәn
participations => pɑː,tɪsɪ'peɪʃn
participative => pɑ:'tɪsɪpeɪtɪv
participator => pɑ:'tisipeitә
participatory => pɑ:'tisipeitәri
participial => pɑ:ti'sipiәl
participially => pɑ:'tɪsɪpɪəlɪ
participle => 'pɑ:tisipl
participles => ˈpɑ:tɪˌsɪpəlz
particle => 'pɑ:tikl
particle board => ˈpɑ:tikl bɔ:d
particle physics => ˈpɑ:tikl ˈfiziks
particleboard => 'pɑ:tɪklbɔ:d
particular => pә'tikjulә
particularism => pә'tikjulәrizәm
particularist => -rist
particularities => pəˌtikjuˈlæritiz
particularity => pә.tikju'læriti
particularization => pətɪkju:ləraɪ'zeɪʃən
particularize => pә'tikjulәraiz
particularized => pəˈtɪkjələˌraɪzd
particularizes => pəˈtɪkjələˌraɪziz
particularizing => pəˈtɪkjələˌraɪzɪŋ
particularly => pә'tikjjlәli
particulate => pә'tikjulit
particulates => pe'tɪkjələts
partied => 'pɑ:rtaɪd
parting => 'pɑ:tiŋ
parting shot => ˈpɑ:tɪŋ ʃɔt
partisan => 'pɑ:tizn
partisans => ˌpɑ:tiˈzænz
partisanship => 'pɑ:tәznʃip
partita => pɑ:'ti:tә
partite => 'pɑ:tait
partition => pɑ:'tiʃәn
partitioner => pɑ:'tɪʃnər
partitionist => pɑ:'tiʃәnist,pә-
partitive => 'pɑ:titiv
partly => 'pɑ:tli
partner => 'pɑ:tnә
partnering => ˈpɑ:tnərɪŋ
partnership => 'pɑ:tnәʃip
partnerships => ˈpɑ:tnəʃips
Parton => 'pɑ:tɔn
partridge => 'pɑ:tridʒ
partridgeberry => 'pɑ:tridʒbәri
partridges => ˈpɑ:trɪdʒz
parts => pɑ:ts
parturient => pɑ:'tjuriәnt
parturition => .pɑ:tjuә'riʃәn
partway => 'pɑ:t'wei
party => 'pɑ:ti
party piece => ˈpɑ:ti pi:s
party political => ˈpɑ:ti pəˈlitikəl
party politics => ˈpɑ:ti ˈpɔlitiks
party pooper => ˈpɑ:ti ˈpu:pə
party wall => ˈpɑ:ti wɔ:l
party-pooper => ˈpɑ:ti pu:pə(r)
partyer => 'pɑːtɪ
partygoer => 'pɑ:ti,^әjә(r)
partying => 'pɑ:ti:ɪŋ
parure => pә'ruә
parvenu => 'pɑ:vәnju:
parvenus => ˈpɑ:vəˌnu:z
parvis => 'pɑ:vis
parvovirus => ,pɑ:vә'vaiәrәs
pas => pɑ:
pas de deux => ˌpɑ: də ˈdɜ:
pas de quatre => 'pɑ:də'kɑ:trə
pas de trois => ˈpɑ:dəˈtrwɑ:
pas seul => ˈpɑ:sə:l
Pasadena => ,pæsə'di:nə
PASCAL => 'pæskәl
paschal => 'pæskәl
paseo => pɑ:'seiәu
pash => pæʃ
pasha => 'pɑ:ʃә
pashka => 'pæʃkә
pashm => 'pæʃәm
pashmina => pæʃˈmi:nə
Pashto => 'pʌʃtәu
pasquinade => .pæskwi'neid
pass => pæs
pass key => pɑ:s ki:
passable => 'pæsәbl
passably => 'pɑ:sәbli;'pæs-
passacaglia => pɑ:sә'kɑ:ljә, pæs-
passade => pә'seid
passage => 'pæsidʒ
passageway => 'pæsidʒwei
passageways => 'pæsɪdʒweɪz
passant => 'pæsәnt
passband => 'pɑ:sbænd
passbook => 'pæsbuk
passed => pɑ:st
passed pawn => pɑ:st pɔ:n
passel => 'pæsәl
passementerie => pas'mәtri:
passenger => 'pæsindʒә
passenger pigeon => ˈpæsindʒə ˈpidʒin
passenger seat => ˈpæsindʒə si:t
passengers => 'pæsndʒɚ
passepied => pɑ:s'pjei
passer => 'pæsә
passer-by => 'pɑ:sə baɪ
passerby => 'pæsә'bai
passerine => 'pæsәrain
passers => 'pɑːsə
passible => 'pæsibl
passim => 'pæsim
passing => 'pæsiŋ
passingly => 'pæsiŋli
passion => 'pæʃәn
passion fruit => ˈpæʃən fru:t
passion play => ˈpæʃən plei
passional => 'pæʃәnәl
passionate => 'pæʃәnit
passionately => 'pæʃənətlɪ
passionflower => 'pæʃәnflauә
passionless => 'pæʃәnlis
passions => 'pæʃnz
Passiontide => 'pæʃәntaid
passivate => 'pæsiveit
passivation => .pæsi'veiʃәn
passive => 'pæsiv
passive smoking => ˈpæsiv ˈsməʊkɪŋ
passive voice => ˈpæsiv vɔis
passiveness => 'pæsɪvnɪs
passivity => pæ'siviti
passivize => ˈpæsɪvaɪz
passkey => 'pæski:
Passover => 'pæs.әuvә
passport => 'pæspɒ:t
passports => 'pa:spɔ:ts
passus => 'pæsәs
password => 'pæswә:d
past => pɑ:st
past it => pɑ:st it
past perfect => pɑ:st ˈpə:fikt
pasta => 'pæstә
pastas => ˈpɑ:stəz
paste => peist
paste-up => 'peɪst'ʌp
pasteboard => 'peistbɒ:d
pastel => pæ'stel
pastellist => pæs'telɪst
pastels => pæˈstelz
pastern => 'pæstәn
Pasternak => 'pæstәnæk
pastes => peists
pasteur => pæs'tә:
pasteurellosis => ,pæstәrә'lәusis
pasteurised => 'pæstəraɪzd
pasteurization => ,pæstәrai'zeiʃәn
pasteurize => 'pæstәraiz
pasteurized => ˈpɑ:stəraɪzd
pasteurizer => 'pæstәraizә
pasteurizes => ˈpæstʃəˌraɪziz
pasteurizing => ˈpæstʃəˌraɪzɪŋ
pasticcio => pæs'titʃәu
pastiche => pæs'ti:ʃ
pastie => 'pæsti
pasties => ˈpæsti:z
pastille => 'pæstil, pæs'ti:l
pastilles => ˈpæstilz
pastime => 'pæstaim
pastimes => ˈpɑ:staimz
pastiness => 'peistinis
pasting => 'peistiŋ
pastis => pɑ:s'ti:s
pastness => 'pɑ:stnis
pastor => 'pæstә
pastoral => 'pæstәrәl
pastorale => .pæstә'rɑ:li
pastoralism => 'pæstәrәlizm
pastorally => 'pæstәrәli
pastorate => 'pæstәrәt
pastors => ˈpæstəz
pastorship => 'pæstәʃip
pastrami => pә'strɑ:mi
pastry => 'peistri
pastry cook => ˈpeistri kuk
pasturage => 'pæstʃәridʒ
pasture => 'pæstʃә
pastureland => 'pɑ:stʃәlænd;'pæs-
pastures => ˈpɑ:stʃəz
pasturing => 'pɑ:stʃərɪŋ
pasty => 'peisti. 'pæsti
pat => pæt
pat-a-cake => 'pæt'eɪk'eɪk
pataca => pә'tɑ:kә
patagium => pә'teidʒiәm
Patagonia => ,pætә'^әjniә,-njә
Patagonian => .pætә'gәunjәn
pataphysics => ,pætә'fiziks
patch => pætʃ
patch test => pætʃ test
patchboard => 'pætʃbɔ:d
patchier => 'pætʃi
patchiest => 'pætʃi
patchily => 'pætʃəlɪ
patchiness => 'pætʃɪnəs
patching => 'pætʃiŋ
patchouli => 'pætʃuli(:)
patchwork => 'pætʃwә:k
patchworks => 'pætʃwɜːk
patchy => 'pætʃi
pate => peit
patella => pә'telә
patellar => pә'telә
patellate => pә'telit
paten => 'pætn
patency => 'peitnsi
patent => 'pætnt. 'peitnt
patent log => ˈpeitənt lɔɡ
patented => 'peitәntid
patentee => .peitn'ti:
patenting => 'peitәntiŋ
patently => 'peitntli
pater => 'peitә
patera => 'pætәrә
paterfamilias => .peitәfә'miliæs
paternal => pә'tә:nl
paternalism => pә'tә:nәlizm
paternalistic => pә.tә:nә'listik
paternalistically => pətɜ:nə'lɪstɪklɪ
paternally => pә'tә:nәli
paternity => pә'tә:niti
paternity test => pəˈtɜ:nɪti: test
paternoster => .pætә'nɒstә
Paterson => 'pætәsәn
pates => peɪts
path => pɑ:θ
Pathan => pә'tɑ:n
pathetic => pә'θetik
pathetic fallacy => pəˈθetik ˈfæləsi:
pathetically => pә'θetikli
pathfinder => 'pɑ:θfaindә(r)
pathfinders => ˈpɑ:θfaindəz
pathless => 'pæθlis
patho- => 'pæθәj
pathogen => 'pæθәdʒ(ә)n
pathogenesis => ,pæθә'dʒenisis
pathogenetic => ,pæθәdʒi'netik
pathogenic => .pæθә'dʒenik
pathogenicity => ,pæθәdʒi'nisiti
pathogens => 'pæθәdʒәns
pathognomonic => pә,θɔnә'mɔnik
pathography => pә'θɔ^rәfi
pathologic => ,pæθә'lɔdʒik
pathological => ,pæθә'lɔdʒikәl
pathologically => ˌpæθə'lɒdʒɪklɪ
pathologies => pæˈθɔlədʒi:z
pathologist => pæ'θɒlәdʒist
pathologists => pə'θɒlədʒɪsts
pathology => pæ'θɒlәdʒi
pathophysiologic => ,pæθәfiziә'lɔdʒik
pathophysiology => 'pæθәj,fizi'ɔlәdʒi
pathos => 'peiθɒs
pathway => 'pɑ:θwei
pathways => ˈpɑ:θweiz
patience => 'peiʃәns
patient => 'peiʃәnt
patiently => 'peiʃәntli
patina => 'pætinә
patinated => pætɪ'nətɪd
patio => 'pɑ:tiәu
patio door => ˈpæti:ˌəʊ dɔ:
patios => ˈpæti:ˌəʊz
patisserie => pә'ti:sәri
patissier => ˌpɑ:tisˈjei
Patna => 'pætnә,'pʌt'nɑ:
patois => 'pætwɑ:
Patras => pә'træs,'pætrәs
patresfamilias => ,pɑ:treizfә'miliæs,,peitri:z-
patri- => 'pætri,'pei-
patrial => 'peɪtrɪəl
patriarch => 'peitriɑ:k
patriarchal => .peitri'ɑ:kәl
patriarchate => 'peitriɑ:kәt
patriarchs => ˈpeɪtri:ˌɑ:ks
patriarchy => 'peitriɑ:ki
patriate => 'peitrieit
Patrice => pə'tri:s
patricia => pә'triʃә
patrician => pә'triʃәn
patricians => pət'rɪʃnz
patriciate => pә'triʃiәt
patricidal => .pætri'saidәl
patricide => 'pætrisaid
patrick => 'pætrik
patrilateral => ,pætri'lætәrәl, ,pei-
patrilineage => ,pætri'liniidʒ, ,pei-
patrilineal => .pætri'liniәl
patrilocal => ,pætri'lәjkәl, ,pei-
patrimonial => .pætri'mәuniәl
patrimonies => ˈpætriməniz
patrimony => 'pætrimәni
patriot => 'peitriәt
patriotic => .peitri'ɒtik
patriotically => ˌpeɪtriˈɒtɪkli
patriotism => 'peitriәtizm
patriots => ˈpeitriəts
patristic => pә'tristik
patristics => pә'tristiks
Patroclus => pә'trɔklәs
patrol => pә'trәul
patrol car => pəˈtrəul kɑ:
patrolman => pә'trәulmәn
patrolmen => pə'trəulmən
patron => 'peitrәn
patronage => 'pætrәnidʒ
patronal => pә'trәunl, pæ't-
patroness => 'peitrәnis
patronise => 'pætrәnaiz, 'pei-
patronised => 'peɪtrənaɪz
patronising => 'peɪtrənaɪz
patronization => ,pætrənɪ'zeʃən
patronize => 'peitrәnaiz
patronized => ˈpætrənaizd
patronizes => ˈpætrənaiziz
patronizing => 'peitrәnaiziŋ
patronizingly => ,pætrə'naiziŋli
patronne => patrɔn
patrons => ˈpeitrənz
patronymic => .pætrә'nimik
patroon => pә'tru:n
patsies => ˈpætsiz
patsy => 'pætsi
patted => pætid
patten => 'pætn
patter => 'pætә
pattered => ˈpætəd
pattering => ˈpætərɪŋ
pattern => 'pætәn
patterning => 'pætәniŋ
patters => ˈpætəz
pattie => 'pæti
patties => 'pættaɪz
patting => pætɪŋ
Pattison => 'pætisn
patty => 'pæti
pattypan => 'pætipæn
patulous => 'pætjulәs
patzer => 'pɑ:tsә(r), 'pæt-
pau => pәj
paucity => 'pɒ:sәti
paul => pɔ:l
paula => 'pɔ:lә
Paulette => pɔ:'let
Pauline => 'pɒ:lain
paulownia => pɒ:'lәuniә
paunch => pɒ:ntʃ
paunches => pɔ:ntʃiz
paunchy => 'pɒ:ntʃi
pauper => 'pɒ:pә
pauperdom => 'pɔ:pәdәm
pauperism => 'pɔ:pәrizәm
pauperization => .pɒ:pәrai'zeiʃәn
pauperize => 'pɒ:pәraiz
paupers => ˈpɔ:pəz
paupiette => pәj'pjet
pause => pɒ:z
paused => pɔ:zd
pauses => pɔ:ziz
pavage => 'peividʒ
pavane => pә'vɑ:n
pave => peiv
paved => peivd
pavement => 'peivmәnt
pavement artist => ˈpeɪvmənt ˈɑ:tist
pavements => 'peɪvmənts
paver => 'peivә
paves => peivz
Pavia => pə'vi:ə
pavilion => pә'viljәn
pavilions => pəˈvɪljənz
paving => 'peiviŋ
paving stone => ˈpeiviŋ stəun
paviour => 'peivjә
pavlov => 'pɑ:vlɔf
Pavlova => pæv'ləuvə
Pavlovian => pæv'lɔ:vi:ən
Pavo => 'peivәu
pavonine => 'pævәnain
paw => pɒ:
pawky => 'pɒ:ki
pawl => pɒ:l
pawn => pɒ:n
pawnbroker => 'pɒ:nbrәukә
pawnbrokers => ˈpɔ:nˌbrəʊkəz
pawnbroking => 'pɒ:nbrәukiŋ
pawned => pɔ:nd
pawns => pɔ:nz
pawnshop => 'pɒ:nʃɒp
pawpaw => 'pɔ:pɔ:
pawpaws => ˈpɔ:pɔ:z
pay => pei
pay cheque => ˈpeɪtʃek
pay-off => pei ɔf
pay-per-view => ˈpeɪpəˌvju:
payable => 'peiәbl
paycheck => 'pei'tʃek
paydirt => peɪ'dɜ:t
payee => pei'i:
payees => peɪˈi:z
payer => 'peiә
payers => ˈpeɪəz
paying => 'peiiŋ
paying guest => ˈpeiiŋ ɡest
payload => 'peilәud
payloads => 'peɪləʊdz
paymaster => 'pei,mɑ:stә
paymasters => ˈpeiˌmɑ:stəz
payment => 'peimәnt
payne => pein
paynim => 'peinim
payoff => 'peiɒf
payoffs => 'peɪɔ:fz
payola => pei'әulә
payor => 'peiә(r), pei'ɔ:(r)
payout => 'pei'aut
payphone => ˈpeɪfəʊn
payroll => 'peirәul
payrolls => ˈpeirəulz
paysage => pei'zɑ:ʒ
payslip => 'peislip
payslips => ˈpeislips
pcp => ,pi:si:'pi:
PE => pei
pea => pi:
pea bean => pi: bi:n
pea crab => pi: kræb
pea flour => pi: ˈflauə
pea green => pi: ɡri:n
pea jacket => pi: ˈdʒækit
pea soup => pi: su:p
pea tree => pi: tri:
pea-brained => piː breɪnd
pea-soupers => 'pi:,su:pə
peaberry => 'pi:beri
peabody => 'pi:bɔdi
peace => pi:s
peace dividend => pi:s ˈdividend
peace march => pi:s mɑ:tʃ
peace offering => pi:s ˈɔ:fərɪŋ
peace pipe => pi:s paip
peaceable => 'pi:sәbl
peaceably => 'pi:səblɪ
peaceful => 'pi:sful
peacefulness => 'pi:sflnəs
peacekeeper => 'pi:s,ki:pә(r)
peacekeepers => 'pi:ski:pəz
peacekeeping => 'pi:s,ki:piŋ
peacemaker => 'pi:smeikә
peacemakers => ˈpi:sˌmeɪkəz
peacemaking => 'pi:s,meikiŋ
peacenik => 'pi:snik
peacetime => 'pi:staim
peach => pi:tʃ
peaches => pi:tʃiz
peachick => 'pi:tʃik
peachy => 'pi:tʃi
peacoat => 'pi:kәjt
peacock => 'pi:kɒk
peacock butterfly => ˈpi:ˌkɔk ˈbʌtəflai
peacock ore => ˈpi:ˌkɔk ɔ:
peacocks => ˈpi:ˌkɔks
peafowl => 'pi:faul
peahen => 'pi:hen
peak => pi:k
peak-to-peak => 'pi:kt'əp'i:k
peaked => pi:kt
peaking => 'pi:kiŋ
peaky => 'pi:ki
peal => pi:l
pealed => pi:ld
pealing => pi:lɪŋ
peals => pi:lz
pean => 'pi:әn
peanut => 'pi:nʌt
peanut butter => ˈpi:nʌt ˈbʌtə
pear => pєә
pearl => pә:l
pearl ash => pə:l æʃ
pearl millet => pə:l ˈmɪlɪt
pearl oyster => pə:l ˈɔistə
pearled => pәld
pearlescent => pә:'lesnt
pearlfish => 'pɜ:lfɪʃ
pearling => 'pә:liŋ
pearlite => 'pә:lait
pearlized => 'pә:laizd
pearls => pɜːlz
pearlwort => 'pә:lwә:t
pearly => 'pә:li
pearly everlasting => ˈpɜ:li: ˌevəˈlɑ:stiŋ
pearly king => ˈpɜ:li: kiŋ
pearly nautilus => ˈpɜ:li: ˈnɔ:tiləs
pearson => 'piәsn
peart => pә:t
peasant => 'peznt
peasantry => 'pezntri
peasants => 'pesnts
pease => pi:z
pease pudding => ˌpi:z ˈpʊdɪŋ
peashooter => 'pi:ʃɒtә
peashooters => 'piː,ʃuːtə
peat => pi:t
peat moss => pi:t mɔs
peatland => 'pi:tlænd
peaty => 'pi:ti
peavey => 'pi:vi
peavine => 'pevaɪn
pebble => 'pebl
pebbledash => 'peblˌdæʃ
pebbly => 'pebli
pecan => pi'kæn
pecans => pɪˈkɑ:nz
peccability => .pekә'biliti
peccable => 'pekәbl
peccadillo => .pekә'dilәu
peccadillos => ˌpekəˈdɪləʊz
peccancy => 'pekәnsi
peccant => 'pekәnt
peccaries => 'pek(ə)rɪ
peccary => 'pekәri
peccavi => pe'kɑ:vi:
Pechora => pe'tʃɔ:rɑ:
peck => pek
peck at => pek æt
pecked => pekt
pecker => 'pekә
peckerhead => 'pekәhed
peckers => ˈpekəz
peckerwood => 'pekәwud
pecking => pekɪŋ
pecking order => ˈpekɪŋ
peckish => 'pekiʃ
pecks => peks
pecorino => ,pekә'ri:nәj
pecs => peks
pecten => 'pektәn
pectic => 'pektik
pectin => 'pektin
pectinate => 'pektinit
pectinated => 'pektinitid
pectination => .pekti'neiʃәn
pectoral => 'pektәrәl
pectoral cross => ˈpektərəl krɔs
pectoral fin => ˈpektərəl fin
pectoral girdle => ˈpektərəl ˈgɜ:dl
pectoral muscle => ˈpektərəl ˈmʌsl
pectorals => 'pektərəlz
peculate => 'pekjuleit
peculated => ˈpekjəˌleɪtid
peculates => ˈpekjəˌleɪts
peculating => ˈpekjəˌleɪtɪŋ
peculiar => pi'kju:ljә
peculiarities => pɪˌkju:li:ˈærɪti:z
peculiarity => pi.kju:li'æriti
peculiarly => pi'kju:liәli
pecuniarily => pɪkju:n'ɪærɪlɪ
pecuniary => pi'kju:njәri
pedagogic => .pedә'gɒdʒik
pedagogical => pedә'^ɔdʒikәl
pedagogically => ˌpedə'ɡɒdʒɪklɪ
pedagogics => pedә'^ɔdʒiks
pedagogue => 'pedәgɒg
pedagogy => 'pedәgәudʒi
pedal => 'pedl
pedal bin => ˈpedl bin
pedal pusher => ˈpedl ˈpuʃə
pedalo => 'pedәlәu
pedals => 'pedlz
pedant => 'pedәnt
pedantic => pi'dæntik
pedantically => pi'dæntikəli
pedantry => 'pedәntri
pedants => ˈpednts
peddle => 'pedl
peddled => ˈpedld
peddler => 'pedlә
peddlers => 'pedləz
peddles => ˈpedlz
peddling => 'pedliŋ
pederast => 'pedәræst, 'pi:dә-
pedes => 'pedi:z, 'pi:-
pedestal => 'pedistl
pedestals => ˈpedɪstəlz
pedestrian => pә'destriәn
pedestrian crossing => piˈdestriən ˈkrɔsiŋ
pedestrian precinct => pəˈdɛstriən ˈpriˌsɪŋkt
pedestrianised => pi'destriənaiz
pedestrianization => pi,destriənai'zeiʃən
pedestrianize => pi'destriәnaiz, pә-
pedestrians => pɪ'destrɪəns
pediatric => .pi:di'ætrik
pediatrician => ,pi:diә'triʃәn
pediatrics => .pi:di'ætriks
pedicab => 'pedikæb
pedicel => 'pedisәl, -sel
pedicellaria => ,pedisә'læriә
pedicle => 'pedikl
pediculicide => pә'dikjuli,said
pediculosis => pi.dikju'lәusis
pedicure => 'pedikjuә
pedicures => ˈpedikjuəz
pedigree => 'pedigri:
pedigreed => 'pedigri:d
pediment => 'pedimәnt
pedimental => ,pedi'mentәl
pedimented => pedɪ'mentɪd
pediments => 'pedɪm(ə)nt
pedipalp => 'pedi,pælp
pediplain => 'pedi,plein
pediplanation => ,pediplei'neiʃәn
pedlar => 'pedlә
pedlars => ˈpedləz
pedlary => 'pedlәri
pedology => pi'dɒlәdʒi
pedometer => pi'dɒmitә
pedophile => 'pi:dəʊfaɪl
pedophilia => .pi:dәu'filiә
pedro => 'pi:drәu
peduncle => ,pi'dʌŋkl
peduncular => pi'dʌŋkjulә
pedunculate => pi'dʌŋkjuleitid
pedway => 'pedweɪ
pee => pi:
pee-pee => 'pi:p'i:
Peebles => 'pi:blz
Peeblesshire => 'pi:blzʃiә(r)
peed => pi:d
peeing => pi:ɪŋ
peek => pi:k
peekaboo => 'pi:kәbu:
peeked => pi:kt
peeking => pi:kɪŋ
peeks => pi:ks
peel => pi:l
peeler => 'pi:lә
peelers => ˈpi:ləz
peeling => 'pi:liŋ
Peelite => 'pi: lait
peels => pi:lz
peen => pi:
peep => pi:p
peep sight => pi:p sait
peep-toe => pi:p təʊ
peepbo => 'pi:pbәj
peeped => pi:pt
peeper => 'pi:pә(r)
peepers => 'pi:pəz
peephole => 'pi:phәul
peepholes => ˈpi:phəulz
peeps => pi:ps
peepshow => 'pi:pʃəʊ
peepul => 'pi:pʌl
peer => piә
peerage => 'piәridʒ
peerages => ˈpɪərɪdʒz
peered => piəd
peeress => 'piәris
peeresses => ˈpiərisiz
peering => piərɪŋ
peerless => 'piәlis
peerlessly => piәlisli
peery => 'piәri
pees => pi:z
peeve => pi:v
peeved => pi:vd
peevers => 'pi:vәz
peevish => 'pi:viʃ
peevishly => 'pi:vɪʃlɪ
peevishness => 'pi:viʃnis
peewee => 'pi:wi:
peewit => 'pi:wit
peewits => 'piːwɪt
peg => peg
peg away => peɡ əˈwei
peg leg => peɡ leɡ
pegasus => 'pe^әsәs
pegboard => 'peɡbɔ:d
pegbox => 'pe^bɔks
pegged => peɡd
pegging => 'pe^iŋ
peggy => 'pe^i
pegmatite => 'pe^mәtait
pegs => peɡz
Pegu => pe'ɡu:
Pehlevi => 'peilivi:
peignoir => 'peinwɑ:
pein => pi:n
Peisistratus => pi:'sistrətəs
pejorative => 'pi:dʒәreitiv
pejoratively => pi'dʒɔrətivli
pekan => 'pekәn
pekinese => pi:ki'ni:z
pekineses => ,pi:ki'ni:z
Peking => 'pi:kiŋ
pekoe => 'pi:kәu
pelage => 'pelidʒ
pelagian => pi'leidʒiәn
pelagic => pe'lædʒik
Pelagius => pi'leidʒiəs
pelargonium => .pelә'gәuniәm
Pelasgian => pe'læzdʒiәn
pele => pi:
pelecypod => pi'lesipɔd
pelerine => .pelә'ri:n
Peleus => 'peliәs, 'pi:-
pelf => pelf
pelham => 'pelәm
pelican => 'pelikәn
pelican crossing => ˈpelɪkən ˈkrɔsiŋ
pelicans => ˈpelɪkənz
Pelion => 'piliәn
pelisse => pe'li:s
pelite => 'pi:lait
pell => pel
pell-mell => 'pel'mel
pellagra => pә'leigrә
pellagrous => pә'leigrәs
pellet => 'pelit
pelletize => 'pelitaiz
pellets => 'pelɪts
pellicle => 'pelikl
pellicular => 'pelikjulә
pellitory => 'pelitәri
pellucid => pә'lju:sid
pellucidly => pe'lu:sɪdlɪ
Pelmanism => 'pelmәnizәm
pelmet => 'pelmit
pelmets => ˈpelməts
Peloponnese => ,pelәpә'ni:s, -'ni:z
Peloponnesian => .pelәpә'ni:ʃәn
Pelops => 'pi:lɔps
pelorus => pi'lɔ:rәs
pelota => pi'lәutә
peloton => pelɔ:'tɔ:n, pelә'tɑ:n
pelt => pelt
pelta => 'peltə
peltate => 'pelteit
pelted => peltid
pelting => 'peltiŋ
peltry => 'peltri
pelts => pelts
pelvic => 'pelvik
pelvic fin => ˈpelvɪk fin
pelvic inflammatory disease => ˈpelvɪk ɪnˈflæməˌtɔ:ri: diˈzi:z
pelvimetry => pel'vimitri
pelvis => 'pelvis
pelvises => ˈpelvɪsiz
pelycosaur => 'pelikәjsɔ:(r)
Pemba => 'pembә
Pembroke => 'pembrәuk
Pembrokeshire => 'pembrjkʃiә(r), -brәjk-
pemmican => 'pemikәn
pemphigoid => 'pemfi^ɔid, pem'fai-
pemphigus => 'pemfi^әs, pem'fai-
pen => pen
pen pusher => pen ˈpuʃə
penaeid => pe'ni:ɪd
penal => 'pi:nl
penalised => 'piːnəlaɪz
penalize => 'pi:nәlaiz
penalized => ˈpi:nəlaizd
penalizes => ˈpi:nəlaiziz
penalizing => ˈpi:nəlaizɪŋ
penally => 'pi:nəlɪ
penalties => ˈpenəltiz
penalty => 'penәlti
penalty box => ˈpenəlti bɔks
penalty point => ˈpenəlti pɔint
penalty shoot-out => ˈpenəlti ʃu:t aut
penance => 'penәns
Penang => pi'næŋ
penannular => pi'nænjulә
penates => pe'nɑ:ti:s
pence => pens
penchant => 'pә:ŋʃә:ŋ
pencil => 'pensl
pencil pusher => ˈpensəl ˈpuʃə
pencil sharpener => ˈpensəl ˈʃɑ:pənə
pencil skirt => ˈpensəl skə:t
pencils => ˈpensəlz
pendant => 'pendәnt
pendants => ˈpendənts
pendency => 'pendәnsi
pendent => 'pendәnt
pendente lite => pen'denti'laiti
pendentive => pen'dentiv
pending => 'pendiŋ
pendular => 'pendjulә
pendulous => 'pendʒәlәs
pendulum => 'pendʒәlәm
pendulums => ˈpendjuləmz
penelope => pi'nelәpi, pә-
peneplain => 'pi:niplein
penetrability => .penitrә'biliti
penetrable => 'penәtrәbl
penetralia => .peni'treiljә
penetrance => 'penitrәns
penetrant => 'penitrәnt
penetrate => 'penitreit
penetrates => ˈpenitreits
penetrating => 'penitreitiŋ
penetratingly => 'penɪtreɪtɪŋlɪ
penetration => .peni'treiʃәn
penetrations => ˌpenɪˈtreɪʃənz
penetrative => 'penitreitiv
penetrator => 'penitreitә
penetrometer => peni'trɔmitә
penfriend => ˈpenfrend
penguin => 'pengwin
penguin suit => ˈpeŋɡwin sju:t
penguins => ˈpeŋɡwinz
penicillate => ,peni'sileit
penicillin => .peni'silin
penicillinase => peni'silineis
penicillium => .peni'siliәm
penile => 'pi:nail
peninsula => pi'ninsjulә
peninsular => pi'ninsjulә
peninsulas => piˈninsjuləz
penis => 'pi:nis
penis envy => ˈpi:nɪs ˈenvi
penitence => 'penitәns
penitent => 'penitәnt
penitential => .peni'tenʃәl
penitentially => .peni'tenʃәli
penitentiary => .peni'tenʃәri
penknife => 'pennaif
penlight => 'penlait
penman => 'penmәn
penmanship => 'penmәnʃip
penn => pen
penn'orth => 'penәθ
pennant => 'penәnt
pennants => ˈpenənts
pennate => 'peneit
penne => 'pennei
penned => pend
penni => 'peni
penniless => 'penilis
PENNINE => 'penain
penning => 'peniŋ
pennon => 'penәn
Pennsylvania => .pensil'veinjә
Pennsylvanian => .pensil'veinjәn
penny => 'peni
penny ante => ˈpeni ˈænti:
penny black => ˈpeni blæk
penny dreadful => ˈpeni ˈdredful
penny whistle => ˈpeni ˈhwisl
penny-farthing => ˈpeni ˈfɑ:ðɪŋ
penny-farthings => 'peni'fɑ:θiŋ
penny-pincher => 'peni:p'ɪntʃə
penny-pinching => ˈpeniˌpintʃiŋ
pennycress => 'penikres
pennyroyal => 'penirɒiәl
pennyweight => 'peniweit
pennywort => 'peniwә:t
pennyworth => 'peniwә:θ
penological => .pi:nә'lɒdʒikl
penologist => pi:'nɒlәdʒist
penology => pi:'nɒlәdʒi
penrose => 'penrәuz
pensile => 'pensail
pension => 'penʃәn
pension plan => ˈpenʃən plæn
pensionable => 'penʃәnәbl
pensione => pen'sjәune
pensioned => 'penʃ(ə)n
pensioner => 'penʃәnә(r)
pensioners => ˈpenʃənəz
pensioning => 'penʃ(ə)n
pensionless => 'penʃənlis
pensions => ˈpenʃənz
pensive => 'pensiv
pensively => 'pensɪvlɪ
penstemon => pen'sti:mәn, 'pensti-
penstock => 'penstɒk
pent => pent
Penta => 'pentә
penta- => ˈpentə
pentachlorophenol => ,pentә,klɔ:rә'fi:nɔl
pentachord => 'pentәkɒ:d
pentacle => 'pentәkl
pentad => 'pentæd
pentadactyl => .pentә'dæktil
pentagastrin => ,pentә'^æstrin
pentagon => 'pentәgәn
pentagonal => pen'tægәnl
Pentagonese => ,pentә^ә'ni:z,-'ni:s
pentagons => ˈpentəˌgɔnz
pentagram => 'pentә^ræm
pentahedral => .pentә'hi:drәl
pentahedron => .pentә'hi:drәn
pentamer => 'pentәmә
pentameric => pentæ'merɪk
pentamerous => pen'tæmәrәs
pentameter => pen'tæmitә
pentameters => penˈtæmitəz
pentane => 'pentein
pentangle => 'penˌtæŋgl
pentanoate => 'pentә,nәuit
pentaploid => 'pentә,plɔid
pentaprism => 'pentәprizəm
Pentateuch => 'pentәtju:k
pentathlete => pen'tæθli:t
pentathlon => pen'tæθlәn
pentatonic => .pentә'tɒnik
pentavalent => ,pentә'veilәnt
pentazocine => pen'tæzәsi:n
Pentecost => 'pentikɔst
Pentecostal => .penti'kɒ:stl
Pentecostalism => ,pentə'kɔ:stə,lizəm
Pentecostalist => ,pentə'kɔːstəlɪst
pentecostals => ,penti'kɔstl; 'pentikɔs-
penthouse => 'penthaus
penthouses => ˈpentˌhaʊsiz
pentimento => ,penti'mentәu
pentlandite => 'pentlәndait
pentobarbital => ,pentә'bɑ:bi,tɔl
pentobarbitone => ,pentә'bɑ:bitәun
pentode => 'pentәud
Pentonville => 'pentәnvil
pentose => 'pentәus
pentoxide => ,pen'tɔksaid
pentstemon => pent'sti:mәn
pentyl => 'pentil
penult => pi'nʌlt
penultimate => pi'nʌltimit
penumbra => pi'nʌmbrә
penumbral => pi'nʌmbrәl
penurious => pi'njuәriәs
penuriously => pɪn'jʊərɪəslɪ
penury => 'penjuri
Penutian => pә'nutiәn
Penza => 'penzə
Penzance => pen'zæns
peo => 'pi:əʊ
peon => 'pi:әn
peonage => 'pi:әnidʒ
peonies => ˈpi:əni:z
peons => 'piːən
peony => 'pi:әni
people => 'pi:pl
people carrier => ˈpi:pl ˈkæriə
people mover => ˈpi:pl ˈmu:və
people person => ˈpi:pl ˈpə:sən
peoplehood => 'pi:plhjd
pep => pep
pep pill => pep pil
pep rally => pep ˈræli
peperomia => pepə'rɒmɪə
peperoni => ,pepә'rәjni
peplos => 'peplɔs
peplum => 'peplәm
pepo => 'pi:pәu
pepped => pept
pepper => 'pepә
pepper mill => ˈpepə mil
pepper spray => ˈpepə sprei
pepper tree => ˈpepə tri:
pepperbox => 'pepәbɔks
peppercorn => 'pepәkɔ:n
peppercorns => ˈpepəkɔ:nz
peppergrass => 'pepә^rɑ:s;-^ræs
pepperidge => 'pepərɪdʒ
peppermint => 'pepәmint
peppermints => ˈpepəˌmɪnts
pepperoni => ˌpepəˈrəʊni
peppers => ˈpepəz
pepperwort => 'pepəwɜːt
peppery => 'pepәri
pepping => pepɪŋ
peppy => 'pepi
peps => peps
pepsi => 'pepsi
pepsin => 'pepsin
pepsinogen => pep'sinәdʒәn
peptic => 'peptik
peptidase => 'peptideis
peptide => 'peptaid
peptidoglycan => ,peptidәj'^laikæn
peptone => 'peptәun
Pepys => 'pepis
Pequot => 'pi:kwɔt
per => pә:
per annum => pәr 'ænәm
per cent => pә'sent
per diem => 'daiem,'di:-
peradventure => pәrәd'ventʃә
Perak => 'pεərə; 'peiræk; 'peira:
perambulate => pә'ræmbjuleit
perambulated => pəˈræmbjəˌleɪtid
perambulates => pəˈræmbjəˌleɪts
perambulating => pəˈræmbjəˌleɪtɪŋ
perambulation => pә.ræmbju'leiʃәn
perambulator => pә'ræmbjuleitә
perambulators => pə'ræmbjʊleɪtə
perambulatory => pә'ræmbjulәtәri
perborate => pә'bɔ:reit
percale => pә'keil
perceivable => pә'si:vәbl
perceive => pә'si:v
perceived => pə'siːvd
perceives => pəˈsi:vz
percent => pә'sent
percentage => pә'sentidʒ
percentages => pə'sentɪdʒɪz
percentile => pә'sentail
percept => 'pә:sept
perceptibility => pә,septә'bilәti
perceptible => pә'septibl
perceptibly => pә'septibli
perception => pә'sepʃәn
perceptional => pә'sepʃәnl
perceptions => pɚ'sɛpʃən
perceptive => pә'septiv
perceptively => pə'septivli
perceptivity => .pә:sep'tiviti
perceptron => pә'septrɔn
perceptual => pә'septʃuәl
perch => pә:tʃ
perchance => pә'tʃɑ:ns
perched => pɜ:tʃt
perchlorate => pә'klɔ:reit
perchloroethylene => pə,klɔ:rəu'eθili:n
percipience => pә'sipiәns
percipient => pә'sipiәnt
percival => 'pә:sivәl
percoid => 'pә:kɔid
percolate => 'pә:kәleit
percolated => ˈpɜ:kəˌleɪtid
percolates => ˈpɜ:kəˌleɪts
percolating => 'pә:kәleitiŋ
percolation => .pә:kә'leiʃәn
percolator => 'pә:kәleitә
percolators => ˈpə:kəleitəz
percuss => pә'kʌs
percussed => pə:ˈkʌst
percusses => pə:ˈkʌsiz
percussing => pə:ˈkʌsɪŋ
percussion => pә:'kʌʃәn
percussion drill => pəˈkʌʃən dril
percussionist => pә'kʌʃәnist
percussive => pә'kʌsiv
percutaneous => ,pә:kju(:)'teiniәs, -njәs
percy => 'pә:si
perdition => pә'diʃәn
perdurable => pә:'djuәrәbl
perdure => pә(:)'djuә
peregrinate => 'perigrineit
peregrinated => ˈperiɡrineitid
peregrinates => ˈperiɡrineits
peregrinating => ˈperiɡrineitɪŋ
peregrination => .perigri'neiʃәn
peregrinations => ,periɡri'neiʃən
peregrinator => 'perigrineitә
peregrine => 'peri^rin
peregrine falcon => ˈperiɡrin ˈfælkən
pereiopod => pә'raiәpɔd
Pereira => pә'reәrә
peremptorily => pә'remptәrili
peremptoriness => pә'remptәrinis
peremptory => pә'remptәri
perennate => 'peәrәneit
perennated => 'perɪneɪt
perennates => 'perɪneɪt
perennating => 'perɪneɪt
perennial => pә'reniәl
perennials => pə'renɪəls
perestroika => ˌperəs'trɔɪkə
perfect => 'pә:fikt
perfect binding => ˈpə:fikt ˈbaɪndɪŋ
perfect participle => ˈpə:fikt ˈpɑ:tɪˌsɪpəl
perfect pitch => ˈpə:fikt pitʃ
perfecta => pә'fektә
perfectibility => pә.fekti'biliti
perfectible => pә'fektәbl
perfection => pә'fekʃәn
perfectionism => pә'fekʃәniz(ә)m
perfectionist => pә'fekʃәnist
perfectionists => pəˈfekʃɵnɪsts
perfective => pә'fektiv
perfectly => 'pә:fiktli
perfectness => 'pә:fiktnis
perfecto => pә'fektәu
perfects => ˈpə:fikts
perfervid => pә:'fә:vid
perfidious => pә'fidiәs
perfidiously => pə'fɪdɪəslɪ
perfidy => 'pә:fidi
perfoliate => pә'fәuliit
perforate => 'pә:fәreit
perforated => 'pɜ:fəreɪtɪd
perforates => ˈpɜ:fəˌreɪts
perforation => .pә:fә'reiʃәn
perforations => pɜ:fə'reɪʃnz
perforator => 'pә:fәreitә
perforce => pә'fɒ:s
perform => pә'fɒ:m
performance => pә'fɒ:mәns
performance art => pəˈfɔ:məns ɑ:t
performances => pə'fɔ:mənsɪz
performative => pә'fɔ:mәtiv
performer => pә'fɒ:mә
performers => pɚ'fɔrmɚz
performing => pә'fɒ:miŋ
performing arts => pəˈfɔ:mɪŋ ɑ:ts
perfume => 'pә:fju:m
perfumed => pә'fju:md
perfumer => pә'fju:mә
perfumery => pә'fju:mәri
perfumes => ˈpə:fju:mz
perfunctorily => pә'fʌŋktәrili
perfunctoriness => ,pə'fʌŋktərinis
perfunctory => pә'fʌŋktәri
perfusate => pә'fju:zeit,-zәt
perfuse => pә'fju:z
perfused => pə(:)ˈfju:zd
perfuses => pə'fjuːz
perfusing => pə(:)ˈfju:zɪŋ
perfusion => pә:'fju:ʒәn
perfusionist => pɜ:f'ju:ʒənɪst
pergana => pә'^ʌnә
pergola => 'pә:gәlә
pergolas => ˈpɜ:gələz
pergunnah => pә'^ʌnә
perhaps => pә'hæps
peri => 'piәri
perianal => ,peri'einәl
perianth => 'periænθ
periapsis => ,peri'æpsis
periapt => 'periæpt
periastron => peri'æstrɔn
pericardial => ,peri'kɑ:diәl
pericarditis => .perikɑ:'daitis
pericardium => ,peri'kɑ:djәm
pericarp => 'perikɑ:p
perichondrium => ,peri'kɔndriәm
periclase => 'perikleis
Pericles => 'perikli:z
periclinal => ,peri'klainl
pericope => pә'rikәpi:
pericranium => .peri'kreiniәm
pericycle => 'perisaikl
pericyclic => ,peri'saiklik
periderm => 'peridә:m
peridium => pә'ridiәm
peridot => 'peridɒt
peridotite => .peri'dәutait
perigee => 'peridʒi:
periglacial => ,peri'^leisjәl
perigynous => pә'ridʒinәs
perigyny => pərɪ'dʒəni
perihelion => .peri'hi:liәn
perikaryon => ,peri'kæriɔn
peril => 'peril
perilous => 'perilәs
perilously => ˈperɪləslɪ
perils => ˈperilz
perilune => 'perilu:n
perilymph => 'peri,limf
perimenopause => 'pɪərɪmɪnəpɔ:z
perimeter => pә'rimitә
perimeters => pəˈrɪmɪtəz
perimetric => ,peri'metrik
perimetry => pә'rimitri
perimysium => ,peri'miziәm
perinatal => ,peri'neitl
perinatology => ,perinei'tɔlәdʒi
perineal => .peri'ni:әl
perineum => .peri'ni:әm
perineurial => pɪəri:nɜ:'raɪəl
perineurium => ,peri'njuәriәm
perinuclear => ,peri'njukliә
period => 'piәriәd
period piece => ˈpiəriəd pi:s
periodate => pe'raiәdeit
periodic => .piәri'ɒdik
periodical => .piәri'ɒdikl
periodically => ,piәri'ɔdikəli
periodicities => ,pɪərɪə'dɪsɪtɪ
periodicity => .piәriә'disәti
periodization => ,piәriәdai'zeiʃən;-di'z-
periodize => 'piәriәdaiz
periodontal => .periәu'dɒntәl
periodontics => ,periәu'dɔntiks
periodontology => ,periә?dɔn'tɔlәdʒi
perioperative => pɪə'raɪɒpərətɪv
periosteum => .peri'ɒstiәm
periostitis => .periɒs'taitis
peripatetic => .peripә'tetik
peripatus => pә'ripәtәs
peripeteia => .peripi'tiә
peripheral => pә'rifәrәl
peripheralization => pərɪfərə'laɪzeɪʃn
peripherally => pə'rɪfərəlɪ
peripherals => pə'rɪfərəls
peripheries => pəˈrɪfəri:z
periphery => pә'rifәri
periphrasis => pә'rifrәsis
periphrastic => .peri'fræstik
periphyton => pә'rifitɔn
peripteral => pә'riptәrәl
perique => pә'ri:k
periscope => 'periskәup
periscopes => ˈperɪˌskəʊps
periscopic => ,peris'kɔpik
perish => 'periʃ
perishability => perɪʃə'bɪlɪtɪ
perishable => 'periʃәbl
perishables => ˈperɪʃəblz
perished => ˈperɪʃt
perisher => 'periʃә
perishers => 'periʃə
perishes => ˈperiʃiz
perishing => 'periʃiŋ
perishingly => 'periʃiŋli
perisperm => 'perispә:m
perissodactyl => pә,risәu'dæktil
peristalsis => .peri'stælsis
peristaltic => .peri'stæltik
peristome => 'peristәum
peristyle => 'peristail
perithecium => ,peri'θiʃiәm
peritoneal => .peritәu'ni:әl
peritoneum => ,peritәu'ni:әm
peritonitis => .peritә'naitis
peritus => pә'ri:tәs
perivascular => ,peri'væskjjlә(r)
periventricular => ,periven'trikjjlә(r)
periwig => 'periwig
periwinkle => 'periwiŋkl
periwinkles => ˈperɪˌwɪŋkəlz
perjure => 'pә:dʒә
perjured => 'pә:dʒәd
perjurer => 'pә:dʒәrә
perjures => ˈpɜ:dʒəz
perjuries => ˈpɜ:dʒəri:z
perjuring => ˈpɜ:dʒərɪŋ
perjurious => 'pә'dʒjәriәs
perjury => 'pә:dʒәri
perk => pә:k
perked => pɜ:kt
perkier => ˈpɜ:ki:ə
perkiness => 'pə:kinis
perking => pɜ:kɪŋ
Perks => pɜːks
perky => 'pә:ki
perlite => 'pә:lait
perm => pә:m
permaculture => pɜ:mæklt'jʊə
permafrost => 'pә:mәfrɔ(:)st
permalloy => 'pә:mәlɔi
permanence => 'pә:mәnәns
permanency => 'pә:mәnәnsi
permanent => 'pә:mәnәnt
permanent tooth => ˈpə:mənənt tu:θ
permanent wave => ˈpə:mənənt weiv
permanganate => pә:'mæŋgәneit
permeabilities => pɜːmɪə'bɪlɪtɪ
permeability => .pә:miә'biliti
permeable => 'pә:miәbl
permeance => 'pә:miәns
permeate => 'pә:mieit
permeated => 'pɜ:mɪeɪtɪd
permeates => ˈpə:mieits
permeating => ˈpə:mieitɪŋ
permeation => .pә:mi'eiʃәn
Permian => 'pә:miәn
permissibility => pә.misә'biliti
permissible => pә'misәbl
permissibly => pә'misәbli
permission => pә'miʃәn
permissions => pɜ:'mɪʃənz
permissive => pә'misiv
permissiveness => pə'mɪsɪvnəs
permit => pә'mit
permits => pəˈmits
permitted => pəˈmitid
permitting => pəˈmitɪŋ
permittivity => ,pә:mi'tiviti
permutate => pɜ:mju:'teɪt
permutation => .pә:mju'teiʃәn
permutations => pɜ:mju:'teɪʃnz
permute => pә'mju:t
permuted => pə(:)ˈmju:tid
permutes => pə(:)ˈmju:ts
permuting => pə(:)ˈmju:tɪŋ
pernicious => pә'niʃәs
pernicious anaemia => pəˈnɪʃəs əˈni:mi:ə
perniciously => pə'nɪʃəslɪ
pernickety => pә'nikiti
pernoctation => .pә:nɒk'teiʃәn
pernod => p?ә'nәu
peroba => pә'rәubә
peroneal => ,perә'niәl
Peronism => pә'rәjnizәm
Peronist => pә'rәjnist
perorate => 'perәreit
peroration => .perә'reiʃәn
perorations => ˌperəˈreɪʃɵnz
perovskite => pә'rɔvz,kait
peroxidase => pә'rɔksideis, -deiz
peroxide => pә'rɔksaid
peroxide blonde => pəˈrɔkˌsaɪd blɔnd
peroxided => pə'rɒksaɪd
peroxides => pəˈrɔkˌsaɪdz
peroxiding => pə'rɒksaɪd
peroxisomal => pə'rɒksɪsəməl
peroxisome => pә'rɔksisәjm
perp => pɚrp
perpend => pә'pend
perpendicular => .pә:pәn'dikjulә
perpendicularity => ,pә:,pәndikju-'læriti
perpendicularly => ˌpɜ:pən'dɪkjʊləlɪ
perpetrate => 'pә:pitreit
perpetrated => ˈpɜ:pɪˌtreɪtid
perpetrates => ˈpɜ:pɪˌtreɪts
perpetrating => ˈpɜ:pɪˌtreɪtɪŋ
perpetration => .pә:pi'treiʃәn
perpetrators => 'pɜːpətreɪtə(r)
perpetual => pә'petʃuәl
perpetual calendar => pəˈpetʃuəl ˈkælində
perpetual check => pəˈpetʃuəl tʃek
perpetual motion => pəˈpetʃuəl ˈməuʃən
perpetuate => pә'petjueit
perpetuates => pəˈpetʃu:ˌeɪts
perpetuating => pəˈpetʃu:ˌeɪtɪŋ
perpetuation => pә.petju'eiʃәn
perpetuator => pә'petjueitә
perpetuity => .pә:pi'tju:iti
perplex => pә'pleks
perplexed => pә'plekst
perplexedly => pә'pleksidli
perplexes => pəˈpleksiz
perplexing => pә'pleksiŋ
perplexingly => pәˊpleksiŋli
perplexities => pəˈpleksɪti:z
perplexity => pә'pleksiti
perquisite => 'pә:kwizit
perquisites => 'pɜ:kwɪzɪts
Perrier => 'periei, ,peri'ei
Perrin => 'perin, pe'ræŋ
perron => 'perәn
perry => 'peri
persecute => 'pә:sikju:t
persecuted => ˈpə:sikju:tid
persecutes => ˈpə:sikju:ts
persecuting => ˈpə:sikju:tɪŋ
persecution => .pә:si'kju:ʃәn
persecutor => 'pә:sikju:tә
Perseids => 'pә:si:idz
Persephone => pә:'sefәni
Persepolis => pә:'sepәlis
Perseus => 'pә:sju:s
perseverance => pә:si'viәrәns
perseverate => pә(:)'sevәreit
perseveration => pә(:),sevә'reiʃәn
persevere => .pә:si'viә
persevered => ˌpə:siˈviəd
perseveres => ˌpə:siˈviəz
persevering => .pә:si'viәriŋ
perseveringly => pɜ:sɪ'vɪərɪŋlɪ
Persia => 'pә:ʒә
Persian => 'pә:ʃәn
persians => ˈpə:ʃənz
persiflage => .pә:si'flɑ:ʒ
persimmon => pә'simәn
persist => pә'sist
persisted => pəˈsistid
persistence => pә'sistәns
persistency => pә'sistәnsi, -'zis-
persistent => pә'sistәnt
persistently => pə'sɪstəntlɪ
persisting => pəˈsistɪŋ
persists => pəˈsists
persnickety => pә'snikәti
person => 'pә:sn
person-to-person => 'pә:sәntә'pә:sәn
persona => pә:'sәunә
personable => 'pә:snәbl
personage => 'pә:snidʒ
personages => ˈpɜ:sənɪdʒz
personal => 'pә:snl
personal column => ˈpə:sənəl ˈkɔləm
personal organizer => ˈpə:sənəl ˈɔ:gənaɪzə
personal pronoun => ˈpə:sənəl ˈprəunaun
personal representative => ˈpə:sənəl ˌrepriˈzentətiv
personal space => ˈpə:sənəl speis
personal stereo => ˈpə:sənəl ˈstiəriəu
personalised => 'pə:sənəlaizd
personalism => 'pә:sәnlizm
personalistic => pəsəʊ'nəlɪstɪk
personality => .pә:sә'næliti
personality disorder => ˌpə:səˈnæliti disˈɔ:də
personality inventory => ˌpə:səˈnæliti /ˈɪnvəntri/
personalize => 'pә:sәnәlaiz
personalizes => ˈpə:sənəlaiziz
personalizing => ˈpə:sənəlaizɪŋ
personally => 'pә:sәnli
personalty => 'pә:snәlti
personas => pəˈsəunəz
personate => 'pә:sәneit
personated => ˈpə:səneitid
personates => ˈpə:səneits
personating => ˈpə:səneitɪŋ
personation => .pә:sә'neiʃәn
personator => 'pә:sәneitә
personification => pә:.sɒnifi'keiʃәn
personified => pəˈsɔnəˌfaɪd
personifies => pəˈsɔnəˌfaɪz
personify => pә'sɒnifai
personifying => pəˈsɔnəˌfaɪŋ
personnel => .pә:sә'nel
perspective => pә'spektiv
perspectives => pəs'pektɪvz
perspectivism => pəs'pektɪvɪzəm
perspex => 'pә:speks
perspicacious => .pә:spi'keiʃәs
perspicaciously => pәːspiˊkeiʃәsli
perspicacity => .pә:spi'kæsiti
perspicuity => .pә:spi'kju:iti
perspicuous => pә'spikjuәs
perspicuously => pə'spɪkjʊəslɪ
perspiration => .pә:spә'reiʃәn
perspiratory => pәs'paiәrәtәri
perspire => pә'spaiә
perspired => pəˈspaɪəd
perspires => pəˈspaɪəz
perspiring => pəs'paɪərɪŋ
persuadable => pә'sweidәbl
persuade => pә'sweid
persuaded => pəˈsweidid
persuader => pә'sweidә
persuades => pəˈsweidz
persuading => pəˈsweidɪŋ
persuasible => pә'sweisibl
persuasion => pә'sweiʒәn
persuasions => pəˈsweiʒənz
persuasive => pә'sweisiv
persuasiveness => pə'sweɪsɪvnəs
pert => pә:t
pertain => pә'tein
pertained => pəˈteind
pertaining => pә:'teiniŋ
pertains => pəˈteinz
perth => pә:θ
pertinacious => .pә:ti'neiʃәs
pertinaciously => pɜ:tɪ'neɪʃəslɪ
pertinaciousness => pәːtiˊneiʃәsnis
pertinacity => .pә:ti'næsәti
pertinence => 'pә:tinәns
pertinency => 'pә:tinәnsi
pertinent => 'pә:tinәnt
pertinently => 'pɜ:tɪnəntlɪ
pertly => 'pә:tli
pertness => 'pә:tnis
perturb => pә'tә:b
perturbation => ,pә:tә:'beiʃәn
perturbed => pə'tɜ:bd
perturbing => pəˈtɜ:bɪŋ
perturbs => pəˈtɜ:bz
pertussis => pә(:)'tʌsis
Peru => pә'ru:
Perugia => pә'ru:dʒiә, pe'ru:dʒɑ:
peruke => pә'ru:k
perusal => pә'ru:zl
peruse => pә'ru:z
perused => pəˈru:zd
peruses => pəˈru:ziz
perusing => pəˈru:zɪŋ
Perutz => 'perәts
Peruvian => pә'ru:viәn
peruvians => pəˈru:vjənz
perv => pɜ:v
pervade => pә'veid
pervaded => pəˈveɪdid
pervades => pəˈveɪdz
pervading => pə'veɪdɪŋ
pervasion => pә'veiʒәn
pervasive => pә'veisiv
pervasiveness => pə'veɪsɪvnəs
perverse => pә'vә:s
perversely => pə'vɜ:slɪ
perverseness => pə'və:snis
perversion => pә(:)'vә:ʃәn
perversions => pəˈvɜ:ʒənz
perversity => pә'vә:sәti
pervert => pә:'vә:t
perverted => pә:'vә:tid
perverting => pəˈvɜ:tɪŋ
perverts => pəˈvɜ:ts
pervious => 'pә:viәs
perviousness => pɜ:vjəs'nes
pes cavus => pi:z ˈkeivəs
peseta => pә'setә
pesetas => pəˈsetəz
pesewa => 'pesiwɑ:
Peshawar => pә'ʃɔ:ә
pesky => 'peski
peso => 'peisәu
pesos => ˈpeisəuz
pessaries => ˈpesəriz
pessary => 'pesәri
pessimism => 'pesimizm
pessimist => 'pesimist
pessimistic => .pesi'mistik
pessimistically => ˌpesɪ'mɪstɪklɪ
pessimists => ˈpesɪmɪsts
pest => pest
Pestalozzi => ,pestә'lɔtsi
pester => 'pestә
pestered => ˈpestəd
pestering => ˈpestərɪŋ
pesters => ˈpestəz
pesticidal => ˊpestisaid
pesticide => 'pestisaid
pesticides => 'pestɪsaɪdz
pestiferous => 'pestifәrәs
pestilence => 'pestilәns
pestilences => 'pestɪlənsɪz
pestilent => 'pestilәnt
pestilential => .pesti'lenʃәl
pestilently => 'pestɪləntlɪ
pestle => 'pesl
pestles => ˈpesəlz
pestling => 'peslɪŋ
pesto => 'pestәj
pests => 'pests
pet => pet
petal => 'petәl
petal-like => 'petll'aɪk
petaline => 'petәlain
petalled => 'petәld
petaloid => 'petәlɔid
petard => pe'tɑ:d
petasus => 'petəsʌs
petcock => 'petkɔk
Pete => pi:t
petechia => pi'ti:kiә
petechial => pi'ti:kiәl, -'te-
peter => 'pi:tә
Peterborough => 'pi:təbrə
petered => 'pi:təd
peterman => 'pi:təmæn
peters => 'pi:tәz
petersburg => 'pi:tәzbә:^
petersham => 'pi:tәʃәm
pethidine => 'peθidin
petiolar => 'petiәlә
petiolate => 'petiәleit
petiole => 'petiәul
petit => pә'ti:, 'peti
petit bourgeois => ˌpeti ˈbʊəʒwɑ:
petit four => ˌpeti ˈfɔ:(r)
petit point => pəˈti: pɔint
petite => pә'tit
petite bourgeoisie => pəˈtiːt ˌbʊəʒwɑːˈziː
petitio principii => pi'tiʃiәu prin'sipiai
petition => pi'tiʃәn
petitionary => pi'tiʃәnәri
petitioned => piˈtiʃənd
petitioner => pi'tiʃәnә
petitioners => pəˈtɪʃənə(r)
petitioning => piˈtiʃənɪŋ
petits => 'petɪ
petits pois => ˌpeti ˈpwɑ:
Peto => 'peitәu
Petra => 'pi:trə
Petrarch => 'pet,ra:k
Petrarchan => pi'trɑ:kәn
petrel => 'petrәl
petri => pɛtrə
Petri dish => 'pi:tri 'diʃ
Petrie => 'pi:tri
petrifaction => .petri'fækʃәn
petrification => ,petrifi'keiʃәn
petrified => ˈpetrɪfaɪd
petrifies => ˈpetrəˌfaɪz
petrify => 'petri,fai
petrifying => ˈpetrəˌfaɪŋ
Petrine => 'pi:train, -rin
petro- => 'petrәj
petrochemical => .petrәu'kemikәl
petrochemicals => ˌpetrəʊ'kemɪkəlz
petrochemistry => .petrәu'kemistri
petrodollar => ˈpetrəʊdɒlə(r)
petrogenesis => ,petrәu'dʒenisis
petrogenetic => ,petrəudʒi'netik
petroglyph => 'petrәglif
Petrograd => 'petrәu^ræd
petrographer => 'petrəʊɡrɑ:fər
petrographic => ,petrəu'græfik
petrographical => petrəʊɡ'ræfɪkəl
petrography => pi'trɒgrәfi
petrol => 'petrәl
petrol bomb => ˈpetrəl bɔm
petrol station => ˈpetrəl ˈsteiʃən
petrolatum => .petrә'leitәm
petroleum => pә'trәuliәm
petroliferous => .petrә'lifәrәs
petrologic => ,petrәj'lɔdʒik
petrological => petrəʊ'lɒdʒɪkl
petrologist => pi'trɒlәdʒist
petrology => pi'trɒlәdʒi
Petropavlovsk => ,petrəu'pɑ:vlɔfsk
petrophysics => ,petrәj'fiziks
petrosal => pi'trәusәl
petrotectonics => ,petrәjtek'tɔniks
petrous => 'petrәs
Petrozavodsk => ,petrɔzɑ:'vɔ:tsk
petticoat => 'petikәut
petticoats => 'petɪkəʊts
pettier => ˈpetiə
pettifog => 'petifɒg
pettifogger => 'petifɒgә
pettifoggery => 'peti.fɒgәri
pettifogging => 'petifɒgiŋ
pettily => 'petili
pettiness => 'petinis
petting => 'petiŋ
petting zoo => ˈpetiŋ zu:
pettish => 'petiʃ
pettishly => 'petiʃli
petty => 'peti
petty officer => ˈpeti ˈɔfisə
petulance => 'petjjlәns; -tʃә-
petulant => 'petʃәlәnt
petulantly => 'petjuləntli
petunia => pi'tju:njә, -niә
petunias => pɪˈtu:njəz
petuntse => pi'tʌntsi, -'tjn-
pew => pju:
pewee => 'pi:wi:
pewit => 'pi:wit
pews => pju:z
pewter => 'pju:tә
pewterer => 'pju:tərə
peyote => pei'әjti
Peyton => 'peitәn
pfennig => 'fenig
pfennigs => ˈpfeniɡz
pfft => ft
pfui => 'pfu:i
pgce => ˌpi: dʒi: si: ˈi:
pH => pi:eitʃ
Phaeacian => fi:'eiʃәn
phaeton => 'feitn
phage => feidʒ
phagocyte => 'fægәusait
phagocytic => .fægәu'sitik
phagocytize => 'fæ^әjsaitaiz, -si-
phagocytose => 'fæ^әjsaitәjs, -tәjz
phagocytosis => .fægәusai'tәusis
phagosome => 'fæ^әsәum
phalange => 'fælændʒ
phalangeal => fә'lændʒiәl
phalanger => fә'lændʒә
phalanges => fæ'lændʒi:z
phalanstery => 'fælәnstәri
phalanx => 'fælæŋks
phalanxes => ˈfælæŋksiz
phalarope => 'fælәrәup
phalera => 'fælәrә
phalli => 'fælɪ
phallic => 'fælik
phallicism => 'fælɪsɪzəm
phallism => 'fælizәm
phallocentric => ˌfæləʊˈsentrɪk
phallocratic => ,fælə'krætik
phallus => 'fælәs
phanerogam => 'fænәrәugæm
phanerogamic => ,fænәrәj'^æmik, fә,neә-
phanerogamous => ,fænә'rɔ^әmәs
Phanerozoic => ,fænәrә'zәuik
phantasize => 'fæntәsaiz
phantasm => 'fæntæzәm
phantasmagoria => .fæntæzmә'gɒ:riә
phantasmagorias => ˌfæntæzməˈɡɔriəz
phantasmagoric => .fæntæzmә'gɒ:rik
phantasmagorical => ˌfæntæzmə'ɡɒrɪkl
phantasmal => fæn'tæsmәl
phantasmic => fæn'tæzmik
phantast => 'fæntæst
phantasy => 'fæntәsi
phantom => 'fæntәm
phantoms => 'fæntəmz
pharaoh => 'færәu
pharisee => 'færisi:
pharmaceutical => ,fɑ:mә'sju:tikәl
pharmaceuticals => ,fɑ:mә'sju:tikәlz
pharmaceutics => .fɑ:mә'sju:tiks
pharmacies => ˈfɑ:məsiz
pharmacist => 'fɑ:mәsist
pharmacists => 'fɑ:məsɪsts
pharmacodynamic => ,fɑ:mәkәjdai'næmik, -di-
pharmacodynamics => fɑ:mә,kәudai'næmiks
pharmacogenetics => ,fɑ:mәkәudʒi'netiks
pharmacogenomics => fɑ:məkədʒe'nɒmɪks
pharmacognosy => ,fɑ:mә'kɔ^nәsi
pharmacokinetic => ˌfɑ:məkoʊknetɪk
pharmacokinetics => ,fɑ:mәkәu,kai'netiks
pharmacological => .fɑ:mә'kɒlәʒikl
pharmacologist => .fɑ:mә'kɒlәdʒist
pharmacology => .fɑ:mә'kɒlәdʒi
pharmacophore => 'fɑ:mәkәfɔ:
pharmacopoeia => .fɑ:mәkә'pi:ә
pharmacotherapy => ,fɑ:mәkә'θerәpi
pharmacy => 'fɑ:mәsi
pharyngeal => ,færin'dʒi:әl, fә'rindʒi-
pharyngitis => .færin'dʒaitis
pharyngotomy => ,færiŋ'^ɔtәmi
pharynx => 'færiŋks
phase => feiz
phased => feizd
phaser => 'feizә
phases => 'feisi:z
phasic => 'feizik
phasing => 'feiziŋ
phasmid => 'fæzmid
phasor => 'feizә
phat => fæt
phatic => 'fætik
pheasant => 'feznt
pheasantry => 'fezәntri
pheasants => ˈfezənts
Pheidippides => fai'dipidi:z
phelps => felps
phen- => fen
phenanthrene => fә'nænθri:n
phencyclidine => fen'saɪklɪdiːn
phenelzine => 'fenәl,zi:n
pheno- => 'fi:nəʊ
phenobarbital => ,fi:nәu'bɑ:bitәl
phenobarbitone => ,fi:nәu'bɑ:bitәun
phenocopy => 'fi:nәkɔpi
phenocryst => 'fi:nәkrist, 'fenә-
phenol => 'fi:nɒl
phenolic => fi'nɒlik
phenological => ,fi:nə'lɔdʒikl
phenology => fi'nɒlәdʒi
phenolphthalein => .fi:nɒl'fθæli:n
phenols => 'fi:nɒlz
phenom => fi'nɒm
phenomena => fi'nɒminә
phenomenal => fi'nɒminәl
phenomenalism => fi'nɒminәlizm
phenomenalist => fɪ'nɒmɪnəlɪst
phenomenalistic => fi,nɔminә'listik
phenomenalize => fi'nɔminәlaiz
phenomenally => fi'nɔminәli
phenomenological => fi.nɒminә'lɒdʒikl
phenomenology => fi.nɒmi'nɒlәdʒi
phenomenon => fi'nɒminәn
phenothiazine => ,fi:nәu'θaiәzi:n
phenotype => 'fi:nәtaip
phenotypic => 'fi:nә,tipik
phentolamine => fen'tɔlәmi:n,-min
phenyl => 'fenil
phenylalanine => .feni'lælәni:n
phenylbutazone => fenәl'bju:tәzәun
phenylenediamine => 'fenәli:n'daiәmin
phenylephrine => ,fenә'lefrin
phenylketonuria => ,fenәl,ki:tә'njuәriә, ,fi:nil-
phenylpropanolamine => fenɪlprɒpənəʊ'læmi:n
phenylthiocarbamide => 'fi: nil,θaiәjkɑ: 'bæmaid, 'fe-
phenytoin => 'fenitɔin
pheromone => 'ferәmәun
pheromones => 'ferəʊməʊnz
phew => fju:
phi => fai
phial => 'faiәl
phials => ˈfaɪəlz
Phidias => ˊfidiәs
phil => fil
phil- => 'fɪl
Philadelphia => .filә'delfjә
philadelphus => fɪlə'delfəs
philander => fi'lændә
philandered => fɪˈlændəd
philanderer => fi'lændәrә(r),fә-
philandering => fɪˈlændərɪŋ
philanders => fɪˈlændəz
philanthrope => 'filәnθrәup
philanthropic => fi'lænθrәpic
philanthropism => fi'lænθrәpizm
philanthropist => fi'lænθrәpist
philanthropists => fɪˈlænθrəpɪsts
philanthropize => fi'lænθrәpaiz
philanthropy => fi'lænθrәpi
philatelic => .filә'telik
philatelist => fi'lætәlist
philately => fi'lætәli
Philemon => fai'li:mɔn,fi-
philharmonic => .filɑ:'mɒnik
philhellene => 'filheli:n
philhellenic => .filhe'li:nik
philhellenism => fil'helinizm
philibeg => 'filibe^
philip => 'filip
Philippa => fi'lipə
Philippi => fi'lipai
philippians => fi'lipiәnz,fә-
Philippine => 'filipi:n
Philippines => 'filipi:nz
Philippopolis => ,fili'pɔpәlis
philips => 'filips
philistine => 'filistain
philistines => ˈfɪlɪˌsti:nz
philistinism => 'filistinizәm, fi'lis-
phillip => 'filip
Phillis => 'filis
phillumenist => fi'lju:minist
phillumeny => fi'lju:mәni,fai-
Philo => 'filəu
philo- => ˈfɪləʊ
philodendron => .filә'dendrәn
philogynist => fi'lɔdʒinist,fә-
philogyny => fi'lɒdʒini
philologian => ,filә'lәjdʒiәn
philological => .filә'lɒdʒikl
philologically => filәˊlɒdʒikәli
philologist => fi'lɒlәdʒist
philology => fi'lɒlәdʒi
philopatry => 'fɪləpətrɪ
philoprogenitive => ,filәprәu'dʒenitiv
philosophe => ,filə'zɔf
philosopher => fi'lɒsәfә
philosophers => fɪ'lɒsəfəz
philosophic => ,filә'sɔfik
philosophical => .filә'sɒfikl
philosophical analysis => ˌfɪləˈsɔfɪkəl əˈnæləsis
philosophies => fiˈlɔsəfiz
philosophise => fi'lɔsәfaiz, fә-
philosophize => fi'lɒsәfaiz
philosophized => fɪ'lɒsəfaɪz
philosophizing => fə'lɒsəfaɪzɪŋ
philosophy => fi'lɒsәfi
philtre => 'filtә
phimosis => fai'mәusis
phishing => ˈfɪʃɪŋ
phiz => fiz
phlebitis => fli'baitis
phlebography => fli'bɔ^rәfi
phlebotomist => fli'bɔtәmist
phlebotomize => fli'bɔtәmaiz
phlebotomized => flɪ'bɒtəmaɪz
phlebotomizes => flɪ'bɒtəmaɪz
phlebotomizing => flɪ'bɒtəmaɪz
phlebotomy => fli'bɒtәmi
phlegm => flem
phlegmatic => fle^'mætik
phlegmy => 'flemi
phloem => 'flәuem
phlogiston => flәu'dʒistәn
phlogopite => 'flɔ^әpait
phlox => flɒks
Phnom Penh => pә'nɔm'pen
phobia => 'fәubiә
phobias => 'fəʊbɪəz
phobic => 'fәubik
phobics => ˈfəubiks
phocine => 'fәusain
phocomelia => .fәukәu'mi:liә
Phoebe => 'fi:bi
Phoebus => 'fi:bәs
Phoenicia => fi'niʃiә
Phoenician => fi'niʃiәn
phoenix => 'fi:niks
phoenixes => ˈfi:nɪksiz
phon => fɒn
phonate => 'fәuneit
phonated => fəuˈneitid
phonates => fəuˈneits
phonating => fəuˈneitɪŋ
phonation => fәu'neiʃәn
phonatory => 'fɔnәtәri
phone => fәun
phone book => fəun buk
phone box => fəun bɔks
phonecard => ˈfəʊnkɑ:d
phonematic => .foәni'mætik
phoneme => 'fәuni:m
phonemic => fәu'ni:mik
phonemics => fәu'ni:miks
phonetic => fәu'netik
phonetically => fәu'netikli
phonetician => .fәuni'tiʃәn
phoneticism => fә'netisizm
phoneticist => fәj'netisist
phoneticize => fә'netisaiz
phonetics => fәu'netiks
phoney => 'fәuni
phoney war => ˈfəʊni: wɔ:
phonic => 'fәunik
phonics => 'fәuniks
phonier => ˈfəʊni:ə
phonies => ˈfəʊni:z
phoniest => ˈfəʊni:st
phonily => 'fәunili
phoniness => 'fәuninis
phono => 'fәunәu
phonocardiogram => ,fәunә'kɑ:diә,^ræm
phonogram => 'fәunәgræm
phonograph => 'fәunәgrɑ:f
phonograph record => ˈfəʊnəˌgræf riˈkɔ:d
phonographic => .fәunә'græfik
phonographs => ˈfəʊnəˌgræfs
phonolite => 'fәunәlait
phonologist => fәu'nɒlәdʒist
phonology => fәu'nɒlәdʒi
phonon => 'fәunɒn
phonotactics => ,fәunә'tæktiks
phony => 'fәuni
phooey => 'fu:i
phorbol => 'fɔ:bɔl
phoresy => 'fɔ:risi
phoretic => fәu'retik
phorid => 'fɒrɪd
phormium => 'fɔ:miәm
phoronid => fәj'rәjnid
phosgene => 'fɒzdʒi:n
phosphatase => 'fɔsfәteis
phosphate => 'fɔsfeit
phosphates => 'fɒsfeɪts
phosphatic => fɒs'fætik
phosphatide => 'fɔsfәtaid
phosphatidylcholine => 'fɔsfә,taidil'kәjli:n,fɔs'fæti-
phosphating => 'fɔsfeitiŋ
phosphene => 'fɔsfi:n
phosphide => 'fɒsfaid
phosphine => 'fɒsfi:n
phosphite => 'fɒsfait
phospho- => 'fɔsfәj
phosphocreatine => fɔsfәu'kri:әti:n, -tin
phosphodiesterase => ,fɔsfә,daiә'stereis
phospholipase => ,fɔsfәu'laipeis
phospholipid => ,fɔsfәu'lipid
phospholipids => fɒsp'hɒlɪpɪdz
phosphonate => 'fɔsfәuneit
phosphonium => fɔs'fәuniәm
phosphoprotein => .fɒsfәu'prәuti:n
phosphor => 'fɔsfә
phosphoresce => .fɒsfә'res
phosphorescence => .fɒsfә'resns
phosphorescent => .fɒsfә'resnt
phosphoric => fɔs'fɔrik
phosphorite => 'fɒsfәrait
phosphorous => 'fɒsfәrәs
phosphorus => 'fɒsfәrәs
phosphoryl => ,fɔs'fɔ:ril
phosphorylase => 'fɔsfәri,leis, fɔs'fɔ:r-
phosphorylate => 'fɔsfәrileit
phosphorylation => fɔ,sfɔri'leiʃәn
phot => fɒt
photic => 'fәutik
photo => 'fәutәu
photo booth => ˈfəutəu bu:ð
photo finish => ˈfəutəu ˈfiniʃ
photo opportunity => ˈfəutəu ˌɔpəˈtju:niti
photo shoot => ˈfəutəu ʃu:t
photo-offset => ,fәutәu'ɔ:fset
photoactive => ,fәutәu'æktiv
photobiology => ,fәutәu,bai'ɔlәdʒi
photobleaching => ,fәutәu'bli:tʃiŋ
photocall => 'fәjtәjkɔ:l
photocatalysis => ,fәutәukә'tælisis
photocathode => ,fәutәu'kæθәud
photocell => 'fәutәsel
photochemical => .fәutәu'kemikl
photochemistry => .fәutәu'kemistri
photochromic => .fәutәu'krәumik
photochromism => .fәutәu'krәumizm
photocoagulation => ,fәutәukәu,æ^ju'leiʃәn
photocomposition => ,fәutәu,kɔmpә'ziʃәn
photoconductive => .fәutәukәn'dʌktiv
photoconductivity => ,fәutәu,kɔndʌk'tiviti
photoconductor => ,fәutәukәn'dʌktә
photocopier => 'fәutәu.kɒpiә
photocopiers => ˈfəʊtəˌkɔpi:əz
photocopies => ˈfəʊtəˌkɔpi:z
photocopy => 'fәutәu.kɒpi
photocurrent => 'fәutәu.kә:rәnt
photodegradable => ,fәjtәjdi'^reidәbl
photodetector => ,fәutәudi'tektә
photodiode => ,fәutәu'daiәud
photodissociation => ,fәutәudi,sәusi'eiʃәn, -ʃi:-
photodynamic => .fәutәudai'næmik
photoelectric => .fәutәui'lektrik
photoelectricity => ,fәutәuilek'trisiti
photoelectron => 'fәutәui'lektrɒn
photoemission => .fәutәui'miʃәn
photoemitter => ,fәutәui'mitә
photofinishing => ,fәutәu'finiʃiŋ
photog => fә'tɔ^
photogenic => ,fәutәu'dʒenik
photogeological => ,fəʊtəʊ,dʒiːə'lɒdʒəkəl
photogeology => ,fәutәudʒi'ɔlәdʒi
photogram => 'fәutә^ræm
photogrammetry => .fәutәu'græmәtri
photograph => 'fәutәgrɑ:f
photographer => fә'tɔ^rәfә
photographers => fə'tɑgrəfɚs
photographic => .fәutә'græfik
photographic memory => ˌfəʊtəˈgræfɪk ˈmeməri
photographically => ˌfəʊtə'ɡræfɪklɪ
photography => fә'tɒgrәfi
photogravure => .fәutәugrә'vjuә
photoionization => ,fәutәu,aiәni'zeiʃәn
photojournalism => ,fәutәu'dʒә:nәlizm
photolithographic => ,fәutә,liθә'^ræfik
photolithography => .fәutәuli'θɒgrәfi
photolysis => fәu'tɒlәsis
photomap => 'fәutәumæp
photomask => 'fәutәumɑ:sk
photomechanical => .fәutәumә'kænikl
photometer => fәu'tɒmitә
photometric => .fәutәu'metrik
photometry => fәu'tɒmitri
photomicrograph => ,fәutәu'maikrәu^rɑ:f
photomicrography => ,fәjtәjmai'krɔ^rәfi
photomontage => .fәutәumɒn'tɑ:ʒ
photomorphogenesis => ,fәutәu,mɔ:fә'dʒenisis
photomosaic => ,fәutәmәu'zeiik
photomultiplier => ,fәutәu'mʌltiplaiә
photon => 'fәutɒn
photonegative => , fәutәu'ne^әtiv
photonic => ,foʊ'tɑnɪk
photonics => fәu'tɔniks
photons => 'fəʊˌtəns
photoperiod => .fәutәu'piәriәd
photoperiodic => ,fəʊtə,pɪriː'ɒdɪk
photoperiodism => ,fәutәu'piәriәdizm
photophobia => .fәutәu'fәubiә
photophore => 'fәutәufɔ:
photopigment => 'fәjtәj,pi^mәnt
photopolarimeter => 'fәjtәj,pәjlә'rimitә(r)
photopolymer => ,fәutәu'pɔlimә
photopositive => ,fәutәu'pɔzitiv
photoproduct => 'fәutә,prɔdʌkt
photoprotein => 'fəʊtəprəʊti:n
photorealism => ,fәjtәj'riәlizәm
photorealistic => 'fəʊtəʊrɪəlɪstɪk
photoreceptor => ,fәutәuri'septә
photoreconnaissance => ,fәutәuri'kɔnisәns
photoresist => ,fәutәuri'zist
photorespiration => ,fәutәu,respi'reiʃәn
photoresponse => ,fәutәuri'spɔns
photosensitive => .fәutәu'sensitiv
photosensitivity => 'fәjtәj,sensi'tivәti
photosensitize => ,fәutәu'sensi,taiz
photosensitized => ,fəʊtəʊ'sensɪtaɪz
photosensitizes => ,fəʊtəʊ'sensɪtaɪz
photoset => 'fәutәu,set
photosetter => fəʊtəʊ'setər
photosetting => 'fәutәu,setiŋ
photosphere => 'fәutәu.sfiә
photospheric => ,fəutəu'sferik
photostat => 'fәutәustæt
photosynthate => ,fәutә'sinθeit
photosynthesis => .fәutәu'sinθәsis
photosynthesize => ,fәutәu'sinθisaiz
photosynthetic => ,fәutәusin'θetik
photosynthetically => fəʊtəʊsɪn'θetɪklɪ
photosystem => ,fәutә'sistәm
phototactic => ,fәutәu'tæktik
phototaxis => ,fәjtәj'tæksis
phototherapy => .fәutәu'θerәpi
phototransistor => ,fәutәutræn'zistә, -'sis-
phototroph => 'fәjtәjtrɔf
phototropic => ,fәutә'trɔpik
phototropism => fәu'tɒtrәpizm
phototube => 'fәutәutju:b
phototypesetter => ,fәjtәj'taip,setә(r)
phototypesetting => .fәutәu'taipsetiŋ
photovoltaic => ,fәutәuvɔl'teiik
phrasal => 'freizәl
phrasal verb => ˈfreɪzl və:b
phrase => freiz
phraseological => .freiziә'lɒdʒikl
phraseology => .freizi'ɒlәdʒi
phrasing => 'freiziŋ
phratries => 'freɪtrɪ
phratry => 'freitri
phreaker => 'fri:kə
phreaking => ˈfri:kɪŋ
phreatic => fri'ætik
phreatophyte => fri(:)'ætә,fait
phreatophytic => ,fri:ætə'fitik
phrenic => 'freinik
phrenological => .frenә'lɒdʒikl
phrenologist => fre'nɒlәdʒist
phrenology => fre'nɒlәdʒi
Phrygia => 'fridʒiә
Phrygian => 'fridʒiәn
phthalate => 'θæleit
phthalocyanine => ,(f)θæləʊ'saɪəniːn
phthisic => 'θaisik
phthisical => 'θaisikl
phthisis => 'θaisis
phut => fʌt
phyco- => 'faɪkəʊ
phycobilin => ,faikәu'bailin
phycocyanin => ,faikәu'saiәnin
phycoerythrin => ,faikәu'eriθrin
phycological => fai'kɔlədʒi
phycology => fai'kɒlәdʒi
phycomycete => .faikәu'maisi:t
phyla => 'failә
phylacteries => fɪ'lækt(ə)rɪ
phylactery => fi'læktәri
phyletic => fai'letik
phyllis => 'filis
phyllite => 'filait
phyllo => 'fi:lәj,'fai-
phylloclade => 'filәjkleid
phyllode => 'filәud
phyllopod => 'filәpɔd
phylloquinone => ,filәjkwi'nәjn,-'kwinәjn
phyllotactic => ,filәj'tæktik
phyllotaxis => ,filә'tæksis
phylloxera => .filɒk'siәrә
phylogenesis => ,failәj'dʒenisis
phylogenetic => ,failәjdʒi'netik
phylogenic => ,failәj'dʒenik
phylogeny => fai'lɒdʒini
phylum => 'failәm
physiatrics => .fizi'ætriks
physiatrist => ,fizi'ætrist
physic => 'fizik
physical => 'fizikl
physical geography => ˈfizikəl dʒiˈɔɡrəfi
physical science => ˈfizikəl ˈsaiəns
physical therapy => ˈfizikəl ˈθerəpi
physical training => ˈfizikəl ˈtreiniŋ
physicalism => 'fizikәlizm
physicalist => fɪzɪ'kælɪst
physicalistic => ,fizikə'-listik
physicality => fizi'kæliti
physically => 'fizikli
physician => fi'ziʃәn
physicians => fɪ'zɪʃnz
physicist => 'fizisist
physicists => 'fɪzɪsɪsts
physicking => ˈfizikɪŋ
physics => 'fiziks
physio => ˈfɪziəʊ
physiochemical => ,fiziә'kemikәl
physiocracy => .fizi'ɒkrәsi
physiocrat => 'fiziәkræt
physiognomic => ,fiziә'nɔmik
physiognomical => .fiziәg'nɒmikl
physiognomies => ˌfiziˈɔnəmiz
physiognomist => .fizi'ɒgnәmist
physiognomy => .fizi'ɒgnәmi
physiographer => .fizi'ɒgrәfә
physiographic => .fiziә'ɡræfik
physiographical => fɪz'ɪɒɡræfɪkəl
physiography => .fizi'ɒgrәfi
physiological => .fiziә'lɒdʒikl
physiologist => .fizi'ɒlәdʒist
physiology => .fizi'ɒlәdʒi
physiotherapy => .fiziә'θerәpi
physique => fi'zi:k
physiques => fɪ'zi:ks
physis => 'fɪsɪs
physostigmine => ,faisәu'sti^mi:n, -min
phyto- => 'faitәj
phytoalexin => ,faitәjә'leksin
phytochemical => ,faitәu'kemikәl
phytochemistry => ,faitәu'kemistri
phytochrome => 'faitәukrәum
phytoestrogen => ˌfeɪtəʊ'estrədʒən
phytogeographic => ,faitəudʒiə'ɡræfik
phytogeographical => ,faitəudʒi'ɔɡrəfikəl
phytogeography => ,faitәudʒi'ɔ^rәfi
phytolith => 'faitәjliθ
phytopathologist => faɪtəpæ'θɒlədʒɪst
phytopathology => ,faitәupæ'θɔlәdʒi
phytophagous => fai'tɔfә^әs
phytophagy => fai'tɔfәdʒi
phytoplankton => ,faitәu'plæŋktәn
phytosanitary => 'faitәj,sænitәri
phytotoxic => ,faitәu'tɔksik
phytotoxicity => -tɔk'sisiti
phytotoxin => ,faitә'tɔksin
pi => pai
pi-dog => ˈpaɪˌdɔ:g, -ˌdɔg
PIA => 'pi:ә
Piacenza => pjɑ:'tʃensɑ:
piacular => pai'ækjulә
piaffe => pjæf, pi'æf
pial => 'paiәl
pianism => pi'ænizm
pianissimo => pjæ'nisimәu, piә'n-
pianist => 'piәnist
pianistic => pɪənɪs'tɪk
pianists => pi:ˈænɪsts
piano => pi'ɑ:nәu
piano accordion => piˈænəu əˈkɔ:di:ən
pianoforte => pi,ɑ:nәu'fɔ:ti, ,pjæn-
pianofortes => pi:ˌænəʊˈfɔ:teɪz
pianola => piә'nәulә
pianos => piˈænəuz
piassava => pɪæ'sɑ:və
piazza => pi'ætsә
piazzas => pi:ˈæzəz
pibroch => 'pi:brɒk
pic => pik
pica => 'pikә
picador => 'pikәdɒ:
Picardy => 'pikədi
picaresque => .pikә'resk
picaro => 'pi:kɑ:rɒ:
picaroon => .pikә'ru:n
Picasso => pi:'kɑ:ssɒ:
picayune => .pikә'ju:n
Piccadilly => ,pikә'dili
piccalilli => 'pikәlili
piccaninny => 'pikәnini
piccolo => 'pikәlәu
piccolos => ˈpɪkəˌləʊz
pice => pais
pichiciego => ˌpɪtʃɪsɪ'eɪgəʊ
pick => pik
pick-me-up => 'pikmi:ʌp
pick-your-own => pik jɔ: əun
pickaback => 'pikәbæk
pickaninny => 'pikәnini
pickax => 'pi,kæks
pickaxe => 'pi,kæks
pickaxes => ˈpiˌkæksiz
picked => pikt
pickelhaube => 'pikəl,haubə
picker => 'pikә
pickerel => 'pikәrәl
pickerelweed => 'pikәrәlwi:d
pickering => 'pikәriŋ
pickers => ˈpɪkəz
picket => 'pikit
pickets => ˈpikits
picking => 'pikiŋ
pickings => ˈpɪkɪŋz
pickle => 'pikl
pickled => 'pikld
pickler => 'piklә
pickling => 'pikliŋ
picklock => 'piklɒk
pickoff => 'pikɒ:f
pickpocket => 'pikpɒkit
pickpockets => ˈpɪkˌpɔkɪts
pickup => 'pikʌp
Pickwick => 'pikwik
Pickwickian => pik'wikiәn, -kjәn
picky => 'piki
picnic => 'piknik
picnicker => 'piknikә
picnickers => 'piknikə(r)
picnics => ˈpikniks
picong => 'pikɔŋ
picornavirus => pai,kɔ:nә'vaiәrәs
picosecond => 'paikә,sekәnd
picot => pi:'kәu
picotee => .pikә'ti:
picrate => 'pikreit
picrite => 'pikrait
picrotoxin => ,pikrә'tɔksin
Pict => pikt
Pictish => 'piktiʃ
pictogram => ˈpɪktəgræm
pictograph => .piktә'grɑ:f
pictographic => .piktә'græfik
pictography => pik'tɔ^rәfi
Pictor => 'piktә
pictorial => pik'tɒ:riәl
pictorially => pɪk'tɔ:rɪəlɪ
picture => 'piktʃә
picture book => ˈpiktʃə buk
picture card => ˈpiktʃə kɑ:d
picture hat => ˈpiktʃə hæt
picture palace => ˈpiktʃə ˈpælis
picture postcard => ˈpiktʃə ˈpəʊstkɑːd
picture rail => ˈpiktʃə reil
picture window => ˈpiktʃə ˈwindəu
picture-perfect => ˈpiktʃə ˈpə:fikt
picture-postcard => ˈpiktʃə ˈpəʊstkɑːd
pictured => ˈpiktʃəd
picturesque => .piktʃә'resk
picturesquely => ,piktʃə'reskli
picturesqueness => piktʃwˊreskris
picturing => ˈpiktʃərɪŋ
piculet => 'pikjulit
piddle => 'pidl
piddling => 'pidliŋ
piddock => 'pidәk
pidgin => 'pidʒin
pidgins => 'pɪdʒɪn
pie => pai
pie chart => pai tʃɑ:t
pie-dog => 'paidɔ^
pie-eyed => 'pai'aid
pie-faced => 'paɪf'eɪst
piebald => 'paibɒ:ld
piece => pi:s
piece de resistance => pies dә re'zistɑŋs
piece of eight => pi:s ɔv eɪt
piece of work => pi:s ɔv wə:k
pieced => pi:st
piecemeal => 'pi:smi:l
piecework => 'pi:swә:k
pieceworker => 'pi:s.wә:kә
piecrust => 'paikrʌst
pied => paid
pied noir => pje'nәwɑ:
pied-a-terre => pjeidɑ:'teә(r)
piedmont => 'pi:dmәnt
Piedmontese => ,pi:dmɔn'ti:z
Piegan => 'pi:^әn
pieman => 'paimәn
Piemonte => pje'mɔ:nte
pier => piә
pier table => piə ˈteibl
pierce => piәs
pierced => piәst
piercer => 'piәsә
pierces => 'pɪəsɪz
piercing => 'piәsiŋ
piercingly => 'pɪəsɪŋlɪ
pierogi => pi'rәj^i
pierre => pi(:)'eә, peә
Pierrot => 'piәrәu
Piet => 'paiit
pieta => ,pie'tɑ:
pietas => 'paiәtɑ:s, pjei'tɑ:s
pietism => 'paiәtizәm
pietist => 'paiәtist
pietistic => paiә'tistik
piety => 'paiәti
piezoelectric => pai,i:zәui'lektrik
piezoelectricity => pai,i:zәuilek'trisiti
piezometer => .paii'zɒmitә
piffle => 'pifl
piffling => 'pifliŋ
pig => pig
pig-headed => piɡ ˈhedid
pig-headedness => 'pig'hedidnis
pigeon => 'pidʒin
pigeon hawk => ˈpidʒin hɔ:k
pigeon pea => ˈpidʒin pi:
pigeon-breasted => 'pidʒin'brestid
pigeon-hole => 'pɪdʒənh'əʊl
pigeonhole => 'pidʒinhәul
pigeonholed => ˈpɪdʒənˌhəʊld
pigeonholes => ˈpɪdʒənˌhəʊlz
pigeonholing => ˈpɪdʒənˌhəʊlɪŋ
pigeonite => 'pidʒinait
pigface => 'pi^feis
pigfish => 'pigfiʃ
piggeries => ˈpiɡəriz
piggery => 'pigәri
piggies => ˈpiɡiz
pigging => 'pi^iŋ
piggish => 'pigiʃ
piggy => 'pigi
piggy bank => ˈpiɡi bæŋk
piggyback => 'pi^ibæk
piggybacked => ˈpɪgi:ˌbækt
piggybacks => ˈpɪgi:ˌbæks
pighead => 'pɪɡhed
pigheaded => 'pig'hedid
piglet => 'pi^lit
piglets => ˈpɪglɪts
pigling => 'pi^liŋ
pigment => 'pigmәnt
pigmentation => .pigmәn'teiʃәn
pigmented => 'pi^mәntid
pigmy => 'pi^mi
pignut => 'pignʌt
pigpen => 'pigpen
pigskin => 'pigskin
pigsties => ˈpɪgˌstaɪz
pigsty => 'pigstai
pigswill => ˈpɪgswɪl
pigtail => 'pigteil
pigtailed => 'pigteild
pigtails => ˈpɪgˌteɪlz
pigweed => 'pigwi:d
Pik => pik
pika => 'paikә
pike => paik
pikelet => 'paiklit
pikeman => 'paikmәn
pikeperch => 'paik,pә:tʃ
piker => 'paikә
pikes => paiks
pikestaff => 'paikstæf
piki => 'piki
pilaf => pi'lɑ:f
pilaff => ˊpilæf
Pilar => 'pailә(r)
pilaster => pi'læstә
pilate => 'pailәt
pilau => pi'laj
pilchard => 'piltʃәd
pilchards => ˈpɪltʃədz
pile => pail
pile dwelling => pail ˈdwelɪŋ
pileated => paɪletdɪ
piles => pailz
pileup => 'pailʌp
pileus => 'pailiәs
pilewort => 'pailwә:t
pilfer => 'pilfә
pilferage => 'pilfәridʒ
pilfered => ˈpɪlfəd
pilferer => 'pilfәrә
pilfers => ˈpɪlfəz
Pilger => 'pilɡə
pilgrim => 'pilgrim
pilgrimage => 'pilgrimidʒ
pilgrimages => ˈpɪlgrəmɪdʒz
pilgrimize => 'pil^rimaiz
pilgrims => 'pɪlɡrɪmz
piling => 'pailiŋ
pilings => ˈpailiŋz
Pilipino => ,pili'pi:nәj, ,pi:-
pill => pil
pillage => 'pilidʒ
pillaged => ˈpɪlɪdʒd
pillages => ˈpɪlɪdʒz
pillaging => ˈpɪlɪdʒɪŋ
pillar => 'pilә
pillar box => ˈpilə bɔks
pillar-box red => ˈpilə bɔks red
pillared => 'pilәd
pillaret => 'pilәrit
pillbox => 'pilbɒks
pillboxes => ˈpilbɔksiz
Pilling => 'piliŋ
pillion => 'piljәn
pilliwinks => 'piliwiŋks
pillock => 'pɪlək
pilloried => ˈpɪləri:d
pillories => ˈpɪləri:z
pillory => 'pilәri
pillorying => ˈpɪləri:ɪŋ
pillow => 'pilәu
pillow lace => ˈpiləu leis
pillow lava => ˈpiləu ˈlɑ:və
pillowcase => 'pilәjkeis
pillowcases => ˈpɪləʊˌkeɪsiz
pillows => ˈpiləuz
pillowslip => 'pilәjslip
pillowslips => 'pɪləʊslɪp
pillowy => 'pilәui
pillwort => 'pilwә:t
pilocarpine => ,pailәu'kɑ:pin
pilose => 'pailәus
pilosity => pai'lɒsiti
pilot => 'pailәt
pilot biscuit => ˈpailət ˈbiskit
pilot cloth => ˈpailət klɔθ
pilot officer => ˈpailət ˈɔfisə
pilot whale => ˈpailət hweil
pilotage => 'pailәtidʒ
piloted => 'pailәtid
pilothouse => 'pailәthaus
piloting => 'pailәtiŋ
pilotless => 'pailәtlis
pilous => 'pailәs
Pilsen => 'pilzin
pilular => 'piljulә
Pima => 'pi:mә
pimento => pi'mentәu
pimentos => piˈmentəuz
pimiento => pi'mjentәu
pimp => pimp
pimped => pimpt
pimpernel => 'pimpәnel
pimping => 'pimpiŋ
pimple => 'pimpl
pimpled => 'pimpld
pimples => pɪm'pəl
pimply => 'pimpli
pimpmobile => 'pimpmәj,bi:l
pimps => pimps
pin => pin
pin-tuck => 'pɪnt'ʌk
pin-up => ˈpɪnˌʌp
pina colada => ˌpi:nə kəˈlɑ:də
pinafore => 'pinәfɒ:
pinafores => ˈpɪnəˌfɔ:z
pinata => pɪ'nɑ:tə
pinball => 'pinbɒ:l
pince-nez => 'p:nsnei
pincer => ˈpɪnsə(r)
pincer movement => ˈpinsə ˈmu:vmənt
pincers => 'pinsәz
pincette => pe:n'set
pinch => pintʃ
pinch-hit => 'pintʃhit
pinch-runner => 'pɪntʃr'ʌnər
pinchbeck => 'pintʃbek
pinched => 'pintʃt
Pincher => 'pintʃә
pinchers => 'pintʃәz
pinches => pintʃiz
pinching => 'pintʃiŋ
pinchpenny => 'pintʃpeni
pincushion => 'pin.kuʃәn
pincushions => ˈpinkuʃinz
Pindar => 'pindә(r)
Pindaric => pin'dærik
Pinder => 'pindә
pine => pain
pine cone => pain kəun
pine nut => pain nʌt
pineal => 'piniәl
pineapple => 'pain.æpl
pineapple weed => ˈpainˌæpl wi:d
pineapples => 'paɪnæplz
pinecone => 'painkәun
pinene => 'paini:n
Pinero => pi'niәrәu
pinery => 'painәri
pinesap => 'painsæp
pinetum => pai'ni:tәm
piney => 'paini
pinfold => 'pinfәuld
ping => piŋ
ping-pong => 'piŋpɔŋ
pinge => 'pindʒ
pinged => pɪŋd
pinger => 'piŋә
pinging => 'piŋiŋ
pingo => 'piŋgәu
pings => pɪŋz
pinguid => 'piŋgwid
pinguin => 'piŋ^win
pinhead => 'pinhed
pinheaded => 'pinhedid
pinhole => 'pinhәul
pinhole camera => ˈpɪnˌhəʊl ˈkæmərə
pining => 'painiŋ
pinion => 'pinjәn
pinioning => ˈpɪnjənɪŋ
pinions => ˈpɪnjənz
pink => piŋk
pink bollworm => piŋk ˈbəulwə:m
pink gin => piŋk dʒɪn
pink noise => piŋk nɔiz
pink salmon => piŋk ˈsæmən
pink-collar => ˈpɪnkˌkɔlə
pinked => pɪŋkd
Pinkerton => 'piŋkәtәn
pinkie => 'piŋki
pinkies => ˈpiŋkiz
pinking => 'pɪŋkɪŋ
pinking shears => ˈpɪŋkɪŋ
pinkish => 'piŋkiʃ
pinkly => 'piŋkli
pinko => 'piŋkәu
pinks => piŋks
Pinkster => 'piŋkstә(r)
pinky => 'piŋki
pinna => 'pinә
pinnace => 'pinis
pinnacle => 'pinәkl
pinnacled => 'pinәkld
pinnacles => ˈpɪnəkəlz
pinnacling => 'pɪnək(ə)l
pinnae => pɪ'ni:
pinnate => 'pinit
pinnated => 'pinitid
pinnatifid => pi'nætifid
pinnation => ,pin'neiʃәn
pinned => ['pind]
pinner => 'pinә
pinnies => ˈpiniz
pinning => 'piniŋ
pinniped => 'piniped
pinnule => 'pinju:l
pinny => 'pini
pinochle => 'pi:nʌkl, -nɔ-
pinocytosis => ,painәusai'tәusis
pinole => pi'nәulei
pinon => 'pɪnjən
Pinot => pi'nәu
pinout => 'paɪnaʊt
pinpoint => 'pinpɒint
pinpointed => ˈpinpɔintid
pinpointing => ˈpinpɔintɪŋ
pinpoints => ˈpinpɔints
pinprick => 'pinprik
pinpricks => ˈpinpriks
pins => pinz
pinstripe => 'pinstraip
pinstriped => 'pinstraipt
pint => paint
pinta => 'pintә
pintail => 'pinteil
pintle => 'pintl
pinto => 'pintәu
pinto bean => ˈpɪntəʊ bi:n
pintos => ˈpɪntəʊz
pints => paints
pinwheel => 'pinhwi:l
pinworm => 'pinwә:m
piny => 'paini
piolet => 'piәulei
pion => 'paiɔn
pioneer => .paiә'niә
pioneers => ˌpaiəˈniəz
pionic => pai'ɔnik
pions => 'paɪɒn
pious => 'paiәs
pip => pip
pipa => 'pi:pә
pipal => 'pi:pәl
pipe => paip
pipe band => paip bænd
pipe bomb => paip bɔm
pipe cleaner => paip ˈkli:nə
pipe fitter => paip ˈfitə
pipe of peace => paip ɔv pi:s
pipe organ => paip ˈɔ:ɡən
pipe rack => paip ræk
pipe-rack => paipræk
pipeclay => 'paɪpkleɪ
piped => paipt
piped music => paipt ˈmju:zik
pipefish => 'paipfiʃ
pipeful => 'paipful
pipeless => 'paiplis
pipeline => 'paiplain
pipelines => ˈpaɪpˌlaɪnz
pipelining => 'paip,lainiŋ
piper => 'paipә
piperazine => pi'perәzi:n
piperidine => pi'peridi:n
pipers => ˈpaipəz
pipes => paips
pipette => pi'pet
pipework => ˈpaɪpwɜ:k
piping => 'paipiŋ
piping hot => ˈpaɪpɪŋ hɔt
pipistrelle => pɪpɪst'rel
pipit => 'pipit
pipkin => 'pipkin
pipless => 'piplis
Pippa => 'pipә
pipped => 'pɪpt
pippin => 'pipin
pipping => 'pɪpɪŋ
pipsissewa => pip'sisәwә
pipsqueak => 'pipskwi:k
pipsqueaks => 'pɪpskwiːk
pipy => 'paipi
piquancy => 'pi:kәnsi
piquant => 'pi:kәnt
pique => pi:k
piqued => pi:kt
piques => pi:ks
piquet => pi'ket
piquing => pi:kɪŋ
piracies => ˈpaɪərəsi:z
piracy => 'paiәrәsi
piraeus => pai'ri:әs,pi'rei-
Pirandello => ,pirәn'delәu
Piranesi => dʒɔ: 'vɑ: nni: bɑ: t'ti: stɑ:
piranha => pi'rɑ:njә
pirate => 'paiәrәt
pirates => ˈpaiərits
piratic => pai'rætik
piratical => pai'rætikәl
pirating => 'paɪrət
piriform => 'pirә,fɔ:m
pirimicarb => ,pi'rimikɑ:b
piripiri => 'piri'piri
pirogi => pi'rәu^i
pirogue => pi'rәug
piroplasmosis => pirәplæz'mәusis
piroshki => pi'rɔ:ʃki
pirouette => .piru'et
pirouetted => ˌpɪru:ˈetid
pirouettes => ˌpɪru:ˈets
pirouetting => ˌpɪru:ˈetɪŋ
pis aller => ,pi:zɑ:'lei
Pisa => 'pi:zә
piscary => 'piskәri
piscatorial => .piskә'tɒ:riәl
piscatory => 'piskәtәri
Piscean => 'paisiәn,'pi-
Pisces => 'pisi:z
piscicultural => .pisi'kʌltʃәrәl
pisciculture => 'pisikʌltʃә
pisciculturist => .pisi'kʌltʃәrist
piscina => pi'si:nә
piscine => 'pisain
Piscis Austrinus => 'pisisɔ'strainəs, 'pai-
piscivore => pɪ'saɪvɔ:r
piscivorous => pi'sivәrәs
pisco => 'piskәu
pish => piʃ
pishogue => pi'ʃәu^
Pishpek => piʃ'pek
Pisidia => pi'sidiə
pisiform => 'paisifɒ:m
Pisistratus => pai'sistrətəs; pi-
pismire => 'pismaiә
pisolite => 'paisәlait
pisolith => 'paisәliθ
pisolitic => pɪsɒ'lɪtɪk
piss => pis
piss artist => pis ˈɑ:tist
piss in the wind => pis in ðə wind
piss-hole => 'pishəul
piss-poor => pis puə
piss-take => pis teik
piss-up => pis ʌp
pissant => ˈpisænt
pissed => pist
pisses => pisiz
pissing => pisɪŋ
pissoir => pi:'swɑ:
pissy => 'pisi
pistachio => pi'stɑ:ʃiәu
pistacite => 'pistә,sait
piste => pi:st
pistil => 'pistil
pistillate => 'pistilit
pistol => 'pistl
pistol grip => ˈpistl ɡrip
pistole => pi'stәul
pistols => ˈpistlz
piston => 'pistәn
pistons => ˈpistənz
pistou => pi:s'tu:
pit => pit
pit boss => pit bɔs
pit bull => pit bul
pit pony => pit ˈpəuni
pit prop => pit prɔp
pit saw => pit sɔ:
pit stop => pit stɔp
pita => 'pi:tə
pitch => pitʃ
pitch pine => pitʃ pain
pitch-and-putt => 'pitʃən'pʌt
pitch-and-toss => 'pitʃәn'tɔs;-'tɔ:s
pitchblende => 'pitʃblend
pitcher => 'pitʃә
pitcher plant => ˈpɪtʃə plɑ:nt
pitcherful => 'pitʃәful
pitches => pitʃiz
pitchfork => 'pitʃfɔ:k
pitchforks => ˈpɪtʃˌfɔ:ks
pitching => 'pitʃiŋ
pitchman => 'pitʃmәn
pitchout => 'pitʃajt
pitchpole => 'pitʃpәjl
pitchstone => 'pitʃstәjn
pitchy => 'pitʃi
piteous => 'pitiәs
piteously => 'pɪtɪəslɪ
pitfall => 'pitfɒ:l
pitfalls => 'pɪtfɔ:lz
pith => piθ
pith helmet => pɪθ ˈhelmit
pithead => 'pithed
pitheads => ˈpithedz
pithed => pɪθt
pithily => 'piθili
pithiness => 'piθinis
pithing => 'piθiŋ
pithless => 'piθlis
pithos => 'piθɔs, 'paiθɔs
piths => pɪθs
pithy => 'piθi
pitiable => 'pitiәbl
pitiably => 'pɪtɪəblɪ
pitied => ˈpitid
pities => ˈpitiz
pitiful => 'pitiful
pitiless => 'pitilis
pitilessly => 'pɪtɪləslɪ
pitilessness => ˊpitilisnis
pitman => 'pitmәn
pitmen => 'pɪtmən
piton => 'pi:tɒn
pitpan => 'pitpæn
pitt => pit
pitta => 'pi:tə
pittance => 'pitns
pitted => 'pitid
pitter-patter => 'pitәpætә
pitting => 'pitiŋ
pittosporum => pә'tɔspәrәm,pi-
Pittsburgh => 'pitsbә:g
pituitaries => pɪˈtu:ɪˌteri:z
pituitary => pi'tju:itәri
pity => 'piti
pitying => 'pitiiŋ
pityriasis => piti'raiәsis
pivot => 'pivәt
pivotal => 'pivәtәl
pivoted => 'pivәtid
pivoting => 'pivәtiŋ
pivots => ˈpɪvəts
pix => piks
pixel => 'piksәl
pixelate => ˈpɪksəleɪt
pixelated => 'piksəleit
pixelation => pɪksɪ'leɪʃən
pixie => 'piksi
pixies => ˈpiksiz
pixilated => 'piksәleitid
pixy => 'piksi
pizazz => pi'zæz
pizza => 'pi:tsә
pizzas => ˈpitsəz
pizzazz => pi'zæz,pә-
pizzeria => pi:tsә'ri:ә
pizzicato => ,pitsi'kɑ:tәu
pizzle => 'pizl
pj's => 'pi:dʒeiz,pi:'dʒeiz
pkt => 'pi:k'eɪt'i:
placability => .plækә'biliti
placable => 'plækәbl
placard => 'plækɑ:d
placarded => 'plækɑːd
placards => ˈplækˌɑ:dz
placate => plә'keit
placated => ˈpleɪˌkeɪtid
placates => ˈpleɪˌkeɪts
placating => ˈpleɪˌkeɪtɪŋ
placation => plə'keiʃən
placatory => 'pleikәtәri
place => pleis
place card => pleis kɑ:d
place kick => pleis kik
place mat => pleis mæt
place name => pleis neim
place setting => pleis ˈsetiŋ
placebo => plә'si:bәu
placebo effect => pləˈsi:bəʊ iˈfekt
placebos => pləˈsi:bəʊz
placed => 'pleist
placeholder => 'pleishәuldә
placeman => 'pleismәn
placement => 'pleismәnt
placements => ˈpleɪsmənts
placenta => plә'sentә
placental => plә'sentl
placentas => pləˈsentəz
placentation => plæsen'teiʃәn
placer => 'pleisә
placet => 'pleiset
placid => 'plæsid
placidity => plә'siditi
placidly => 'plæsɪdlɪ
Placido => 'plæsidəu
placing => 'pleisiŋ
placket => 'plækit
placodont => 'plækәdɔnt
placoid => 'plækɒid
plafond => plaf
plagal => 'plei^әl
plage => plɑ:ʒ
plagiarise => 'pleidʒiәraiz
plagiarism => 'pleidʒiәrizm
plagiarisms => ˈpleɪdʒəˌrɪzəmz
plagiarist => 'pleidʒiәrist
plagiarists => 'pleidʒiərist
plagiarize => 'pleidʒiәraiz
plagiarized => ˈpleɪdʒəˌraɪzd
plagiarizes => ˈpleɪdʒəˌraɪziz
plagiarizing => ˈpleɪdʒəˌraɪzɪŋ
plagioclase => 'pleidʒiәkleis
plague => pleig
plagues => pleiɡz
plaguing => pleɪg
plaguy => 'pleigi
plaice => pleis
plaid => plæd
plaided => 'plædid
plaids => plædz
plain => plein
plain chocolate => plein ˈtʃɔkəlit
plain clothes => plein kləuðz
plain flour => plein ˈflauə
plain weave => plein wi:v
plain-spoken => p'leɪnsp'əʊkən
plainchant => ˈpleɪntʃɑ:nt
plainclothes => 'plein'klәjðz
plainclothesman => 'plein'klәuðzmәn
plainer => 'pleinә
plaining => pleɪn
plainly => 'pleinli
plainness => 'pleinnis
plains => pleinz
plainsman => 'pleinzmәn
plainsong => 'pleinsɒŋ
plainspoken => 'plein'spәukәn
plaint => pleint
plaintiff => 'pleintif
plaintiffs => ˈpleɪntɪfs
plaintive => 'pleintiv
plaintively => 'pleɪntɪvlɪ
plaints => pleints
plait => pleit
plaited => 'pleɪtɪd
plaiting => plætɪŋ
plaits => pleɪts
plan => plæn
planar => 'pleinә
planarian => plә'nєәriәn
planation => plei'neiʃәn
planche => plɑ:ntʃ, plæntʃ
planchet => 'plæntʃit
planchette => plɑ:n'ʃet
planck => plɑ:ŋk
plane => plein
plane table => plein ˈteibl
plane-polarized => 'plein'pəuləraizd
planed => pleind
planeload => 'pleinlәjd
planer => 'pleinә
planet => 'plænit
planetarium => .plæni'tєәriәm
planetariums => ˌplænɪˈteəri:əmz
planetary => 'plænitri
planetary nebula => ˈplænɪˌteri: ˈnebjələ
planetesimal => .plæni'tesiml
planetoid => 'plænitɒid
planetologist => ,plæni'tɔlәdʒist
planetology => ,plæni'tɔlәdʒi
planets => p'lænɪts
planform => 'plænfɒ:m
plangent => 'plændʒәnt
planification => ,plænifi'keiʃәn
planigale => 'plænigeil,,plæni'^eili
planimeter => plæ'nimitә
planimetric => plænɪ'metrɪk
planimetry => plæ'nimitri,plә-
planish => 'plæniʃ
planisphere => 'plænisfiә
planispheric => ,plæni'sfεərik; 'plei
plank => plæŋk
planking => 'plæŋkiŋ
planks => plæŋks
plankton => 'plæŋktәn
planned => plænd
planner => 'plænә
planners => p'lænəz
planning permission => ˈplænɪŋ pəˈmiʃən
planographic => ,pleɪnə'ɡræfɪk
planography => plә'nɒgrәfi
planometer => plә'nɒmitә
plant => plænt. plɑ:nt
plant hopper => plɑ:nt ˈhɔpə
plantable => 'plɑ:ntәbl
Plantagenet => plæn'tædʒәnit
plantain => 'plæntin
plantain lily => ˈplæntin ˈlili
plantains => ˈplæntinz
plantar => 'plæntә
plantation => plæn'teiʃәn
plantations => plæn'teɪʃnz
planter => 'plæntә
planters => ˈplæntəz
plantigrade => 'plæntigreid
planting => 'plæntiŋ
plantlet => 'plɑ:ntlit
plantocracy => plæn'tɔkrәsi
plantsman => 'plɔ:ntsmәn;'plænts-
planula => 'plænjulә
plaque => plɑ:k
plaques => p'lɑ:ks
plaquette => plɑ:'ket
plash => plæʃ
plashed => plæʃt
plashes => plæʃiz
plashing => plæʃɪŋ
plasm => plæzm
plasma => 'plæzmә
plasma cell => ˈplæzmə sel
plasmalemma => ,plæzmә'lemә
plasmapause => 'plæzmә,pɔ:z
plasmapheresis => ,plæzmә'ferәsis
plasmasphere => ,plәz'mæzfiә
plasmic => 'plæzmik
plasmid => 'plæzmid
plasmin => 'plæzmin
plasminogen => plæz'minәdʒin
plasmodesma => ,plæzmәj'dezmә
plasmodium => plæz'mәudiәm
plasmolyse => 'plæzmәjlaiz
plasmolysis => plæz'mɒlisis
plasmon => 'plæz,mәn
Plassey => 'plɑ:si
plaster => 'plæstә
plasterboard => 'plæstәbɒ:d
plastered => 'plæstәd
plasterer => 'plæstәrә
plasterers => plɑ:s'tərəz
plastering => 'plæstәriŋ
plastery => p'lɑ:stərɪ
plastic => 'plæstik
plastic art => ˈplɑ:stik ɑ:t
plastic arts => ˈplɑ:stik ɑ:ts
plastic bomb => ˈplɑ:stik bɔm
plastic bullet => ˈplɑ:stik ˈbulit
plastic explosive => ˈplɑ:stik iksˈpləusiv
plastic surgery => ˈplɑ:stik ˈsə:dʒəri
plastic wrap => ˈplɑ:stik ræp
plastically => p'læstɪklɪ
plasticine => 'plæstisi:n
plasticity => plæ'stisiti
plasticization => ,plæstisai'zeiʃәn
plasticize => 'plæstisaiz
plasticized => p'læstɪsaɪzd
plasticizer => 'plæstisaizә
plasticizes => ˈplæstisaiziz
plastid => 'plæstid
plastique => plɑ:s'ti:k
plastisol => 'plæstisɔ:l, -sɔl
plastral => 'plæstrәl
plastron => 'plæstrәn
plat => plæt
plat du jour => 'plɑ:dә'ʒjә(r),-dju:'ʒu:r
Plata => 'plɑ:tɑ:
Plataea => plə'ti:ə
platan => p'lætən
platanna => plә'tænә
plate => pleit
plate armour => pleit ˈɑ:mə
plate glass => pleit ɡlɑ:s
plateau => plæ'tәu
plateaux => 'plætəʊz
plated => 'pleitid
plateful => 'pleitful
platelayer => 'pleitleiә
platelet => 'pleitlit
platemaker => 'pleit,meikә(r)
platen => 'plætn
plater => 'pleitә
plateresque => ,plætә'resk
platform => 'plætfɒ:m
platformer => 'plæt,fɔ:mә
platforms => p'lætfɔ:mz
plating => 'pleitiŋ
platinize => 'plætinaiz
platinized => 'plætɪnaɪz
platinizes => 'plætɪnaɪz
platinizing => p'lætɪnaɪzɪŋ
platinoid => 'plætinɔid
platinum => 'plætinәm
platinum blonde => ˈplætnəm blɔnd
platitude => 'plætitju:d
platitudes => p'lætɪtju:dz
platitudinize => .plæti'tju:dinaiz
platitudinized => ,plætɪ'tjuːdɪnaɪz
platitudinizes => ,plætɪ'tjuːdɪnaɪz
platitudinizing => ,plætɪ'tjuːdɪnaɪz
platitudinous => .plæti'tju:dinәs
Plato => 'pleitәu
platonic => plә'tɔnik
Platonism => 'pleitәnizm
Platonist => 'pleitnist
platoon => plә'tu:n
platoons => pləˈtu:nz
Plattdeutsch => 'plɑ:tdɔitʃ
platter => 'plætә
platters => ˈplætəz
platy => 'pleiti
platyhelminth => ,plæti'helminθ
platykurtosis => ,plætikә:'tәusis
platypus => 'plætipәs
platyrrhine => 'plætirain
platysma => plә'tizmә
plaudit => 'plɒ:dit
plaudits => ˈplɔ:dɪts
plausibility => .plɒ:zi'biliti
plausible => 'plɒ:zibl
plausibly => ˌplɔ:zəblɪ
play => plei
play along => plei əˈlɔŋ
play dirty => plei ˈdə:ti
play therapy => plei ˈθerəpi
play-acting => pleɪ ˈæktɪŋ
play-by-play => 'pleibai'plei
playa => 'plaiә
playable => 'pleiәbl
playact => 'pleiækt
playacted => ˈpleɪˌæktid
playacting => 'pleɪˌæktɪŋ
playacts => ˈpleɪˌækts
playback => 'pleibæk
playbill => 'pleibil
playboy => 'pleibɒi
playboys => ˈpleɪˌbɔɪz
playdate => 'pleideit
playdown => 'pleidaun
played-out => p'leɪd'aʊt
player => 'pleiә
player piano => ˈpleɪə piˈænəu
player-manager => p'leɪərm'ænɪdʒər
playfellow => 'plei.felәu
playful => 'pleiful
playgoer => 'pleigәuә
playground => 'pleigraund
playgrounds => p'leɪɡraʊndz
playgroups => ˈpleiɡru:ps
playhouse => 'pleihaus
playhouses => ˈpleɪˌhaʊsiz
playlet => 'pleilit
playlets => 'pleɪlɪt
playlist => 'pleilist
playmaker => 'plei,meikә(r)
playmaking => 'plei,meikiŋ
playmate => 'pleimeit
playmates => ˈpleɪˌmeɪts
playoff => 'pleiɔ:f
playpen => 'pleipen
playpens => ˈpleɪˌpenz
playroom => 'pleiru:m
playrooms => ˈpleiru:mz
playschool => ˈpleɪsku:l
playsuit => 'pleisju:t
plaything => 'pleiθiŋ
playthings => ˈpleɪˌθɪŋz
playtime => 'pleitaim
playwright => 'pleirait
playwrights => ˈpleɪˌraɪts
playwriting => 'plei,raitiŋ
plaza => 'plɑ:zә
plazas => ˈplɑ:zəz
plea => pli:
plea bargain => pli: ˈbɑ:ɡin
pleach => pli:tʃ
plead => pli:d
pleader => 'pli:dә
pleading => 'pli:diŋ
pleadingly => ˈpli:dɪŋli
pleads => pli:dz
pleas => pli:z
pleasance => 'plezns
pleasant => 'pleznt
pleasanter => ˈplezəntə
pleasantness => 'plezntnəs
pleasantries => ˈplezəntri:z
pleasantry => 'plezәntri
please => pli:z
pleased => pli:zd
pleases => pli:ziz
pleasing => 'pli:ziŋ
pleasingly => 'pli:ziŋli
pleasurable => 'pleʒәrәbl
pleasurably => ˈpleʒərəbli
pleasure => 'pleʒә
pleat => pli:t
pleated => ˈpli:tɪd
pleather => 'pleðə(r)
pleating => 'pli:tɪŋ
pleats => pli:ts
pleb => pleb
plebby => 'plebi
plebe => pli:b
plebeian => pli'bi:әn
plebeians => plɪˈbi:ənz
plebiscitary => pli'bisitәri
plebiscite => 'plebisit, -sait
plebs => plebz
plecopteran => pli'kɔptәrәn
plectrum => 'plektrәm
plectrums => ˈplektrəmz
pled => pled
pledge => pledʒ
pledged => pledʒd
pledgee => ple'dʒi:
pledges => pledʒz
pledget => 'pledʒit
pledgor => 'pledʒә
pleiad => 'pli:әd, 'plaiәd
plein-air => p'laɪn'eər
pleiotropic => ,plaiәj'trɔpik
pleiotropy => plai'ɔtrәpi
Pleistocene => 'plaistәsi:n
plena => 'pli:nә, 'ple-
plenaries => ˈpli:nəri:z
plenary => 'plenәri
plenipotentiaries => ˌplenəpəˈtenʃi:ˌeri:z
plenipotentiary => .plenipә'tenʃәri
plenitude => 'plenitju:d
plenteous => 'plentiәs
plenteousness => ˊplentjәsnis
plentiful => 'plentiful
plentifully => 'plentifuli
plentifulness => ˊplentifulnis
plentitude => 'plentitju:d
plenty => 'plenti
plenum => 'pli:nәm
pleochroic => ,pli:ә'krәjik
pleochroism => pli'ɔkrәu,izәm
pleocytosis => ,pli:әusai'tәusis
pleomorphic => ,pli:ә'mɔ:fik
pleomorphism => ,pli:ә'mɔ:fizәm
pleonasm => 'pli:әnæzm
pleonastic => .pli:әu'næstik
pleopod => 'pli:әpɒd
plesiosaur => 'pli:siәsɒ:
plessor => 'plesә
plethora => 'pleθәrә
plethoric => ple'θɒ:rik
plethysmograph => pli'θizmә,^rɑ:f
pleura => 'pluәrә
pleural => 'pluәrәl
pleurisy => 'pluәrisi
pleuritic => .pluә'ritik
pleurodynia => ,pluәrәu'diniә
pleuron => 'pluәrɔn
pleuropneumonia => ,pluәrәnju:'mәunjә
plew => plu:
plexiform => 'pleksifɔ:m
plexiglas => 'pleksi^lɑ:s
plexiglass => 'pleksi^lɑ:s
plexor => 'pleksә
plexus => 'pleiksәs
pliability => .plaiә'biliti
pliable => 'plaiәbl
pliably => ˊplaiәbli
pliancy => 'plaiәnsi
pliant => 'plaiәnt
pliantly => ˊplaiәntli
plica => 'plaikә
plicate => 'plaikit
plication => plai'keiʃәn
plied => plaɪd
plier => 'plaiә(r)
pliers => 'plaiәz
plies => plaɪz
plight => plait
plighted => p'laɪtɪd
plights => plaits
plimsoll => 'plimsәl
plimsolls => plɪm'səlz
plink => pliŋk
plinth => plinθ
plinths => plɪnθs
Pliny => 'plini
Pliocene => 'plaiәsi:n
pliosaur => 'plaiәsәuә
plod => plɒd
plodded => plɔdid
plodder => 'plɒdә
plodders => ˈplɔdəz
plodding => 'plɒdiŋ
plods => plɔdz
ploidy => 'plɔidi
plonk => plɔŋk
plonked => plɔŋkt
plonker => ˈplɒŋkə(r)
plonking => plɔŋkɪŋ
plonks => plɔŋks
plop => plɒp
plopped => plɔpt
plopping => plɔpɪŋ
plops => plɔps
plosion => 'plәuʒәn
plosive => 'plәusiv
plot => plɒt
Plotinus => pləu'tainəs
plotless => plɒt'les
plotline => 'plɔtlain
plotter => 'plɒtә
plotters => p'lɒtəz
plotting => 'plɒtiŋ
plotty => 'plɔti
plotz => plɔts
plough => plau
plough on => plau ɔn
ploughboy => 'plajbɔi
ploughing => 'plauiŋ
ploughman => 'plajmәn
ploughs => plauz
ploughshare => 'plajʃeә(r)
Plovdiv => 'plɔ:vdif
plover => 'plʌvә
plovers => ˈplʌvəz
plow => plau
plowed => plaud
plowman => 'plaumәn
plows => plauz
plowshare => 'plauʃєә
ploy => plɒi
ploys => plɔɪz
pluck => plʌk
plucked => plʌkt
plucker => 'plʌkә
plucking => 'plʌkiŋ
plucks => plʌks
plucky => 'plʌki
plug => plʌg
plug fuse => plʌɡ fju:z
plug-ugly => 'plʌ^,ʌ^li
plugboard => 'plʌ^bɔ:d
plugged => 'plʌɡd
plugger => 'plʌgә
plugging => 'plʌ^iŋ
plughole => ˈplʌghəʊl
plum => plʌm
plum duff => plʌm dʌf
plum pudding => plʌm ˈpudiŋ
plum tomato => plʌm təˈmɑ:təu
plumage => 'plu:midʒ
plumaged => 'plu:midʒd
plumb => plʌm
plumb rule => plʌm ru:l
plumbago => plʌm'beigәu
plumbate => 'plʌmbeit
plumbeous => 'plʌmbiәs
plumber => 'plʌmә
plumbers => ˈplʌməz
plumbic => 'plʌmbik
plumbing => 'plʌmiŋ
plumbism => 'plʌmbizәm
plumbless => 'plʌmlis
plumbous => 'plʌmbәs
plumbs => plʌmz
plume => plu:m
plumed => ˈplu:md
plumery => p'lu:mərɪ
plumes => plu:mz
Plummer => 'plʌmә
plummet => 'plʌmit
plummeted => ˈplʌmɪtid
plummeting => ˈplʌmɪtɪŋ
plummets => ˈplʌmɪts
plummy => 'plʌmi
plumose => 'plu:mәus
plump => plʌmp
plump for => plʌmp fɔ:
plump up => plʌmp ʌp
plumped => plʌmpt
plumper => 'plʌmpә
plumpish => 'plʌmpiʃ
plumply => 'plʌmpli
plumps => plʌmps
plumpy => 'plʌmpi
plums => p'lʌmz
plumule => 'plu:mju:l
plumy => 'plu:mi
plunder => 'plʌndә
plundered => ˈplʌndəd
plundering => ˈplʌndərɪŋ
plunders => ˈplʌndəz
plunge => plʌndʒ
plunge pool => plʌndʒ pu:l
plunged => plʌndʒd
plunger => 'plʌndʒә
plunges => plʌndʒz
plunging => 'plʌndʒiŋ
plunk => plʌŋk
plunked => plʌŋkt
plunking => plʌŋkɪŋ
plunks => plʌŋks
pluperfect => .plu:'pә:fikt
plural => 'pluәrәl
pluralism => 'pluәrәlizm
pluralist => 'pluәrәlist
pluralistic => .pluәrә'listik
pluralities => pluəˈrælitiz
plurality => .pluә'rælәti
pluralization => ,pluərəlai'zeiʃən,-li'z-
pluralize => 'pluәrәlaiz
pluralized => ˈpluərəlaizd
pluralizes => ˈpluərəlaiziz
pluralizing => ˈpluərəlaizɪŋ
plurally => 'pljәrәli
plurals => ˈpluərəlz
pluripotent => pljә'ripәtәnt
plus => plʌs
plus fours => plʌs'fɔ:z
plus-minus => plʌs ˈmainəs
pluses => plʌsiz
plush => plʌʃ
plusher => plʌʃə
plushiest => 'plʌʃi
Plutarch => 'plu:tɑ:k
pluteus => 'plu:tiәs
Pluto => 'plu:tәu
plutocracy => plu:'tɒkrәsi
plutocrat => 'plu:tәkræt
plutocratic => ,plu:tәj'krætik
plutocrats => ˈplu:təkræts
pluton => 'plu:tɔn
Plutonian => plu:'tәunjәn
Plutonic => plu:'tɔnik
Plutonism => 'plu:tәnizәm
plutonium => plu:'tәuniәm
pluvial => 'plu:viәl
ply => plai
plying => p'laɪɪŋ
plymouth => 'plimәθ
plyometrics => plaɪə'metrɪks
plywood => 'plaiwud
pneuma => 'nju:mә
pneumatic => nju:'mætik
pneumatic drill => nu:ˈmætɪk dril
pneumatically => nju:'mætikli
pneumaticity => ,nju:mә'tisiti
pneumatics => nju:'mætiks
pneumatique => nju:'mætik
pneumato- => 'nju:mәtәj
pneumatology => .nju:mә'tɒlәdʒi
pneumatolysis => ,nju:mә'tɔlisis ,nu:-
pneumatolytic => ,nju:mәtәj'litik
pneumatophore => nju'mætәfɔ:
pneumococcus => .nju:mәu'kɒkәs
pneumoconiosis => 'nju:mә,kәuni'әusis, 'nu:-
pneumoencephalography => ,nju:mә,ensifә'lɔ^rәfi
pneumogastric => ,nju:mә'^æstrik
pneumonectomy => ,nju:mәj'nektәmi
pneumonia => nju:'mәunjә
pneumonic => nju:'mɒnik
pneumonitis => ,nju:mәu'naitis
pneumonoultramicroscopicsilicovolcanoconiosis => 'nju:mәnәu ,ʌltrә-,maikrәs' kɔpik'silikәvɔl'keinәu kәuni'әusis
pneumotachograph => nju:mә'tækә^rɑ:f
pneumothorax => ,nju:mәu'θɔ:ræks
PO => pәj
po-faced => ˈpəʊ feɪst
po-mo => 'pəuməu
poach => pәutʃ
poached => pəʊtʃt
poacher => 'pәutʃә
poaches => pəʊtʃiz
Pocahontas => ,pəukə'hɔntəs
pochard => 'pәutʃәd
pochette => pəʊ'ʃɪeɪ
pocho => 'pәjtʃәj
pock => pɒk
pocket => 'pɒkit
pocket book => ˈpɔkit buk
pocket gopher => ˈpɔkit ˈɡəufə
pocket knife => ˈpɔkit naif
pocket mouse => ˈpɔkit maus
pocket watch => ˈpɔkit wɔtʃ
pocket-handkerchief => 'pɔkit'hæŋkәtʃif
pocketable => 'pɒkitәbl
pocketbook => 'pɒkitbuk
pocketed => ˈpɔkitid
pocketfuls => ˈpɔkitfulz
pocketknife => 'pɒkitnaif
pockmark => 'pɒkmɑ:k
pockmarked => 'pɒkmɑ:kt
pockmarks => ˈpɔkmɑ:ks
pocks => pɒk
pocky => 'pɒki
poco => 'pәukәu
pod => pɒd
podagra => pәu'dægrә
podagric => pәu'dægrik
podded => 'pɒdid
podding => 'pɒdɪŋ
podge => pɒdʒ
podger => 'pɔdʒә
Podgorica => 'pɔ:d^ɔ:,ri:tsɑ:
podgy => 'pɒdʒi
podiatrist => pәu'daiәtrist
podiatry => pәu'daiәtri
podium => 'pәudiәm
podiums => 'pəʊdɪəmz
podocarp => 'pɔdәkɑ:p
Podolsk => pә'dɔ:lsk
Podunk => 'pәudʌŋk
podzol => 'pɔdzɔ:l, -zɔl
podzolization => ,pɔdzɔlai'zeiʃәn; -li'z-
podzolize => 'pɔdzɔlaiz
poe => 'pәji
poem => 'pәuim
poesy => 'pәuizi
poet => 'pәuit
poetaster => 'pәuitæstә
poetess => 'pәuitis
poetic => pәu'etik
poetic justice => pәj'etik
poetic licence => pəʊˈetɪk ˈlaisəns
poetical => pәu'etikәl
poetically => pәu'etikәli
poeticism => pə'ʊetɪsɪzəm
poeticize => pәu'etisaiz
poetics => pәu'etiks
poetize => 'pәjitaiz
poetry => 'pәuitri
pogo => 'pәuɡәu
pogo stick => ˈpəʊgəʊ stɪk
pogonophoran => ,pәu^ә'nɔfәrәn
pogrom => 'pɒgrәm
pogroms => ˈpɔɡrəmz
pohutukawa => pәj,hu:tә'kɑ:wә
poi => 'pɒi
poignancy => 'pɒinәnsi
poignant => 'pɒinәnt
poignantly => 'pɔignəntli
poikilitic => ,pɔiki'litik
poikilotherm => pɔi'kilәuθә:m
poikilothermal => pɔi,kilәu'θә:ml, ,pɔikәlәu-
poilu => 'pwa:lu:
poinciana => pɔinsi'ænә
poind => pɔind
poinsettia => pɒin'setiә
poinsettias => pɔinˈsetiəz
point => pɒint
point duty => pɔint ˈdju:ti
point estimate => pɔint ˈestəˌmeit
point guard => pɔint ɡɑ:d
point man => pɔint mæn
point of departure => pɔint ɔv diˈpɑ:tʃə
point-and-click => pɔint ænd klik
point-blank => 'pɔintblæŋk
point-to-pointer => 'pɔinttə'pɔint
pointe => pwænt
pointed => 'pɒintid
pointed arch => ˈpɔɪntɪd ɑ:tʃ
pointedness => ˊpɒitidnis
pointelle => pɔin'tel
pointer => 'pɒintә
pointillism => 'pɒintilizm
pointillist => 'pwæntilist, 'pɔin-
pointillistic => 'pɔɪntɪlɪztɪk
pointing => 'pɔintiŋ
pointless => 'pɒintlis
pointlessly => 'pɔintlisli
pointlessness => 'pɔɪntləsnəs
pointsman => 'pɒintsmәn
pointy => 'pɒinti
pointy-headed => 'pɔintihed
poise => pɒiz
poised => pɔizd
poises => pɔiziz
poisha => 'pɔɪshə
poising => pɔizɪŋ
poison => 'pɒizn
poison gas => ˈpɔizən ɡæs
poison pill => ˈpɔizən pil
poisoner => 'pɒizәnә
poisoners => ˈpɔizənəz
poisoning => 'pɒizәniŋ
poisonous => 'pɒizәnәs
poisons => ˈpɔizənz
Poitiers => 'pwɑ:tjei
Poitou => pwɑ:'tu:
poke => pәuk
poked => pəukt
poker => 'pәukә
poker-faced => 'pәjkәfeist
pokers => ˈpəʊkəz
pokes => pəuks
pokeweed => 'pәukwi:d
pokey => 'pәuki
pokie => 'pәjki
pokier => ˈpəʊki:ə
poking => pəukɪŋ
poky => 'pәuki
pol => pɔl
Polack => 'pәulæk
Poland => 'pәulәnd
polar => 'pәulә
polar body => ˈpəulə ˈbɔdi
polarimeter => .pәulә'rimitә
polarimetric => pәu,læri'metrik
polarimetry => ,pәulә'rimitri
Polaris => pәu'leris
polarisation => ,pәjlәrai'zeiʃәn; -ri'z-
polariscope => pәu'læriskәup
polarise => 'pәjlәraiz
polarities => pəʊˈlærɪti:z
polarity => pәu'læriti
polarizable => 'pәjlәraizәbl
polarization => ,pәjlәrai'zeiʃәn; -ri'z-
polarize => 'pәulәraiz
polarized => 'pəʊləraɪzd
polarizer => 'pәulәraizә
polarizes => ˈpəʊləˌraɪziz
polarizing => ˈpəʊləˌraɪzɪŋ
polarography => pәulә'rɔ^rәfi
polaroid => 'pәulәrɒid
polder => 'pәuldә
Pole => pәul
pole bean => pəul bi:n
pole position => pəul pəˈziʃən
pole-axed => 'pəʊl'ækst
poleaxe => 'pәulæks
polecat => 'pәulkæt
poled => 'pəʊld
polemic => pɒ'lemik
polemical => pә'lemikәl
polemically => pə'lemɪklɪ
polemicist => pɒ'lemisist
polemicists => pəˈlemisists
polemicize => pәu'lemisaiz
polemics => pɔ'lemiks
polenta => pәu'lentә
poles => pəulz
poleward => 'pәjlwәd
polewards => 'pәjlwәdz
police => pә'li:s
police force => pəˈli:s fɔ:s
police officer => pəˈli:s ˈɔfisə
policed => pəˈli:st
policeman => pә'li:smәn
polices => pəˈli:siz
policewoman => pә'li:swumәn
policewomen => pə'li:swɪmɪn
policier => ,pɔli:'sjei
policing => pəˈli:sɪŋ
policy => 'pɒlisi
policyholder => 'pɒlәsi.hәuldә
policyholders => ˈpɔlɪsi:ˌhəʊldəz
policymaker => 'pɔlisi.meikә
policymaking => 'pɔlәsi,meikiŋ
poling => 'pәuliŋ
poliomyelitis => ,pәuliәumaiә'laitis
poliovirus => ,pәuliәu'vaiәrәs
polis => 'pәulis
Polisario => ,pəuli'sɑ:riəu
Polish => 'pɒliʃ
polishable => 'pɒlɪʃeɪbl
polished => 'pɒliʃt
polisher => 'pɒliʃә
polishers => 'pɔliʃə
polishes => ˈpɔliʃiz
polishing => 'pɔliʃiŋ
politburo => pә'litbjuәrәu
polite => pә'lait
politely => pә'laitli
politeness => pә'laitnis
politesse => pɔli'tes
politest => pə'laɪtɪst
politic => 'pɒlitik
political => pә'litikl
political asylum => pəˈlitikəl əˈsailəm
political commissar => pəˈlɪtɪkəl ˈkɑmɪˌsɑr
political correctness => pəˈlɪtɪkəl kəˈrektnəs
political geography => pəˈlitikəl dʒiˈɔɡrəfi
political prisoner => pəˈlitikəl ˈprizənə
political science => pəˈlitikəl ˈsaiəns
political scientist => pəˈlitikəl ˈsaiəntist
politically correct => pəˈlɪtɪkɵlɪ kəˈrekt
politician => .pɒli'tiʃәn
politicians => pɒlɪ'tɪʃnz
politicise => pɒ'lɪtɪsaɪs
politicization => pə,litisai'zeiʃən, -si'z-
politicize => pә'litisaiz
politicized => pəˈlitisaizd
politicizes => pəˈlitisaiziz
politicizing => pəˈlitisaizɪŋ
politick => 'pɔlitik
politicking => 'pɔlitikiŋ
politico => pә'litikәu
politico- => pә'litikәj
politics => 'pɒlitiks
polities => ˈpɔlitiz
polity => 'pɒliti
polje => 'pәulje
polka => 'pәulkә
polka dot => ˈpɔlkə dɔt
polkas => ˈpɔlkəz
poll => pәul
poll tax => pəul tæks
pollack => 'pɒlәk
pollan => 'pɔlәn
pollard => 'pɒlәd
pollarded => 'pɒlədɪd
pollarding => 'pɒlədɪŋ
pollards => 'pɒlədz
polled => pәuld
pollee => ,pәu'li
pollen => 'pɒlәn
pollen basket => ˈpɔlən ˈbɑ:skit
pollen count => ˈpɔlən kaunt
pollen tube => ˈpɔlən tju:b
pollex => 'pɒleks
pollinate => 'pɒlineit
pollinated => ˈpɔləˌneɪtid
pollinates => ˈpɔləˌneɪts
pollinating => ˈpɔləˌneɪtɪŋ
pollination => .pɒli'neiʃәn
pollinator => 'pɒlɪneɪtə
polling station => ˈpəʊlɪŋ ˈsteiʃən
pollinium => pә'liniәm
pollock => 'pɔlәk
pollster => 'pәulstә
pollsters => ˈpəʊlstəz
polltaker => 'pәjl,teikә(r)
pollutant => pә'lu:tәnt
pollutants => pə'lu:tənts
pollute => pә'lu:t
polluted => pә'lu:tid
polluters => pəˈlu:tə(r)
pollutes => pəˈlu:ts
pollution => pә'lu:ʃәn
polly => 'pɔli
pollyanna => .pɔli'ænә
pollywog => 'pɔliwɔ^
polo => 'pәulәu
polo neck => ˈpəʊləʊ nek
polo pony => ˈpəʊləʊ ˈpəuni
polo shirt => ˈpəʊləʊ ʃə:t
polo stick => ˈpəʊləʊ stik
poloidal => pәj'lɔidәl
polonaise => .pɒlә'neiz
polonium => pә'lәuniәm
Polonius => pә'lәjniәs
polony => pә'lәuni
Poltava => pɔl'tɑ:vɑ:
poltergeist => 'pәultә^aist
poltergeists => ˈpəultəɡaists
poltroon => pɒl'tru:n
poltroonery => pɒl'tru:nәri
poly- => 'pɔli
polyacetylene => ,pɔliә'setәli:n
polyacetylenes => ,pɔliә'setәli:nz
polyacrylamide => ,pɔlә'krilәmaid, 'pɔli,ækri'læ-
polyamide => pɔli'æmaid
polyamory => 'pɒljəmərɪ
polyandrous => .pɒli'ændrәs
polyandry => .pɒli'ændri
polyanthus => , pɔli'ænθәs
polyatomic => .pɒliә'tɒmik
Polybius => pɔ'libiəs
polycarbonate => ,pɔli'kɑ:bәnit, -neit
polychaete => 'pɔliki:t
polychromatic => .pɒlikrәu'mætik
polychrome => 'pɒlikrәum
polychromed => ˈpɔlikrəumd
polychromes => ˈpɔlikrəumz
polychroming => ˈpɔlikrəumɪŋ
polychromy => 'pɒlikrәumi
polyclinic => .pɒli'klinik
polyclonal => ,pɔli'klәjnәl
polycrystalline => ,pɔli'kristәlain
polyculture => pɒli:'kʌltʃər
polycyclic => , pɔli'saiklik
polycystic => pɔli'sistik
polycythaemia => pɒli:kaɪ'θi:mɪə
polydactyl => , pɔli'dæktil
polydipsia => ,pɔli'dipsiә
polyelectrolyte => ,pɔlii'lektrәu,lait
polyembryonic => ,pɔliembri'ɔnik
polyembryony => ,pɔli'embriәni
polyene => 'pɔlii:n
polyester => .pɒli'estә
polyethnic => ,pɔli'eθnik
polyethylene => .pɒli'eθili:n
polygamist => pә'ligәmist
polygamous => pә'ligәmәs
polygamy => pә'ligәmi
polygene => 'pɒlidʒi:n
polygenesis => .pɒli'dʒenisis
polygenism => pә'lidʒәnizm
polygenist => 'pɒlɪdʒɪnɪst
polygeny => pә'lidʒini
polyglot => 'pɒliglɒt
polygon => 'pɒligәn
polygonal => pә'ligәnәl
polygons => 'pɒlɪgəns
polygram => 'pɔli^ræm
polygraph => 'pɒligrɑ:f
polygrapher => pə'liɡrəfə; 'pɔliɡrɑ:fə
polygynous => pә'lidʒinәs
polygyny => pә'lidʒini
polyhedral => .pɒli'hi:drәl
polyhedric => ,pɔli'hi:drik, -'he-
polyhedron => .pɒli'hi:drәn
polyhedrons => pɔliˈhedrənz
polyhistor => pɔli'histә
Polyhymnia => .pɒli'himniә
polyimide => ,pɔli'imaid
polymath => 'pɒlimæθ
polymaths => 'pɒlɪmæθ
polymathy => pә'limәθi
polymer => 'pɒlimә
polymerase => 'pɔlimә,reis
polymeric => .pɒli'merik
polymerization => .pɒlimәrai'zeiʃәn
polymerize => 'pɒlimәraiz
polymerized => 'pɒli:məraɪzd
polymerizes => ˈpɔliməraiziz
polymerizing => 'pɒli:məraɪzɪŋ
polymerous => pɔ'limәrәs
polymict => 'pɔlimikt
polymorph => 'pɒlimɒ:f
polymorphic => ,pɔli'mɔ:fik
polymorphism => .pɒli'mɒ:fizm
polymorphonuclear => ,pɔli,mɔ:fә'nju:kljә
polymorphous => .pɒli'mɒ:fәs
polymyositis => ,pɔli,maiә'saitis
polymyxin => ,pɔli'miksin
Polynesia => .pɒli'ni:ʒiә
Polynesian => .pɒli'ni:ʒiәn
polyneuritis => ,pɔlinjuә'raitis
polynomial => .pɒli'nәumiәl
polynuclear => ,pɔli'nju:kljә
polynucleotide => ,pɔli'nju:kljә,taid
polynya => 'pɔliniә
polyoma virus => ˌpɔliˈəumə ˈvaiərəs
polyp => 'pɒlip
polypary => 'pɔlipәri
polypeptide => ,pɔli'peptaid
polyphagous => pә'lifәgәs
polyphase => 'pɒlifeiz
Polyphemus => ,pɔli'fi:mәs
polyphenol => ,pɔli'fi:nɔl
polyphonic => .pɒli'fɒnik
polyphonist => pә'lifәnist
polyphonous => pә'lifәnәs
polyphony => pә'lifәni
polyphosphate => ,pɔli'fɔsfeit
polyphyletic => ,pɔlifai'letik
polypi => 'pɔlipai
polyploid => 'pɒliplɒid
polyploidy => 'pɔli,plɔidi
polypod => 'pɔlipɔd
polypody => 'pɒlipәudi
polypoid => 'pɒlipɒid
polypore => 'pɔlipɔ:
polyposis => ,pɔli'pәusis
polypous => 'pɒlipәs
polypropylene => .pɒli'prәupili:n
polyps => ˈpɔlips
polyptych => 'pɔliptik
polypus => 'pɒlipәs
polyrhythm => 'pɒliriðm
polyribosome => ,pɔli'raibәsәum
polys => 'pɒlɪz
polysaccharide => pɔli'sækәraid
polysaccharides => 'pɒlɪsækærɪdi:z
polysemous => ,pɔli'si:mәs
polysemy => 'pɒlisi:mi
polysome => 'pɔlisәum
polystyrene => .pɒli'stairi:n
polysulphide => ,pɔli'sʌlfaid, -fid
polysyllabic => ,pɔlisi'læbik
polysyllable => 'pɒlisilәbl
polysyllables => 'pɒlɪsɪləb(ə)l
polytechnic => .pɒli'teknik
polytechnics => pɒlɪ'teknɪks
polytene => 'pɔliti:n
polytetrafluoroethylene => 'pɔli,tetrə-,fluərəu'eθili:n
polytheism => 'pɒliθi:izm
polytheist => 'pɒliθi:ist
polytheistic => .pɒliθi:'istik
polythene => 'pɔli,θi:n
polytonal => ,pɔli'tәunәl
polytonality => .pɒlitәu'nælәti
polytype => 'pɔlitaip
polytypic => ,pɔli'tipik
polytypism => ,pɔli'taipizәm
polyunsaturate => ,pɔliʌn'sætʃәrit, -reit
polyunsaturated => ,pɔliʌn'sætʃә,reitid
polyurethane => .pɒli'juriθein
polyuria => ,pɔli'juәriә
polyvalent => .pɒli'veilәnt
polyvinyl => .pɒli'vainil
polyvinylpyrrolidone => ,pɔli,vainil,pirә'lidәun
polyzoan => ,pɔli'zәuәn
pom => pɒm
pomace => 'pʌmis
pomade => pә'mɑ:d
pomaded => pəˈmɑ:did
pomades => pəˈmɑ:dz
pomading => pəˈmɑ:dɪŋ
Pomak => pәu'mɑ:k
pomander => pәu'mændә
pomatum => pә'meitәm
pombe => 'pɔmbi
pome => pәum
pomegranate => 'pɒmgrænit
pomegranates => ˈpɔmˌgrænɪts
pomelo => 'pɒmәlәu
Pomerania => .pɒmә'reiniә
Pomeranian => .pɒmә'reiniәn
pomfret => 'pʌmfrit
pomiculture => 'pәumikʌltʃә
pommel => 'pʌml
pommel horse => ˈpʌml hɔ:s
pommels => ˈpʌmlz
pommy => 'pɒmi
pomology => pәu'mɒlәdʒi
pomp => pɒmp
pompadour => 'pɒmpәdɒ:
pompano => 'pɔmpәnәu
Pompeii => pɒm'peii:
pompey => 'pɔmpi
pompier => 'pɒmpiә
pompom => 'pɔmpɔm
pompon => 'pɒmpɒn
pomposity => pɒm'pɒsiti
pompous => 'pɒmpәs
pompously => 'pɒmpəslɪ
pompousness => ˊpɒmpәsnis
poms => pɔmz
ponce => 'pɔns
ponces => pɔnsiz
poncey => ˈpɒnsi
poncho => 'pɒntʃәu
ponchos => ˈpɔntʃəʊz
poncing => pɔnsɪŋ
poncy => 'pɒnsɪ
pond => pɒnd
pond scum => pɔnd skʌm
ponder => 'pɒndә
ponderability => .pɒndәrә'biliti
ponderable => 'pɒndәrәbl
ponderation => ,pɔndә'reiʃәn
pondered => 'pɒndəd
ponderosa => pɒndə'rəʊzə
ponderosity => .pɒndә'rɒsiti
ponderous => 'pɒndәrәs
ponderously => 'pɔndərəsli
ponders => ˈpɔndəz
pondok => 'pɔndɔk
pondweed => 'pɒndwi:d
pone => pәun
pong => pɒŋ
ponga => 'pɔn^ә
pongee => pɒn'dʒi:
pongid => 'pɔndʒid
pongo => 'pɔŋgәu
pongs => pɔŋz
poniard => 'pɔnjәd
poniarded => ˈpɔnjədid
poniarding => ˈpɔnjədɪŋ
poniards => ˈpɔnjədz
ponies => ˈpəuniz
pons => pɔnz
pons asinorum => ˈpɔnzˌæsəˈnɔ:rəm, -ˈnəʊrəm
pont => pɔnt
pontes => 'pɒntɪz
Pontiac => 'panti,æk
Pontianak => ,pɔnti'ɑ:næk
pontifex => 'pɔnti,feks
pontiff => 'pɒntif
pontiffs => ˈpɔntifs
pontifical => pɒn'tifikl
pontificate => pɒn'tifikit
pontificated => pɔnˈtifikitid
pontificates => pɔnˈtifikits
pontificating => pɔnˈtifikitɪŋ
pontifices => pɔn'tifisi:z
pontil => 'pɔntil
pontine => 'pɒntain
pontoon => pɒn'tu:n
pontoon bridge => pɔnˈtu:n bridʒ