x => eks
X chromosome => 'ekskrәjmәsәjm
x-axis => 'eks,æksis
x-height => 'eksh'aɪt
X-rated => 'eks,reitid
xanadu => 'zænә,du:
xanthate => 'zænθeit
Xanthe => 'zænθi
xanthene => 'zænθi:n
xanthine => 'zænθi:n
xanthoma => zæn'θәumә
xavier => 'zeiviә(r),'zæ-,'zeivjә(r)
xebec => 'zi:bek
xeno- => 'zenәj,'zi:-
xenobiotic => ,zenәjbai'ɔtik,,zi:-
xenobiotics => ,zenә,bai'ɔtiks
xenocryst => 'zenә,krist
xenogamy => zi:'nɒgәmi
xenogeneic => ,zenәjdʒi'ni:ik,,zi:-
xenograft => 'zenә^rɑ:ft
xenolith => 'zenәliθ
xenology => zi'nɔlәdʒi
xenon => 'zenɒn
Xenophanes => zi'nɔfәni:z
xenophobe => 'zenәfәub
xenophobia => ,zenә'fәubiә
xenophobic => ,zenәj'fәjbik,,zi:-
Xenophon => 'zenәfәn
xenotime => 'zenәtaim
xenotransplant => 'zenəʊʃrænsplɑ:nt
xenotransplantation => zi:nəʊˌtrænsplɑ:nˈteɪʃn
xeric => 'ziәrik
xeriscape => zerɪs'keɪp
xero- => 'ziәrәj
xeroderma => ,ziәrәu'dә:mә
xerography => .ziә'rɒgrәfi
xerophile => 'zi:rә,fail
xerophilous => zi'rɒfilәs
xerophthalmia => .ziәrɒf'θælmiә
xerophyte => 'ziәrәufait
xerophytic => 'zerəfaɪtɪk
xerox => 'ziәrɒks
xhosa => 'kәusɑ:, -zɑ:
xi => sai. zai. ksai. ksi:
Xiamen => 'ʃjɑ:'men
Xining => 'ʃi:'niŋ
Xinjiang => 'ʃin'dʒjɑ:ŋ
xiphisternum => ,zifi'stә:nәm
xis => 'zɪs
Xizang => 'ʃi:'zɑ:ŋ
Xmas => 'krismәs
xoanon => 'zәuәnɒn
xu => su:
xylem => 'zailem
xylene => 'zaili:n
xylitol => 'zailә,tɔl
xylo- => 'zailәj
xylographic => zailә'^ræfik
xylography => zai'lɒgrәfi
xylophagous => zai'lɒfәgәs
xylophone => 'zailәfәun
xylophones => ˈzaɪləˌfəʊnz
xylophonist => 'zailәfәunist
xylose => 'zailәus
xystus => 'zistәs