brown sauce => braun sɔ:s
brown trout => braun traʊt
brown-bag => ˈbraʊnˈbæg
brown-nose => braun nəuz
brown-nosing => b'raʊnn'əʊzɪŋ
browne => braun
browned => braʊn
brownfield => ˈbraʊnfi:ld
brownian => 'brajniәn
brownie => 'brauni
brownie point => ˈbrauni pɔint
brownies => ˈbrauniz
Browning => 'brauniŋ
brownish => 'brauniʃ
brownness => 'braunis
brownout => 'braunaut
brownstone => 'braunstәun
brownstones => ˈbraunstəunz
browny => 'brajni
browse => brauz
browsed => brauzd
browser => 'brauzә
browses => brauziz
brrr => br-r-r
brubru => 'brubru:
Bruce => bru:s
brucellosis => .bru:si'lәusis
brucite => 'bru:sait
Bruges => bru:ʒ
Brugge => 'brʌ^ә
bruise => bru:z
bruiser => 'bru:zә(r)
bruisers => ˈbru:zəz
bruises => bru:ziz
bruit => bru:t
bruited => bru:tid
bruiting => bru:tɪŋ
bruits => bru:ts
Brum => bru:m
Brumaire => bru:'meә
brumby => 'brʌmbi
brume => bru:m
brummie => 'brʌmi
brummy => 'brʌmi
brumous => 'bru:mәs
brunch => brʌntʃ
brunches => brʌntʃiz
Brunei => 'bru:nai
brunet => bru:'net
brunette => bru:'net
brunettes => bru:ˈnets
Brunhild => 'brjnhilt
bruno => 'bru:nәu
Brunswick => 'brʌnzwik
brunt => brʌnt
bruschetta => brʊ'sketə
brush => brʌʃ
brush-off => ˈbrʌʃˌɔ:f, -ˌɔf
brush-up => b'rʌʃ'ʌp
brushback => 'brʌʃbæk
brushed => brʌʃt
brushes => brʌʃiz
brushfire => 'brʌʃ,faiә(r)
brushing => 'brʌʃiŋ
brushless => b'rʌʃlɪs
brushstroke => brʌʃɪzt'rəʊk
brushwood => 'brʌʃwud
brushwork => 'brʌʃwә:k
brushy => 'brʌʃi
brusque => brusk
brusquely => 'brʊsklɪ
brusquerie => .bræskә'ri:
Brussels => 'brʌsәlz
brut => bru:t
brutal => 'bru:tәl
brutalise => b'ru:təli:z
brutalism => 'bru:tәlizm
brutalist => 'bru:tәlist
brutalities => bru:ˈtælɪti:z
brutality => bru:'tæliti
brutalization => bru:təlaɪ'zeɪʃən
brutalize => 'bru:tәlaiz
brutalized => ˈbru:tlˌaɪzd
brutalizes => ˈbru:tlˌaɪziz
brutalizing => ˈbru:tlˌaɪzɪŋ
brute => bru:t
brutes => bru:ts
brutish => 'bru:tiʃ
brutishly => b'ru:tɪʃlɪ
brutishness => ˊbruːtiʃnis
Brutus => 'bru:təs
Bruxelles => brju:'sel
bruxism => 'brʌksizm
bryan => 'braiәn
Bryansk => bri:'ɑ:nsk
bryant => 'braiәnt
Bryce => brais
bryological => ,braiə'lɔdʒikəl
bryology => brai'ɒlәdʒi
bryony => 'braiәni
bryophyte => 'braiәfait
Bryozoa => ,braiә'zәjә
bryozoan => ,braiә'zәuәn
Brythonic => bri'θɔnik
bse => ˌbi:es'i:
bsl => 'bi:'es'el
bub => bʌb
bubal => ˊbjuːbәl
bubba => 'bʌbə
bubble => 'bʌbl
bubble and squeak => ˈbʌbl ænd skwi:k
bubble gum => ˈbʌbl ɡʌm
bubble jet printer => ˈbʌbl dʒet ˈprɪntə
bubble pack => ˈbʌbl pæk
bubbled => ˈbʌbld
bubblegum => ˈbʌblgʌm
bubblehead => 'bʌblhed
bubbler => 'bʌblә
bubbly => 'bʌbli
Buber => 'bu:bə
bubinga => bjuː'bɪŋgə
bubo => 'bju:bәu
bubonic => bju:'bɔnik
buccal => 'bʌkәl
buccaneer => .bʌkә'niә
buccaneering => ˌbʌkəˈnɪərɪŋ
buccaneers => ˌbʌkəˈniəz
buccinator => 'bʌksineitә
Bucephalus => bju(:)'sefәlәs
Buchanan => bju:ˈkænən
Bucharest => 'bju:kә'rest
Buchmanism => 'bjkmәnizәm
Buchmanite => 'bjkmәnait
Buchner => 'buknә
buck => bʌk
buck fever => bʌk ˈfi:və
buck naked => bʌk ˈneikid
buck-passing => 'bʌk,pɑ:siŋ
buckaroo => 'bʌkәru:
buckbean => 'bʌkbi:n
buckboard => 'bʌkbɒ:d
bucked => bʌkt
buckeen => ,bʌk'i:n
bucket => 'bʌkit
bucket seat => ˈbʌkit si:t
bucketful => 'bʌkitfjl
bucketfuls => ˈbʌkitfulz
buckets => ˈbʌkits
buckeye => 'bʌkai
buckhorn => 'bʌkhɒ:n
Buckingham => 'bʌkiŋәm
Buckinghamshire => 'bʌkiŋәmʃә(r)
buckjump => ˊbʌkdʒʌmp
buckjumper => 'bʌk,dʒʌmpә(r)
buckle => 'bʌkl
buckle down => ˈbʌkl daun
buckle up => ˈbʌkl ʌp
buckled => 'bʌkld
buckler => 'bʌklә
buckles => ˈbʌklz
buckling => 'bʌkliŋ
buckminsterfullerene => ˌbʌkmɪnstəˈfʊləri:n
bucko => 'bʌkәu
buckra => 'bʌkrә
buckram => 'bʌkrәm
buckramed => 'bʌkrəm
buckraming => 'bʌkrəm
buckrams => 'bʌkrəm
buckshee => 'bʌkʃi:
buckshot => 'bʌkʃɔt
buckskin => 'bʌkskin
buckskinned => 'bʌkskɪn
buckskins => ˈbʌkˌskinz
buckthorn => 'bʌkθɒ:n
buckwheat => 'bʌkhwi:t
buckyball => bʌ'kaɪbɔ:l
bucolic => bju:'kɒlik
bucolically => bju:'kɒlikәli
bud => bʌd
Budapest => bju:dә'pest
Buddh Gaya => ,budɡə'jɑ:
Buddha => 'budә
buddhas => ˈbu:dəz
Buddhism => 'budizm
Buddhist => 'budist
Buddhistic => bu'distik
buddie => 'bʌdi
buddied => ˈbʌdi:d
buddies => ˈbʌdi:z
budding => 'bʌdiŋ
buddle => 'bʌdl
buddleia => 'bʌdliә
buddy => 'bʌdi
buddy-buddy => 'bʌdɪ'bʌdɪ
budge => bʌdʒ
budged => bʌdʒd
budgerigar => 'bʌdʒәri^ɑ:
budgerigars => ˈbʌdʒəriɡɑ:z
budges => bʌdʒz
budget => 'bʌdʒit
budget account => ˈbʌdʒit əˈkaunt
budgetary => 'bʌdʒitәri
budgie => 'bʌdʒi
budging => bʌdʒɪŋ
buds => bʌdz
Buenaventura => 'bwenә,ven'tjjәrә
Buenos Aires => 'bwenәs'aiәriz
buff => bʌf
buffalo => 'bʌfәlәu
buffalo gnat => ˈbʌfələu næt
buffer => 'bʌfә
buffer state => ˈbʌfə steit
buffered => ˈbʌfəd
buffering => 'bʌfәriŋ
buffet => 'bʌfit
buffeted => ˈbʌfitid
buffeting => 'bʌfitiŋ
buffets => ˈbʌfits
buffing => 'bʌfiŋ
bufflehead => 'bʌflhed
buffo => 'bu:fәu
Buffon => bu:'fɔ:ŋ
buffoon => bә'fu:n
buffoonery => bә'fu:nәri
buffoons => bəˈfu:nz
buffy => 'bʌfi
bug => bʌg
bug-eyed => 'bʌ^aid
bugaboo => 'bʌ^әbu:
Buganda => bj'^ændә
bugbane => 'bʌ^bein
bugbear => 'bʌɡbεә
bugbears => ˈbʌgˌbeəz
bugger => 'bʌ^ә
bugger all => ˈbʌɡə ɔ:l
bugger me => ˈbʌɡə mi:
bugger off => ˈbʌɡə ɔf
buggered => ˈbʌgəd
buggering => ˈbʌɡərɪŋ
buggers => ˈbʌɡəz
buggy => 'bʌgi
bughouse => 'bʌghaus
bugle => bju:gl
bugler => 'bju:glә
bugles => ˈbju:gəlz
bugleweed => 'bju:^lwi:d
bugloss => 'bju:glɒs
bugs => bʌgz
buhl => bu:l
build => bild
build on => bild ɔn
build-up => 'bildʌp
buildable => 'bildәbl
builder => 'bildә
building => 'bildiŋ
building site => ˈbildiŋ sait
building society => ˈbildiŋ səˈsaiəti
builds => bildz
buildup => 'bildʌp
built => bilt
built-in => 'bilt'in
built-up => 'biltʌp
Bujumbura => ,bu:dʒәm'burә
Bukhara => bu'kɑ:rә
Bukovina => ,bu:kә'vi:nә
Bulawayo => ,bu:lә'weiәj
bulb => bʌlb
bulbil => 'bʌlbil
bulblet => 'bʌlblit
bulbous => 'bʌlbәs
bulbul => 'bulbul
Bulgar => 'bʌl^ɑ:
Bulgaria => bʌl'^eәriә
bulgarian => bʌl'ɡεәriәn
bulgarians => bʌlˈɡɛəriənz
bulge => bʌldʒ
bulged => bʌldʒd
bulger => 'bʌldʒә
bulges => bʌldʒz
bulging => 'bʌldʒiŋ
bulgur => 'bjl^jә(r)
bulgy => 'bʌldʒi
bulimarexia => bju:,limә'reksiә
bulimia => bju:'limiә
bulk => bʌlk
bulkhead => 'bʌlkhed
bulkier => ˈbʌlki:ə
bulkily => 'bʌlkili
bulkiness => 'bʌlkinis
bulking => 'bʌlkiŋ
bulks => bʌlks
bulky => 'bʌlki
bull => bul
bull terrier => bul ˈteri:ə
bull's-eye => 'bʊlzaɪ
bull-headed => 'bʊlh'edɪd
bulla => 'bʌlә, 'bulә
bullace => 'bulis
bullate => 'bʌleit
bulldike => 'bjldaik
bulldog => 'bjldɔ^
bulldogs => ˈbuldɔɡz
bulldoze => 'buldәuz
bulldozed => ˈbʊlˌdəʊzd
bulldozer => 'buldәuzә
bulldozers => ˈbʊlˌdəʊzəz
bulldozes => ˈbʊlˌdəʊziz
bulldyke => 'bjldaik
Buller => 'bulә
bullet => 'bulit
bullet point => ˈbulit pɔint
bullet train => ˈbulit trein
bulleted => ˈbʌlɪtɪd
bulletin => 'bulitin
bulletins => 'bʊlətɪnz
bulletproof => 'bulitpru:f
bulletproofed => 'bʊlɪtpruːf
bulletproofing => 'bʊlɪtpruːf
bulletproofs => 'bʊlɪtpruːf
bullfight => 'bulfait
bullfighter => 'bʊlfaɪtə(r)
bullfighters => 'bul,faitə
bullfighting => 'bʊlfaɪtɪŋ
bullfights => 'bʊlfaɪts
bullfinch => 'bulfintʃ
bullfrog => 'bulfrɒg
bullfrogs => ˈbulfrɔɡz
bullhead => 'bulhed
bullheaded => 'bul.hedid
bullheadedly => 'bul,hedid
bullhorn => 'bjlhɔ:n
bullied => ˈbulid
bullies => ˈbuliz
bulling => 'buliŋ
bullion => 'buljәn
bullish => 'buliʃ
bullnecked => 'bulnekt
bullock => 'bulәk
bullocks => ˈbuləks
bullocky => 'bʊləkɪ
bullous => 'bjlәs
bullpen => 'bjlpen
bullring => 'bjlriŋ
bullrings => ˈbulriŋz
bullrush => 'bjlrʌʃ
bullseye => 'bulzai
bullshit => 'bulʃit
bullshits => ˈbulʃits
bullshitted => ˈbulʃitid
bullshitting => ˈbulʃitɪŋ
bullshot => 'bjlʃɔt
bullwhip => 'bulhwip
bully => 'buli
bully boy => ˈbuli bɔi
bully pulpit => ˈbuli ˈpʊlpɪt
bullying => ˈbuliŋ
bullyrag => 'buli,ræ^
bulrush => 'bulrʌʃ
bulrushes => 'bʊlrʌʃ
bulwark => 'bʌlwәk
bulwarked => 'bʊlwək
bulwarking => 'bʊlwək
bulwarks => ˈbʊlwəks
bum => bʌm
bum-rush => bʌmrʌʃ
bumbershoot => 'bʌmbәʃu:t
bumble => 'bʌmbl
bumblebee => 'bʌmbl,bi:
bumblebees => ˈbʌmbəlˌbi:z
bumbled => ˈbʌmbəld
bumbler => 'bʌmbəlɚ
bumbles => ˈbʌmbəlz
bumbling => 'bʌmbliŋ
bumboat => 'bʌmbәut
bumf => bʌmf
bummalo => 'bʌmәlәj
bummed => bʌmd
bummer => 'bʌmә
bummers => ˈbʌməz
bumming => 'bʌmiŋ
bump => bʌmp
bumped => bʌmpt
bumper => 'bʌmpә
bumper car => ˈbʌmpə kɑ:
bumper sticker => ˈbʌmpə ˈstɪkə
bumper-to-bumper => 'bʌmpәtә'bʌmpә(r)
bumpers => ˈbʌmpəz
bumph => 'bʌmf
bumpier => ˈbʌmpi:ə
bumpily => 'bʌmpili
bumpiness => 'bʌmpinis
bumping => 'bʌmpiŋ
bumpkin => 'bʌmpkin
bumpkins => ˈbʌmpkɪnz
bumps => bʌmps
bumptious => 'bʌmpʃәs
bumpy => 'bʌmpi
bun => bʌn
Bunbury => 'bʌnbәri
bunch => bʌntʃ
bunch grass => bʌntʃ ɡrɑ:s
bunchberry => 'bʌntʃbәri
bunched => bʌntʃɪd
bunches => bʌntʃiz
bunchflower => 'bʌntʃflauә
bunching => 'bʌntʃiŋ
bunchy => 'bʌntʃi
bunco => 'bʌŋkәu
buncombe => 'bʌŋkәm
bund => bʌnd, bʌnt
bundesbank => 'bundəs,bæŋk
bundesrat => 'bundəs,rɑ:t
Bundestag => 'bundәstɑ:k
bundle => 'bʌndl
bundler => 'bʌndlә
bundles => ˈbʌndlz
bundling => 'bʌndliŋ
bundobust => 'bʌndәbʌst
bundu => 'bjndj
bunfight => 'bʌnfaɪt
bung => bʌŋ
bungalow => 'bʌŋgәlәu
bungalows => ˈbʌŋɡələuz
bungarotoxin => ,bʌŋ^ærәu'tɔksin
bunged => bʌŋd
bungee => 'bʌndʒi:
bunghole => 'bʌŋhәul
bunging => bʌŋɪŋ
bungle => 'bʌŋgl
bungled => ˈbʌŋgəld
bunglers => 'bʌŋglɚ
bungles => ˈbʌŋgəlz
bungs => bʌŋz
Bunin => 'bu:nin
bunion => 'bʌnjәn
bunions => ˈbʌnjənz
bunk => bʌŋk
bunked => bʌŋkt
bunker => 'bʌŋkә
bunkered => 'bʌŋkəd
bunkering => 'bʌŋkәriŋ
bunkhouse => 'bʌŋkhaus
bunking => bʌŋkɪŋ
bunkmate => 'bʌŋkmeit
bunks => bʌŋks
bunkum => 'bʌŋkәm
bunned => bʌnd
bunnies => ˈbʌniz
bunny => 'bʌni
buns => bʌnz
bunsen => 'bʌnsn
bunt => bʌnt
buntal => 'bʌntәl
Bunter => 'bʌntə
bunting => 'bʌntiŋ
buntline => 'bʌntlain
bunya => 'bʌnjә
bunyan => 'bʌnjәn
bunyip => ˈbʌnjɪp
Buonaparte => ,bwɔ:nɑ:'pɑ:te
buoy => bɒi. 'bu:i
buoyage => 'bɒiidʒ
buoyancy => 'bɔiәnsi
buoyant => 'bɒiәnt
buoyantly => 'bɔiəntli
buoyed => ˈbu:i:d
buoying => ˈbu:i:ɪŋ
buoys => ˈbu:i:z
Bupa => 'bju:pə; 'bu:pə
buppie => ˈbʌpi
bur => bә:
bur oak => bə: əuk
Burbage => 'bә:bidʒ
Burberry => 'bә:bәri
burble => bә:bl
burbled => ˈbə:bld
burbles => ˈbə:blz
burbling => 'bә:bliŋ
burbot => 'bә:bәt
burbs => bɜ:bz
burden => 'bә:dn
burdens => ˈbə:dənz
burdensome => 'bә:dnsәm
burdock => 'bә:dɒk
BURDON => 'bə:dn
bureau => 'bjuәrәu
bureau de change => ˌbjʊərəʊ də ˈʃɑ:nʒ
bureaucracies => bjuəˈrɔkrəsiz
bureaucracy => bjuә'rɒkrәsi
bureaucrat => 'bjuәrәukræt
bureaucratese => ,bjuәrәkrә'ti:z
bureaucratic => bjuәrәu'krætik
bureaucratically => ,bjuərə'krætikli
bureaucratisation => bjuə,rɔkrətai'zeiʃən; -ti'z-
bureaucratization => bjʊərəkrətaɪ'zeɪʃn
bureaucratize => bju'rɔkrәtaiz
bureaucratized => bjuəˈrɔkrətaizd
bureaucrats => b'jʊərəkræts
bureaux => bjuә'rәuz
burette => bjuә'ret
burg => bә:^
burgage => 'bә:gidʒ
Burgas => bur'ɡɑ:s
burgee => 'bә:dʒi:
burgeon => 'bә:dʒәn
burgeoned => ˈbɜ:dʒənd
burgeons => ˈbɜ:dʒənz
burger => 'bә:ɡә
burgers => ˈbə:ɡəz
burgess => 'bә:dʒis
burgh => 'bә:g
burgher => 'bә:gә
burghers => ˈbə:ɡəz
Burghley => 'bә:li
burglar => 'bә:glә
burglaries => ˈbɜ:gləri:z
burglarize => 'bә:^lәraiz
burglarized => ˈbɜ:gləˌraɪzd
burglarizes => ˈbɜ:gləˌraɪziz
burglarizing => ˈbɜ:gləˌraɪzɪŋ
burglars => ˈbə:ɡləz
burglary => 'bә:^lәri
burgle => 'bә:gl
burgled => ˈbɜ:gəld
burgles => ˈbɜ:gəlz
burgling => ˈbɜ:gəlɪŋ
burgomaster => 'bә:gә.mɑ:stә
burgonet => 'bә:^әnet
burgoo => 'bә:gu:
Burgos => 'bu:ɡɔ:s
Burgoyne => bə:'ɡɔin
Burgundian => bә:'^ʌndiәn
Burgundy => 'bә:gәndi
burial => 'beriәl
burials => ˈberiəlz
burin => 'bjuәrin
burk => bɜ:k
burka => 'bә:kә
burke => bә:k
burked => bə:kt
burkes => bə:ks
burl => bә:l
burlap => 'bә:læp
burled => bə:ld
burlesque => bә:'lesk
burlesqued => bəˈleskt
burlesques => bəˈlesks
burlesquing => bəˈleskɪŋ
burlier => ˈbə:liə
burliness => 'bә:linis
burling => 'bә:liŋ
Burlington => 'bə:liŋtən
burls => bə:lz
burly => 'bә:li
Burma => 'bә:mә
Burman => 'bә:mәn
burmans => 'bə:mən
Burmese => .bә:'mi:z
burn => bә:n
burner => 'bә:nә
burnet => 'bә:nit
burnett => bә(:)'net, 'bә:nit
Burney => 'bә:ni
burning => 'bә:niŋ
burning bush => ˈbɜ:nɪŋ buʃ
burnish => 'bә:niʃ
burnished => ˈbɜ:nɪʃt
burnisher => 'bә:niʃә
burnishes => ˈbɜ:nɪʃiz
burnishing => 'bә:niʃiŋ
Burnley => 'bə:nli
burnout => 'bә:naut
burns => bә:nz
Burnside => 'bә:nsaid
burnt => bә:nt
burnt ochre => bɜ:nt ˈəukə
burnt offering => bɜ:nt ˈɔ:fərɪŋ
burnt sienna => ˌbɜ:nt siˈenə
burnt-out => ˈbɜ:ntˈaʊt
burp => bә:p
burped => bɜ:pt
burping => bɜ:pɪŋ
burps => bɜ:ps
burr => bә:
Burra => 'bʌrә
burrawang => 'bʌrәwæŋ
burred => bə:d
burring => 'bɜ:rɪŋ
burrito => bә'ritәu
burro => 'burәu
Burroughs => ˈbɜ:rəʊz
burrow => 'bʌrәu
burrowed => ˈbʌrəud
burrowing => ˈbʌrəuɪŋ
burs => bə:z
bursa => 'bә:sә
bursar => 'bә:sә
bursarial => bә:'sєәriәl
bursaries => ˈbə:səriz
bursars => ˈbɜ:səz
bursary => 'bә:sәri
burse => bә:s
bursitis => bә:'saitis
burst => bә:st
bursts => bə:sts
burthen => 'bә:ðәn
burthened => 'bɜːðən
burthening => 'bɜːðən
burthens => 'bɜːðən
burton => 'bә:tn
Burundi => bu'ru:ndi
Burundian => bu'ru:ndiən
bury => 'beri
burying ground => ˈberiiŋ ɡraund
bus => bʌs
bus lane => bʌs lein
bus shelter => bʌs ˈʃeltə
bus station => bʌs ˈsteiʃən
busbar => 'bʌzbɑ:
busby => 'bʌzbi
Busch => buəʃ
bush => buʃ
bush baby => buʃ ˈbeibi
bush fire => buʃ ˈfaiə
bush jacket => buʃ ˈdʒækit
bush league => buʃ li:ɡ
bush telegraph => buʃ ˈtelɪˌgræf
bush-league => ˈbʊʃˌli:g
bushbaby => ˈbʊʃbeɪbi
bushbuck => 'buʃbʌk
bushcraft => 'bjʃkrɑ:ft
bushed => 'buʃt
bushel => 'buʃәl
bushelful => 'bʊʃelfʊl
bushels => ˈbʊʃəlz
bushes => buʃiz
bushido => 'buːʃɪdəʊ; bʊ'ʃiːdəʊ
bushie => 'bjʃi
bushier => ˈbʊʃi:ə
bushiness => 'buʃinis
bushing => 'buʃiŋ
bushland => 'bjʃlænd
bushman => 'bjʃmәn
bushmaster => 'buʃ.mɑ:stә
bushmen => 'bʊʃmən
bushranger => 'bjʃ,reindʒә(r)
bushtit => 'buʃtit
bushveld => 'buʃveld
bushwa => bʊʃ'wɑ:
bushwalking => 'buʃ.hwækiŋ
bushwhack => 'bjʃwæk
bushwhacker => ˈbʊʃwækə(r)
bushwhacking => 'bjʃ,hwækiŋ
bushy => 'buʃi
busied => ˈbizid
busies => ˈbiziz
busily => 'bizili
business => 'biznis
business card => ˈbiznis kɑ:d
business park => ˈbiznis pɑ:k
business person => ˈbiznis ˈpə:sən
businesses => 'bɪznəsɪz
businesslike => 'biznislaik
businessman => 'biznismæn
businessmen => 'biznismen
businessperson => 'bɪznəspɜ:sn
businesswoman => 'bizniswjmæn
busing => 'bʌsiŋ
busk => bʌsk
busked => 'bʌskt
busker => 'bʌskә(r)
buskers => ˈbʌskəz
buskin => 'bʌskin
buskined => 'bʌskind
busking => bʌskɪŋ
busload => 'bʌslәjd
busman => 'bʌsmәn
busman's holiday => ˈbʌsmənz
buss => bʌs
bussed => 'bʌst
busses => 'bʌsiz
bussing => 'bʌsiŋ
bust => bʌst
bust up => bʌst ʌp
bustard => 'bʌstәd
bustee => 'bʌsti:
buster => 'bʌstә
bustier => ˈbʌstieɪ
busting => bʌstɪŋ
bustle => 'bʌsl
bustled => ˈbʌsld
bustles => ˈbʌslz
bustling => 'bʌsliŋ
busts => bʌsts
busty => 'bʌsti
busway => 'bʌswei
busy => 'bizi
busybodies => bɪ'zɪbɒdɪz
busybody => 'bizibɒdi
busying => ˈbiziŋ
busyness => 'bizinis
but => bʌt
but that => bʌt ðæt
butadiene => .bju:tә'daii:n
butane => 'bju:tein
butanol => 'bjutәnәul
butch => butʃ
butcher => 'butʃә
butcher-bird => ˈbutʃə bə:d
butcheries => ˈbutʃəriz
butchers => ˈbutʃəz
butchery => 'butʃәri
bute => bju:t
buteo => 'bju:tiәj
butler => 'bʌtlә
butlers => ˈbʌtləz
butt => bʌt
butt out => bʌt aut
butte => bju:t
butter => 'bʌtә
butter knife => ˈbʌtə naif
butter-and-eggs => 'bʌtәrәn'e^z
butterball => 'bʌtәbɔ:l
buttercream => ˈbʌtəkri:m
buttercup => 'bʌtәkʌp
buttercups => ˈbʌtəˌkʌps
buttered => ˈbʌtəd
butterfat => 'bʌtәfæt
butterfingered => 'bʌtә,fiŋ^әd
butterfingers => 'bʌtәfiŋgәz
butterfish => 'bʌtәfiʃ
butterflies => ˈbʌtəflaiz
butterfly => 'bʌtәflai
butterfly effect => ˈbʌtəflai iˈfekt
butterfly fish => ˈbʌtəflai fiʃ
butterfly ray => ˈbʌtəflai rei
buttering => 'bʌtәriŋ
buttermilk => 'bʌtәmilk
butternut => 'bʌtәnʌt
butternut squash => ˈbʌtənʌt skwɔʃ
butters => ˈbʌtəz
butterscotch => 'bʌtәskɒtʃ
butterwort => 'bʌtәwә:t
buttery => 'bʌtәri
butting => 'bʌtiŋ
buttinsky => bʌ'tinski
buttle => 'bʌtәl
buttock => 'bʌtәk
button => 'bʌtәn
button man => ˈbʌtən mæn
button mushroom => ˈbʌtən ˈmʌʃrum
button-down => 'bʌtәndajn
buttonbush => 'bʌtәnbjʃ
buttonhole => 'bʌtnhәul
buttonhole stitch => ˈbʌtnhəul stitʃ
buttonholed => ˈbʌtnhəuld
buttonholes => ˈbʌtnhəulz
buttonholing => bʌtnhəʊ'lɪŋ
buttoning => 'bʌtniŋ
buttonless => 'bʌtәnlis
buttonwood => 'bʌtnwʊd
buttony => 'bʌtәni
buttress => 'bʌtris
buttressed => ˈbʌtrɪst
buttresses => 'bʌtrəsɪz
buttressing => ˈbʌtrɪsɪŋ
butty => 'bʌti
butut => bj'tu:t
butyl => 'bju:til
butyrate => 'bju:tireit
buxom => 'bʌksәm
buy => bai
buy the farm => bai ðə fɑ:m
buy-in => baɪ ɪn
buyback => 'baibæk
buyer => 'baiә
buying => 'baiiŋ
buyout => ˈbaɪaʊt
buyouts => ˈbaiˌauts
buys => baiz
buz => 'bʌz
buzz => bʌz
buzz bomb => bʌz bɔm
buzz saw => bʌz sɔ:
buzzard => 'bʌzәd
buzzards => ˈbʌzədz
buzzed => bʌzd
buzzer => 'bʌzә
buzzers => 'bʌzəz
buzzes => bʌz
buzzsaw => bʌzɪ'zɔ:
buzzword => 'bʌzwә:d
buzzwords => 'bʌzwɜ:dz
buzzy => 'bʌzi
BVDs => 'bi:'vi:'di:z
bwana => 'bwɑ:nә
by => bai
by all odds => bai ɔ:l ɔdz
by extension => bai iksˈtenʃən
by hook or by crook => bai huk ɔ: bai krʊk
by marriage => bai ˈmæridʒ
by myself => bai maiˈself
by numbers => bai ˈnʌmbəz
by the bye => bai ðə baɪ
by- => baɪ
by-blow => 'baiblәj
by-catch => 'baɪk'ætʃ
by-election => 'baiilekʃ(ә)n
by-laws => 'baɪlɔ:z
by-product => 'baiprɔdʌkt
by-products => 'baɪpr'ɒdʌkts
Bydgoszcz => 'bid^ɔ:ʃtʃ
bye => bai
bye-bye => 'baibai
byelaw => 'bailɒ:
byelaws => baɪ'lɔ:z
Byelorussia => ,bjelә'rʌʃә
Byelorussian => ,bjeləu'rʌʃən
bygone => 'baigɒn
bygones => ˈbaɪgɒnz
bylaw => 'bailɔ:
byname => 'baineim
bypass => 'baipɑ:s
bypassed => ˈbaipɑ:st
bypasses => ˈbaipɑ:siz
bypath => 'baipɑ:θ
byplay => 'baiplei
byproduct => 'bai.prɒdækt
byproducts => 'baɪ,prɒdʌkt
byrd => bә:d
byre => 'baiә
byroad => 'bairәud
byron => 'baiәrәn
Byronic => bai'rɒnik
byssinosis => ,bisi'nәusis
byssus => 'bisәs
bystander => 'baistændә(r)
bystanders => 'baɪstændəz
byte => bait
Bytom => 'bitɔm
byway => 'baiwei
byways => ˈbaɪˌweɪz
byword => 'baiwә:d
bywords => ˈbaiwə:dz
Byzantine => bi'zæntain
Byzantinism => bi'zæntinizm
Byzantinist => bi'zæntinist
Byzantium => bi'zæntiәm