B => bi:
b-ball => biː bɔ:l
B-movie => 'bi:,mu:vi
BA => bɑ:
baa => bɑ:
baa-lamb => 'bɑ:læm
baaed => bɑ:d
baaing => bɑ:ɪŋ
Baal => beiәl
Baalbek => 'bɑ:lbek
baas => bɑ:s
Baathism => 'bɑ:θizəm
Baathist => 'bɑ:θist
bab => bɑ: b
baba => 'bɑ:bә
Babar => 'bɑ:bə
babassu => ,bɑ:bɑ:'su:
Babbage => 'bæbidʒ
Babbitt => 'bæbit
babbitted => ˈbæbitid
babbitting => 'bæbɪtɪŋ
babbitts => ˈbæbits
babble => 'bæbl
babbled => ˈbæbəld
babblement => bæbl'mənt
babbler => 'bæblә(r)
babbles => ˈbæbəlz
babbling => 'bæbliŋ
babe => beib
Babel => 'beibl
babes => 'beɪbz
babesiosis => bә,bi:zi:'әusis
babiche => bɑ:'bi:ʃ
babirusa => bæbi'ru:sә
Babism => 'bɑ:bizәm
baboon => bә'bu:n
baboons => bəˈbu:nz
babouche => bә'bu:ʃ
babu => 'bɑ:bu:
babul => bә'bu:l
Babur => 'bɑ:bə
babushka => bә'bu:ʃkә
baby => 'beibi
baby blues => ˈbeibi blu:z
baby boom => ˈbeibi bu:m
baby boomer => ˈbeibi ˈbu:mə
baby bust => ˈbeibi bʌst
baby fat => ˈbeibi fæt
baby grand => ˈbeibi ɡrænd
baby oil => ˈbeibi ɔil
baby talk => ˈbeibi tɔ:k
baby tooth => ˈbeibi tu:θ
baby walker => ˈbeibi ˈwɔ:kə
Babycham => 'beibiʃæm
babyhood => 'beibihud
babyish => 'beibiiʃ
Babylon => 'bæbilәn
Babylonia => .bæbi'lɒnjә
Babylonian => .bæbi'lɒnjәn
bacalao => ,bækә'laj, 'bæ-
bacardi => bə'kɑ:di:
baccalaureate => .bækә'lɒ:riәt
baccarat => 'bækәrɑ:
Bacchae => 'bæki:
bacchanal => 'bækәnl
bacchanalia => ,bækә'neiljә
bacchanalian => .bækә'neiljәn
bacchant => 'bækәnt
Bacchus => 'bækәs
baccy => 'bæki
bach => bætʃ
bached => bætʃt
bachelor => 'bætʃәlә
bachelor party => ˈbætʃələ ˈpɑ:ti
bachelorette => ,bætʃәlә'ret
bachelorhood => 'bætʃәlәhud
bachelors => 'bætʃələz
baches => bætʃiz
baching => bætʃɪŋ
bacillary => bә'silәri, 'bæsileri
bacilli => bә'silai
bacilliform => bә'silifɒ:m
bacillus => bә'silәs
back => bæk
back alley => bæk ˈæli
back catalogue => bæk ˈkætəlɔɡ
back country => bæk ˈkʌntri
back issue => bæk ˈisju:
back passage => bæk ˈpæsidʒ
back-bencher => 'bækb'entʃə
back-pedal => bæk,pedəl
back-projection => ˈbækprəˌdʒekʃən
back-seat driver => ˈbækˌsi:t
backache => 'bækeik
backbeat => 'bækbi:t
backbench => 'bækbentʃ
backbencher => 'bækbentʃә
backbenches => 'bækbentʃɪz
backbite => 'bækbait
backbiter => 'bækbaitә
backbiting => 'bækbaitiŋ
backboard => 'bækbɒ:d
backbone => 'bækbәun
backbones => 'bækbəʊnz
backbreaking => 'bækbreikiŋ
backcast => 'bækæst
backchat => 'bæktʃæt
backcloth => 'bækklɔθ
backcomb => ˈbækkəʊm
backcountry => 'bækkʌntri
backcourt => 'bæk,kɔ:t
backcross => 'bæk,krɔs
backdate => 'bækdeit
backdated => bækˈdeitid
backdates => bækˈdeits
backdoor => .bæk'dɒ:
backdown => 'bækˌdaʊn
backdrop => 'bækdrɒp
backdrops => 'bækdrɒps
backed => bækt
backer => 'bækә
backers => ˈbækəz
backfield => 'bækfiːld
backfill => bækfil
backfire => .bæk'faiә
backfired => ˈbækˌfaɪəd
backfires => ˈbækˌfaɪəz
backfiring => ˈbækˌfaɪərɪŋ
backflip => 'bæk,flip
backgammon => bæk'gæmәn
background => 'bækgraund
backgrounder => 'bæk,^rajndә(r)
backhand => 'bæk'hænd
backhanded => 'bæk'hændid
backhander => 'bækhændә(r)
backhands => ˈbækhændz
backhoe => 'bækhәj
backing => 'bækiŋ
backland => 'bæk,lænd
backlash => 'bæklæʃ
backless => 'bæklis
backlight => 'bæk.lait
backlighting => 'bæklaɪtɪŋ
backlist => 'bæklist
backlit => 'bæklit
backlog => 'bæklɔ^
backlogging => ˈbækˌlɔgɪŋ
backlogs => ˈbækˌlɔgz
backlot => 'bæklɔt
backmarker => 'bæk,mɑ:kә(r)
backmost => 'bækmәust
backpack => 'bækpæk
backpacker => 'bæk.pækә
backpacking => 'bæk,pækɪŋ
backpacks => ˈbækpæks
backpedal => .bæk'pedl
backpedalled => ˈbækˌpedld
backpedalling => ˈbækˌpedlɪŋ
backpedals => ˈbækˌpedlz
backrest => 'bækrest
backroom => 'bækrum
backroom boy => ˈbækˌru:m bɔi
backsaw => 'bæksɔ:
backscattering => 'bæk,skætәriŋ
backscratcher => 'bækskrætʃә
backscratching => 'bæk,skrætʃiŋ
backseat => 'bæksi:t
backsheesh => 'bækʃi:ʃ
backshift => ˈbækʃɪft
backside => .bæk'said
backsides => ˈbæksaidz
backsight => 'bæksait
backslap => 'bækslæp
backslapper => ˊbækslæpә
backslapping => ˈbækslæpɪŋ
backslash => 'bækdlæʃ
backslide => .bæk'slaid
backslides => ˈbækslaidz
backsliding => 'bækslaɪdɪŋ
backspace => 'bækspeis
backspaced => ˈbækspeist
backspaces => ˈbækspeisiz
backspin => 'bækspin
backsplash => 'bækˌsplæʃ
backstage => 'bæksteidʒ
backstair => bæk'steә(r)
backstairs => .bæk'stєәz
backstay => 'bækstei
backstitch => 'bækstitʃ
backstitched => 'bækstɪtʃ
backstitches => ˈbækstitʃiz
backstop => 'bækstɒp
backstreet => 'bækstri:t
backstretch => 'bækstretʃ
backstroke => 'bækstrәuk
backstroked => 'bækstrəʊk
backstroking => 'bækstrəʊk
backswept => 'bækswept
backswing => 'bækswiŋ
backsword => 'bæksɒ:d
backtrack => 'bæktræk
backtracked => ˈbæktrækt
backtracks => ˈbæktræks
backup => 'bækʌp
backveld => 'bækvelt
backward => 'bækwәd
backward-looking => ˈbækwəd ˈlukiŋ
backwardation => .bækwә'deiʃәn
backwards => 'bækwәdz
backwards compatible => ˈbækwərdz kəmˈpætəbəl
backwash => 'bækwɒʃ
backwater => 'bæk.wɒ:tә
backwaters => ˈbækwɔ:təz
backwood => 'bækwjd
backwoods => 'bækwudz
backwoodsman => 'bækwudzmәn
backyard => 'bæk'jɑ:d
backyards => 'bækjɑ:dz
Bacolod => bɑ:'kəulɔd
bacon => 'beikәn
baconer => 'beɪkənə
Baconian => bei'kәunjәn
bacteremia => ,bæktә'ri:miә
bacteria => bæk'tiәriә
bacterial => bæk'tiәriәl
bactericidal => bæk.tiәri'saidl
bactericide => bæk'tiәrisaid
bacterio- => bæk'tiәriәj
bacteriocin => bæk'tiәriәsin
bacteriological => bæk,tiәriә'lɔdʒikәl
bacteriology => bæk.tiәri'ɒlәdʒi
bacteriolysis => bæk.tiәri'ɒlisis
bacteriolytic => bæk,tiәriә'litik
bacteriophage => bæk'tiәriәfeidʒ
bacteriostasis => ,bæktiәriә'steisis
bacteriostat => bæk'tiәriәstæt
bacteriostatic => bæk,tiәriә'stætik
bacterium => bæk'tiәriәm
bacteriuria => bæk,tiәri'jjәriә
Bactria => 'bæktriә
Bactrian => 'bæktriәn
baculum => 'bækjulәm
bad => bæd
badass => 'bædæs
baddeleyite => 'bædәli,ait
badder => 'bædə
badderlocks => 'bædә,lɔks
baddest => 'bædəst
baddie => 'bædi
baddies => 'bæddaɪz
baddish => 'bædiʃ
baddy => 'bædi
Baden-Baden => 'bɑ:dən'bɑ:dən
badge => bædʒ
badger => 'bædʒә
badgering => 'bædʒə
badgers => ˈbædʒəz
badges => 'bædʒɪz
badinage => bædinɑ:ʒ
badlands => 'bædlændz
badly => 'bædli
badmash => 'bʌdmɑ:ʃ
badminton => 'bædmintәn
badness => 'bædnis
baedeker => 'beidikә
Baeyer => 'beijә
baffle => 'bæfl
bafflegab => 'bæfl^æb
baffler => 'bæflә
baffles => ˈbæflz
baffling => 'bæfliŋ
bafta => 'bæftə
bag => bæg
bag and baggage => 'bæ^idʒ
bag lady => bæɡ ˈleidi
Baganda => bә'^ændә
bagasse => bә'gæs
bagatelle => .bægә'tel
Bagehot => ˈbædʒət
bagel => 'beiɡәl
bagels => ˈbeiɡəlz
bagful => 'bægful
baggage => 'bægidʒ
bagged => bægd
bagger => 'bægә
baggie => 'bæɡɪ
baggier => ˈbægi:ə
bagging => 'bægiŋ
baggy => 'bægi
Baghdad => 'bægdæd
bagman => 'bægmәn
bagmen => 'bæɡmən
bagnio => 'bɑ:njәu
bagpipe => 'bægpaip
bagpiper => 'bægpaipә
baguette => bæ'^et
bagwash => 'bæ^wɔʃ
bagworm => 'bægwә:m
bah => bɒ
bahadur => bə'hɑ:də
Bahamas => bә'hɑ:mәz
Bahamian => bә'heimiәn
Bahasa Malaysia => bəˌhɑ:sə mə'leɪʒə
Bahawalpur => bə'hɑ:wəlpuə
baht => bɑ:t
Bahutu => bәhu:'tu:
bai => bai
Baikal => bai'kɑ:l
bail => beil
bail-out => 'beil,aut
bailable => 'beilәbl
bailed => beild
bailee => .bei'li:
bailer => 'beilә(r)
bailey => 'beili
bailie => 'beili
bailiff => 'beilif
bailiffs => ˈbeilifs
bailing => 'beiliŋ
bailiwick => 'beiliwik
bailment => 'beilmәnt
bailor => 'beilә
bailout => 'beilaut
bails => beilz
bain-marie => bænmә'ri:
Bairam => bai'rɑ:m
bairn => bєәn
bairns => bɛənz
bait => beit
bait-and-switch => beit ænd switʃ
baited => beɪt
baits => beits
baiza => 'baizә
baize => beiz
bajada => bә'hɑ:dә
Bajan => 'beidʒәn
bajra => 'bɑ:dʒrә
bake => beik
bake-off => 'beik,ɔf
bakeapple => 'beik,æpl
baked => 'beikid
baked potato => beɪkt pəˈteitəu
bakehouse => 'beikhajs
bakelite => 'beikәlait
baker => 'beikә
bakeries => ˈbeɪkəri:z
bakers => ˈbeɪkəz
bakery => 'beikәri
bakes => beiks
bakeshop => 'beikʃɔp
bakeware => ˊbeikwєә
Bakewell => 'beikwel
baking => 'beikiŋ
baking powder => 'beikiŋ
baking sheet => ˈbeikiŋ ʃi:t
baking tray => ˈbeikiŋ trei
bakkie => 'bɑ: ki:
baklava => 'bæklәvә
baksheesh => 'bækʃi:ʃ
Baku => bɑ:'ku:
Bakunin => bɑ:'ku:nin
balaclava => bælә'klɑ:vә
balaclavas => bæləˈklɑ:vəz
balalaika => .bælә'laikә
balance => 'bælәns
balanced => 'bælәnst
balancer => 'bælәnsә
balances => ˈbælənsiz
Balanchine => ˈbælənˌtʃi:n
balancing => 'bælәnsiŋ
balas => 'bælәs
balas ruby => ˈbæləs ˈru:bi
balata => 'bælәtә
Balaton => 'bælәtɔn
balboa => bæl'bәuә
balbriggan => bæl'brigәn
balconied => 'bælkәnid
balconies => ˈbælkəniz
balcony => 'bælkәni
bald => bɒ:ld
bald cypress => bɔ:ld ˈsaɪprɪs
baldachin => 'bɒ:ldәkin
balder => 'bɔ:ldə
balderdash => 'bɒ:ldәdæʃ
baldhead => 'bɒ:ldhed
baldie => 'bɔ:ldi
balding => 'bɔ:ldiŋ
baldish => 'bɔ:ldiʃ
baldly => 'bɒ:ldli
baldness => 'bɒ:ldnis
baldpate => 'bɒ:ldpeit
baldric => 'bɒ:ldrik
baldwin => 'bɔ:ldwin
baldy => 'bɔ:ldi
bale => beil
Balearic => ,bæli'ærik
baled => beɪl
baleen => bә'li:n
baleen whale => bəˈli:n hweil
balefire => 'beil.faiә
baleful => 'beilful
balefully => 'beilfuli
balefulness => 'beifulnis
baler => 'beilә
bales => beɪlz
balfour => 'bælfuә
Bali => 'bɑ:li
balibuntal => ,bæli'bʌntәl
Balinese => bɑ:li'ni:z
baling => 'beiliŋ
balk => bɒ:k
Balkan => 'bɒ:lkәn
Balkanization => .bɒ:lkәnai'zeiʃәn
Balkanize => 'bɒ:lkәnaiz
balkanized => 'bɔ:lkənaiz
Balkans => 'bɔ:lkənz
balked => 'bɔ:kt
Balkhash => bæl'kæʃ
balkier => ˊbɒːkiә
balkiest => ˊbɒːkist
balking => 'bɔ:kiŋ
balks => 'bɔ:ks
balky => 'bɒ:ki
ball => bɒ:l
ball boy => bɔ:l bɔi
ball game => bɔ:l ɡeim
ball girl => bɔ:l ɡə:l
ball lightning => bɔ:l ˈlaitniŋ
ball-bearing => 'bɔ:lb'eərɪŋ
ballad => 'bælәd
ballade => bæ'lɑ:d
balladeer => .bælә'diә
balladry => 'bælәdri
ballads => 'bælədz
Ballarat => ,bælə'ræt
ballast => 'bælәst
ballasted => ˈbæləstid
ballasting => 'bælәstiŋ
ballasts => ˈbæləsts
Ballater => bə'lɑ:tei
ballcarrier => 'bɔ:l,kæriә(r)
baller => 'bɔ:lә
ballerina => .bælә'ri:nә
ballerinas => ˌbæləˈri:nəz
ballet => 'bælei
balletic => bæ'letik
balletically => bæ'letikәli
balletomane => bæ'letәmein
balletomania => bæ,letә'meinjә
ballets => ˈbæleiz
ballgown => 'bɔːlgaʊn
ballhandler => 'bɔ:l,hændlə
balling => 'bɔ:liŋ
Balliol => 'beiliəl
ballista => bә'listә
ballistic => bә'listik
ballistic missile => bəˈlɪstɪk ˈmisail
ballistically => bə'listikli
ballistics => bә'listiks
ballocks => 'bɔlәks
ballon => bɑ:'ljŋ
balloon => bә'lu:n
balloon angioplasty => bəˈlu:n ˈændʒi:əˌplæsti:
balloon catheter => bəˈlu:n ˈkæθitə
balloonfish => bә'lu:nfiʃ
ballooning => bә'lu:niŋ
balloonist => bә'lu:nist
balloons => bəˈlu:nz
ballot => 'bælәt
balloted => ˈbælətid
ballotin => 'bælətin
ballots => ˈbæləts
ballpark => 'bɔl.pɑ:k
ballplayer => 'bɔ:l,pleiә(r)
ballpoints => ˈbɔ:lˌpɔɪnts
ballroom => 'bɒ:lrum
ballroom dancing => ˈbɔ:lˌru:m ˈdænsɪŋ
ballrooms => ˈbɔ:lˌru:mz
balls-up => 'bɔ:lzʌp
ballsiness => 'bɔ:lsinis
ballsy => 'bɔ:lzi
bally => 'bæli
ballyhoo => .bæli'hu:
ballyhooed => ,bæli'hu:d
ballyhooing => ˈbæli:ˌhu:ɪŋ
ballyhoos => ˈbæli:ˌhu:z
Ballymena => ,bæli'mi:nə
ballyrag => 'bæliræ^
ballyrags => 'bæliræɡ
balm => bɑ:m
balmacaan => ,bælmә'kɑ:n
balminess => 'bɑ:minis
BALMORAL => bæl'mɔrәl
balms => bɑ:mz
balmy => 'bɑ:mi
balneology => .bælni'ɒlәdʒi
balneotherapy => ,bælniә'θerәpi
baloney => bә'lәuni
balsa => 'bɒlsә
balsa wood => ˈbɔ:lsə wud
balsam => 'bɒ:lsәm
balsam poplar => ˈbɔ:lsəm ˈpɔplə
balsamic => bɒ:l'sæmik
balsamic vinegar => bɔ:lˌsæmɪk ˈvɪnɪgə(r)
balt => bɔ:lt
Balti => 'bɔ:lti, 'bælti
Baltic => 'bɒ:ltik
Baltimore => 'bɒ:ltimɒ:
Baluchi => bә'lu:tʃi:
Baluchistan => bə'lu:tʃistɑ:n; -stæn
balun => 'bælәn
baluster => 'bælәstә
balustrade => .bælә'streid
balustrades => ˈbæləˌstreɪdz
Balzac => 'bælzæk
Balzacian => bæl'zeiʃәn
bam => bæm
Bamako => 'bɑ:mәkәu
Bambara => bɑ:m'bɑ:rә
Bamberg => 'bæmbəɡ
bambino => bæm'bi:nәu
bamboo => bæm'bu:
bamboos => bæmˈbu:z
bamboozle => bæm'bu:zl
bamboozles => bæmˈbu:zəlz
bamboozling => bæmˈbu:zəlɪŋ
ban => bæn
Banaba => bә'nɑ:bә
banal => bә'nɑ:l
banality => bә'næliti
banana => bә'nɑ:nә
banana republic => bəˈnɑ:nə riˈpʌblik
banana skin => bəˈnɑ:nə skin
banana split => bəˈnɑ:nə split
bananas => bә'nɑ:nәs
banausic => bә'nɔ:sik
Banbury => 'bænbәri
Banca => 'bɑ:ŋkɑ:
banco => 'bæŋkәu
band => bænd
banda => 'bɑ:ndә
bandage => 'bændidʒ
bandaged => 'bændɪdʒ
bandages => ˈbændidʒz
bandana => bæn'dænә
bandanna => bæn'dænә
bandannas => bænˈdænəz
Bandar => 'bʌndɑ:
Bandar Seri Begawan => bæn'dɑ: 'siәri: bә'^ɑ:wæn
bandbox => 'bændbɒks
bandeau => 'bændәu
banded => 'bændid
bander => bændə
banderilla => ,bændә'rilә
banderillero => ,bændәril'eәrәu
banderole => 'bændәrәul
bandersnatch => 'bændәsnætʃ
bandgap => 'bændgæp
bandh => bɑ:nd
bandicoot => 'bændiku:t
bandied => ˈbændid
bandier => ˊbændiә
bandies => ˈbændiz
bandiest => ˊbændiist
banding => 'bændiŋ
bandit => 'bændit
banditry => bæn'ditiri
Bandjarmasin => ,bændʒә'mɑ:sin
bandleader => 'bænd,li:dә(r)
bandmaster => 'bænd.mɑ:stә
bandobast => 'bʌndәjbәst
bandog => 'bændɒg
bandora => bæn'dɔ:; bæn'dɔ:rə
bands => 'bændz
bandsaw => ˈbændsɔ:
bandsman => 'bændzmәn
bandsmen => 'bændzmən
bandstand => 'bændstænd
bandstands => ˈbændstændz
Bandung => 'bɑ:ndjŋ
bandwagon => 'bænd.wægәn
bandwidth => 'bændwidθ
bandy => 'bændi
bandy-legged => 'bændile^d
bandying => ˈbændiŋ
bane => bein
baneberry => 'beinbәri
baneful => 'beinful
Banff => bænf
Banffshire => 'bæmfʃә(r)
bang => bæŋ
bang-up => 'bæŋʌp
Bangalore => ,bæŋ^ә'lɔ:
banger => 'bæŋә
bangers => ˈbæŋəz
banging => 'bæŋiŋ
Bangkok => 'bæŋkɒk
Bangladesh => ,bɑ:ŋ^lә'deʃ
Bangladeshi => -ʃi
bangle => 'bæŋgl
bangles => ˈbæŋɡlz
Bangor => 'bæŋɡɔ:
bangtail => 'bæŋteil
Bangui => bɑ:ŋ'^i
bani => 'bɑ:ni
bania => 'bænjә
banish => 'bæniʃ
banishes => ˈbæniʃiz
banishing => ˈbæniʃɪŋ
banishment => 'bæniʃmәnt
banister => 'bænistә
banisters => 'bænɪstəz
Banjarmasin => ,bændʒә'mɑ:sin
banjax => 'bændʒæks
banjo => 'bændʒәu
banjoist => 'bændʒәuist
banjos => ˈbændʒəʊz
Banjul => 'bændʒu:l
bank => bæŋk
bank card => bæŋk kɑ:d
bank manager => bæŋk ˈmænidʒə
bank note => 'bæŋk nәjt
bankability => ,bæŋkә'biliti
bankable => 'bæŋkәbl
bankbook => 'bæŋkbuk
banked => bæŋkt
banker => 'bæŋkә
bankers => ˈbæŋkəz
banket => 'bæŋkit
banking => 'bæŋkiŋ
banknote => 'bæŋknәut
banknotes => 'bæŋknəʊts
bankroll => 'bæŋkrәul
bankrolled => ˈbæŋkrəuld
bankrolling => ˈbæŋkrəulɪŋ
bankrolls => ˈbæŋkrəulz
bankrupt => 'bæŋkrʌpt
bankruptcies => ˈbæŋkrʌptsɪz
bankruptcy => 'bæŋkrәptsi
bankrupted => ˈbæŋkrʌptid
bankrupting => ˈbæŋkrʌptɪŋ
bankrupts => ˈbæŋkrʌpts
banks => bæŋks
banksia => 'bæŋksiә
banner => 'bænә
banner headline => ˈbænə ˈhedlain
bannered => 'bænə
banneret => ,bænә'ret
bannister => 'bænistә
bannisters => 'bænɪstə
bannock => 'bænәk
Bannockburn => 'bænək,bə:n
banns => bænz
banquet => 'bæŋkwit
banqueted => 'bæŋkwɪt
banquets => 'bæŋkwɪt
banquette => bæŋ'ket
Banquo => 'bæŋkwәu, 'bæn-
bans => bænz
banshee => bæn'ʃi:
banshees => bænˈʃi:z
bant => bænt
bantam => 'bæntәm
bantams => ˈbæntəmz
bantamweight => 'bæntәmweit
banteng => 'bɑ:ntәŋ
banter => 'bæntә
bantered => ˈbæntəd
banters => ˈbæntəz
bantling => 'bæntliŋ
Bantu => .bæn'tu:
banyan => 'bænjәn
banyans => 'bænjən
banzai => 'bɑ:n'zai
bao => bau
baobab => 'beiәubæb
Baotou => 'baj'tәj
BAP => bæp
baptise => bæp'taiz
baptism => 'bæptizm
baptismal => bæp'tizmәl
baptismal name => bapˈtizməl neim
baptisms => ˈbæpˌtɪzəmz
Baptist => 'bæptist
baptistery => 'bæptistәri
baptists => ˈbæptɪsts
baptize => bæp'taiz
baptizes => bæpˈtaɪziz
baptizing => bæpˈtaɪzɪŋ
bapu => 'bɑ:pu
bar => bɑ:
bar billiards => bɑ: ˈbɪljədz
bar girl => 'bɑ:ɡə:l
bar line => bɑ: lain
bar mitzvah => ˌbɑ: ˈmɪtsvə
bar sinister => bɑ: ˈsinistə
bar stool => bɑːr stu:l
Barak => 'beәræk
barathea => ,beәrә'θiә
barb => bɑ:d
Barbadian => bɑ:'beidiәn
Barbados => bɑ:'beidәus
barbara => 'bɑ:bәrә
barbarian => bɑ:'bєәriәn
barbaric => bɑ:'bærik
barbarism => 'bɑ:bәrizәm
barbarities => ˈbɑ:bikju:z
barbarity => bɑ:'bæriti
barbarization => .bɑ:bәrai'zeiʃәn
barbarize => 'bɑ:bәraiz
barbarized => ˈbɑ:bəraizd
barbarizes => ˈbɑ:bəraiziz
barbarizing => ˈbɑ:bəraizɪŋ
Barbarossa => ,bɑ:bә'rɔsә
barbarous => 'bɑ:bәrәs
Barbary => 'bɑ:bәri
barbecue => 'bɑ:bikju:
barbecue sauce => ˈbɑ:bikju: sɔ:s
barbecued => ˈbɑ:bikju:d
barbecues => ˈbɑ:bikju:z
barbecuing => ˈbɑ:bikju:ɪŋ
barbed => bɑ:bd
barbel => 'bɑ:bәl
barbell => 'bɑ:bel
barbeque => 'bɑ:bәkju:
barber => 'bɑ:bә
barbered => 'bɑːbə
barbering => 'bɑ:bәriŋ
barberry => 'bɑ:bәri
barbers => ˈbɑ:bəz
barbet => 'bɑ:bit
barbette => bɑ:'bet
barbican => 'bɑ:bikәn
barbital => 'bɑ:bitæl
barbitone => 'bɑ:bitәun
barbiturate => bɑ:'bitjurәt
barbiturates => bɑ:'bɪtjʊərɪts
barbola => bɑ:'bәulә
barbotine => 'bɑ:bә,ti:n
barbs => bɑ:bz
Barbuda => bɑ: 'bu: dә
barbule => 'bɑ:bju:l
barbwire => bɑːb'waɪə
barcarole => bɑ:kә'rɔl, bɑ:kә'rәjl
Barcelona => .bɑ:si'lәunә
barchan => bɑ:'kɑ:n, 'bɑ:kɑ:n
barclay => 'bɑ:kli
Barclays => ba:'kleiz
barcode => bɑ:'kəʊd
bard => bɑ:d
barded => bɑːd
Barden => 'bɑ:dәn
bardic => 'bɑ:dɪk
barding => 'bɑ:diŋ
bardolatry => bɑ:'dɒlәtri
Bardolino => ,bɑ:dә'li:nәj
bards => bɑ:dz
bare => bєә
bare-knuckle => ˈbɛəˈnʌkl
bareback => 'bєәbæk
barebacking => 'bεəbækiŋ
bareboat => 'beә'bәjt
barefaced => 'bєәfeist
barefoot => 'bєәfut
barefooted => .bєә'futid
barehanded => 'bєә'hændid
bareheaded => 'bєә'hedid
barelegged => 'beә'le^id
barely => 'bєәli
bareness => 'bєәnis
barents => 'bærәnts
barer => bɛəə
bares => bɛəz
barf => bɑ:f
barfed => bɑ:ft
barfing => bɑ:fɪŋ
barfly => 'bɑ:flai
barfs => bɑ:fs
bargain => 'bɑ:gin
bargained => ˈbɑ:ɡind
bargainer => 'bɑ:ginә
bargainers => 'ba:ginə
bargaining => 'bɑ:giniŋ
bargaining counter => ˈbɑ:ɡiniŋ ˈkauntə
barge => bɑ:dʒ
barge in => bɑ:dʒ in
bargeboard => 'bɑ:dʒbɒ:d
barged => bɑːdʒ
bargee => bɑ:'dʒi
bargees => bɑː'dʒiː
barges => bɑ:dʒz
Barham => 'bærәm
barhop => 'bɑ:hɒp
bari => 'bɑ:ri
barilla => bә'rilә
baring => 'beәriŋ
barista => bə'rɪstə
barite => 'bєәrait
baritone => 'bæritәun
baritones => ˈbærɪˌtəʊnz
barium => 'bєәriәm
bark => bɑ:k
bark beetle => bɑ:k ˈbi:tl
barked => bɑ:kt
barkeep => 'bɑ:ki:p
barkeeper => 'bɑ:ki:pә
barkentine => 'bɑ:kәnti:n
barker => 'bɑ:kә
barking => 'bɑ:kiŋ
barking deer => ˈbɑ:kiŋ diə
barks => bɑ:ks
barley => 'bɑ:li
barley water => ˈbɑ:li ˈwɔ:tə
barley wine => ˈbɑ:li wain
barleycorn => 'bɑ:likɒ:n
Barlow => 'bɑ:lәu
barm => bɑ:m
barmaid => 'bɑ:meid
barmaids => ˈbɑ:meidz
barman => 'bɑ:mәn
barmbrack => 'bɑ:m,bræk
barmier => ˈbɑ:miə
barmy => 'bɑ:mi
barn => bɑ:n
barn dance => bɑ:n dɑ:ns
barn door => bɑ:n dɔ:
barn owl => bɑ:n aul
barn swallow => bɑ:n ˈswɔləu
Barnabas => 'bɑ:nəbəs
Barnaby => 'bɑ:nәbi
barnacle => 'bɑ:nәkl
barnacle goose => ˈbɑ:nəkl ɡu:s
barnacles => 'bɑ:nәklz
barnard => 'bɑ:nәd
barnes => bɑ:nz
Barnett => 'bɑ:net
barney => 'bɑ:ni
barns => bɑ:nz
Barnsley => 'bɑ:nzli
barnstorm => 'bɑ:nstɒ:m
barnstormer => 'bɑ:nstɒ:mә
barnstorming => 'bɑrnstɔrmɪŋ
barnyard => 'bɑ:njɑ:d
baro- => 'bærәj
Baroda => bə'rəudə
barograph => 'bærәgrɑ:f
Barolo => bә'rәulәu
barometer => bә'rɒmitә
barometers => bə'rɒmɪtəz
barometric => .bærәu'metrik
barometrical => ,bærәu'metrikәl
barometry => bә'rɔmitri
baron => 'bærәn
baronage => 'bærәnidʒ
baroness => 'bærәnis
baronet => 'bærәnit
baronetage => 'bærәnitidʒ
baronetcy => 'bærәnitsi
baronets => ˈbærənits
baronial => bә'rәunjәl
barons => ˈbærənz
barony => 'bærәni
baroque => bә'rɒk
baroreceptor => ,bærәuri'septә
barotitis => ,bærә'taitis
barotrauma => ,bærә'traumә
barouche => bә'ru:ʃ
barque => bɑ:k
barquentine => 'bɑːk(ə)ntiːn
Barquisimeto => ,bɑ:kisi'meitәj
Barr body => bɑ:
Barra => 'bærә
barrack => 'bærәk
barracked => ˈbærəkt
barracking => 'bærəkiŋ
barracoon => .bærә'ku:n
barracouta => ˌbærəˈku:tə
barracuda => ,bærә'ku:dә
barracudas => ˌbærəˈku:dəz
barrage => 'bærɑ:dʒ
barrage balloon => ˈbɑ:rɪdʒ bəˈlu:n
barraged => ˈbɑ:rɪdʒd
barrages => bæ'rɑ:ʒɪz
barraging => ˈbɑ:rɪdʒɪŋ
barramundi => ,bærә'mʌndi
barranca => bә'ræŋkә
Barranquilla => ,bɑ:rɑ:ŋ'ki:ljɑ:
barrator => 'bærәtә(r)
barratrous => 'bærәtrәs
barratry => 'bærәtri
barre => bɑ:r
barred => bɑ:d
barrel => 'bærәl
barrel roll => ˈbærəl rəul
barrel vault => ˈbærəl vɔ:lt
barrel-chested => 'bærәl,tʃestid
barreled => 'bærәld
barrelhead => 'bærәlhed
barrelhouse => 'bærәlhajs
Barrell => 'bæril
barrelled => 'bærәld
barrelling => 'bærәliŋ
barrels => ˈbærəlz
barren => 'bærәn
barrenwort => 'bærәnw\\\\:t
barrett => 'bærәt, 'bærit
barrette => bә'ret
barricade => .bæri'keid
barricaded => ,bærɪ'keɪd
barricades => ˌbæriˈkeidz
barricading => ˌbæriˈkeidɪŋ
Barrie => 'bæri
barrier => 'bæriә
barrier method => ˈbæriə ˈmeθəd
barrier reef => ˈbæriə ri:f
barriers => 'bærɪəz
barring => 'bɑ:riŋ
barrio => 'bɑ:riәu
barrios => ˈbɑ:riəuz
barrique => 'bæri^
barrister => 'bæristә
barristers => ˈbærɪstəz
barroom => 'bɑ:ru:m
barrow => 'bærәu
barrow boy => ˈbærəʊ bɔi
barrows => ˈbærəʊz
Barry => 'bæri
barrymore => 'bærimɔ:
bars => bɑ:z
Barsac => 'bɑ:sæk
barstool => 'bɑ:stu:l
bart => bɑ:t
bartender => 'bɑ:.tendә
bartenders => ˈbɑ:tendəz
barter => 'bɑ:tә
bartering => ˈbɑ:tərɪŋ
barters => ˈbɑ:təz
Barth => ba:θ
Barthian => 'bɑ:ti:ən
Bartholdi => ba:'θɔldi:
bartholinitis => bɑ:,tәuli'naitis
Bartholomew => bɑ:'θɔlәmju:
Bartlett => 'bɑ:tlit
barton => 'bɑ:tn
barycentre => ,bæri'sentә(r)
baryon => 'bæriɔn
baryonic => 'bɑ:rjɒnɪk
baryons => 'bærɪɒn
baryta => bә'raitә
baryte => bæ'rɪt
barytes => bә'raiti:z
bas-relief => 'bæsrili:f
basal => 'beisl
basalt => 'bæsɒ:lt
basaltic => bә'sɒ:ltik
basalts => bæ'sɔ:lts
basanite => 'bæsәnait
bascinet => ,bæsi'net; 'bæsi,net
bascule => 'bæskju:l
base => beis
base hit => beis hit
baseball => 'beisbɒ:l
baseball cap => ˈbeisbɔ:l kæp
baseboard => 'beisbɒ:d
baseborn => 'beisbɒ:n
based => beist
Basel => 'bɒzәl
baseless => 'beislis
baseline => 'beislain
baselines => 'beɪslaɪnz
baseload => 'beisləud
basely => 'beisli
baseman => 'beismәn
basement => 'beismәnt
basement membrane => ˈbeismənt ˈmemˌbreɪn
basements => ˈbeismənts
baseness => 'beisnis
basenji => bә'sendʒi
baseplate => 'beispleit
bases => 'beisiz
bash => bæʃ
basha => 'bɑ:ʃә
bashed => bæʃt
basher => 'bæʃә
bashes => bæʃiz
bashful => 'bæʃful
bashing => 'bæʃiŋ
basho => 'bɑ:ʃәj
basic => 'beisik
basically => 'beisikli
basicity => bә'sisiti
basidiomycete => bә.sidiәumai'si:t
basidium => bә'sidiәm
basil => 'bæzil
basilar => 'bæsilә
basilect => 'bæsilekt
Basilian => bә'ziliәn
basilica => bә'zilikә
basilican => bə'zilikən; bə'silikən; -'zi-
basilicas => bəˈzilikəz
Basilicata => bɑ:zi:li'kɑ:tɑ:
basilisk => 'bæzilisk
basin => 'beisn
basinet => 'bæsinit
basinful => 'beisinful
Basingstoke => 'beiziŋ,stəuk
basins => 'beɪsnz
basipetal => bei'sipәtl
basipetally => beɪsɪ'petælɪ
basis => 'beisis
bask => bɑ:sk
basked => bæskt
Baskerville => 'bæskәvil
basket => 'bɑ:skit
basket weave => ˈbɑ:skit wi:v
basketball => 'bɑ:skitbɒ:l
basketful => 'bɑ:skitful
basketry => 'bɑ:kitri
basketwork => 'bɑ:skitwә:k
basking => bæskɪŋ
basking shark => ˈbæskɪŋ
basks => bæsks
Basle => bɑ:l
basophil => 'beisәfil
basophilic => ,beisәu'filik
Basque => bæsk
Basra => 'bæzrә
bass => bæs
bass clef => beis'klef
bass drum => beis
bass guitar => beis ɡiˈtɑ:
bass viol => beis ˈvaiəl
Bassein => bә'sein
basses => beisiz
basset => 'bæsit
basseted => 'bæsɪt
Basseterre => bɑ:s'teә(r)
basseting => 'bæsɪt
bassets => 'bæsɪt
bassinet => .bæsi'net
bassist => 'beisist
basso => 'bæsәu
basso continuo => kən'tinju:əu
basso profundo => 'bæsәuprәu'fʌndәu
basso-relievo => 'bæsәuri'li:vәu
bassoon => bә'su:n
bassoonist => bә'su:nist
bassoons => bəˈsu:nz
basswood => 'bæswud
bast => bæst
bastard => 'bæstәd
bastard wing => ˈbæstəd wiŋ
bastardization => .bæstәdai'zeiʃәn
bastardize => 'bæstәdaiz
bastards => ˈbæstədz
bastardy => 'bæstәdi
baste => beist
basted => beɪstid
baster => 'beistә
bastes => beɪsts
Bastia => bɑ:s'ti:ə
bastide => bæs'ti:d
bastille => bæ'sti:l
bastinado => .bæsti'neidәu
bastinadoed => ˌbæstiˈneidəud
bastinadoes => ˌbæstiˈneidəuz
bastinadoing => ˌbæstiˈneidəuɪŋ
basting => 'beistiŋ
bastion => 'bæstʃәn
bastions => ˈbæstiənz
basuco => bə'su:,kəu; bə'zu:kəu
Basutoland => bә'su:tәulænd
bat => bæt
bat mitzvah => ˌbæt ˈmɪtsvə
batata => bә'tɑ:tә
Batavia => bә'teivjә
Batavian => -vjәn
batboy => 'bætbɔ:i
batch => bætʃ
batches => bætʃiz
batching => 'bætʃiŋ
bate => beit
bateau => bæ'tәu
bateleur => ,bætә'l\\\\:(r)
bates => beits
batfish => 'bætfiʃ
bath => bæθ.bɑ:θ
bath chair => bɑ:θ tʃɛə
bath salts => bæθ, bɑ:θ
bath towel => bɑ:θ ˈtauəl
bathe => beið
bather => 'beiðә
bathers => ˈbeɪðəz
bathes => beiðz
bathetic => bә'θetik
bathhouse => 'bæθhaus
bathing => 'beiðiŋ
batholith => 'bæθәliθ
bathos => 'beiθɒs
bathrobe => 'bɑ:θrәub
bathrobes => ˈbæθˌrəʊbz
bathroom => 'bɑ:θru:m
bathrooms => 'bæθrums
Bathsheba => bæθ'ʃi:bә, 'bæθʃibә
bathtub => 'bɑ:θtʌb
bathtubs => ˈbɑ:θtʌbz
bathurst => 'bæθә(:)st
bathwater => 'bɑ:θ,wɔ:tә(r)
bathyal => 'bæθiәl
bathymeter => bә'θimitә
bathymetric => ,bæθi'metrik
bathymetry => bæ'θimitri
bathypelagic => ,bæθipә'lædʒik
bathyscaphe => 'bæθiskæf
bathysphere => 'bæθi.sfiә
batik => 'bætik
batiks => 'bəti:ks
bating => 'beitiŋ
batiste => bæ'ti:st
batman => 'bætmәn
batmen => 'bætmən
baton => 'bætәn
baton round => bəˈtɔn raund
batons => bəˈtɔnz
Batrachia => bә'treikjә
batrachian => bә'treikjәn
bats => bæts
batsman => 'bætsmәn
Batswana => bæt'swɑ:nə
batt => bæt
battalion => bә'tæljәn
battalions => bəˈtæljənz
battel => 'bætl
battement => 'bætmәnt
batten => 'bætn
Battenberg => 'bætən,bə:ɡ
battened => ˈbætənd
battening => ˈbætənɪŋ
battens => ˈbætənz
batter => 'bætә
battered => 'bætәd
batterer => 'bætərər
batterie => ,bætә'ri:
battering => 'bætәriŋ
batters => ˈbætəz
Battersea => 'bætəsi
battery => 'bætәri
battier => ˈbætiə
batting => 'bætiŋ
batting average => ˈbætiŋ ˈævəridʒ
batting order => ˈbætiŋ ˈɔ:də
battle => 'bætl
battleaxe => 'bæt(ə)l.æks
battledore => 'bætldɒ:
battlefield => 'bætlfi:ld
battlefields => ˈbætlˌfi:ldz
battlefront => 'bætlfrʌnt
battleground => 'bætlgraund
battlement => 'bætlmәnt
battlemented => 'bætl,mentɪd
battler => 'bætlə
battleship => 'bætlʃip
battleships => ˈbætlˌʃɪps
battling => 'bæt(ə)l
battue => bæ'tju:
batty => 'bæti
batwing => 'bætwiŋ
batwoman => 'bæt,wjmәn
bauble => 'bɒ:bl
baubles => ˈbɔ:bəlz
Baucis => 'bɔ:sis
baud => bɔ:d
Baudelairean => ,bәjdә'leәriәn
bauer => 'bauә
bauhaus => 'bajhajs
baulk => bɒ:k
baulked => bɔːk
baulking => bɔːk
baulks => bɔːk
bauxite => 'bɒ:ksait
bauxitic => bɔ:k'sɪtɪk
Bavaria => bә'vєәriә
Bavarian => bә'vєәriәn
bawbee => .bɒ:'bi:
bawd => bɒ:d
bawdier => ˈbɔ:di:ə
bawdily => 'bɔ:dɪlɪ
bawdry => 'bɒ:dri
bawdy => 'bɒ:di
bawdy house => ˈbɔ:di: haus
bawl => bɒ:l
bawled => bɔ:ld
bawley => 'bɔ:li
bawling => bɔːl
bawls => bɔ:lz
bawn => bɔːn
baxter => 'bækstә
bay => bei
bay laurel => bei ˈlɔ:rəl
baya => 'bɑ:jә, 'bɑ:jɑ:
Bayard => 'beiәd
bayberry => 'beibәri
Bayer => 'beiә
Bayern => 'baiәn
bayeux => bai'j\\\\:
baying => beɪ
Bayle => beɪl
bayman => 'beɪmən
bayonet => 'beiәnit
bayoneted => ˈbeɪənɪtid
bayoneting => ˈbeɪənɪtɪŋ
bayonets => ˈbeɪənɪts
Bayonne => bei'jəun
bayou => 'baiu:
Bayreuth => 'bairɔit
bazaar => bә'zɑ:
bazaars => bəˈzɑ:z
bazar => bә'zɑ:
bazoo => bә'zu:
bazooka => bә'zu:kә
bazookas => bəˈzu:kəz
bazoom => bә'zu:m
bdellium => 'deliәm
be => bi:
be about => bi: əˈbaut
be associated with => bi: ə'səuʃi wið
be history => bi: ˈhistəri
be my guest => bi: mai ɡest
be toast => bi: təust
be- => bi
bea => bi:, biә
beach => bi:tʃ
beach ball => bi:tʃ bɔ:l
beach buggy => bi:tʃ ˈbʌgi:
beach chair => bi:tʃ tʃɛə
beach volleyball => bi:tʃ ˈvɔlibɔ:l
beachcomber => 'bi:tʃkәjmә(r)
beachcombers => 'biːtʃkəʊmə
beached => biːtʃ
beachfront => 'bi:tʃ,frʌnt
beachhead => 'bi:tʃhed
beachheads => ˈbi:tʃhedz
beaching => 'bi:tʃiŋ
beachside => 'bi:tʃsaid
beachwear => 'bi:tʃweә(r)
beachy => 'bi:tʃi
beacon => 'bi:kn
beaconed => 'biːk(ə)n
beacons => ˈbi:kənz
bead => bi:d
beaded => bi:did
beading => bi:diŋ
beadle => 'bi:dl
beadsman => 'bi:dzmәn
beadwork => 'bi:dw\\\\:k
beady => 'bi:di
beady-eyed => ˈbi:diaid
beagle => 'bi:gl
beagles => ˈbi:ɡlz
beagling => 'bi:^liŋ
beak => bi:k
beaked => 'bi:kt
beaker => 'bi:kә
beakers => ˈbi:kəz
beaks => bi:ks
beam => bi:m
beam-ends => 'bi:m,endz
beamed => bi:md
beamer => 'bi:mә
beaming => 'bi:miŋ
beamish => 'bi:miʃ
beams => bi:mz
beamy => 'bi:mi
bean => bi:n
bean counter => bi:n ˈkauntə
beanbag => 'bi:nbæg
beaner => 'bi:nə
beanery => 'bi:nәri
beanfeast => 'bi:nfi:st
beanie => 'bi:ni
Beano => 'bi:nәj
beanpole => ˈbi:npəʊl
beanpoles => ˈbi:nˌpəʊlz
beanstalk => 'bi:nstɒ:k
bear => bєә
bear hug => bɛə hʌɡ
bear-baiting => 'beəbeɪtɪŋ
bearable => 'bєәrәbl
bearably => 'bєәrәbli
bearberry => 'beәbəri
bearcat => 'beәkæt
beard => biәd
bearded => 'biәdid
bearded collie => 'biədid'kɔli
beardie => ˈbɪədi
bearding => 'biәdiŋ
beardless => 'biәdlis
beards => biədz
Beardsley => 'biәdzli
bearer => 'bєәrә
bearers => ˈbeərəz
bearing => 'bєәriŋ
bearing rein => ˈbɛəriŋ rein
bearish => 'bєәri:ʃ
bearskin => 'bєәskin
bearskins => ˈbɛəskinz
Beas => 'bi:,a:s
beast => bi:st
beastie => 'bi:sti
beasting => biːst
beastings => 'bi:stiŋz
beastly => 'bi:stli
beat => bi:t
beat generation => bi:t ˌdʒenəˈreiʃən
beat-up => 'bi:t'ʌp
beatable => 'bi:təbl
beaten => 'bi:tn
beater => 'bi:tә
beaters => ˈbi:təz
beatific => .bi:ә'tifik
beatification => bi:.ætifi'keiʃәn
beatifies => bi:ˈætifaiz
beatify => bi:'ætifai
beating => 'bi:tiŋ
beatitude => bi:'ætitju:d
Beatle => 'bi:tl
beatnik => 'bi:tnik
beatniks => 'bi:tnɪks
beatrice => 'biәtris
Beatrix => 'biәtriks
beats => bi:ts
beau => bәu
beau geste => bəʊˈʒest
beau monde => 'mɔnd
beaucoup => bәu'ku:
Beaufort => 'bәufәt
Beaufort scale => 'bәjfәt
Beaujolais => 'bəuʒə,lei
beaumont => 'bәumәnt
Beaune => bәun
beaus => bəʊz
beaut => bju:t
beauteous => 'bju:tjәs
beautician => bju:'tiʃәn
beauticians => bju:ˈtɪʃənz
beautification => .bju:tifi'keiʃәn
beautified => ˈbju:təˌfaɪd
beautifier => 'bju:tifaiә
beautifies => ˈbju:təˌfaɪz
beautiful => 'bju:tiful
beautifully => 'bju:tifuli
beautify => 'bju:tifai
beautifying => ˈbju:təˌfaɪŋ
beauts => bju:ts
beauty => 'bju:ti
beauty mark => ˈbju:ti mɑ:k
beauty pageant => ˈbju:ti ˈpædʒənt
beauty parlour => ˈbju:ti ˈpɑ:lə
beauty queen => ˈbju:ti kwi:n
beauty salon => ˈbju:ti ˈsælɔ:ŋ
beauty shop => ˈbju:ti ʃɔp
beauty sleep => ˈbju:ti sli:p
Beauvais => bәu'vei
beaux => bәuz
beaux arts => bəʊˈzɑ:, -ˈzɑ:t
beaux yeux => 'bәjz'j\\\\:
beaver => 'bi:vә
beaverboard => 'bi:vәbɒ:d
Beaverbrook => 'bi:vәbruk
beavers => ˈbi:vəz
bebop => 'bi:bɒp
becalm => bi'kɑ:m
becalmed => bi'kɑ:md
becalming => biˈkɑ:mɪŋ
becalms => biˈkɑ:mz
became => bi'keim
becard => bei'kɑ:d
because => bi'kɒ:z
bechamel => .beiʃә'mel
Becher => 'bi:tʃә
Bechuanaland => ,betʃu'ɑ:nәlænd
beck => bek
becket => 'bekit
Beckett => ˈbekɪt
beckon => 'bekәn
beckoned => ˈbekənd
beckons => ˈbekənz
becky => 'beki
becloud => bi'klaud
beclouded => biˈklaudid
beclouding => biˈklaudɪŋ
beclouds => biˈklaudz
become => bi'kʌm
become of => biˈkʌm ɔv
becomes => biˈkʌmz
becoming => bi'kʌmiŋ
becomingly => bi'kʌmiŋli
Becquerel => ,bekә'rel
bed => bed
bed-and-breakfast => 'bed'ændbr'ekfəst
bed-hop => 'bedh'ɒp
bedabble => bi'dæbl
bedad => bi'dæd
bedaub => bi'dɒ:b
bedazzle => bi'dæzl
bedazzled => bi'dæzld
bedazzlement => bɪ'dæzlmənt
bedazzles => biˈdæzlz
bedazzling => biˈdæzlɪŋ
bedbug => 'bedbʌg
bedbugs => ˈbedbʌɡz
bedchamber => 'bed.tʃeimbә
bedchambers => ˈbedtʃeimbəz
bedclothes => 'bedklәuðz
bedcover => 'bed.kʌvә
bedded => 'bedid
bedder => 'bedә
bedding => 'bediŋ
bedding plant => ˈbedɪŋ plɑ:nt
Bede => bi:d
bedeck => bi'dek
bedecked => bɪ'dekt
bedecking => bɪˈdekɪŋ
bedecks => bɪˈdeks
bedeguar => 'bedә,^ɑ:
bedevil => bi'devl
bedevilled => biˈdevəld
bedevilling => biˈdevəlɪŋ
bedevils => biˈdevəlz
bedew => bi'dju:
bedewed => 'bɪdju:d
bedfellow => 'bed.felәu
bedfellows => ˈbedˌfeləuz
bedford => 'bedfәd
Bedfordshire => 'bedfәdʃiә
bedframe => 'bed,freim
bedhead => 'bedhed
bedight => bi'bait
bedim => bi'dim
bedimmed => 'bɪdɪmd
bedimming => 'bɪdɪmɪŋ
bedizen => bi'daizn
bedizened => biˈdaiznd
bedizening => biˈdaiznɪŋ
bedizens => biˈdaiznz
bedjacket => ˈbeddʒækɪt
bedlam => 'bedlәm
bedlinen => 'bedlinin
Bedlington => 'bedliŋtən
bedmaker => 'bed.meikә
bedmate => 'bedmeit
Bedouin => 'beduin
bedpan => 'bedpæn
bedpans => ˈbedpænz
bedplate => 'bedpleit
bedpost => 'bedpәust
bedraggle => bi'drægl
bedraggled => bi'drægld
bedrail => 'bedreil
bedridden => 'bedridn
bedrock => bed'rɒk
bedroll => 'bedrәul
bedroom => 'bedrum
bedroomed => 'bedruːm; -rʊm
bedsheet => 'bed.ʃi:t
bedside => 'bedsaid
bedside manner => ˈbedˌsaɪd ˈmænə
bedsit => bed'sɪt
bedsock => 'bedsck
bedsore => 'bedsɒ:
bedspread => 'bedspred
bedspreads => ˈbedˌspredz
bedspring => 'bedspriŋ
bedstand => 'bedstænd
bedstead => 'bedsted
bedsteads => ˈbedstedz
bedstraw => 'bedstrɒ:
bedtime => 'bedtaim
Bedu => 'bedu:
bee => bi:
bee fly => bi: flai
bee-keeper => ˈbi:ˌki:pə
bee-keeping => bi: ˈki:pɪŋ
bee-stung => ˈbi:ˌstʌŋ
Beeb => bi:b
beech => bi:tʃ
Beecham => 'bi:tʃәm
beecher => 'bi:tʃә
beeches => bi:tʃiz
Beeching => biːtʃ
beechnut => 'bi:tʃnʌt
beechwood => 'bi:tʃwud
beef => bi:f
beef tomato => bi:f təˈmɑ:təu
beefalo => 'bi:fәlәj
beefburger => 'bɛdbɝɡɚ
beefcake => 'biːfkeɪk
beefeater => 'bi:f.i:tә
beefed => biːf
beefier => ˈbi:fi:ə
beefing => biːf
beefsteak => 'bi:fsteik
beefsteak fungus => ˈbi:fsteik ˈfʌŋɡəs
beefwood => 'bi:fwud
beefy => 'bi:fi
beehive => 'bi:haiv
beehives => ˈbi:ˌhaɪvz
beekeeper => 'bi:fki:pә
beekeeping => 'bi:,ki:piŋ
beeline => 'bi:lain
Beelzebub => bi:'elzibʌb
been => bi:n
beep => bi:p
beeped => bi:pt
beeping => bi:pɪŋ
beeps => bi:ps
beer => biә
beer garden => biə ˈɡɑ:dn
beer hall => biə hɔ:l
Beerbohm => 'biәbәum
beerhouse => 'biәhɑjs
Beersheba => biə'ʃi:bə
beery => 'biәri
beestings => 'bi:stiŋz
beeswax => 'bi:zwæks
beeswaxed => 'biːzwæks
beeswaxes => 'biːzwæks
beeswaxing => 'biːzwæks
beet => bi:t
Beethoven => 'beitәuvәn
Beethovenian => ,beitәj'vi:niәn
beetle => 'bi:tl
beetle-crusher => 'bi:tl,krʌʃә(r)
beetled => ˈbi:tld
beetles => 'biːt(ə)lz
beetling => 'bi:tliŋ
beetroot => 'bi:tru:t
beets => bi:ts
beeves => bi:vz
beezer => 'bi:zә
befall => bi'fɒ:l
befalling => bɪˈfɔ:lɪŋ
befalls => bɪˈfɔ:lz
befell => bi'fel
befit => bi'fit
befits => biˈfits
befitted => 'bɪfɪtɪd
befitting => bi'fitiŋ
befittingly => bi'fitiŋli
befog => bi'fɒg
befogged => bɪ'fɒɡd
befool => bi'fu:l
befooled => bɪ'fuːl
befooling => bɪ'fuːl
befools => bɪ'fuːl
before => bi'fɒ:
beforehand => bi'fɒ:hænd
befoul => bi'faul
befouled => biˈfauld
befouling => biˈfaulɪŋ
befouls => biˈfaulz
befriend => bi'frend
befriended => bɪˈfrendid
befriending => bɪˈfrendɪŋ
befriends => bɪˈfrendz
befuddle => bi'fʌdl
befuddled => bi'fʌdld
befuddles => biˈfʌdlz
befuddling => biˈfʌdlɪŋ
befur => bi'fə:
beg => beg
begad => bi'gæd
began => bi'gæn
begat => bi'^æt
begem => bi'dʒem
beget => bi'get
begets => bɪˈgets
begetter => bi'getə
begetting => bɪ'ɡetɪŋ
beggar => 'begә
beggar-my-neighbour => 'be^әmi'neibә(r)
beggared => 'begə
beggaring => 'begə
beggarliness => 'begәlinis
beggarly => 'begәli
beggars => ˈbeɡəz
beggary => 'begәri
begin => bi'gin
beginner => bi'ginә
beginning => bi'giniŋ
begins => bɪ'ɡɪnz
begob => bi'^ɔb
begone => bi'gɒn
begonia => bi'gәunjә
begorra => bɪˈgɒrə
begot => bi'gɒt
begotten => bi'gɒtn
begrime => bi'graim
begrimed => bɪ'graɪmd
begrudge => bi'grʌdʒ
begrudged => bɪˈgrʌdʒd
begrudges => bɪˈgrʌdʒz
begrudging => bɪˈgrʌdʒɪŋ
begs => beɡz
beguile => bi'gail
beguiled => bɪˈgaɪld
beguilement => bi'gailmәnt
beguiler => bi'gailә
beguiles => bɪˈgaɪlz
beguiling => bi'gailiŋ
beguilingly => bi'grʌdʒiŋli
beguine => bi'gi:n
begum => 'beigәm
begun => bi'gʌn
behalf => bi'hɑ:f
behave => bi'heiv
behaved => biˈheivd
behaves => biˈheivz
behaving => biˈheivɪŋ
behavior => bi'heivjә
behavioral => bi'heivjәrәl
behaviorism => bi'heiviәriz(ә)m
behavioristic => bi.heivjә'ristik
behaviors => bɪheɪ'vi:əʊz
behaviour => bi'heivjә
behavioural => bi'heivjәrәl
behaviouralist => bi'heivjərəlist
behaviourally => bi'heivjərəl
behaviourism => bi'heivjәrizəm
behaviourist => -rist
behaviouristic => bi.heivjә'ristik
behead => bi'hed
beheaded => bi'hedid
beheads => bɪˈhedz
beheld => bi'held
behemoth => bi'hi:mɔθ
behest => bi'hest
behests => bɪˈhests
behind => bi'haind
behindhand => bi'haidhænd
behold => bi'hәuld
beholden => bi'hәudәn
beholder => bi'hәjldә(r)
beholding => bɪˈhəʊldɪŋ
beholds => bɪˈhəʊldz
behoof => bi'hu:f
behoove => bi'hu:v
behooved => biˈhəuvd
behooves => biˈhəuvz
behooving => biˈhəuvɪŋ
behove => bi'hәuv
Behring => 'beriŋ
beige => beiʒ
beignet => bei'jei
Beijing => beidʒiŋ
being => 'bi:iŋ
Beira => 'beirә
Beirut => .bei'ru:t
beisa => 'beizә
Beja => 'beidʒә
bejesus => bi'dʒi:zәs
bejewel => bi'dʒu:әl
bejeweled => bi'dʒu:əld
Bekaa => bi'kɑ:
BEL => bel
bel canto => ,bel'kɑ:ntәu
bel esprit => 'bel es'pri:
bela => 'beilә, belә, 'bilә
belabour => bi'leibә
belaboured => bɪˈleɪbəd
belabouring => bɪˈleɪbərɪŋ
belabours => bɪˈleɪbəz
Belarus => 'belərəs
belated => bi'leitid
belatedly => bi'leitidli
Belau => be'laj
belay => bi'lei
belayed => biˈleid
belayer => 'bɪleɪər
belaying => biˈleiŋ
belaying pin => bɪˈleɪɪŋ
belch => beltʃ
belched => beltʃt
belcher => 'beltʃә
belches => beltʃiz
beldam => 'beldәm
beleaguer => bi'li:gә
beleaguered => bɪ'liɡɚd
beleaguering => bɪˈli:gərɪŋ
beleaguers => bɪˈli:gəz
belemnite => 'belәmnait
Belfast => .belfɑ:st
belfries => ˈbelfriz
belfry => 'belfri
Belgae => 'beldʒi:
Belgian => 'beldʒәn
belgians => ˈbeldʒənz
Belgic => 'beldʒik
Belgium => 'beldʒәm
Belgrade => .bel'greid
Belgravia => bel'greiviә
Belial => 'bi:ljәl
belie => bi'lai
belied => bɪˈlaɪd
belief => bi'li:f
belies => bɪˈlaɪz
believability => bi.li:vә'bilәti
believable => bi'li:vәbl
believe => bi'li:v
believed => biˈli:vd
believer => bi'li:vә
believing => bi'li:viŋ
Belinda => bi'lindә
belittle => bi'litl
belittled => bɪˈlɪtld
belittles => bɪˈlɪtlz
belittling => bɪˈlɪtlɪŋ
Belitung => bә'li:tjŋ
belize => be'li:z
Belizean => be'li:ziәn
bell => bel
bell captain => bel ˈkæptin
bell curve => bel kə:v
bell glass => bel ɡlɑ:s
bell pepper => bel ˈpepə
bell pull => bel pul
bell push => bel puʃ
bell-bottom => 'belb'ɒtəm
bell-bottomed => 'belbɔtəm(d)
bella => 'belә
belladonna => .belә'dɒnә
belladonna lily => ˌbeləˈdɔnə ˈlili
bellamy => 'belә mi
bellbird => 'belb\\\\:d
bellboy => 'belbɒi
belle => bel
belle laide => 'bel'leid
belled => 'belid
belles => belz
belles-lettres => 'bel'letr
belletrism => ,bel'letrizm
belletrist => .bel'letrist
belletristic => .belә'tristik
bellevue => ˈbelˌvju:
bellflower => 'bel.flauә
bellhop => 'belhɔp
bellhops => 'belhɒp
bellicose => 'belikәus
bellied => 'belid
bellies => ˈbeliz
belligerence => bi'lidʒәrәns
belligerency => bi'lidʒәrәnsi
belligerent => bi'lidʒәrәnt
belligerents => bəˈlɪdʒərənts
belling => 'beliŋ
Bellingham => 'beliŋhæm
Bellingshausen Sea => 'beliŋz,hauzən
Bellini => bə'liːniː
bellman => 'belmәn
Belloc => 'belɔk
bellow => 'belәu
bellowed => beˈləud
bellowing => beˈləuɪŋ
bellows => 'belәuz
bells => belz
bellwether => 'bel.weðә
belly => 'beli
belly dance => ˈbeli dɑ:ns
belly dancer => ˈbeli ˈdɑ:nsə
belly flop => ˈbeli flɔp
belly-laugh => 'belilɑ:f
bellyache => 'belieik
bellyached => ˈbelieikt
bellyacher => 'beli,eikə
bellyband => 'belibænd
bellybutton => 'belɪ,bʌtn
bellyful => 'beliful
belmont => bel'mɔnt
Belmopan => 'belmәlpæ n
belong => bi'lɒŋ
belonged => bɪ'lɒŋd
belonging => bi'lɔŋiŋ
belongingness => bi'lɔŋiŋnis
belongings => bi'lɒŋiŋz
belongs => biˈlɔŋz
Belorussia => ,bjelә'rʌʃә
beloved => bi'lʌvd
below => bi'lәu
below the belt => biˈləu ðə belt
belowdecks => bɪləʊ'deks
Belsen => 'belzən
Belshazzar => bel'ʃæzә(r)
belt => belt
belt up => belt ʌp
Beltane => 'beltein
belted => 'beltid
belter => 'beltə
belting => 'beltiŋ
beltway => 'beltwei
beluga => bә'lu:gә
belvedere => 'belvi.diә
belying => bi'laiiŋ
bema => 'bi:mә
Bemba => 'bembә
bemire => bi'maiә
bemoan => bi'mәun
bemoaned => bɪˈməʊnd
bemoaning => bɪˈməʊnɪŋ
bemoans => bɪˈməʊnz
bemuse => bi'mju:z
bemused => bi'mju:zd
bemusedly => bi'mju:zidli
bemusement => bi'mju:zmənt
bemuses => biˈmju:ziz
bemusing => biˈmju:zɪŋ
ben => ben
benares => bi'nɑ:riz
bench => bentʃ
bench press => bentʃ pres
bench seat => bentʃ si:t
benched => 'bentʃid
bencher => 'bentʃә
benches => bentʃiz
benching => 'bentʃiŋ
benchmarks => ˈbentʃˌmɑ:ks
bend => bend
bend sinister => bend ˈsinistə
bended => 'bendid
bender => 'bendә
benders => ˈbendəz
Bendigo => 'bendiɡəu
bending => 'bendiŋ
bendy => 'bendi
beneath => bi'ni:θ
benedicite => ,beni'daisiti
benedict => 'benidikt
Benedictine => ,beni'diktain
benediction => .beni'dikʃәn
benedictions => ˌbenɪˈdɪkʃənz
benedictory => .beni'diktәri
Benedictus => .beni'diktәs
benefaction => .beni'fækʃәn
benefactive => ,beni'fæktiv
benefactor => 'benifæktә
benefactors => 'benɪfæktəz
benefactress => 'benifæktris
benefic => bi'nefik
benefice => 'benifis
beneficed => 'bɪnefɪkd
beneficence => bi'nefisәns
beneficent => bi'nefisәnt
benefices => 'benɪfɪs
beneficial => .beni'fiʃәl
beneficiaries => ˌbenəˈfɪʃi:ˌeri:z
beneficiary => .beni'fiʃәri
beneficing => 'benɪfɪs
benefit => 'benifit
benefit of clergy => ˈbenifit ɔv ˈklə:dʒi
Benelux => 'benilʌks
benevolence => bi'nevәlәns
benevolent => bi'nevәlәnt
benevolently => bi'nevәlәntli
bengal => beŋ'^ɔ:l
Bengali => beŋ'^ɔ:li
bengaline => 'beŋ^әli:n
Benghazi => ben'ga:zi
Benguela => ben'^eilә
benighted => bi'naitid
benign => bi'nain
benignancy => bi'nignәnsi
benignant => bi'nignәnt
benignantly => bi'nignәntli
benignity => bi'nigniti
benignly => bi'nainli
Benin => be'nin
benison => 'benizәn
Benito => bә'naitәu
benjamin => 'bendʒәmin
benne => 'beni
bennet => 'benit
bennett => 'benit
benny => 'beni
benomyl => 'benәmil
Benoni => bə'nəuni
bent => bent
bentham => 'bentәm, 'benθәm
benthamite => 'benθәmait
benthic => 'benθik
benthos => 'benθɒs
benton => 'bentәn
bentonite => 'bentә,nait
bentwood => 'bentwud
benumb => bi'nʌm
benumbed => bi'nʌmd
benumbing => biˈnʌmɪŋ
Benz => bents
benzaldehyde => ben'zældi,haid
benzene => 'benzi:n
benzenoid => 'benzәnɔid
benzine => 'benzi:n
benzoate => 'benzәueit
benzocaine => 'benzәkein, -zәu-
benzodiazepine => ,benzәjdai'æzәpi:n
benzoin => 'benzәuin
benzol => 'benzɔl
benzopyrene => benzәu'pairi:n
benzoquinone => ,benzәu'kwinәun
benzoyl => 'benzәuil
benzyl => 'benzil
Beograd => 'beiә^rɑ:d
bequeath => bi'kwi:ð
bequeathal => bi'kwi:ðәl
bequeathed => bɪˈkwi:ðd
bequeather => bɪk'wi:ðə
bequeathing => bɪk'wi:ðɪŋ
bequeaths => bɪˈkwi:ðz
bequest => bi'kwest
bequests => bɪˈkwests
berate => bi'reit
berated => bɪˈreɪtid
berates => bɪˈreɪts
berating => bɪˈreɪtɪŋ
Berber => 'bә:bә
Berbera => 'bә:bәrә
berberine => 'bә:bәri:n
berberis => 'b\\\\:bәris
berceuse => beә'sә:z
Berchtesgaden => 'bεrʃtəs,ɡɑ:dən
Berdichev => bə'di:tʃef
bereave => bi'ri:v
bereaved => bi'ri:vd
bereavement => bi'ri:vmәnt
bereavements => bɪˈri:vmənts
bereaves => bɪˈri:vz
bereaving => bɪˈri:vɪŋ
bereft => bi'reft
Berenice => ,beri'naisi:; ,beri'ni:s
beret => 'berei
berets => ˈbereiz
berg => bә:g
Bergamo => 'beә^әmәu
bergamot => 'bә:gәmɒt
bergen => 'bә:^әn
Berger => 'bә:dʒә
bergschrund => 'bєәkʃrunt
bergson => 'bә:^sәn
Bergsonian => bә:^'sәunjәn
beribboned => bi'ribәnd
beriberi => .beri'beri
Bering => 'beriŋ
berk => bɜ:k
berkeley => 'bɑ:kli, 'bә:kli
berkelium => 'bә:kliәm
Berkshire => 'bә:kʃә
Berlin => bә:'lin
Berliner => bә'linә
Berlioz => 'beәliәuz
berm => bә:m
Bermuda => bә'mju:dә
Bermudan => bә'mju:dәn
Bermudian => bə'mju:diən
Bern => bә:n
Bernadette => ,bә:nә'det
bernard => bә:'nɑ:d, 'bә:nәd
Berne => bә:n
Bernese => bә:'ni:z
bernice => 'bә:nis, bә:'ni:s
bernie => 'bә:ni
Bernoulli => bә:'nu:li
Bernstein => bә:n'stein
berried => 'berid
berry => 'beri
berrying => 'berɪ
berserk => bә'sә:k
berserker => bә(:)'sә:kә
bert => b\\\\:t
berth => bә:θ
bertha => 'bә:θә
berthed => bɜ:θt
berthing => 'bɜ:θɪŋ
berths => bɜ:θs
Bertillon => 'bә:tilɔn
bertram => 'bә:trәm
Bertrand => 'b\\\\:trәnd
berwick => 'berik
beryl => 'beril
berylliosis => bә,rili:'әusis
beryllium => be'riljәm
Berzelius => bә'zi:liәs
BES => bes
beseech => bi'si:tʃ
beseeches => bɪˈsi:tʃiz
beseechingly => bi'si:tʃiŋli
beset => bi'set
besets => bɪˈsets
besetting => bi'setiŋ
beside => bi'said
besides => bi'saidz
besiege => bi'si:dʒ
besieged => bɪ'sɪdʒd
besieger => bi'si:dʒә
besieges => biˈsi:dʒz
besieging => biˈsi:dʒɪŋ
besmear => bi'smiә
besmeared => bɪˈsmɪəd
besmearing => bɪˈsmɪərɪŋ
besmirch => bi'smә:tʃ
besmirched => bɪˈsmɜ:tʃt
besmirches => bɪˈsmɜ:tʃiz
besmirching => bɪˈsmɜ:tʃɪŋ
besom => 'bi:zәm
besot => bi'sɒt
besotted => bi'sɒtid
besotting => biˈsɔtɪŋ
besought => bi'sɒ:t
bespangle => bi'spæŋgl
bespangled => 'bɪspæŋɡld
bespangles => bɪ'spæŋg(ə)l
bespangling => bɪ'spæŋg(ə)l
bespatter => bi'spætә
bespattered => bɪs'pætəd
bespattering => biˈspætərɪŋ
bespeak => bi'spi:k
bespeaking => bɪˈspi:kɪŋ
bespeaks => bɪˈspi:ks
bespectacled => bi'spektәkld
bespoke => bi'spәuk
bespoken => bi'spәukәn
besprinkle => bi'spriŋkl
bess => bes
Bessarabia => ,besә'reibiә
Bessarabian => ,besә'reibiәn
Bessel => 'besәl
Bessemer => 'besimә
bessie => 'besi
best => best
best practice => best ˈpræktis
best-seller => ˌbestˈselə(r)
best-selling => 'best'seliŋ
bested => bi'sted
bestial => 'bestjәl
bestiality => ,besti'æliti
bestialize => 'bestjәlaiz
bestialized => 'besʃlaɪzd
bestially => 'bestɪəlɪ
bestiary => 'bestiәri
besting => bestɪŋ
bestir => bi'stә:
bestirred => biˈstə:d
bestirring => biˈstə:ɪŋ
bestow => bi'stәu
bestowal => bi'stәuәl
bestowed => biˈstəud
bestowing => bi'stәuiŋ
bestows => biˈstəuz
bestrew => bi'stru:
bestrewing => bɪˈstru:ɪŋ
bestrews => bɪˈstru:z
bestride => bi'straid
bests => bests
bet => bet
beta => 'beitә
beta blocker => ˈbi:tə ˈblɔkə
beta-blocker => 'bi:təbl'ɒkər
betaine => 'bi:tәi:n
betake => bi'teik
Betamax => 'beitәmæks
betas => ˈbi:təz
betatron => 'bi:tәtrɔn, 'bei-
betcha => 'betʃә
betel => 'bi:tәl
betel nut => 'bi:t(ә)l
Betelgeuse => .bi:tәl'ʒә:z
Beth => beθ
bethel => 'beθәl
bethesda => be'θezdə
bethink => bi'θiŋk
bethinking => biˈθiŋkɪŋ
bethinks => biˈθiŋks
Bethlehem => 'beθlihem
bethought => bi'θɒ:t
betide => bi'taid
betided => biˈtaidid
betiding => biˈtaidɪŋ
betimes => bi'taimz
betoken => bi'tәukn
betokened => bɪˈtəʊkənd
betokening => bɪˈtəʊkənɪŋ
betokens => bɪˈtəʊkənz
betony => 'betәni
betook => bi'tuk
betray => bi'trei
betrayal => bi'treiәl
betrayals => bɪˈtreɪəlz
betrayed => biˈtreid
betrayer => bi'treiә
betraying => biˈtreiŋ
betrays => biˈtreiz
betroth => bi'trәuð
betrothal => bi'trәuðәl
betrothals => biˈtrəuðlz
betrothed => bi'trәuðd
betrothing => bɪˈtrəʊðɪŋ
betroths => bɪˈtrəʊðz
Betsy => 'betsi
bett => bet
better => 'betә
better half => ˈbetə hɑ:f
better off => ˈbetə ɔf
bettered => ˈbetəd
bettering => ˈbetərɪŋ
betterment => 'betәmәnt
Betti => 'beti
betting => 'betiŋ
betting shop => ˈbetiŋ ʃɔp
bettor => 'betә
betty => 'beti
between => bi'twi:n
betwixt => bi'twikst
beurre blanc => 'bə:r'blɔŋ
beurre noir => 'bə:r'nwɑ:r
Beuthen => 'bɔitәn
bev => bev
Bevan => 'bevәn
bevatron => 'bevәtrɒn
bevel => 'bevәl
bevelling => be'vəlɪŋ
bevels => ˈbevəlz
beverage => 'bevәridʒ
beverages => be'vərɪdʒɪz
Beveridge => 'bevәridʒ
Beverley => 'bevәli
beverly => 'bevәli
bevies => ˈbevi:z
Bevin => 'bevin
bevvy => ˈbevi
bevy => 'bevi
bewail => bi'weil
bewailed => biˈweild
bewailing => biˈweilɪŋ
bewails => biˈweilz
beware => bi'wєә
bewhiskered => bi'wiskәd
bewigged => bi'wi^d
bewilder => bi'wildә
bewildered => bɪ'wɪldəd
bewilderedly => bi'wildədli
bewildering => bi'wildәriŋ
bewilderingly => bi'wildәriŋli
bewilderment => bi'wildәmәnt
bewilders => biˈwildəz
bewitch => bi'witʃ
bewitched => bɪ'wɪtʃt
bewitches => bɪˈwɪtʃiz
bewitching => bi'witʃiŋ
bewitchingly => bi'witʃiŋli
bewitchment => bi'witʃmәnt
Bexley => 'beksli
bey => bei
beyond => bi'jɒnd
bezant => 'bezәnt
bezel => 'bezәl
bezique => bi'zi:k
bezoar => 'bi:zɒ:
Bhagavadgita => 'bʌɡəvəd'ɡi:tə
bhajan => 'bʌdʒәn
bhaji => ˈbɑ:dʒi
bhakti => 'bʌkti
bhang => bæŋ
bhangra => ˈbɑ:ŋgrə
bharal => 'bә:rәl
bhavan => 'bʌv(ə)n
BHC => ,bi:,eitʃ'si:
Bhil => bi:l
Bhojpuri => 'bәjdʒ,pjәri
Bhubaneswar => ,buvə'neiʃvə
Bhutan => bu:'tæn
Bhutanese => ,bu:tә'ni:z
BI => bai
bi- => bai-
bi-level => 'bai'levəl
Biafra => bi'ɑ:frә
biafran => bi'æfrәn
bialy => bi'ɑ:li
Bianca => bi'æŋkә, 'bjɑ:ŋkә
biannual => bai'ænju:әl
biannually => bi:ən'jʊəlɪ
Biarritz => biә'rits
bias => 'baiәs
bias tape => ˈbaiəs teip
biased => 'baiәst
biases => ˈbaiəsiz
biassing => 'baɪəssɪŋ
biathlete => bai'æθlit
biathlon => bai'æθlәn
biaxial => bai'æksiәl
bib => bib
bibbed => bɪbd
bibber => 'bibә
Bibby => 'bibi
bibelot => 'biblәu
bible => 'baibl
Bible-basher => 'baibl,bæʃə
Bible-bashing => 'baibl,bæʃiŋ
biblical => 'biblikәl
biblio- => 'bibliәj
bibliographer => .bibli'ɒgrәfә
bibliographic => .bibliә'græfik
bibliographical => .bibliә'græfikәl
bibliographies => ˌbibliˈɔɡrəfiz
bibliography => .bibli'ɒgrәfi
bibliomancy => 'bibliә.mænsi
bibliomania => .bibliә'meiniә
bibliomaniac => .bibliәu'meiniæk
bibliometrics => ,bɪblɪə(ʊ)'metrɪks
bibliophile => 'bibliәufail
bibliophilic => ,bibliəu'filik
bibliophily => ,bibli'ɔfili; ,bibli'ɔfəli
bibliopole => 'bibliәupәul
bibs => bibz
bibulous => 'bibjulәs
bicameral => bai'kæmәrәl
bicarb => bai'kɑ:b
bicarbonate => bai'kɑ:bәnit
bicarbonate of soda => baiˈkɑ:bənit ɔv ˈsəudə
bice => bais
bicentenaries => ˌbaɪsenˈtenəri:z
bicentenary => baisen'ti:nәri
bicentennial => baisen'tenjәl
bicep => baɪ'sep
bicephalous => bai'sefәlәs
biceps => 'baiseps
bichon frise => bi:'ʃɔŋfri:'zei
bicker => 'bikә
bickered => 'bɪkə
bickering => 'bɪkərɪŋ
bickers => ˈbɪkəz
bicky => 'biki
bicoastal => bai'kәjstәl
Bicol => 'bi:kәul
bicolour => 'bai,kʌlә(r)
bicoloured => bɪ'kʌləd
biconcave => bai'kɒnkeiv
biconvex => bai'kɒnveks
bicultural => bai'kʌltʃәrәl
biculturalism => bai'kʌltʃərəlizəm
bicuspid => bai'kʌspid
bicuspid valve => baiˈkʌspid vælv
bicycle => 'baisikl
bicycle chain => ˈbaisikl tʃein
bicycle pump => ˈbaisikl pʌmp
bicyclic => bai'saiklik, -'siklik
bicyclist => 'baisiklist
bid => bid
bidarka => bai'dɑ:kә
biddability => ,bidә'bilәti
biddable => 'bidәbl
bidden => 'bidn
bidder => 'bidә
bidders => 'bɪdəz
biddies => ˈbidiz
bidding => 'bidiŋ
biddle => 'bidl
biddy => 'bidi
bide => baid
bided => baɪdid
bides => baɪdz
bidet => bidet
bidets => bidɛts
bidi => 'bi:di
biding => baɪdɪŋ
bidirectional => ,baidi'rekʃәnәl
bidonville => bi:dɔ'vi:l
Biedermeier => 'bi:dә.maiә
Bielefeld => 'bi:lәfelt
bien-pensant => 'bjæŋpɔŋ'sɔŋ
Biennale => ,biːe'nɑːleɪ; -lɪ
biennial => bai'eniәl
biennially => bai'eniәli
biennium => bai'eniәm
bier => biә
biface => 'baifeis
bifacial => bai'feiʃәl
biff => bif
biffed => bift
biffing => bifɪŋ
biffs => bifs
bifid => 'baifid
bifilar => bai'failә
bifocal => .bai'fәukl
bifold => 'baifәuld
bifurcate => 'baifәkeit
bifurcated => 'baɪfɜ:keɪtɪd
bifurcates => ˈbaɪfəˌkeɪts
bifurcating => ˈbaɪfəˌkeɪtɪŋ
bifurcation => .baifә'keiʃәn
big => big
big band => biɡ bænd
big bang theory => biɡ bæŋ ˈθiəri
Big Ben => ben
big box => biɡ bɔks
big brother => biɡ ˈbrʌðə
big business => biɡ ˈbiznis
big cat => biɡ kæt
big deal => biɡ di:l
big hitter => biɡ ˈhitə
big league => biɡ li:ɡ
big name => biɡ neim
big science => biɡ ˈsaiəns
big screen => biɡ skri:n
big tent => biɡ tent
big ticket => biɡ ˈtikit
big time => biɡ taim
big toe => biɡ təu
big top => biɡ tɔp
big tree => biɡ tri:
big-headed => biɡ ˈhedid
big-note => 'biɡnəut
big-ticket => 'bi^'tikit
big-timer => 'bɪɡt'aɪmə
bigamist => 'bigәmist
bigamous => 'bigәmәs
bigamy => 'bigәmi
bigeneric => ,baidʒi'nerik
bigeye => 'bɪɡaɪ
Bigfoot => 'bɪɡfʊt
bigg => biɡ
Biggin => 'bi^in
Biggins => 'biɡin
biggish => 'bigiʃ
bighead => 'bighed
bighorn => 'bighɒ:n
bight => bait
bighted => baɪt
bighting => baɪt
bights => baɪt
bigmouth => 'biɡmauθ
bigness => 'bignis
bigot => 'bigәt
bigoted => 'bigәtid
bigotry => 'bigәtri
bigots => ˈbɪgəts
biguanide => bai'^wɑ:naid
bigwig => 'bigwig
bigwigs => ˈbiɡwiɡz
Bihar => bi'hɑ:
bijection => bai'dʒekʃәn
bijou => 'bi:ʒu:
bijouterie => bi:'ʒu:tәri
bike => baik
biked => baikt
biker => 'baikә(r)
bikes => baiks
bikeway => 'baikwei
bikie => 'baiki
bikini => bi'ki:ni
bikini line => bɪˈki:ni: lain
bikky => 'biki
bilabial => bai'leibiәl
bilateral => bai'lætәrәl
bilaterally => ˌbaɪ'lætərəlɪ
bilayer => ,bai'leiә
bilbao => bil'bɑ:әu
bilberries => ˈbilbəriz
bilberry => 'bilbәri
bilbo => 'bilbәu
bilboes => 'bɪlbəʊ
bildungsroman => 'bildjŋzrәj,mɑ:n
bile => bail
bile duct => baɪl dʌkt
bilge => bildʒ
bilge keel => bildʒ ki:l
bilged => 'bɪldʒd
bilges => bildʒz
bilharzia => bil'hɑ:ziә
bilharziasis => ,bilhɑ:'zaiәsis
biliary => 'biljәri
bilinear => bai'liniә
bilingual => bai'liŋgwәl
bilious => 'biljәs
bilirubin => ,bili'ru:bin
biliverdin => ,bili'vә:dn
bilk => bilk
bilked => bilkt
bilker => 'bilkә
bilking => bilkɪŋ
bilks => bilks
bill => bil
bill of sale => bil ɔv seil
billable => 'bɪleɪbl
billabong => 'bilә,bɔŋ
billboard => 'bilbɒ:d
billboards => ˈbɪlˌbɔ:dz
billed => 'bɪld
billet => 'bilit
billet-doux => 'bilei'du:
billeted => ˈbilitid
billeting => ˈbilitɪŋ
billets => ˈbilits
billfish => 'bilfiʃ
billfold => 'bilfәuld
billhook => 'bilhjk
billiard => 'biljәd
billiards => 'biljәdz
billie => 'bili
billing => 'biliŋ
billingsgate => 'biliŋz^eit
billion => 'biljәn
billionaire => .biljә'nєә
billionaires => biljəˈnɛəz
billions => 'bɪljənz
billionth => 'biljәnθ
Billiton => bi'li:tɔn
billon => 'bilәn
billow => 'bilәu
billowed => ˈbiləud
billowing => ˈbiləuɪŋ
billows => ˈbiləuz
billowy => 'bilәui
billposter => 'bilpәjstә(r)
billposting => 'bil,pәjstiŋ
billy => 'bili
billy goat => 'bili ^әjt
billy-goat => 'bɪli:ɡ'əʊt
billycock => 'bilikɒk
bilobed => 'bai,lәjbd
bilocation => ,bailә'keiʃәn
Bilston => 'bilstәn
biltong => 'biltɒŋ
bim => bim
bimanual => bai'mænjuәl
bimbette => 'bɪmbet
bimbo => 'bimbәu
bimetallic => .baimә'tælik
bimetallism => bai'metәlizәm
bimetallist => bai'metlist
bimillenary => baɪ'mɪləˌnerɪ
bimodal => bai'mәudl
bimolecular => ,baimә'lekjulә
bimonthly => .bai'mʌnθli
bin => bin
bin liner => bin ˈlainə
bin- => bain
binary => 'bainәri
binary star => ˈbaɪnəri: stɑ:
binational => bai'næʃәnәl
binaural => .bain'ɒ:rәl
bind => baind
bind off => baind ɔf
binder => 'baindә
binders => 'baɪndəz
bindery => 'baindәri
binding => 'baindiŋ
bindlestiff => 'bindlstif
binds => baindz
bindweed => 'baindwi:d
bine => bain
Binet => bi'nei
bing => biŋ
binge => bindʒ
binged => bɪndʒd
bingeing => bɪndʒɪŋ
binges => bɪndʒz
bingle => 'biŋgl
bingo => 'biŋgәu
bingy => 'bindʒi
binman => 'binmәn
binnacle => 'binәkl
binned => bind
binning => 'biniŋ
binocs => bә'nɔks
binocular => bi'nɒkjulә
binoculars => bi'nɒkjulәs
binomial => bai'nәumjәl
binominal => bai'nɒminl
bins => binz
bint => bɪnt
binturong => 'bintjurɔŋ
binucleate => bai'nu:kli:it
bio => 'baiәu
bio- => 'baiәj
bioaccumulation => ,baiәuәkju:mju'leiʃәn
bioacoustics => ,baiәuә'ku:stiks
bioactive => ,baiәj'æktiv
bioactivity => ,baiәuæk'tiviti
bioassay => ,baiәu'æsei, -ә'sei
bioassayed => ˌbaiəuˈæseid
bioassaying => ˌbaiəuˈæseiŋ
bioavailability => ,baiәuә,veilә'biliti
biocenosis => ,baiәusi'nәusis
biochemical => .baiәu'kemikl
biochemicals => ,baiәu'kemikәlz
biochemist => .baiәu'kemist
biochemistry => .baiәu'kemistri
biochemists => ˈbaɪəʊˈkemɪsts
biochip => 'baiәutʃip
biocidal => ,baiәj'saidәl
biocide => 'baiәsaid
bioclast => bɪəʊk'læst
bioclimatic => .baiәuklai'mætik
biocoenosis => ,baiәusi'nәusis
biocompatibility => ,baiәukәm,pætә'biliti
biocompatible => ,baiәjkәm'pætәbl
biocontrol => 'baiәukәu'trәul
bioconversion => ,baiәukәn'vә:ʃәn
biodata => ˈbaɪəʊdeɪtə
biodegradable => .baiәudi'greidәbl
biodegradation => ,baiәudi^rei'deiʃәn
biodegrade => ,baiәudi'^reid
biodegrading => baɪəʊdɪɡ'reɪdɪŋ
biodiesel => 'baɪəʊdi:zl
biodynamic => ,baiәudai'næmik
biodynamics => .baiәudai'næmiks
bioelectric => ,baiәji'lektrik
bioelectrical => bi:əʊe'lektrɪkəl
bioelectronics => 'baiәu,ilek'trɔniks
bioenergetic => 'baiəu,enə'dʒetik
bioenergetics => 'baiәj,enә'dʒetiks
bioenergy => ,baiәu'enәdʒi
bioengineer => 'baɪəʊ,endʒɪ'nɪə
bioengineered => bi:əʊendʒɪ'nɪərd
bioengineering => baiәu,endʒi'niәriŋ
bioethical => ,baiə'eθikəl
bioethicist => ,baiəu'eθisist
bioethics => 'baiәueθiks
biofeedback => 'baiәu,fi:dbæk
biofilm => 'bɪɒfɪlm
biofilter => ,baiәu'filtә
bioflavonoid => baiәu'fleivәnɔid, -'flævә-
biofouling => bɪə'faʊlɪŋ
biofuel => baiәu'fju:әl
biog => 'baɪəʊɡ
biogas => 'baiәu,^æs
biogenesis => .baiәu'dʒenisis
biogenic => ,baiәu'dʒenik
biogeochemical => ,baiәu,dʒiәu'kemikl
biogeochemistry => baiәu,dʒiәu'kemistri
biogeographer => ,baiəudʒi'ɔɡrəfə
biogeographic => bi:əʊdʒɪəɡ'ræfɪk
biogeographical => 'baiəu,dʒi:əu'ɡræfik; 'baiəu,dʒi:ə'ɡræfikəl
biogeography => ,baiәudʒi'ɔ^rәfi
biographee => bai,ɔ^rә'fi:
biographer => bai'ɒgrәfә
biographers => baiˈɔɡrəfəz
biographic => ,baiәj'^ræfik
biographical => baiәu'græfikәl
biography => bai'ɒgrәfi
biohazard => ,baiәu'hæzәd
bioinformatics => bi:əʊɪn'fɔ:mətɪks
biologic => .baiәu'lɒdʒik
biological => .baiәu'lɒdʒikәl
biologics => baiә'lɔdʒiks
biologism => ba'ɪɒlədʒɪzəm
biologist => bai'ɒlәdʒist
biologistic => baɪɒləd'ʒɪstɪk
biologists => baɪˈɔlədʒɪsts
biology => bai'ɒlәdʒi
bioluminescence => 'baiәu,lu:mi'nesns
biomagnetism => ,baiәu'mæ^nitizәm
biomarker => 'baɪɒmɑ:kər
biomass => 'baiәumæs
biomaterial => ,baiәumә'tiәriәl
biomathematics => ,baiәu,mæθi'mætiks
biome => 'baiәum
biomechanics => ,baiәumә'kæniks
biomedical => ,baiәu'medikәl
biomedicine => ,baiәu'medisn
biometeorology => ,baiәu,mi:tjә'rɔlәdʒi
biometric => ˌbaɪəʊˈmetrɪk
biometrical => 'baɪɒmɪtrɪkl
biometrician => ,baiәumi'triʃәn
biometrics => baiәu'metriks
biometry => bai'ɔmitri
biomimetic => baɪɒmɪ'metɪk
biomolecular => baɪɒməʊ'lekjʊlə
biomolecule => ,baiәu'mɔlikju:l
biomorph => 'baiәjmɔ:f
biomorphic => baiәu'mɒ:fik
bionic => bai'ɔnik
bionics => bai'ɒniks
bionomic => bjə'nɒmɪk
bionomics => baiәu'nɒmiks
biopharmaceutical => -kəl
biopharmaceutics => 'baiәj,fɑ:mә'sju:tiks
biophilia => ,baiәu'filiә
biophysical => ,baɪəʊ'fɪzɪkəl
biophysics => .baiәu'fiziks
biopic => ˈbaɪəʊpɪk
biopolymer => 'baiәu'pɔlimә
biopsies => baiˈɔpsiz
biopsy => 'bai.ɒpsi
biopsychological => 'baiəu,saikə'lɔdʒikəl
biopsychology => 'baiәusai'kɔlәdʒi
biopsychosocial => baɪɒpsaɪkə'səʃl
bioreactor => ,baiәuri(:)'æktә
bioregion => baɪə'ri:dʒən
bioregionalism => baɪə'ri:dʒənælɪzəm
bioremediation => baɪərmi:d'ɪeɪʃn
biorhythm => ,baiәu'riðәm
biorhythmic => ,baiəu'riðmik
BIOS => 'baiɔs
biosafety => ,baiәj'seifti
bioscience => 'baiәusaiәns
bioscientist => 'baɪəʊ,saɪəntɪst
bioscope => 'baiәskәup
biosecurity => ˌbaɪəʊsɪ'kjʊərətɪ
biosensor => ,baiәu'sensә
biosocial => ,baiәu'sәuʃәl
biosolids => bi:əʊ'zɒlɪdz
biosphere => 'baiәsfiә
biospherian => bi:əʊs'fɪərɪən
biospheric => ,baiə'sferik
biostatistical => 'baiəustə'tistikəl
biostatistician => baɪəstətɪs'tɪʃən
biostatistics => .baiәustә'tistiks
biostratigraphic => ,baiәu,stræti'^ræfik
biostratigraphy => ,baiәustrә'ti^rәfi
biosynthesis => .baiәu'sinθisis
biosystematics => baiәu,sisti'mætiks
biosystematist => ,baiәu'sistimәtist
biota => bai'әutә
biotech => 'baɪəʊtek
biotechnological => ˌbaɪəʊteknə'lɒdʒɪkl
biotechnologist => baɪətek'nɒlədʒɪst
biotechnology => .baiәutek'nɔlәdʒi
bioterrorism => ˌbaɪəʊ'terəˌrɪzəm
biotherapy => ,baiәu'θerәpi
biotic => bai'ɔtik
biotin => 'baiәtin
biotite => 'baiәtait
biotope => 'baiәtәup
biotransformation => ,baiәu,trænsfә'meiʃәn
bioturbate => 'baɪətɜ:beɪt
biotype => 'baiәtaip
biowarfare => ,baiәj'wɔ:feә(r)
bioweapon => 'baiəwepən
biparental => ,baipә'rentəl
bipartisan => bai,pɑ:ti'zæn
bipartite => .bai'pɑ:tait
biped => 'baiped
bipedal => 'bai,pedəl,bai'pe-
bipedalism => 'baɪpedlɪzəm
bipeds => ˈbaipedz
biphasic => bai'feizik
biphenyl => bai'fenil
bipinnate => bai'pineit
biplane => 'baiplein
biplanes => ˈbaipleinz
bipod => 'baipɒd
bipolar => bai'pәulә
bipolar disorder => baɪˈpəʊlə disˈɔ:də
biracial => bai'reiʃәl
biramous => bai'reimәs
birch => bә:tʃ
birchbark => 'bɜ:tʃbɑ:k
birched => bɜːtʃ
birchen => 'bә:tʃәn
Bircher => 'b\\\\:tʃә(r)
birches => bɜ:tʃiz
birching => bɜːtʃ
bird => bә:d
bird bath => bə:d bɑ:θ
bird cherry => bə:d ˈtʃeri:
bird flu => bə:d flu:
bird table => bə:d ˈteibl
bird-like => 'bɜːd,laɪk
bird-watcher => 'bɜ:dw'ɒtʃər
birdbath => 'bә:dbɑ:θ
birdbrain => 'bєәdbrein
birdbrained => 'bə:dbreind
birdcage => 'bә:dkeidʒ
birdcages => ˈbɜ:dˌkeɪdʒz
birdcall => 'bә:dkɒ:l
birder => 'b\\\\:dә(r)
birdhouse => 'bә:dhaus
birdie => 'bә:di
birdied => ˈbə:did
birdies => ˈbə:diz
birding => 'bә:diŋ
birdlife => 'bɜ:dlaɪf
birdlike => 'bɜ:dlaɪk
birdlime => 'bә:dlaim
birdlimed => 'bɜːdlaɪm
birdlimes => 'bɜːdlaɪm
birdliming => 'bɜːdlaɪm
birdseed => 'bә:dsi:d
birdshot => 'b\\\\:dʃɔt
birdsong => ˈbɜ:dsɒŋ
birdwatcher => ˈbɜ:dwɒtʃə(r)
birdy => 'bɜ:dɪ
birdying => ˈbə:diŋ
birefringence => ,bairi'frindʒins
bireme => 'bairi:m
biretta => bi'retә
biri => 'biri
biriani => ˌbɪriˈɑ:ni
Birk => bə:k
Birkenhead => 'bә:kәnhed
birl => bә:l
birling => ˈbə:liŋ
Birman => 'b\\\\:mәn
Birmingham => 'bә:miŋәm
biro => 'bairәu
birr => bә:
birred => bɜː
Birrell => 'birәl
birring => bɜː
birrs => bɜː
Birse => bә:s
birth => bә:θ
birth mother => bə:θ ˈmʌðə
birth rate => bə:θ reit
birthdate => 'bɜ:θdeɪt
birthday => 'bә:θdei
birthdays => ˈbə:θdeiz
birthed => bɜːθ
birthing => bɜ:θɪŋ
birthmark => 'bә:θmɑ:k
birthmarks => ˈbɜ:θˌmɑ:ks
birthplace => 'bә:θpleis
birthplaces => ˈbɜ:θˌpleɪsiz
birthrate => 'bә:θreit
birthright => 'bә:θrait
birthrights => ˈbɜ:θˌraɪts
births => bə:θs
birthstone => 'bә:θstәun
birthwort => 'bɜ:θwɜ:t
biryani => biər'jɑ:ni
BIS => bis
Biscay => 'biskei
biscotti => bi'skɔti:
biscuit => 'biskit
biscuits => 'bɪskɪts
biscuity => 'biskiti
bisect => bai'sekt
bisected => ˈbaɪˌsektid
bisecting => ˈbaɪˌsektɪŋ
bisection => .bai'sekʃәn
bisector => bai'sektә
bisects => ˈbaɪˌsekts
biserial => bai'si:riәl
bisexual => .bai'seksjuәl
bisexuality => 'bai,seksju'æliti
Bishkek => 'biʃkek
bishop => 'biʃәp
bishopric => 'biʃәprik
Bishops => 'bɪʃəp
Bisley => 'bizli
Bismarck => 'bizmɑ:k
bismuth => 'bizmәθ
bison => 'baisәn
bisons => 'baisən
bisphosphonate => bɪs'fɒsfəʊneɪt
bisque => bisk
bistable => bai'steibl
bistort => 'bistɒ:t
bistoury => 'bisturi
bistre => 'bistә
bistro => 'bistrәu
bistros => ˈbistrəuz
bisulphate => ,bai'sʌlfait
bit => bit
bit part => bit pɑ:t
bitch => bitʃ
bitched => bɪtʃt
bitchery => 'bitʃәri
bitches => bɪtʃiz
bitchiness => 'bitʃinis
bitching => 'bɪtʃɪŋ
bite => bait
bite-sized => bait ˈsaizd
biter => 'baitә
biternate => 'baitәnit
Bithynia => bi'θiniә
biting => 'baitiŋ
biting midge => ˈbaɪtɪŋ midʒ
bitingly => 'baitiŋli
bitonal => bai'tәjnəl
bitonality => ,baɪtəʊ'nælətɪ
bitted => bitid
bitten => 'bitn
bitter => 'bitә
bitter orange => ˈbitə ˈɔrindʒ
bitter-sweet => ˈbitə swi:t
bittering => 'bitәriŋ
bitterly => 'bitәli
bittern => 'bitәn
bitterness => 'bitәnis
bitters => 'bitәz
bittersweet => 'bitәswi:t
bitts => 'bɪts
bitty => 'biti
bitumen => bi'tjumin
bituminize => bi'tju:minaiz
bituminized => bɪt'ju:mɪnaɪzd
bituminous => bi'tju:minәs
bituminous coal => bi'tju:minәs
bivalence => .bai'veilәns
bivalent => bai'veilәnt
bivalve => 'baivælv
bivariate => bai'væriit
bivouac => 'bivuæk
bivouacked => 'bivuækd
bivouacking => 'bivuækiŋ
bivouacs => ˈbivu:æks
bivvy => 'bivi
biweekly => bai'wi:kli
biyearly => bai'jiәli
biz => biz
bizarre => bi'zɑ:
bizarrely => bɪ'zɑ:lɪ
bizarreness => bɪ'zɑ:nes
bizarrerie => bi.zɑ:rә'ri:
bizarro => bɪ'zɑːrəʊ
Bizet => bi:'zei
bizzy => 'bɪzɪ
blab => blæb
blabbed => blæbd
blabber => 'blæbә
blabbered => 'blæbə
blabbering => 'blæbə
blabbermouth => 'blæbәmauθ
blabbers => 'blæbə
blabbing => blæbɪŋ
blabs => blæbz
black => blæk
black bass => blæk beis
black bean => blæk bi:n
black bear => blæk bɛə
black belt => blæk belt
black bile => blæk baɪl
black bindweed => blæk ˈbaindwi:d
black bread => blæk bred
black comedy => blæk ˈkɔmidi
black economy => blæk iˈkɔnəmi
black hole => blæk həul
black humour => blæk ˈhju:mə
black ice => blæk ais
black knight => blæk nait
black lead => 'blæk led
black letter => blæk ˈletə
black lung => blæk lʌŋ
black market => blæk 'mɑ:kɪt
black marketeer => blæk ˌmɑ:kiˈtiə
black pepper => blæk ˈpepə
black poplar => blæk ˈpɔplə
black rot => blæk rɔt
black smoker => blæk ˈsməʊkə
black tie => blæk tai
black velvet => blæk ˈvelvit
black widow => blæk ˈwidəu
black-tailed deer => ˈblækˌteɪld
black-tie => 'blæk'tai
blackamoor => 'blækә.muә
blackball => 'blækbɒ:l
blackballed => ˈblækbɔ:ld
blackballing => ˈblækbɔ:lɪŋ
blackballs => ˈblækbɔ:lz
Blackbeard => 'blækbiəd
blackberries => ˈblækbəriz
blackberry => 'brækbәri
blackbird => 'blækbә:d
blackbirds => b'lækbɜ:dz
blackboard => 'blækbɒ:d
blackboards => ˈblækbɔ:dz
blackbody => 'blæk'bɔdi
blackbuck => 'blækbʌk
blackcap => 'blækkæp
blackcock => 'blækkɒk
blackcurrant => blæk'kʌrәnt
blackcurrants => blæk'kʌrənts
blacked => blækt
blacken => 'blækәn
blackened => ˈblækənd
blackening => 'blækәniŋ
blackens => ˈblækənz
blacker => 'blækә
Blackett => 'blækit
blackface => 'blækfeis
blackfellow => 'blækfelәu
blackfish => 'blækfiʃ
blackfly => ˈblækflaɪ
Blackfoot => 'blækfut
blackguard => 'blægɑ:d
blackguarded => ˈblækɡɑ:did
blackguarding => ˈblækɡɑ:dɪŋ
blackguardly => 'blægɑ:dli
blackhead => 'blækhed
blackheads => b'lækhedz
Blackie => 'blæki
blacking => 'blækiŋ
blackish => 'blækiʃ
blackjack => 'blækdʒæk
blackjacked => ˈblækˌdʒækt
blackjacking => ˈblækˌdʒækɪŋ
blacklead => b'lækled
blackleg => 'blækleg
blacklegs => 'blækleg
blacklist => 'blæklist
blacklisted => ˈblækˌlɪstid
blacklisting => ˈblækˌlɪstɪŋ
blacklists => ˈblækˌlɪsts
blackly => 'blækli
blackmail => 'blækmeil
blackmailed => ˈblækmeild
blackmailer => 'blækmeilә
blackmailers => ˈblækˌmeɪləz
blackmailing => b'lækmeɪlɪŋ
blackmails => ˈblækmeilz
Blackman => blækmæn
Blackmore => 'blækmɔ:
blackness => 'blæknis
blackout => 'blækaut
blackouts => b'lækaʊts
blackpoll => 'blækpәjl
blackshirt => 'blækʃәt
blacksmith => 'blæksmiθ
blacksmiths => ˈblæksmi:θs
blackspot => b'lækspɒt
blacktail => b'lækteɪl
blackthorn => 'blækθɒ:n
blacktop => 'blæktɒp
Blackwall => 'blækwɔ:l
blackwater => 'blæk,wɔ:tә(r)
blackwater fever => ˈblækˌwɔ:tə ˈfi:və
blackwood => 'blækwud
blackwork => b'lækwɜ:k
bladder => 'blædә
bladder campion => ˈblædə ˈkæmpjən
bladder fern => ˈblædə fɜ:n
bladder worm => ˈblædə wə:m
bladdered => 'blædəd
bladders => ˈblædəz
bladderwort => 'blædәwә:t
bladderwrack => 'blædəræk
blade => bleid
bladed => 'bleɪdɪd
blader => 'blædә
blaeberry => 'bleibәri
blag => blæg
blagger => 'blæɡə
blague => blɑ:^
blagueur => blɑ:'^\\\\:r
blah => blɑ:
blahs => b'lɑ:z
blain => blein
blair => bleә(r)
Blaise => bleiz
blake => bleik
Blakemore => 'bleik,mɔ:
blame => bleim
blame game => bleim ɡeim
blameable => 'bleimәbl
blamed => 'bleimd
blameful => 'bleimful
blameless => 'bleimlis
blamelessly => 'bleɪmləslɪ
blames => bleimz
blamestorming => b'leɪmstɔ:mɪŋ
blameworthy => 'bleimwә:ði
blanc => blæŋk
blanch => blɑ:ntʃ
Blanchard => 'blæntʃəd
blanche => blɑ:ntʃ
blanched => blæntʃt
blanches => blæntʃiz
blanching => 'blɑ:ŋtʃiŋ
blancmange => blә'mɒnʒ
blancmanges => blə'mɒnʒ; -'mɑːnʒ
Blanco => 'blæŋkәj
bland => blænd
blander => blændə
blandish => 'blændiʃ
blandished => ˈblændɪʃt
blandishing => ˈblændɪʃɪŋ
blandishment => 'blændiʃmәnt
blandishments => ˈblændɪʃmənts
blandly => 'blændli
blank => blæŋk
blank cartridge => blæŋk ˈkɑ:tridʒ
blank cheque => blæŋk tʃek
blanked => blæŋkt
blanker => 'blæŋkә
blanket => 'blæŋkit
blanket finish => ˈblæŋkit ˈfiniʃ
blanket stitch => ˈblæŋkit stitʃ
blanketing => 'blæŋkitiŋ
blankets => ˈblæŋkits
blankety => 'blæŋkәti
blanking => 'blæŋkiŋ
blankly => 'blæŋkli
blankness => 'blæŋknis
blanquette => blɔŋ'ket
blare => blєә
blared => bleəd
blares => bleəz
blaring => bleərɪŋ
blarney => 'blɑ:ni
blarneys => 'blɑːnɪ
blas => blɑ:s
blase => 'blɑ:zei
blaspheme => blæs'fi:m
blasphemed => blæsˈfi:md
blasphemer => blæs'fi:mә
blasphemes => blæsˈfi:mz
blasphemies => ˈblæsfəmi:z
blaspheming => blæsˈfi:mɪŋ
blasphemous => 'blæsfәmәs
blasphemously => 'blæsfəməsli
blasphemy => 'blæsfәmi
blast => blæst
blasted => 'blæstid
blaster => 'blɑ:stә
blasting => 'blɑ:stiŋ
blasto- => 'blæstәj
blastocyst => 'blæstәusist
blastoderm => 'blæstәudә:m
blastoff => 'blɑ:st,ɔf
blastomere => 'blæstәumiә
blastomycosis => ,blæstәumai'kәusis
blasts => blɑ:sts
blastula => 'blæstjulә
blat => blæt
blatancy => 'bleitәnsi
blatant => 'bleitәnt
blather => 'blæðә
blathered => ˈblæðəd
blathering => ˈblæðərɪŋ
blathers => ˈblæðəz
blatherskite => 'blæðәskait
blatted => blɑ:tid
blatter => 'blætә
blatting => blɑ:tɪŋ
Blavatsky => blə'vætski:
blaxploitation => 'blæk,splɔi'teiʃәn
blaze => bleiz
blazed => bleizd
blazer => 'bleizә
blazers => ˈbleizəz
blazes => ˈbleiziz
blazing => 'bleiziŋ
blazon => 'bleizәn
blazoned => ˈbleiznd
blazoning => ˈbleiznɪŋ
blazonry => 'bleizәnri
blazons => ˈbleiznz
bleach => bli:tʃ
bleached => bli:tʃt
bleacher => 'bli:tʃә
bleacherite => 'bli:tʃәrait
bleachers => 'bli:tʃәz
bleaches => bli:tʃiz
bleaching => 'bli:tʃiŋ
bleak => bli:k
bleaker => bli:kə
bleakness => 'bliknɪs
blear => bliә
bleared => bliəd
blearier => 'bliəri
bleariest => 'bliəri
blearily => ˈblɪərəli
blearing => bliərɪŋ
bleary => 'bliәri
bleary-eyed => ˈblɪəri:ˌaɪd
bleat => bli:t
bleated => bli:tid
bleating => bli:tɪŋ
bleats => bli:ts
bleb => bleb
bled => bled
bleed => bli:d
bleeder => 'bli:dә
bleeding => 'bli:diŋ
bleeding edge => ˈbli:diŋ edʒ
bleeding heart => ˈbli:diŋ hɑ:t
bleep => bli:p
bleeped => bli:pt
bleeper => 'bli:pә
bleepers => ˈbli:pəz
bleeping => bli:pɪŋ
bleeps => bli:ps
blemish => 'blemiʃ
blemished => ˈblemɪʃt
blemishes => ˈblemɪʃiz
blemishing => ˈblemɪʃɪŋ
blench => blentʃ
blenched => blentʃt
blenching => blentʃɪŋ
blend => blend
blende => blend
blended family => ˈblendɪd
blender => 'blendә
blenders => ˈblendəz
blending => 'blendiŋ
blends => blendz
blenheim => 'blenim
blennies => ˈbleniz
blenny => 'bleni
blent => blent
bleomycin => bliә'maisin
blepharitis => ,blefә'raitis
blepharoplasty => 'blefәrәj,plæsti
blepharospasm => ,blefәrәu'spæzm
blesbok => 'blesbɒk
bless => bles
blessed => 'blesid
blessedly => 'blesɪdlɪ
blessedness => 'blesidnis
blesses => blesiz
blessing => 'blesiŋ
blest => blest
blether => bleðә
blethered => 'bleðər
blethers => 'bleðər
bleu => blә:
blew => blu:
Bligh => blai
blight => blait
blighter => 'blaitә
blighters => ˈblaitəz
blighting => blaɪtɪŋ
blights => blaɪts
Blighty => 'blaiti
blimey => 'blaimi
blimp => blimp
blimpish => 'blimpiʃ
blin => blin
blind => blaind
blind date => blaind deit
blind drunk => blaind drʌŋk
blind pig => blaind piɡ
blind tiger => blaind ˈtaiɡə
blinded => blamd
blinder => 'blaindә
blindfold => 'blaindfәuld
blindfolded => ˈblaɪndˌfəʊldid
blindfolding => ˈblaɪndˌfəʊldɪŋ
blindfolds => ˈblaɪndˌfəʊldz
blinding => 'blaindiŋ
blindly => 'blaindli
blindness => 'blaindnis
blinds => 'blaindz
blindside => ˈblaɪndsaɪd
blindsight => 'blaind,sait
blindworm => 'blaindwә:m
blini => ˈblɪni
blink => bliŋk
blinked => bliŋkt
blinker => 'bliŋkә
blinkers => 'bliŋkәs
blinking => 'bliŋkiŋ
blinks => bliŋks
blintze => 'blintsә
bliny => 'blini
blip => blip
blips => blips
bliss => blis
bliss out => blis aut
blisses => blɪs
blissful => 'blisful
blissfully => 'blɪsfəlɪ
blissfulness => ˊblisfulnis
blister => 'blistә
blister pack => ˈblistə pæk
blistered => 'blɪstəd
blistering => 'blistәriŋ
blisteringly => 'blistəriŋli
blisters => ˈblistəz
blithe => blaið
blither => 'bliðә
blithering => 'bliðәriŋ
blithesome => 'blaiðsәm
blitz => blits
blitze => blits
blitzed => blitst
blitzes => blɪtsiz
blitzing => blɪtsɪŋ
blitzkrieg => 'blitskri:ɡ
blitzkriegs => ˈblɪtsˌkri:gz
blizzard => 'blizәd
blizzards => ˈblɪzədz
bloat => blәut
bloated => 'blәutid
bloater => 'blәutә
bloaters => 'bləʊtə
blob => blɒb
blobby => 'blɔbi
blobs => blɔbz
bloc => blɒk
bloch => blɔk
block => blɒk
block grant => blɔk ɡrɑ:nt
block letters => blɔk ˈletəz
block plane => blɔk plein
block vote => blɔk vəut
blockade => blɒ'keid
blockaded => blɔˈkeɪdid
blockader => blɒ'keidә
blockades => blɔˈkeɪdz
blockading => blɔˈkeɪdɪŋ
blockage => 'blɒkidʒ
blockages => ˈblɔkidʒz
blockboard => 'blɔkbɔ:d
blockbuster => 'blɒkbʌstә
blockbusters => ˈblɔkˌbʌstəz
blockbusting => 'blɔk,bʌstiŋ
blocked => blɔkt
blocker => 'blɔkә
blockers => b'lɒkərz
blockhead => 'blɒkhed
blockheaded => 'blɒk,hedɪd
blockheads => ˈblɔkˌhedz
blockhouse => 'blɒkhaus
blocking => 'blɔkiŋ
blockish => 'blɒkiʃ
blocks => 'blɔks
blockship => 'blɒkʃip
blockwork => 'blɔkwә:k
blocky => 'blɔki
blocs => blɔks
Bloemfontein => 'blu:mfәntein
blogosphere => 'blɒɡəsfɪə(r)
blogroll => 'blɒgrəʊl
blogs => b'lɒɡz
Blois => blwa
bloke => blәuk
blokes => bləʊks
blond => blɒnd
blonde => blɔnd
Blondel => 'blɔndel
blondes => blɔndz
blondish => 'blɒndɪʃ
blonds => blɔndz
blood => blʌd
blood heat => blʌd hi:t
blood lust => blʌd lʌst
blood platelet => blʌd ˈpleitlit
blood sausage => blʌd ˈsɔsidʒ
blood sport => blʌd spɔ:t
blood-and-guts => b'lʌd'ændɡ'ʌts
blood-and-thunder => 'blʌdәn'θʌndә(r)
blood-red => 'blʌd'red
bloodbath => 'blʌdbɑ:θ
bloodcurdling => 'blʌd.kә:dliŋ
blooded => 'blʌdid
bloodfin => 'blʌdfin
bloodhound => 'blʌdhaund
bloodhounds => ˈblʌdˌhaʊndz
bloodied => ˈblʌdid
bloodier => ˈblʌdiə
bloodily => 'blʌdili
bloodiness => 'blʌdinis
bloodless => 'blʌdlis
bloodletting => 'blʌd.letiŋ
bloodline => 'blʌdlain
bloodlines => ˈblʌdlainz
bloodlust => 'blʌdlʌst
bloodroot => 'blʌdru:t
bloodshed => 'blʌdʃed
bloodshot => 'blʌdʃɒt
bloodstain => 'blʌdstein
bloodstained => 'blʌdsteind
bloodstains => ˈblʌdsteinz
bloodstock => 'blʌdstɒk
bloodstone => 'blʌdstәun
bloodsucker => 'blʌdsʌkә
bloodsuckers => :blʌdsʌkəz
bloodsucking => 'blʌd,sʌkiŋ
bloodthirstier => 'blʌdθɜːstɪ
bloodthirstiest => 'blʌdθɜːstɪ
bloodthirsty => 'blʌd.θә:sti
bloodwood => 'blʌdwud
bloodworm => 'blʌdwә:m
bloody => 'blʌdi
blooey => 'blu:i
bloom => blu:m
bloomed => 'blu:md
bloomer => 'blu:mә
bloomers => 'blu:mәz
bloomery => 'blu:mәri
bloomfield => 'blu:mfi:ld
Bloomfieldian => ,blu:m'fi:ldian
blooming => 'blu:miŋ
blooms => blu:mz
Bloomsbury => 'blu:mzbəri
bloop => blu:p
blooper => 'blu:pә
Bloor => blu:, blɔә
blossom => 'blɒsәm
blossomed => ˈblɔsəmd
blossoming => 'blɑsəmɪŋ
blossoms => ˈblɔsəmz
blossomy => b'lɒsəmɪ
blot => blɒt
blotch => blɒtʃ
blotched => blɔtʃt
blotches => blɔtʃiz
blotchy => 'blɒtʃi
blots => blɔts
blotted => blɔtid
blotter => 'blɒtә
blotters => ˈblɔtəz
blotting => 'blɔtiŋ
blotto => 'blɒtәu
blouse => blauz
blouses => blaʊziz
blouson => 'blu:sɔn
blow => blәu
blow job => bləu dʒɔb
blow-dried => bləu draid
blow-dries => bləu drais
blow-dry => ˈbləʊˌdraɪ
blow-dryer => b'ləʊdr'aɪər
blow-in => bləu in
blow-lamp => b'ləʊl'æmp
blowback => 'blәubæk
blowdown => 'blәudaun
blower => 'blәuә
blowfly => 'blәuflai
blowgun => 'blәugʌn
blowhard => 'blәuhɑ:d
blowhole => 'blәuhәul
blowing => 'blәuiŋ
blowjob => 'blәudʒɔb
blowjobs => 'bləʊdʒɒb
blowlamp => 'blәulæmp
blown => blәun
blowout => 'blәuaut
blowpipe => 'blәupaip
blowpipes => 'bləʊpaɪp
blowsy => 'blɑjzi
blowtorch => 'blәutɒ:tʃ
blowy => 'blәui
blowzy => 'blajzi
blub => blʌb
blubbed => blʌbd
blubber => 'blʌbә
blubbered => ˈblʌbəd
blubbers => ˈblʌbəz
blubbery => 'blʌbәri
blubbing => blʌbɪŋ
blubs => blʌbz
bludgeon => 'blʌdʒәn
bludgeoned => ˈblʌdʒənd
bludgeoning => ˈblʌdʒənɪŋ
bludgeons => ˈblʌdʒənz
bludger => 'blʌdʒә(r)
blue => blu:
blue cheese => blu: tʃi:z
blue chip => blu: tʃip
blue crab => blu: kræb
blue ensign => blu: ˈensən
blue funk => blu: fʌŋk
blue helmet => blu: ˈhelmit
blue jay => 'blu:dʒei
blue law => blu: lɔ:
blue note => blu: nəut
blue riband => ˌblu: ˈrɪbənd
blue screen => blu: skri:n
blue sheep => blu: ʃi:p
blue tit => blu: tɪt
blue whale => blu: hweil
blue-black => 'blu:'blæk
blue-chip => 'blu:tʃip
blue-eyed boy => ˈblu:ˌaɪd
blue-green algae => ˈblu:ˌgri:n
blue-pencil => ,blu:'pensәl
blue-pencilled => blu: 'pensəld
blue-ribbon => 'blu:'ribәn
blue-sky => 'blu:'skai
blueback => 'blu:,bæk
Bluebeard => 'blu:.biәd
bluebell => 'blu:bel
bluebells => ˈblu:belz
blueberries => b'lu:berɪz
blueberry => 'blu:bәri
bluebill => 'blu:bil
bluebird => 'blu:bә:d
bluebirds => ˈblu:bə:dz
bluebonnet => 'blu:bɒnit
bluebottle => 'blu:.bɒtl
bluebottles => ˈblu:ˌbɔtlz
bluecoat => 'blu:kәut
blued => b'lu:d
bluefin => 'blu:fin
bluefish => 'blu:fiʃ
bluegill => 'blu:^il
bluegrass => 'blu:græs
bluehead => 'blu:hed
blueing => 'blu:iŋ
blueish => 'blu:iʃ
bluejacket => 'blu:dʒækit
bluejay => 'blu:dʒei
blueness => 'blu:nis
bluenose => 'blu:nәjz
bluenosed => 'blu:nəuzd
blueprint => 'blu:'print
blues => blu:z
bluesman => 'blu:zmәn
bluest => bluː
bluestem => 'blu:stem
bluestocking => 'blu:stɒkiŋ
bluestockings => 'bluːstɒkɪŋ
bluestone => 'blu:stәun
bluesy => 'blu:zi
bluet => 'blu:it
bluethroat => 'blu:θrәjt
bluetit => 'blu:,tit
bluetongue => 'blu:tʌŋ
bluey => 'blu:i
bluff => blʌf
bluffed => blʌft
bluffly => 'blʌfli
bluffness => 'blʌfnis
bluffs => blʌfs
bluing => 'bluiŋ
bluish => 'bluiʃ
blunder => 'blʌndә
blunderbuss => 'blʌndәbʌs
blundered => ˈblʌndəd
blunderer => 'blʌndәrә
blundering => 'blʌndәriŋ
blunderingly => b'lʌndərɪŋlɪ
blunders => ˈblʌndəz
blunge => blʌndʒ
blunt => blʌnt
blunted => blʌntid
blunter => blʌntə
blunting => blʌntɪŋ
bluntly => 'blʌntli
bluntness => 'blʌntnis
blunts => blʌnts
blur => blә:
blurb => blә:b
blurred => 'blә:rid. blә:d
blurring => 'blә:riŋ
blurry => 'blә:ri
blurs => blə:z
blurt => blә:t
blurted => blə:tid
blurting => blə:tɪŋ
blurts => blə:ts
blush => blʌʃ
blushed => blʌʃt
blusher => 'blʌʃә
blushes => blʌʃiz
blushing => 'blʌʃiŋ
bluster => 'blʌstә
blustered => ˈblʌstəd
blustering => 'blʌstiŋ
blusters => ˈblʌstəz
blustery => 'blʌstәri
Blythe => blaiθ
bmx => bi:em'eks
bo => bәu
bo tree => bəʊ
boa => 'bәuә
boab => 'bəuæb
Boadicea => ,bəuədi'siə
boak => bəuk
boar => bɒ:
board => bɒ:d
board game => bɔ:d ɡeim
boarder => 'bɒ:dә
boarders => 'bɔ:dəz
boarding => 'bɒ:diŋ
boarding card => ˈbɔ:dɪŋ kɑ:d
boardinghouse => 'bɔ:diŋhajs
Boardman => 'bɔ:dmən
boardroom => 'bɒ:drum
boardrooms => ˈbɔ:dru:mz
boardsailing => ˈbɔ:dseɪlɪŋ
boardwalk => 'bɒ:dwɒ:k
boardwalks => 'bɔ:dwɔ:ks
boarfish => 'bɔ:,fiʃ
boars => bɔ:z
boart => bɔ:t
Boas => 'bәuәz
boast => bәust
boasted => bəustid
boaster => 'bәustә
boastful => 'bәustful
boastfully => 'bəʊstfəlɪ
boastfulness => ˊboustfulnis
boasts => bəusts
boat => bәut
boat deck => bəut dek
boat hook => bəut huk
boat people => bəut ˈpi:pl
boatbill => 'bәjtbil
boatbuilder => bəʊtb'ju:ldə
boatbuilding => bəʊtb'ju:ldɪŋ
boated => bəʊt
boatel => bәu'tel
boater => 'bәutә
boaters => ˈbəutəz
boatful => 'bəutful
boathook => 'bәuthuk
boathouse => 'bәuthaus
boathouses => ˈbəʊtˌhaʊsiz
boatie => 'bəuti
boating => 'bәutiŋ
boatlift => 'bəʊtlɪft
boatload => 'bәutlәud
boatman => 'bәutmәn
boatmen => 'bəʊtmən
boatswain => 'bәutswein
boatswains => ˈbəutsweinz
boatyard => 'bәut.jɑ:d
bob => bɒb
bobbed => bɒbd
bobber => 'bɒbә
bobbie => 'bɔbi
bobbies => ˈbɔbiz
bobbin => 'bɒbin
bobbin lace => ˈbɔbin leis
bobbinet => bɒbi'net
bobbing => 'bɔbiŋ
bobbins => ˈbɔbinz
bobble => 'bɔbl
bobbled => ˈbɔbld
bobbles => ˈbɔblz
bobbling => ˈbɔblɪŋ
bobbly => 'bɔbli
bobby => 'bɒbi
bobby pin => ˈbɔbi pin
bobcat => 'bɒbkæt
bobolink => 'bɒbәliŋk
bobotie => 'bɔbәti:
bobsled => 'bɒbsled
bobsledding => 'bɔbslediŋ
bobsleds => ˈbɔbsledz
bobsleigh => 'bɒbslei
bobstay => 'bɒbstei
bobtail => 'bɒbteil
bobweight => 'bɔb'weit
bobwhite => 'bɒb'wait
bocage => bәu'kɑ:ʒ
Boccaccio => bәu'kɑ:tʃiәu
bocce => 'bɑtʃi:
Boche => bɒʃ
Bochum => 'bәjhәm
bock => bɒk
BOD => bɔd
bodacious => bәu'deiʃәs
bode => bәud
boded => bəʊdid
bodega => bәu'di:^ә
Bodensee => 'bәjdәn,zei
bodes => bəʊdz
bodge => bɒdʒ
bodger => bɔdʒə
bodgie => 'bɔdʒi
bodice => 'bɒdis
bodiced => 'bɒdɪs
bodices => ˈbɔdɪsiz
bodied => 'bɔdid
bodiless => 'bɒdilis
bodily => 'bɒdili
boding => 'bәudiŋ
bodkin => 'bɒdkin
bodkins => 'bɒdkɪn
bodleian => bɔd'li:әn
Bodley => 'bɔdli
Bodmin => 'bɔdmin
Bodoni => bә'dәjni
bods => bɔdz
body => 'bɒdi
body and soul => ˈbɔdi ænd səul
body armour => ˈbɔdi ˈɑ:mə
body bag => ˈbɔdi bæɡ
body blow => ˈbɔdi bləu
body clock => ˈbɔdi klɔk
body count => ˈbɔdi kaunt
body double => ˈbɔdi ˈdʌbl
body language => ˈbɔdi ˈlæŋɡwidʒ
body mass index => ˈbɔdi mæs ˈindeks
body piercing => ˈbɔdi ˈpɪəsɪŋ
body politic => ˈbɔdi ˈpɔlɪtɪk
body press => ˈbɔdi pres
body search => ˈbɔdi sə:tʃ
body shop => ˈbɔdi ʃɔp
body slam => ˈbɔdi slæm
body stocking => ˈbɔdi ˈstɔkiŋ
body swerve => ˈbɔdi swə:v
body-building => 'bɔdi,bildiŋ
body-check => ˈbɔdi tʃek
body-con => 'bɔdikɔn
bodyboard => ˈbɒdibɔ:d
bodyguard => 'bɒdigɑ:d
bodyguards => ˈbɔdi:ˌgɑ:dz
bodying => 'bɔdiiŋ
bodyshell => 'bɔdiʃel
bodysuit => ˈbɒdisu:t
bodysurf => 'bɔdis\\\\:f
bodywork => 'bɒdiwә:k
bodyworker => 'bɑdɪwɝk
boe => bəu
Boeotia => bi'әuʃjә
Boeotian => bi'әuʃjәn
Boer => 'bәuә
boeuf => bəuf
boff => bɒf
boffin => 'bɒfin
boffins => ˈbɔfinz
boffo => 'bɔfәu
boffola => bә'fәulә
BOFORS => 'bәufɔ:z
bog => bɒg
bog asphodel => bɔɡ ˈæsfədel
bog moss => bɔɡ mɔs
bog spavin => bɔɡ ˈspævin
bog-standard => bɔɡ ˈstændəd
bogan => 'bəʊg(ə)n
Bogart => 'bəuɡɑ:t
bogbean => 'bɔ^bi:n
bogey => 'bәugi
bogeyman => 'bәj^imæn
bogeys => ˈbəuɡiz
boggart => 'bɒɡət
bogginess => ˊbɒginis
bogging => 'bɔ^iŋ
boggle => 'bɒgl
boggled => ˈbɔgəld
boggles => ˈbɔgəlz
boggling => ˈbɔgəlɪŋ
boggy => 'bɒgi
bogie => 'bәugi
bogies => 'bəʊɡɪz
bogland => 'bɔɡ,lænd
bogle => 'bәugl
bogs => bɔɡz
bogus => 'bәugәs
bogwood => 'bɔ^wjd
bogy => 'bәugi
bogyman => bəʊ'ɡi:mæn
bohea => bәu'hi:
Bohemia => bәu'hi:mjә
bohemian => bәu'hi:mjәn
bohemianism => bәj'hi:mjәnizәm
bohemians => bəuˈhi:mjənz
Bohol => bəu'hɔ:l
Bohr => 'bәuә
bohrium => 'bɔriәm
bohunk => 'bәuhʌŋk
boil => bɒil
boiled => bɔild
boiled sweet => bɔɪld swi:t
boiler => 'bɒilә
boilermaker => ˈbɔɪləmeɪkə(r)
boilerplate => 'bɔilәpleit
boilers => 'bɔɪləz
boiling => 'bɒiliŋ
boiling point => 'bɔiliŋ
boilover => 'bɔil,әjvә(r)
boils => bɔilz
boing => 'bәuiŋ
bois => bwɑ:
boisterous => 'bɒistәrәs
boisterously => 'bɒistәrәsli
boisterousness => 'bɔistərəsnis
bok choy => ˌbɒk ˈtʃɔɪ
boke => bɔk. bәuk
bola => 'bәulә
Bolan => bәj'lɑ:n
bolas => 'bəʊləs
bold => bәuld
boldface => 'bәuldfeis
boldfaced => 'bәuldfeist
boldly => 'bәuldli
boldness => 'boәldlinis
bole => bәul
bolection => bәu'lekʃәn
bolero => bә'lerәu
boleros => bəˈlɛərəuz
Boleyn => 'bulin
bolide => 'bәulaid
Bolingbroke => 'bɔliŋbruk
bolivar => 'bɒlәvɑ:
Bolivia => bә'liviә
bolivian => bә'liviәn
boliviano => bә.livi:'ɑ:nәu
boll => bәul
bollard => 'bɒlәd
bollards => ˈbɔlɑ:dz
bollock => 'bɒlək
bollocks => 'bɔlәks
bollworm => 'bәulwә:m
bolo => 'bәulәu
bolo tie => ˈbəʊləʊ taɪ
bologna => bә'lәunjә
bolognese => ,bәjlә'ni:z
bolometer => bәu'lɒmitә
bolometric => ,bəulə'metrik
boloney => bә'lәuni
Bolshevik => 'bɒlʃivik
bolsheviks => ˈbɔlʃiviks
Bolshevism => 'bɒlʃivizm
Bolshevist => 'bɒlʃivist
bolshie => ˈbɒlʃi
Bolsover => 'bɔlsәvә
bolster => 'bәulstә
bolstered => ˈbəʊlstəd
bolsters => ˈbəʊlstəz
bolt => bәult
bolt-action => bəult ˈækʃən
bolter => 'bәultә
bolthole => 'bəʊlthəʊl
bolting => 'bәultiŋ
bolton => 'bәultәn
bolts => bәults
bolus => 'bәulәs
Bolzano => bɔ:l'tsɑ:nɔ:
boma => 'bəumə
bomb => bɒm
bomb bay => bɔm bei
bomb disposal => bɔm disˈpəuzəl
bombard => bɒm'bɑ:d
bombarded => bɔmˈbɑ:did
bombardier => .bɒmbә'diә
bombardier beetle => ˌbɔmbəˈdiə ˈbi:tl
bombardment => bɒm'bɑ:dmәnt
bombardments => bɔmˈbɑ:dmənts
bombardon => bɒm'bɑ:dәn
bombards => bɔmˈbɑ:dz
bombast => 'bɒmbæst
bombastic => bɒm'bæstik
bombastically => bɔm'bæstikli
Bombay => bɒm'bei
bombazine => 'bɒmbәzi:n
bombe => bәumb
bombed => bɔmd
bombed-out => 'bɔmdajt
bomber => 'bɒmә
bomber jacket => ˈbɔmə ˈdʒækit
bombers => ˈbɔməz
bombinate => 'bɒmbineit
bombing => 'bɔmiŋ
bomblet => 'bɔmlit
bombora => bɔm'bɔ:rә
bombproof => 'bɒmpru:f
bombshell => 'bɒmʃel
bombshells => ˈbɔmˌʃelz
bombsight => 'bɒmsait
bon => bɔ:n
bon vivant => bɔ vi:'vɑŋ
bon viveur => ,buŋvi:'və:r
bona fide => bәjnә 'faidi
Bonaire => bә'neә(r)
bonanza => bәu'nænzә
bonanzas => bəˈnænzəz
Bonaparte => 'bәunәpɑ:t
Bonapartism => 'bәunәpɑ:tizәm
Bonaventure => ,bɔnә'ventʃә
bonbon => 'bɒnbɒn
bonbons => ˈbɔnbɔnz
bonce => bɒns
bond => bɒnd
bondage => 'bɒndidʒ
bondager => 'bɒndɪdʒ
bonded => 'bɒndid
bondholder => 'bɒndhәuldә
bondholders => ˈbɔndˌhəuldəz
Bondi => 'bɔn'dai
bondieuserie => bәjŋ,dju:zә'ri:
bonding => 'bɔndiŋ
bonds => bɒndz
bondsman => 'bɒndzmәn
bondsmen => 'bɒndzmən
bondstone => 'bɒndstәun
bone => bәun
bone idle => bəun ˈaidl
bone marrow => bəun ˈmærəʊ
bone spavin => bəun ˈspævin
bone-setter => 'bəʊn,setə
bone-tired => 'bəʊnt'aɪəd
boned => bәund
bonefish => 'bəʊnfɪʃ
bonehead => 'bәunhed
boneheaded => 'bəʊ'hedɪd
boneless => 'bәjnlis
boner => 'bәunә
bones => bәunz
boneset => 'bәunset
boney => 'bәuni
bonfire => 'bɒnfaiә
bonfires => ˈbɔnˌfaiəz
bong => bɔŋ. bɔ:ŋ
bongo => 'bɒŋgәu
bongos => ˈbɔŋɡəuz
bongs => bɔŋz
bonhomie => bɔnɔ'mi:; (?@) bɔnә'mi:
bonhomous => 'bɔnәmәs
boniato => ˌbəʊni:ˈɑ:təʊ
boniface => 'bɔnifeis
boniness => 'bәjninis
boning => 'bәuniŋ
bonito => bә'ni:tәu
Bonjour => bɔnzhur
bonk => bɒŋk
bonked => bɔŋkt
bonkers => 'bɔŋkәz
bonking => bɔŋkɪŋ
bonks => bɔŋks
Bonn => bɒn
bonne => bɔn
bonne bouche => ,bɔn'bu:ʃ
BONNER => 'bɔnә
bonnet => 'bɒnit
bonneted => 'bɒnɪtɪd
bonnethead => 'bɒnethed
bonnets => ˈbɔnɪts
bonnie => 'bɒni
bonnier => ˈbɔni:ə
bonnily => 'bɒnili
bonny => 'bɒni
bonobo => 'bәunә,bәu
bonsai => 'bɔnsai
bonsais => bəunˈsaiz
bonspiel => 'bɔnspi:l
bontebok => 'bɔntibɔk
bonus => 'bәunәs
bonxie => 'bɔŋksi
bony => 'bәuni
bony fish => ˈbəʊni: fiʃ
bonze => bɒnz
bonzer => 'bɒnzә
Bonzo => 'bɔnzəu
boo => bu:
boob => bu:b
boob tube => bu:b tju:b
boobies => ˈbu:biz
boobing => buːb
booboisie => bu:bwɑ:'zi:
booby => 'bu:bi
booby hatch => ˈbu:bi hætʃ
booby trap => ˈbu:bi træp
boodle => 'bu:dl
booed => bu:d
boogaloo => ,bu:^ә'lu:
booger => 'bu:^ә
boogeyman => 'bu:^i,mæn
boogie => 'bu(:)^i
boogied => ˈbu:ɡid
boogies => ˈbu:ɡiz
boohoo => 'bu:hu:
booing => bu:ɪŋ
boojum => 'bu:dʒәm
book => buk
book club => buk klʌb
book lung => buk lʌŋ
bookable => 'bjkәbl
bookbinder => 'bukbaindә
bookbinding => 'bukbaindiŋ
bookcase => 'bukkeis
bookcases => ˈbʊkˌkeɪsiz
bookend => 'bukend
booker => 'bukә
bookie => 'buki
bookies => ˈbukiz
booking => 'bukiŋ
bookish => 'bukiʃ
bookishness => 'bʊkɪʃnəs
bookkeeper => 'bukki:pә
bookkeeping => 'bukki:piŋ
bookland => 'bjklænd
booklet => 'buklit
booklets => ˈbuklits
booklist => 'buklist
booklouse => 'bukləus
bookmaker => 'bukmeikә
bookmakers => ˈbukˌmeikəz
bookmaking => 'bjk,meikiŋ
bookman => 'bukmәn
bookmark => 'bukmɑ:k
bookmobile => 'bukmә,bi:l
bookplate => 'bukpleit
bookrest => 'bjkrest
bookseller => 'bukselә
Booksellers => 'bʊkselə(r)
bookshelf => 'bukʃelf
bookshop => 'bukʃɒp
bookshops => ˈbukʃɔps
bookstall => 'bukstɒ:l
bookstalls => ˈbʊkˌstɔ:lz
bookstore => 'bukstɒ:
bookstores => ˈbʊkˌstɔ:z
booksy => 'buksi
bookwork => 'bukwә:k
bookworm => 'bukwә:m
bookworms => ˈbukwə:mz
booky => 'bjki
boom => bu:m
boom box => bu:m bɔks
boombox => bu:m'bɒks
boomed => bu:md
boomer => 'bu:mә
boomerang => 'bu:mәræŋ
boomeranged => ˈbu:məˌræŋd
boomeranging => ˈbu:məˌræŋɪŋ
boomerangs => ˈbu:məˌræŋz
boomers => 'bu:məz
boominess => 'bu:minis
booming => 'bu:miŋ
boomlet => 'bu:mlit
booms => bu:mz
boomslang => 'bu:mslæŋ
boomy => 'bu:mi
boon => bu:n
boondocks => 'bu:ndɔks
boondoggle => 'bu:ndɒgl
boondoggled => 'buːndɒg(ə)l
boondoggles => ˈbu:nˌdɔɡlz
boondoggling => 'buːndɒg(ə)l
boone => bu:n
boong => bu:ŋ
boonies => 'bu:niz
boons => bu:nz
boor => buә
boorish => 'buriʃ
boorishness => 'buriʃnis
boors => bʊəz
boos => bu:z
boost => bu:st
booster => 'bu:stә
booster seat => ˈbu:stə si:t
boosterism => 'bu:stərɪzəm
boosters => ˈbu:stəz
boosting => 'bu:stiŋ
boosts => bu:sts
boot => bu:t
boot camp => bu:t kæmp
boot sale => bu:t seil
boot-up => 'bu:t'ʌp
bootable => 'bu:tәbl
bootblack => 'bu:tblæk
bootboy => 'buːtbɒɪ
booted => 'bu:tid
bootee => 'bu:ti:
bootees => bu:'ti:z
booth => bu:θ
Boothia => 'bu:θiә
booths => bu:ðz
bootie => 'bu:ti:
bootjack => 'bu:tdʒæk
bootlace => 'bu:tleis
bootlaces => 'buːtleɪs
Bootle => 'bu:tl
bootleg => 'bu:tleg
bootlegged => ˈbu:tleɡd
bootlegger => 'bu:tlegә
bootleggers => 'bu:t,legə
bootlegs => ˈbu:tleɡz
bootless => 'bu:tlis
bootlick => 'bu:tlik
bootlicker => bu:tlikә(r)
bootlicking => ˈbu:tlikɪŋ
bootmaker => 'bu:tmeikә
boots => bu:ts
bootstrap => 'bu:tstræp
bootstrapping => 'bu:tstræpiŋ
booty => 'bu:ti
bootylicious => ˌbu:tɪˈlɪʃəs
booze => bu:z
boozers => ˈbu:zəz
boozes => 'bu:zɪz
boozing => bu:zɪŋ
boozy => 'bu:zi
bop => bɔp
Bophuthatswana => ,bәjpu:tɑ:t'swɑ:nә
bopped => bɔpt
bopper => 'bɔpә
bopping => bɔpɪŋ
bops => bɔps
bora => 'bɒ:rә
boracic => bә'ræsik
borage => 'bɔridʒ
borak => 'bɒ:rәk
borane => 'bәurein
borate => 'bәureit
borax => 'bɒ:ræks
borborygmus => ,bɔ:bә'ri^mәs
Bordeaux => bɒ:'dәu
bordello => bɒ:'delәu
bordellos => bɔ:ˈdeləuz
border => 'bɒ:dә
bordered => 'bɔ:dәd
borderer => 'bɒ:dәrә
borderland => 'bɒ:dәlænd
borderless => 'bɔ:dələs
borderline => 'bɒ:dәlain
borders => 'bɔ:dәz
Bordet => ,bɔ:'dei
bordure => 'bɔ:djuә
bore => bɒ:
boreal => 'bɒ:riәl
boredom => 'bɒ:dәm
boreen => bәj'ri:n
borehole => 'bɔ:hәul
boreholes => ˈbɔ:həulz
borer => 'bɒ:rә
borescope => 'bɔ:skәjp
Borgia => 'bɔ:dʒiə
boric => 'bɒ:rik
boric acid => 'bɔ:rik
boride => 'bɒ:raid
boring => 'bɒ:riŋ
boris => 'bɔris
born => bɒ:n
born and bred => bɔ:n ænd bred
born-again => ˈbɔ:nəˌgen
borne => bɔ:n
Bornean => 'bɒ:niәn
Borneo => 'bɒ:niәu
Bornholm => 'bɔ:nhәjm
bornite => 'bɒ:nait
boro- => 'bɔ:rəʊ
boron => 'bɒ:rɒn
boronia => bә'rәjniә
borough => 'bә:rәu
boroughs => ˈbʌrəz
borrow => 'bɒrәu
borrow pit => ˈbɔrəu pit
borrowed => 'bɒrәud
borrower => 'bɒrәuә
borrowers => 'bɒrəʊəz
borrowing => 'bɔrәuiŋ
borrows => ˈbɔrəuz
Borsalino => ,bɔ:sә'li:nәj
borscht => bɔ:ʃt
borstal => 'bɔ:stl
borstals => 'bɔ:stlz
bort => bɔ:t
borzoi => 'bɒ:zɒi
Bosanquet => 'bәuznkit
boscage => 'bɔskidʒ
bosch => bɔ:ʃ
bose => bәus
bosh => bɒʃ
bosie => 'bәjzi
boskage => 'bɔskidʒ
bosky => 'bɒski
bosnia => 'bɔzniә
Bosnian => bɔzni:ən
bosom => 'buzәm
bosomed => bʊ'zəmd
bosoming => 'bʊz(ə)m
bosoms => ˈbuzəmz
bosomy => 'buzәmi
boson => 'bәuzɒn
Bosporus => 'bɔspәrәs
boss => bɒs
boss-eyed => 'bɒsaid
bossa nova => ˌbɒsə ˈnəʊvə
bosses => bɔsiz
bossiness => 'bɔsinis
bossing => 'bɔsiŋ
bossism => 'bɒsizm
bossy => 'bɒsi
bosthoon => bɔs'tu:n,-'θu:n
Boston => 'bɒstәn
Bostonian => bɒ'stәunjәn
bosun => 'bәusn
bosuns => ˈbəusnz
boswell => 'bɔzwәl
Boswellian => bɔz'weliәn
BOT => bɔt
botanic => bә'tænik
botanic garden => bəˈtænik ˈɡɑ:dn
botanical => bә'tænikәl
botanically => bə'tænɪklɪ
botanist => 'bɒtәnist
botanists => ˈbɔtnɪsts
botanize => 'bɔtәnaiz
botanizing => 'bɒtənaɪzɪŋ
botany => 'bɒtәni
botch => bɒtʃ
botched => bɔtʃt
botcher => 'bɒtʃә
botches => bɔtʃiz
botching => bɔtʃɪŋ
botel => bәu'tel
botfly => 'bɒtflai
both => bәuθ
bother => 'bɒðә
botheration => ,bɔðә'reiʃәn
bothering => ˈbɔðərɪŋ
bothers => ˈbɔðəz
bothersome => 'bɒðәsәm
Bothnia => 'bɔθniә
bothy => 'bɔθi
botnet => 'bɒtnet
boto => ˈbəʊˌtəʊ
Botox => 'bəutɔks
botryoidal => ,bɔtri'ɔidәl
bots => bɔts
botswana => bɔt'swɑ:nә
bott => bɔt
Botticelli => ,'bɔtisli:
bottle => 'bɒtl
bottle bank => ˈbɔtl bæŋk
bottle opener => ˈbɔtl ˈəʊpənə
bottle party => ˈbɔtl ˈpɑ:ti
bottle-fed => 'bɔtlfed
bottle-feed => ˈbɔtlˌfi:d
bottle-feeding => 'bɒtlf'i:dɪŋ
bottlebrush => 'bɔtlbrʌʃ
bottled => 'bɒtld
bottleneck => 'bɒtlnek
bottlenecks => ˈbɔtlˌneks
bottlenose => 'bɔtlnәjz
bottlenose dolphin => ˈbɔtlnəuz ˈdɔlfin
bottlenose whale => ˈbɔtlnəuz hweil
bottler => 'bɔtlә
bottlers => ˈbɔtləz
bottles => ˈbɔtlz
bottling => 'bɔtliŋ
bottom => 'bɒtәm
bottom dog => ˈbɔtəm dɔɡ
bottom feeder => ˈbɔtəm ˈfi:də
bottom line => ˈbɔtəm lain
bottome => 'bɔtәum
bottomed => 'bɔtәmd
bottoming => 'bɔtәmiŋ
bottomland => 'bɔtәmlænd
bottomless => 'bɔtәmlis
bottommost => 'bɒtәmmәust
bottomry => 'bɒtәmri
bottoms => 'bɔtәms
botulin => 'bɔtjulin
botulinum => ˌbɑtʃə'lɑɪnəm
botulinum toxin => ˌbɔtʃəˈlaɪnəm ˈtɔksɪn
botulism => 'bɒtjulizm
boubou => 'bu:bu:
boucle => ˈbu:kleɪ
Boudicca => bu:'dikә
boudin => bu:'dæŋ
boudoir => 'bu:dwɑ:r
boudoirs => ˈbu:ˌdwɑ:z
bouffant => bu:'fɒŋ
bouffants => 'buːfɒŋ
bougainvillaea => .bu:gәn'viliә
Bougainville => 'bu:^әnvil
bougainvillea => bu:^әn'viliә
bough => bau
boughs => baʊz
bought => bɒ:t
boughten => 'bɒ:tn
bougie => 'bu:ʒi:
bouillabaisse => ,bu:ljә'beis
bouilli => 'bu:ji:
bouillon => 'bu:jɔŋ
bouillons => ˈbu:jɔŋz
boulder => 'bәuldә
bouldering => 'bәuldәriŋ
boulders => ˈbəʊldəz
bouldery => 'bəʊldərɪ
Boule => 'bu:li
boulevard => 'bu:lәvɑ:d
boulevardier => bu:lvɑ:'djei
boulevards => ˈbuːləvɑː(r)dz
boulle => bu:l
Boulogne => bu'lәun
Boult => bәult
bounce => bauns
bounce back => bauns bæk
bouncer => 'baunsә
bouncers => ˈbaunsəz
bounces => baunsiz
bouncing => 'baunsiŋ
bouncy => 'baunsi
bouncy castle => ˈbaunsi ˈkɑːsl
bound => baund
boundaries => 'baʊndri
boundary => 'baundri
bounded => 'baundid
bounden => 'baundәn
bounder => 'baundә
bounders => ˈbaundəz
bounding => baundɪŋ
boundless => 'baundlis
boundlessly => 'baʊndlɪslɪ
bounteous => 'bauntiәs
bounteously => 'baʊntɪəslɪ
bounteousness => ˊbauntiәsnis
bounties => ˈbauntiz
bountiful => 'bauntiful
bountifully => 'baʊntɪfəlɪ
bounty => 'baunti
bounty hunter => ˈbaunti ˈhʌntə
bouquet => bu'kei
bouquet garni => ˌbu:keɪ gɑ:ˈni:
bouquets => ˈbukeiz
Bourbon => 'buәbәn
Bourbonnais => ,buəbə'nei
bourdon => 'buәdәn
bourgeois => buә'ʒwɑ:
bourgeoise => 'buәʒwɑ:z
bourgeoisie => .buәʒwɑ:'zi:
Bourgogne => bu:r'gɔ:nj
Bourn => bjәn
bourne => buәn
Bournemouth => 'bə:nməθ
bourse => buәs
bourses => buəsiz
boustrophedon => ,baustrә'fi:dәn
bout => baut
boutade => bu:'tɑ:d
boutique => bu:'ti:k
boutiques => bu:ˈti:ks
bouts => bauts
bouzouki => bu:'zu:ki
bovid => 'bәuvid
bovine => 'bәuvain
bovril => 'bɒvrәl
bovver => 'bәuvә
bovver boots => ˈbɒvə bu:ts
bow => bәu.bau
bow out => bəu aut
bow window => bəu ˈwindəu
bow-legged => ˌbəʊ'leɡɪd
bowdlerism => 'baudlәrizm
bowdlerization => baudlәraiˊzeiʃәn
bowdlerize => 'baudlәraiz
bowdlerized => ˈbaudləraizd
bowdlerizes => ˈbaudləraiziz
bowdlerizing => ˈbaudləraizɪŋ
bowed => bәud
bowel => 'bauәl
bower => 'bauә
bowerbird => 'bauәbә:d
bowered => 'baʊərd
bowfin => 'bәjfin
bowhead => 'bәuhed
bowhunter => bəʊ'hʌntə
bowhunting => 'bəuhʌntiŋ
bowie => 'bәui
bowing => 'bauiŋ
bowknot => 'bәunɒt
bowl => bәul
bowler => 'bәulә
bowlers => ˈbəʊləz
bowlful => 'bәulful
bowline => 'bәulin 'bәulain
bowling => 'bәuliŋ
bowling alley => ˈbəuliŋ ˈæli
bowling ball => ˈbəuliŋ bɔ:l
bowling green => ˈbəuliŋ ɡri:n
bowman => 'bәumәn
bowmen => 'bəʊmən
bowrider => 'bau,raidə
bowshot => 'bәuʃɒt
bowsprit => 'bausprit
bowstring => 'bәustriŋ
bowwow => 'bauwau
bowyang => 'bәujæŋ
bowyer => 'bәujә
box => bɒks
box beam => bɔks bi:m
box camera => bɔks ˈkæmərə
box clever => bɔks ˈklevə
box junction => bɔks ˈdʒʌnkʃən
box kite => bɔks kait
box lunch => bɔks lʌntʃ
box pleat => bɔks pli:t
box room => bɔks ru:m
box score => bɔks skɔ:
box spring => bɔks spriŋ
boxboard => 'bɔksbɔ:d
boxcar => 'bɒkskɑ:
boxed => bɔkst
boxer => 'bɒksә
boxer shorts => ˈbɔksə ʃɔ:ts
boxfish => 'bɒksfɪʃ
boxful => 'bɒksful
boxing => 'bɒksiŋ
boxlike => 'bɒkslaik
boxroom => 'bɒksru:m
boxrooms => 'bɔksru:m
boxthorn => 'bɒksθɔ:n
boxty => 'bɔksti
boxwood => 'bɒkswud
boxy => 'bɔksi
boy => bɒi
boy band => bɔi bænd
boy racer => bɔi ˈreɪsə
boy wonder => bɔi ˈwʌndə
boyar => 'bɔ:jɑ:
boycott => 'bɒikɒt
boycotted => ˈbɔikɔtid
boycotts => ˈbɔikɔts
boyd => bɔid
boyfriend => 'bɔifrend
boyfriends => ˈbɔɪˌfrendz
boyhood => 'bɒihud
boyish => 'bɒiiʃ
boyishly => 'bɔɪɪʃlɪ
boyla => 'bɔilә
boyle => bɔil
Boyne => 'bɔin
boyo => ˈbɔɪəʊ
boysenberry => 'bɒizәnbәri
Boz => bɔz
bozo => 'bәuzәu
bra => brɑ:
braaivleis => 'braifleis
Brabant => brə'bænt
brace => breis
braced => breist
bracelet => 'breislit
bracelets => b'reɪslɪts
bracer => 'breisә
bracero => brә'serәu
brachial => 'breikiәl
brachiate => 'breikiit
brachiopod => 'brækiәpɒd
Brachiopoda => ,bræki'ɔpәdә
brachiosaurus => ˌbrækiəˈsɔ:rəs
brachistochrone => brә'kistә,krәun
brachy- => 'bræki
brachycephalic => ,brækisә'fælik
brachytherapy => ,bræki'θerəpi
bracing => 'breisiŋ
brack => bræk
bracken => 'brækn
bracket => 'brækit
bracket fungus => ˈbrækit ˈfʌŋɡəs
bracketed => 'brækətɪd
bracketing => 'brækitiŋ
brackish => 'brækiʃ
Bracknell => 'bræknəl
braconid => brə'kɒnɪd
bract => brækt
bracteate => 'bræktiit
brad => bræd
bradawl => 'brædɒ:l
bradbury => 'brædbәri
bradded => brædid
bradding => brædɪŋ
Braddock => 'brædək
bradford => 'brædfәd
bradley => 'brædli
bradoon => brə'du:n
brads => brædz
Bradshaw => 'brædʃɔ:
bradycardia => brædi'kɑ:diә
bradykinin => ,brædi'kainin
brae => brei
Braemar => ,brei'mɑ:
Braer => breɪ
brag => bræg
Bragg => bræ^
braggadocio => .brægә'dәutʃiәu
braggart => 'brægәt
braggarts => 'brægət; -ɑːt
bragged => bræɡd
bragger => 'brægә
brags => bræɡz
brahma => 'brɑːmə
Brahman => 'brɑ:mәn
Brahmana => 'brɑ:mənə
Brahmanic => brɑ:'mænik
Brahmanical => brɑ:'mænikәl
Brahmanism => 'brɑ:mәnizm
Brahmaputra => ,brɑ:mә'pu:trә
Brahmin => 'brɑ:min
brahmins => ˈbrɑ:minz
brahms => brɑ:mz
Brahmsian => 'brɑ:mziәn
Brahui => brɑ:'hu:i
braid => breid
braided => 'breidid
braiding => 'breidiŋ
braids => breɪdz
brail => breil
brailed => breild
brailing => breilɪŋ
braille => breil
braillewriter => 'breil,raitә(r)
brain => brein
brain cell => brein sel
brain coral => brein ˈkɔrəl
brain damage => breɪn 'dæmɪdʒ
brain death => brein deθ
brain fungus => brein ˈfʌŋɡəs
brainbox => ˈbreɪnbɒks
braincase => 'breinkeis
brainchild => 'breintʃaild
brained => breɪnd
brainiac => 'breɪnɪæk
brainier => ˈbreiniə
braininess => 'breininis
brainless => 'breinlis
brainpan => 'breinpæn
brainpower => 'breinpauә
brains => 'breinz
brainstorm => 'breinstɒ:m
brainstormed => ˈbreɪnˌstɔ:md
brainstorming => 'brein,stɔ:miŋ
brainstorms => ˈbreɪnˌstɔ:mz
Braintree => 'brein,tri:
brainwash => 'breinwɒʃ
brainwashed => ˈbreɪnˌwɔʃt
brainwashes => ˈbreɪnˌwɔʃiz
brainwashing => 'breinwɒʃiŋ
brainwave => 'breinweiv
brainwaves => breɪn'weɪvz
brainy => 'breini
braise => breiz
braised => breɪzd
braises => breiziz
braising => breɪzɪŋ
brake => breik
brake light => breik lait
brake pad => breik pæd
braked => breikt
brakeman => 'breikmәn
braking => 'breikiŋ
braless => 'brɑ:lis
Bram => bræm
bramble => 'bræmbl
brambles => b'ræmblz
brambling => 'bræmbliŋ
brambly => 'bræmbli
Bramley => 'bræmli
Brampton => 'bræmptən
Bramwell => 'bræmwel
bran => bræn
branch => bræntʃ
branch water => brɑ:ntʃ ˈwɔ:tə
branchia => 'bræŋkiә
branchial => 'bræŋkiәl
branching => 'bræntʃiŋ
branchiopod => 'bræŋkiәpɔd
branchlet => b'rɑ:ntʃlet
branchy => 'bræntʃi
Branco => 'bræŋ,kəu
brand => brænd
brand name => brænd neim
brandade => brɔŋ'dɑ:d
branded => 'brændid
Brandenburg => 'brændənbə:ɡ
brander => 'brændә
brandied => 'brændid
brandies => ˈbrændiz
branding iron => ˈbrændɪŋ
brandish => 'brændiŋ
brandished => ˈbrændɪʃt
brandishes => ˈbrændɪʃiz
brandishing => ˈbrændɪʃɪŋ
brandling => 'brændliŋ
Brando => ˈbrændəʊ
BRANDRETH => 'brændriθ
brandt => brænt
brandy => 'brændi
brandy butter => ˈbrændi ˈbʌtə
brandy snap => ˈbrændi snæp
branks => bræŋks
brannigan => 'bræni^әn
brant => brænt
brash => bræʃ
brasher => bræʃə
brashly => 'bræʃlɪ
brashness => 'bræʃnəs
Brasil => brә'zil
Brasilia => brә'ziljә
Brasov => brɑ:'ʃɔ:v
brass => bræs.brɑ:s
brass hat => brɑ:s hæt
brass monkey => brɑ:s ˈmʌŋki
brass rubbing => brɑ:s ˈrʌbɪŋ
brassard => 'bræsɑ:d
brasserie => 'brɑ:s'ri:
Brassey => 'brɑ:si; 'bræsi
brassie => 'brɑ:si
brassier => ˈbrɑ:siə
brassiere => 'bræsiә
brassieres => ˈbræsiəz
brassware => 'brɑ:sweә(r)
brassy => 'bræsi
brat => bræt
brat pack => bræt pæk
Bratislava => ,bræti'slɑ:vә
brats => bræts
brattice => b'rættaɪs
bratticed => 'brætɪs
brattices => 'brætɪs
bratticing => b'rættaɪsɪŋ
brattish => 'brætiʃ
brattle => 'brætl
bratty => 'bræti
bratwurst => 'brætwә:st
Braun => braun
Braunschweig => 'brajnʃwaig
brava => 'brɑ:vɑ:
bravado => brә'vɑ:dәu
brave => breiv
braved => breivd
bravely => 'breivli
braveness => 'breivnis
bravery => 'breivәri
braves => breivz
braving => breivɪŋ
bravo => 'brɑ:vәu
bravura => brә'vjuәrә
braw => brɒ:
brawl => brɒ:l
brawled => brɔ:ld
brawls => brɔ:lz
brawly => 'brɔ:li
brawn => brɒ:n
brawniness => 'brɒ:ninis
brawny => 'brɒ:ni
braxy => 'bræksi
bray => brei
brayed => breɪd
braying => breɪŋ
brays => breɪz
braze => breiz
brazed => breɪzd
brazen => 'breizn
brazened => 'breɪz(ə)n
brazening => 'breɪz(ə)n
brazens => 'breɪz(ə)n
brazes => breiziz
brazier => 'breizjә
braziers => ˈbreizjəz
braziery => 'breizjәri
Brazil => brә'zil
Brazilian => brә'ziljәn
brazing => 'breiziŋ
Brazzaville => 'bræzәvil
breach => bri:tʃ
breached => bri:tʃt
breaches => bri:tʃiz
breaching => bri:tʃɪŋ
bread => bred
bread bin => ˈbredbɒks
bread knife => bred naif
bread pudding => bred ˈpudiŋ
bread sauce => bred sɔ:s
breadbasket => 'bred,bɑ:skit
breadboard => 'bredbɔ:d
breadbox => 'bredbɔks
breadcrumbs => ˈbredkrʌmz
breadline => 'bredlain
breadth => bredθ
breadthways => 'bredθweiz
breadwinner => 'bred.winә
breadwinners => ˈbredˌwɪnəz
breadwinning => 'bred,wɪnɪŋ
break => breik
break camp => breik kæmp
break free => breik fri:
break of day => breik ɔv dei
break-dance => 'brekdæns
break-off => b'reɪk'ɔ:f
breakable => 'breikәbl
breakage => 'breikidʒ
breakages => b'reɪkɪdʒɪz
breakbeat => ˈbreɪkbi:t
breakbone fever => ˈbreɪkbəʊn fi:və(r)
breakdown => 'breikdaun
breakdowns => b'reɪkdaʊnz
breaker => 'breikә
breakfast => 'brekfәst
breakfast television => ˈbrɛkfəst ˈtɛləˌvɪʒən
breakfasted => ˈbrekfəstid
breakfasting => ˈbrekfəstɪŋ
breakfasts => ˈbrekfəsts
breakfront => 'breikfrʌnt
breaking => 'breikiŋ
breakneck => 'breiknek
breakout => 'breikajt
breakthrough => 'breikθru:
breakthroughs => b'reɪkθru:z
breakup => 'breikʌp
breakwater => 'breikwɒ:tә
breakwaters => ˈbreɪkˌwɔ:təz
breakwind => 'breikwind
bream => bri:m
breamed => briːm
breaming => briːm
breams => briːm
breast => brest
breast implant => brest ɪmˈplænt
breast-high => 'brest'hai
breastbone => 'brestbәun
breasted => 'brestid
breastfeed => ˈbrestfi:d
breastfeeding => brest'fi:dɪŋ
breastfeeds => ˈbrestfi:dz
breasthook => 'bresthjk
breasting => 'brestiŋ
breastpin => 'brestpin
breastplate => 'brestpleit
breastplates => ˈbrestpleits
breaststroke => 'breststrәjk
breastsummer => 'brest,sʌmә(r)
breastwork => 'brestwә:k
breath => breθ
breathalyse => 'breθә,laiz
breathalyser => 'breθәlaizә
breathe => bri:ð
breathed => breθt
breather => 'bri:ðә
breathers => ˈbri:ðəz
breathes => bri:ðz
breathing => 'bri:ðiŋ
breathless => 'breθlis
breathlessly => 'breθləslɪ
breathlessness => 'breθləsnəs
breaths => breθs
breathtaking => 'breθ.teikiŋ
breathtakingly => 'breθteikiŋli
breathy => 'breθi
breccia => 'bretʃiә
brecciate => 'bretʃi,eit
brecciated => 'bretʃieitid
Brechtian => 'breʃtiәn
Brecon => 'brekən
Breconshire => 'brekәnʃә(r)
bred => bred
breech => bri:tʃ
breech birth => bri:tʃ bə:θ
breechblock => 'bri:tʃblɒk
breechcloth => 'bri:tʃklɔθ
breechclout => bri:tʃk'laʊt
breeched => bri:tʃt
breeches => 'britʃiz
breeches buoy => ˈbrɪtʃɪz ˈbu:i:
breeching => 'britʃiŋ
breed => bri:d
breeder => 'bri:dә
breeders => ˈbri:dəz
breeding => 'bri:diŋ
breeding ground => ˈbri:dɪŋ ɡraund
breeks => bri:ks
Breen => bri:n
breeze => bri:z
breeze block => bri:z blɔk
breeze through => bri:z θru:
breeze-block => b'ri:zbl'ɒk
breezes => bri:ziz
breezeway => 'bri:zwei
breezily => 'bri:zili
breeziness => 'bri:zinis
breezing => bri:zɪŋ
breezy => 'bri:zi
Bregenz => 'breiɡents
brekkie => 'breki
bremsstrahlung => 'bremz,ʃtrɑːlʊŋ
Bren => bren
brenda => 'brendә
brennan => 'brenәn
brenner => 'brenә(r)
Brent => brent
Brentwood => 'brent,wud
brer => br\\\\:(r),breә(r)
bresaola => breˈsəʊlə, brɪˈzəʊ-
Brescia => 'breiʃɑ:
brest => brest
Bretagne => brә'tɑ:njә
brethren => 'breðrәn
Breton => 'bretn
brett => bret
Bretton => 'bretәn
Breughel => 'brɔi^әl,'bru:-
breve => bri:v
brevet => 'brevit
breviary => 'bri:vjәri
brevity => 'breviti
brew => bru:
brew-up => bru: ʌp
brewed => bru:d
brewer => 'bru:ә
breweries => ˈbru:əri:z
brewers => b'ru:əz
brewery => 'bru:әri
brewhouse => 'bru:hajs
brewing => 'bru:iŋ
brewmaster => bru:'mɑ:stə
brewpub => ˈbru:ˌpʌb
brews => bru:z
brewski => b'ru:ski:
brewster => 'bru:stә
Brezhnev => 'breʒnei
brian => 'braiәn
briar => 'braiә
briars => ˈbraiəz
bribable => 'braibәbl
bribe => braib
bribed => braibd
briber => 'braibә
bribery => 'braibәri
bribing => braibɪŋ
bric-a-brac => 'brikәbræk
brice => brais
brick => brik
brickbat => 'brikbæt
brickfield => 'brikfi:ld
brickfielder => 'brikfi:ldә
brickie => 'briki
bricklayer => 'brikleiә
bricklayers => ˈbrikleiəz
bricklaying => 'brikleiiŋ
bricks => brɪk
brickwork => 'brikwә:k
brickyard => 'brikjɑ:d
bricolage => ,bri:kәj'lɑ:ʒ
bricoleur => ,bri:kәj'l\\\\:(r)
bridal => 'braidl
bride => braid
bridegroom => 'braidgrum
bridegrooms => ˈbraɪdˌgru:mz
bridesmaid => 'braidzmeid
bridesmaids => ˈbraɪdzˌmeɪdz
bridesman => 'braidzmәn
bridewell => 'braidwәl
bridge => bridʒ
bridge loan => bridʒ ləun
bridge-builder => bridʒ ˈbɪldə
bridged => bridʒd
bridgehead => 'bridʒhed
Bridgeman => 'bridʒmən
bridges => 'bridʒiz
bridget => 'bridʒit
bridgetown => 'bridʒtaun
Bridgewater => 'bridʒ,wɔtə
bridgework => 'bridw\\\\:k
bridging => 'bridʒiŋ
Bridgman => 'bridʒmәn
Bridie => 'braidi
bridle => 'braidl
bridle path => ˈbraɪdlweɪ
bridled => ˈbraɪdld
bridles => ˈbraɪdlz
bridling => ˈbraɪdlɪŋ
bridoon => bri'du:n
brie => bri:
brief => bri:f
briefcase => 'bri:fkeis
briefcases => ˈbri:fkeisiz
briefed => bri:ft
briefer => bri:fə
briefing => 'bri:fiŋ
briefless => 'bri:flis
briefly => 'brifli
briefness => 'bri:fnis
briefs => bri:fs
brier => 'braiә
brig => bri^
brigade => bri'geid
brigaded => brɪ'geɪd
brigades => briˈɡeidz
brigadier => .brigә'diә
brigadier general => ˌbrɪgəˈdɪə ˈdʒenərəl
brigadier-general => brɪɡə'dɪərdʒ'enrəl
brigadiers => ˌbrɪgəˈdɪəz
brigading => brɪ'geɪd
brigalow => 'bri^әlәj
brigand => 'brigәnd
brigandage => 'bri^әndidʒ
brigandine => 'brigәndi:n
brigands => ˈbrɪgəndz
brigantine => 'brigәntain
bright => brait
bright-eyed => 'braitaid
brighten => 'braitn
brightened => ˈbraɪtnd
brightening => 'braitniŋ
brightens => ˈbraɪtnz
brighter => braitə
brightly => 'braitli
brightness => 'braitnis
brighton => 'braitn
brights => braits
brightwork => 'braitwʒ:k
Brigitte => 'bridʒit
brigs => briɡz
brill => bril
brilliance => 'briljәns
brilliancy => 'brɪljənsɪ
brilliant => 'briljәnt
brilliantine => 'briljәnti:n
brilliantly => 'brijәntli
brim => brim
brimful => brim'fjl
brimless => 'brimlis
brimmed => brimd
brimmer => 'brimә
brims => brimz
brimstone => 'brimstәun
Brindisi => 'brindizi
brindle => 'brindl
brindled => 'brindld
brine => brain
brine shrimp => brain ʃrimp
brined => braind
brines => brainz
bring => briŋ
bringer => 'brɪŋə
bringing => briŋɪŋ
bringing-up => 'briŋiŋ'ʌp
brinjal => 'brɪndʒəl
brink => briŋk
brinkmanship => 'briŋkmәnʃip
briny => 'braini
brio => 'bri:әu
brioche => 'bri(:)әuʃ
briquette => bri'ket
bris => b'rɪs
brisbane => 'brizbәn
brisk => brisk
brisken => dj:'briskən
brisker => briskə
brisket => 'briskit
briskly => 'briskli
briskness => 'brisknis
brisling => 'brisliŋ
bristle => 'brisl
bristlecone pine => 'brislkəun
bristled => b'rɪsld
bristletail => 'brislteil
bristly => 'brisli
Bristol => 'bristәl
bristols => ˈbrɪstlz
brit => brit
Britain => 'britәn
Britannia => bri'tænjә
Britannic => bri'tænik
britch => b'rɪtʃ
britches => 'britʃiz
Briticism => 'britisizm
British => 'britiʃ
Britisher => 'britiʃә
Britishism => 'britiʃizәm
Britishness => 'britiʃnis
Briton => 'britәn
britons => ˈbrɪtnz
Britpop => 'britpɔp
britt => brit
brittany => 'britәni
brittle => 'britl
brittleness => 'britlnis
Brittonic => bri'tɔnik
Brize => bri:z
Brno => 'bә:nәu
broach => brәutʃ
broached => brəʊtʃt
broaches => brəʊtʃiz
broaching => 'brәutʃiŋ
broad => brɒ:d
broad gauge => brɔ:d ɡeidʒ
broad jump => brɔ:d dʒʌmp
broad-brush => ˈbrɔ:dˌbrʌʃ
broad-spectrum => 'brɔ:d'spektrәm
broadband => 'brɔ:dbænd
broadbill => 'brɔːdbɪl
broadcast => 'brɒ:dkæst
broadcaster => 'brɒ:dkæstә
broadcasters => ˈbrɔ:dkɑ:stəz
broadcasting => 'brɒ:dkæstiŋ
broadcasts => ˈbrɔ:dkɑ:sts
broadcloth => 'brɔ:dklɔθ; (?@) 'brɔ:dklɔ:θ
broaden => 'brɒ:dn
broadened => ˈbrɔ:dnd
broadening => 'brɔ:dniŋ
broadens => ˈbrɔ:dnz
broader => brɔːdə
broadest => brɔ:dɪst
broadleaf => 'brɒ:dli:f
broadloom => 'brɒ:dlu:m
broadly => 'brɒ:dli
Broadmoor => 'brɔ:d,mjә(r)
broadness => 'brɒ:dnis
broadsheet => 'brɒ:dʃi:t
broadsheets => ˈbrɔ:dʃi:ts
broadside => 'brɔ:dsaid
broadsides => ˈbrɔ:dˌsaɪdz
broadsiding => brɔ:d'saɪdɪŋ
broadsword => 'brɒ:dsɒ:d
broadtail => 'brɒ:dteil
broadway => 'brɒ:dwei
Brobdingnagian => ,brɔbdiŋ'næɡiən
brocade => brәu'keid
brocaded => brәu'keidid
brocades => brəʊˈkeɪdz
brocading => brə'keɪdɪŋ
broccoli => 'brɒkәli
broch => brɔk
brochette => brәu'ʃet
brochure => 'brәuʃә
brochures => brəʊ'ʃəz
brock => brɔk
Brocken => 'brəukən
brocket => 'brɒkit
broderie anglaise => ˌbrəʊdəri ˈɒŋgleɪz
Brodie => 'brәudi
brogan => 'brәugәn
brogue => brәug
brogues => brəuɡz
broil => brɒil
broiler => 'brɔilә(r)
broilers => b'rɔɪləz
broiling => 'brɒiliŋ
broils => brɔɪlz
broke => brәuk
broken => 'brәukәn
broken wind => wind
broken-winded => 'brәjkәn'windid
brokenly => 'brәukәnli
broker => 'brәukә
broker-dealer => ˈbrəʊkə ˈdi:lə
brokerage => 'brәukәridʒ
brokerages => ˈbrəʊkərɪdʒz
brokered => ˈbrəukəd
brokering => ˈbrəʊkərɪŋ
broking => 'brәukiŋ
brolga => 'brɔl^ә
brolly => 'brɒli
bromate => 'brәumeit
bromated => ˈbrəumeitid
bromates => ˈbrəumeits
Bromberg => 'brɔmb\\\\:^
bromeliad => brәu'mili,æd
bromide => 'brәumaid
bromides => b'rəʊmaɪdz
bromidic => brәu'midik
bromine => 'brәumi:n
bromism => 'brәumizm
Bromley => 'brɔmli:
bromocriptine => ,brәjmә'knpti:n
Brompton => 'brɔmtәn
bronc => brɔŋk
bronchi => 'brɔŋki
bronchial => 'brɔŋkiәl
bronchiectasis => ,brɔŋki'ektәsis
bronchiolar => ,brɒŋkɪ'əʊlə
bronchiole => 'brɔŋkiәul
bronchiolitis => ,brɔŋkiәu'laitis
bronchitic => brɒŋ'kitik
bronchitis => brɒŋ'kaitis
broncho- => 'brɔŋkәj
bronchocele => 'brɔŋkәusi:l
bronchogenic => ,brɔŋkәj'dʒenik
bronchopneumonia => ,brɔŋkәunju:'mәunjә
bronchoscope => 'brɒŋkәskәup
bronchoscopy => brɔŋ'kɔskәpi
bronchospasm => 'brɔŋkә,spæzm
bronchus => 'brɒŋkәs
bronco => 'brɒŋkәu
broncobuster => 'brɒŋkәu.bʌstә
broncos => ˈbrɔŋkəuz
brontosaur => brɒntə'sɔ:
brontosaurus => .brɒntә'sɒ:rәs
Bronx => brɒŋks
bronze => brɒnz
bronze medal => brɔnz ˈmedəl
bronzer => 'brɔnzә(r)
bronzes => brɔnziz
bronzewing => b'rɒnzju:ɪŋ
bronzing => 'brɒnziŋ
bronzy => 'brɔnzi
broo => bru:
brooch => brәutʃ
brooches => brəʊtʃiz
brood => bru:d
brooded => bru:did
brooder => 'bru:dә
broodiness => 'bru:dɪnəs
brooding => 'bru:diŋ
broodingly => 'bru:diŋ
broodmare => 'bru:dmeә(r)
broods => bru:dz
broody => 'bru:di
brook => bruk
brook trout => bruk traʊt
Brookfield => 'bruk,fi:ld
brooklet => 'bruklit
brooklime => 'bruklaim
Brooklyn => 'bruklin
Brooklynese => ,brjkli'ni:z, 'brjk-
brooks => bruks
brookweed => 'bruk,wi:d
broom => bru:m
broomball => 'bru:mbɔ:l
broomie => 'bru:mi
broomrape => 'bru:mreip
brooms => bru:mz
broomstick => 'bru:mstik
broomsticks => ˈbru:mˌstiks
brose => brәuz
broth => brɒθ
brothel => 'brɒθәl
brothels => ˈbrɔθəlz
brother => 'brʌðә
brotherhood => 'brʌðәhud
brotherhoods => ˈbrʌðəˌhʊdz
brotherliness => 'brʌðəlɪnɪs