H => eitʃ
h'm => hm
H-bomb => 'eitʃbɔm
H-hour => 'eitʃ,ajә(r)
ha => hɑ:
ha ha => hɑ: hɑ:
ha'penny => 'heɪpnɪ
ha-ha => hɑ(:)'hɑ:
haaf => hɑ:f
haar => hɑ:
Haarlem => 'hɑ:lәm
Habakkuk => 'hæbәkәk
habanera => .hɑ:bә'nєәrә
Habanero => hɑ:bә:'neәrәj
habdabs => 'hæb,dæbz
Habdalah => ,hɑ:vdɑ:'lɑ:,hɑ:v'dɔ:lә
habeas corpus => 'heibjәs'kɒ:pәs
haberdasher => 'hæbәdæʃә
haberdashers => ˈhæbədæʃəz
haberdashery => 'hæbәdæʃәri
habergeon => 'hæbәdʒәn
habile => 'hæbil
habiliment => hә'bilәmәnt
habilitate => hә'biliteit
habilitated => həˈbiliteitid
habilitates => həˈbiliteits
habilitating => həˈbiliteitɪŋ
habit => 'hæbit
habitability => ,hæbitә'bilәti
habitable => 'hæbitәbl
habitant => 'hæbitәnt
habitat => 'hæbitæt
habitation => .hæbi'teiʃәn
habitations => ˌhæbɪˈteɪʃənz
habitats => 'hæbɪtæts
habited => 'hæbitid
habitual => hә'hitʃuәl
habitually => hә'bitjjәli
habituate => hә'bitjueit
habituated => həˈbɪtʃueɪtɪd
habituates => həˈbɪtʃu:ˌeɪts
habituating => həˈbɪtʃu:ˌeɪtɪŋ
habituation => hә.bitju'eiʃәn
habitude => 'hæbitju:d
habitue => hә'bitjjei
habitus => 'hæbitәs
haboob => hә'bu:b
hacendado => ,hɑ:sen'dɑ:dәj
hacienda => .hæsi'endә
hack => hæk
hack it => hæk it
hackamore => 'hækәmɒ:
hackberry => 'hækberi
hacked => hækt
hacker => 'hækә
hackery => 'hækәri
hackette => hæ'ket
hacking => 'hækiŋ
hackle => hækl
hackled => ˈhækld
hackling => 'hæklɪŋ
hackman => 'hækmәn
hackmatack => 'hækmәtæk
hackney => 'hækni
hackneyed => 'hæknid
hackneys => ˈhækniz
hacks => hæks
hacksaw => 'hæksɒ:
hacksaws => ˈhæksɔ:z
had => hæd
hadal => 'heidl
hadda => 'hædə
Haddington => 'hædiŋtən
haddock => 'hædәk
Haddon => 'hædən
hade => heid
Hadean => 'heidiәn
Hades => 'heidi:z
Hadhramaut => ,hɑ:drə'mɔ:t
hadj => hædʒ
hadji => 'hædʒi(:)
hadley => 'hædli
hadn't => ˈhædnt
Hadrian => 'heidriən
hadron => 'hædrɔn
hadrons => 'hædrɒn
hadrosaur => 'hædrә'sɔ:ә
hadst => hædst, hәdst
haecceity => hek'si:әti
Haeckel => 'hekәl
haem => hi:m, hem
haem- => hi:m, hem
haemagglutination => ,hi:mә^lu:ti'neiʃәn
haemagglutinin => ,hi:mә'^lu:tinin,,hem-
haemal => 'hi:mәl
haemangioma => hi,mændʒi'әjmә
haematemesis => ,hi:mә'temәsis
haematic => hi:'mætik
haematin => 'hemәtin
haematite => 'hi:mәtait
haematocele => 'hemәtәusi:l
haematocrit => 'hemәtәukrit
haematogenous => ,hi:mә'tɔdʒinәs,,hem-
haematological => ,hi:mәtәj'lɔdʒikәl,,hem-
haematologist => ˌhi:mə'tɒlədʒɪst
haematology => ,hi:mә'tɔlәdʒi, 'hi:-
haematoma => ,hi:mә'tәumә
haematophagous => ,himәtәu'fæ^әs
haematopoiesis => ,hemәtәupɔi'i:sis
haematopoietic => ,hemәtәupɔi'etik
haematoxylin => ,hi:mә'tɔksilin
haematuria => ,hi:mә'tjuәriә
haemo- => 'hi:mәj,'hemәj
haemocyanin => ,hi:mәj'saiәnin,,hem-
haemocyte => 'hi:mәusait
haemocytometer => ,hi:mәjsai'tɔmitә(r)
haemodialysis => ,hi:mәjdai'ælisis
haemodynamic => ,hi:mәjdai'næmik,,hem-
haemodynamics => ,hi:mәdai'næmiks
haemoglobin => ,hi:mәu'^lәubin
haemoglobinopathy => 'hi:mәj,^lәjbi'nɔpәθi,'hem-
haemoglobinuria => 'hi:mәj,^lәjbi'njjәriә,'hem-
haemolymph => 'hi:mәjlimf,'hem-
haemolysis => hi:'mɔlisis
haemolytic => ,hi:mәj'litik,,hem-
haemophilia => hi:mәu'filiә
haemophiliac => ,hi:mәu'filiæk
haemophilic => ,hi:mәj'filik,,hem-
haemopoiesis => ,hi:mәjpɔi'i:sis,,hem-
haemopoietic => hi:məʊpɒ'ɪetɪk
haemoptysis => hi'mɔptisis,he-
haemorrhage => 'hemәridʒ
haemorrhaged => ˌhemərɪdʒd
haemorrhages => ˌhemərɪdʒz
haemorrhaging => ˌhemərɪdʒɪŋ
haemorrhoid => 'hemәrɔid
haemostasis => hi:mәj'steizis,,hem-
haemostat => 'hi:mәustæt
haemostatic => hi:mәu'stætik
hafiz => 'hɑ:fiz
hafnium => 'hæfniәm
haft => hɑ:ft
hafts => hæfts
hag => hæg
hag-ridden => 'hæɡrɪdən
Hagar => 'hei^ɑ:
hagen => 'hɑ:^әn
hagfish => 'hægfiʃ
Haggai => 'hægeiai
haggard => 'hægәd
haggardness => ˊhægәdnis
haggis => 'hæ^is
haggish => 'hægiʃ
haggle => hægl
haggled => ˈhægəld
haggles => ˈhægəlz
haggling => ˈhægəlɪŋ
hagio- => 'hæ^iәj
Hagiographa => ,hæ^i'ɔ^rәfә
hagiographer => .hægi'ɒgrәfә
hagiographic => ,hæɡɪə'ɡræfɪk
hagiography => .hægi'ɒgrәfi
hagiolatry => ,hæ^i'ɔlәtri,,heidʒi-
hagiologist => ,hæ^i'ɔlәdʒist
hagiology => .hægi'ɒlәdʒi
hagioscope => 'hæ^iәskәup
hags => hæɡz
Hague => hei^
hah => hɑ:
hahn => hɑ:n
hahnium => 'hɑ:ni:әm
Haida => 'haidә
haifa => 'haifә
haik => 'haik
Haikou => 'hai'kәj
haiku => 'haiku:
hail => heil
hailed => heild
hailing => heilɪŋ
hails => heilz
hailstone => 'heilstәun
hailstones => ˈheɪlˌstəʊnz
hailstorm => 'heilstɒ:m
hailstorms => ˈheɪlˌstɔ:mz
Hainan => 'hai'nɑ:n
Hainaut => e'nəu
Haiphong => 'hai'fɔŋ
hair => hєә
hair of the dog => hɛə ɔv ðə dɔɡ
hair shirt => hɛə ʃə:t
hair slide => hɛə slaid
hair space => hɛə speis
hair-like => 'heərl'aɪk
hair-splitting => ˈheəˌsplɪtɪŋ
hairball => 'heәbɔ:l
hairbreadth => 'hєәbredθ
hairbrush => 'hєәbrʌʃ
hairbrushes => 'heəbrʌʃɪz
haircloth => 'heәklɔθ
haircut => 'hєәkʌt
haircuts => 'h?әkʌts
hairdo => 'hєәdu:
hairdos => ˈhɛəˌdu:z
hairdresser => 'hєәdresә
hairdressers => ˈheəˌdresəz
hairdressing => 'hєәdresiŋ
hairdryer => ˈheədraɪə(r)
hairdryers => ˈheədraɪəz
hairier => ˈheəri:ə
hairiness => 'hєәrinis
hairless => 'hєәlis
hairlike => 'hєәlaik
hairline => 'heәlain
hairlines => ˈheəlainz
hairnet => 'hєәnet
hairnets => ˈheəˌnets
hairpiece => 'hєәpi:s
hairpieces => heə'pi:sɪz
hairpin => 'hєәpin
hairpin bend => ˈheəˌpɪn bend
hairpins => 'heəpɪnz
hairspring => 'hєәspriŋ
hairstreak => 'hєәstri:k
hairstyle => 'hєәstail
hairstyles => ˈheəˌstaɪlz
hairstylist => 'hεә.stailist
hairy => 'hєәri
Haiti => 'heiti
Haitian => 'heitiәn
haj => 'hədʒ
haji => hædʒ
hajj => hædʒ
hajji => 'hædʒi
haka => 'hɒkɒ
hake => heik
Hakenkreuz => 'hɑ:kәnkrɔits
Hakim => hɑ:'ki:m
Hakka => 'hɑ:k'kɑ:
Hakluyt => 'hæklu:t
Hakodate => ,hækәu'dɑ:ti
HAL => hæl
Halafian => hә'lɑ:fiәn
halal => hә'lɑ:l
halala => hә'lɑ:lә
halation => hә'leiʃәn
halberd => 'hælbәd
halberdier => .hælbә'diә
halcyon => 'hælsiәn
Haldane => 'hɔ:ldein
hale => heil
haler => 'hɑ:lә
half => hɑ:f
half a dozen => hɑ:f ə ˈdʌzn
half binding => hɑ:f ˈbaɪndɪŋ
half blood => hɑ:f blʌd
half board => hɑ:f bɔ:d
half brother => hɑ:f ˈbrʌðə
half crown => hɑ:f kraun
half dollar => hɑ:f ˈdɔlə
half hitch => hɑ:f hitʃ
half nelson => hɑ:f ˈnelsn
half note => hɑ:f nəut
half volley => hɑ:f ˈvɔli
half-blooded => 'hɑ:f,blʌdid
half-bound => 'hɑ:f'bajnd
half-cock => hɑ:f kɔk
half-cocked => 'hɑ:f'kɔkt
half-crown => ˈhæfˈkraʊn, ˈhɑ:f-
half-cut => 'hɑ:fk'ʌt
half-dozen => 'hɑ:fd'ʌzn
half-hardy => 'hɑ:f,hɑ:di
half-holiday => 'hɑ:fh'ɒlədeɪ
half-hour => 'hɑ:f'auә
half-integral => 'hɑ:f,inti^rәl
half-lap => 'hɑ:fl'æp
half-length => 'hɑ:fleŋθ
half-light => hɑ:f lait
half-lives => 'hɑ:fl'aɪvz
half-price => 'hɑ:f'prais
half-term => hɑ:fˈtɜ:m
half-timbered => ˈhæfˈtɪmbəd, ˈhɑ:f-
half-title => hɑ:f ˈtaitl
half-volley => hɑ:f ˈvɔli
half-wit => 'hɑ:fwit
half-witted => 'hɑ:f'witid
halfback => 'hɑ:f'bæk
halfbeak => 'hɑ:fbi:k
halfheartedly => 'hɑ:fhɑ:tɪdlɪ
halfpennies => ˈheipəniz
halfpenny => 'heipәni
halfpennyworth => 'heipәniwә:θ
halftone => 'hɑ:ftәun
halftones => 'hɑ:ftəun
halfway => 'hɑ:f'wei
halfway house => ˈhæfˈweɪ haus
halfway line => ˈhæfˈweɪ lain
halfwit => ˈhɑ:fwɪt
halibut => 'hælibәt
Halicarnassus => ,hælikɑ:'næsəs
halide => 'hælaid
halifax => 'hælifæks
halite => 'hælait
halitosis => .hæli'tәusis
hall => hɒ:l
hall of residence => hɔ:l ɔv ˈrezidəns
hall porter => hɔ:l ˈpɔ:tə
hallal => 'hæl
Hallam => 'hælәm
hallelujah => .hæli'lu:jә
halley => 'hæli
halliard => 'hæljәd
Halling => 'hæliŋ
hallmark => 'hɑ:lmɑ:k
hallmarks => ˈhɔ:lˌmɑ:ks
hallo => hә'lәu
halloo => hә'lu:
hallooed => həˈlu:d
hallooing => həˈlu:ɪŋ
halloos => həˈlu:z
hallow => 'hælәu
hallowed => 'hælәuid
Halloween => .hælәu'i:n
hallowing => 'hæləʊ
hallstand => 'hɔ:lstænd
Hallstatt => 'hælstæt
halluces => 'hæljjsi:z
hallucinate => hә'lu:sineit
hallucinated => həˈlu:sineitid
hallucinates => həˈlu:sineits
hallucinating => həˈlu:sineitɪŋ
hallucination => hә.lu:si'neiʃәn
hallucinations => həˌlu:səˈneɪʃənz
hallucinator => hə'lu:sineitə
hallucinatory => hәlu:'sineitәri
hallucinogen => hә'lu:sinәdʒin
hallux => 'hælәks
hallway => 'hɔ:lwei
hallways => ˈhɔ:lˌweɪz
halma => 'hælmә
Halmahera => ,hælmә'hʌrә
halo => 'heilәu
halo effect => ˈheɪləʊ iˈfekt
halo- => 'hælәj,'heilәj
halocarbon => ,hælәj'kɑ:bәn
haloed => ˈheɪləʊd
haloes => ˈheɪləʊz
halogen => 'hælәdʒin
halogenate => 'hælәdʒәneit
halogenation => hælәdʒә'neiʃәn
halogens => 'hælədʒənz
haloing => ˈheɪləʊɪŋ
haloperidol => ,hælәj'peridɔl
halophile => 'hælәfail
halophyte => 'hælәfait
halothane => 'hælәθein
halt => hɒ:lt
halted => hɔ:ltid
halter => 'hɒ:ltә
haltere => 'hɔ:ltiә(r),'hæl-
haltered => ˈhɔ:ltəd
halteres => ˈhɔ:ltəz
halters => ˈhɔ:ltəz
halting => 'hɒ:ltiŋ
haltingly => 'hɔ:ltiŋli
halts => hɔ:lts
halva => 'hɑ:və
halve => hɑ:v
halved => hævd
halves => hɑ:vz
halving => 'hɑ:viŋ
halyard => 'hɒljәd
ham => hæm
ham-fisted => hæm'fistid
ham-handed => 'hæm'hændid
Hama => 'hæmә
hamadryad => .hæmә'draiәd
hamadryas => ,hæmә'draiәs
Hamah => 'hɑ:mɑ:
Hamamatsu => ,hɑ:mә'mɑ:tsu:
hamamelis => ,hæmә'mi:hs
hamartia => hæ'mɑ:ʃiә
hamate => 'heimeit
hambone => 'hæmbәun
hamburg => 'hæmbә:^
hamburger => 'hæmbә:gә
hamburgers => 'hæmbɜ:ɡəz
hame => heim
Hamel => 'hæmәl
Hamelin => 'hæməlin
hames => heimz
Hamhung => 'hɑ:mhjŋ
hamilton => 'hæmiltәn
Hamiltonian => ,hæmil'tәuniәn
Hamiltonianism => ,hæmil'təuniənizəm
Hamite => 'hæmait
Hamitic => hæ'mitik
Hamito-Semitic => 'hæmitәjsә'mitik
hamlet => 'hæmlit
hamlets => ˈhæmlɪts
hamlin => 'hæmlin
hammer => 'hæmә
hammer and sickle => ˈhæmə ænd ˈsɪkəl
hammer drill => ˈhæmə dril
hammered => 'hæmәd
Hammerfest => 'hæmәfest,'hɑ:m-
hammerhead => 'hæmәhed
hammering => 'hæmәriŋ
hammerkop => 'hæməkəp
hammerless => 'hæmәlis
hammerlock => ˈhæməlɒk
hammermill => 'hæmərmɪl
hammers => ˈhæməz
hammersmith => 'hæmәsmiθ
hamming => 'hæmiŋ
hammock => 'hæmәk
hammocks => ˈhæməks
hammond => 'hæmәnd
Hammond organ => ˌhæmənd 'ɔ:gən
Hammurabi => ,hɑ:mu'rɑ:bi
hammy => 'hæmi
Hampden => 'hæmpdәn
hamper => 'hæpә
hampered => ˈhæmpəd
hampering => ˈhæmpərɪŋ
hampers => ˈhæmpəz
hampshire => 'hæmpʃiә
hampton => 'hæmptәn
hamster => 'hæmstә
hamsters => 'hæmstəz
hamstring => 'hæmstriŋ
hamstringing => ˈhæmstriŋɪŋ
hamstrings => 'hæmstrɪŋz
Hamsun => 'hɑ:msәn
hamulus => 'hæmjulәs
hamza => 'hæmzә,'hɑ:mzɑ:
han => hæn
hancock => 'hænkɔk
hand => hænd
hand cream => hænd kri:m
hand grenade => hænd grəˈneɪd
hand luggage => hænd ˈlʌɡidʒ
hand towel => hænd ˈtauəl
hand-held => ˈhændˌheld
hand-holding => 'hændh'əʊldɪŋ
hand-me-downs => hænd mi: daʊnz
hand-pick => 'hændp'ɪk
handbag => 'hændbæg
handbags => ˈhændbæɡz
handball => 'hændbɒ:l
handbell => 'hændbel
handbill => 'hændbil
handbills => 'hændbɪlz
handbook => 'hænd,buk
handbooks => ˈhændbuks
handcar => 'hændkɑ:
handcart => 'hændkɑ:t
handcarts => ˈhændkɑ:ts
handclap => 'hændklæp
handclasp => 'hændklæsp
handcraft => 'hændkrɑ:ft
handcrafted => ˈhændkrɑ:ftɪd
handcrafting => ˈhændkrɑ:ftɪŋ
handcrafts => ˈhændkrɑ:fts
handcuff => 'hændkʌf
handcuffed => ˈhændˌkʌft
handcuffing => ˈhændˌkʌfɪŋ
handcuffs => 'hændkʌfs
handed => 'hændid
handedness => 'hændidnis
handel => 'hændl
handful => 'hændful
handfuls => ˈhændfulz
handgrip => 'hændgrip
handgun => 'hændɡʌn
handguns => ˈhændˌgʌnz
handheld => hændheld
handhold => 'hændhәuld
handicap => 'hændikæp
handicapped => 'hændikæpt
handicapper => 'hændi,kæpә(r)
handicapping => ˈhændikæpɪŋ
handicaps => ˈhændikæps
handicraft => 'hændikræft
handicrafts => 'handi:ˌkræfts
handily => 'hændili
handiness => 'hændinis
handiwork => 'hændiwә:k
handjob => 'hænddʒɔb
handkerchief => 'hæŋkәtʃif
handle => hændl
handleability => ,hændlә'biliti
handleable => 'hændləbl
handlebar => 'hændlbɑ:
handlebar moustache => ˈhænd(ə)lbɑ: məsˈtɑ:ʃ
handlebars => 'hændlbɑ:z
handler => 'hændlә
handless => 'hændlis
handling => 'hændliŋ
handlist => 'hændlist
handloom => 'hændlu:m
handmade => 'hændmeid
handmaid => 'hændmeid
handmaiden => 'hændmeid(ә)n
handmaidens => ˈhændmeid(ə)nz
handoff => 'hændɔf
handout => 'hændaut
handouts => 'hændˌɑʊts
handover => 'hændәuvә
handphone => ˈhændfəʊn
handpick => 'hændpik
handpicked => 'hænd'pikt
handprint => 'hændprint
handpump => hænd'pʌmp
handrail => 'hændreil
handrails => ˈhændreilz
handsaw => 'hændsɒ:
handsel => 'hænsәl
handset => 'hændset
handsets => ˈhændsets
handshake => 'hændʃeik
handshakes => ˈhændˌʃeɪks
handsome => 'hænsәm
handsomely => 'hænsәmli
handsomeness => 'hænsəmnəs
handsomer => 'hæns(ə)m
handsomest => 'hæns(ə)m
handspike => 'hændspaik
handspring => 'hændspriŋ
handstand => 'hændstænd
handstands => ˈhændˌstændz
handwash => 'hændwɒʃ
handwork => 'hændwә:k
handwoven => 'hænd,wәjvәn
handwriting => 'hændraitiŋ
handwritten => 'hænd.ritәn
handy => 'hændi
handyman => 'hændimæn
handymen => 'hændɪmen
hanepoot => 'hɑ:nә,pu:t
hang => hæŋ
hang glider => hæŋ ˈglaɪdə
hang gliding => hæŋ ˈɡlaidiŋ
hang in => hæŋ in
hang ten => hæŋ ten
hang tough => hæŋ tʌf
hang-glider => hæŋ ˈglaɪdə
hang-out => hæŋ aut
hang-ups => 'hæŋ'ʌps
hangar => 'hæŋә
hangarage => 'hæŋәridʒ
hangars => ˈhæŋəz
Hangchow => 'hæŋ'tʃaj
hangdog => 'hæŋdɒg
hanger => 'hæŋә
hangers => 'hænɡəz
hanging => 'hæŋiŋ
hanging basket => ˈhæŋɪŋ ˈbɑ:skit
hanging valley => ˈhæŋɪŋ ˈvæli
hangman => 'hæŋmәn
hangnail => 'hæŋneil
hangouts => ˈhæŋˌaʊts
hangover => 'hæŋәuvә
hangovers => ˈhæŋˌəʊvəz
hangs => hæŋz
hank => hæŋk
hanker => 'hæŋkә
hankering => 'hæŋkәriŋ
hankie => 'hæŋki
hankies => ˈhæŋkɪz
hanky => 'hæŋki
hanky-panky => 'hæŋki'pæŋki
hanna => 'hænә
hannah => 'hænә
hannibal => 'hænibәl
Hannover => hɑ:'nəuvə
hanoi => hæ'nɔi
Hanoverian => ,hænәj'viәriәn
hans => hænz
Hansard => 'hænsәd
Hansel => 'hænsәl
hansen => 'hænsәn
hansom => 'hænsәm
hansoms => ˈhænsəmz
hanuman => 'hʌnumɑ:n, 'hɑ:n-
haole => 'hajli:
hap => hæp
hapax legomenon => 'heipæksli'^ɔ:mәnɔn
haphazard => hæp'hæzәd
haphazardly => .hæp'hæzәdli
hapless => 'hæplis
haplessness => ˊhæplisnis
haplodiploid => hæp'ləʊdɪplɔɪd
haplography => hæp'lɔ^rәfi
haploid => 'hæplɔid
haploidy => 'hæplɔidi
haplology => hæp'lɒlәdʒi
haplont => 'hæplɔnt
haplontic => hæp'lɒntɪk
haplotype => 'hæplәutaip
happed => hæpt
happen => 'hæpәn
happening => 'hæpәniŋ
happens => ˈhæpənz
happenstance => 'hæpәnstæns
happi => 'hæpɪ
happily => 'hæpili
happiness => 'hæpinis
happing => hæpɪŋ
happy => 'hæpi
happy event => ˈhæpi iˈvent
happy hour => ˈhæpi ˈauə
haps => hæps
Hapsburg => 'hæpsbә:^
hapten => 'hæpten
haptic => 'hæptik
haptics => 'hæptiks
haptoglobin => ,hæptәu'^lәubin
hara-kiri => 'hærә'kiri
HARALD => 'hɑ:ræld
haram => 'heәrәm
harambee => hɑ:'rɑ:mbi:
harangue => hә'ræŋ
harangued => həˈræŋd
haranguer => hə'ræŋ
harangues => həˈræŋz
haranguing => həˈræŋɪŋ
Harappa => hə'ræpə
HARARE => hә'rɑ:rei
harass => 'hærәs
harassed => 'hærәst. hә'ræst
harasses => ˈhærəsiz
harassing => ˈhærəsɪŋ
harassment => 'hærәsmәnt
harbinger => 'hɑ:bindʒә
harbingered => ˈhɑ:bɪndʒəd
harbingering => ˈhɑ:bɪndʒərɪŋ
harbingers => ˈhɑ:bɪndʒəz
harbor => 'hɑ:bә
harbored => ˈhɑ:bəd
harbors => ˈhɑ:bəz
harbour => 'hɑ:bә
harbour master => ˈhɑ:bə ˈmɑ:stə
harboured => ˈhɑ:bəd
harbourless => ˊhaːbәlis
harbours => ˈhɑ:bəz
harcourt => 'hɑ:kәt
hard => hɑ:d
hard case => hɑrd keis
hard clam => hɑrd klæm
hard court => hɑrd kɔ:t
hard going => hɑrd ˈgəʊɪŋ
hard hat => hɑrd hæt
hard nut => hɑrd nʌt
hard porn => hɑrd pɔ:n
hard rock => hɑrd rɔk
hard roe => hɑrd rəʊ
hard sauce => hɑrd sɔ:s
hard shoulder => hɑrd ˈʃəuldə
hard up => hɑrd ʌp
hard-boiled => 'hɑ:d'bɔild
hard-drinking => hɑrd ˈdrɪŋkɪŋ
hard-headed => hɑrd ˈhedid
hard-hitting => 'hɑ:d'hitiŋ
hard-on => ˈhɑ:dˌɔn, -ˌɔ:n
hard-paste => hɑrd peist
hard-pressed => ˌhɑ:dˈprest
hard-shell => 'hɑ:dʃ'el
hard-wire => 'hɑ:dw'aɪər
hardback => 'hɑ:dbæk
hardbacked => 'hɑ:dbækt
hardbacks => ˈhɑ:dˌbæks
hardball => 'hɑ:dbɔ:l
hardbitten => ˌhɑ:dˈbɪtn
hardboard => 'hɑ:dbɒ:d
hardbound => hɑ:d'baund
hardcore => 'hɑ:dkɔ:
hardcover => 'hɑ:dkʌvә
harden => hɑ:dn
hardened => 'hɑ:dәnd
hardener => 'hɑ:dәnә
hardening => 'hɑ:dәniŋ
hardens => ˈhɑ:dnz
hardhat => 'hɑ:d'hæt
hardhead => 'hɑ:dhed
hardheaded => 'hɑ:d'hedid
Hardie => 'hɑ:di
hardier => ˈhɑ:diə
hardihood => 'hɑ:dihud
hardily => 'hɑ:dili
hardiness => 'hɑ:dinis
harding => 'hɑ:diŋ
hardish => 'hɑ:dɪʃ
hardliner => ˌhɑ:d'laɪnə(r)
hardliners => 'hɑ:dlaɪnəz
hardly => 'hɑ:dli
hardness => 'hɑ:dnis
hardpan => 'hɑ:dpæn
hardship => 'hɑ:dʃip
hardships => 'hɑ:dʃɪps
hardtack => 'hɑ:dtæk
hardtop => 'hɑ:dtɔp
hardware => 'hɑ:dwєә
hardwiring => 'hɑ:d'waiəriŋ
hardwood => 'hɑ:dwud
hardwoods => ˈhɑ:dˌwʊdz
hardworking => 'hɑ:d.wә:kiŋ
hardy => 'hɑ:di
hare => hєә
hare wallaby => heə ˈwɔləbi:
hare-brained => ˈheəˈbreɪnd
harebell => 'hєәbel
harebrained => 'hєәbreind
harelip => .hєә'lip
harelipped => .hєә'lipt
harem => 'herәm
harem pants => ˈheərəm pænts
harems => ˈheərəmz
hares => heəz
Harewood => 'heәwjd
Hargeisa => hɑ:r'^eisә
haricot => 'hærikәu
HARINGEY => 'hɑ:riŋ,ɡei
hark => hɑ:k
hark back => hɑ:k bæk
harked => hɑ:kt
harken => 'hɑ:kәn
harking => hɑ:kɪŋ
harks => hɑ:ks
Harlem => 'hɑ:lәm
harlequin => 'hɑ:likwin
harlequinade => ,hɑ:likwi'neid
harley => 'hɑ:li
Harley Street => 'hɑ:li stri:t
harlot => 'hɑ:lәt
harlotry => 'hɑ:lәtri
harlots => ˈhɑ:ləts
Harlow => 'hɑ:lәu
harm => hɑ:m
harmattan => .hɑ:mә'tæn
harmed => hɑ:md
harmful => 'hɑ:mful
harming => hɑ:mɪŋ
harmless => 'hɑ:mlis
harmlessness => 'hɑ:mləsnəs
harmon => 'hɑ:mәn
harmonic => hɑ:'mɒnik
harmonica => hɑ:'mɒnikә
harmonically => hɑ:'mɒnikli
harmonicas => hɑ:ˈmɔnɪkəz
harmonics => hɑ:'mɒniks
harmonies => ˈhɑ:məniz
harmonious => hɑ:'mәuniәs
harmoniously => hɑ:'məʊnɪəslɪ
harmoniousness => hɑ:r'məʊnɪəsˌnɪs
harmonisation => ˌha:mənaɪ'zeɪʃən
harmonise => 'hɑ:mәnaiz
harmonised => 'hɑ:mənaiz
harmonist => 'hɑ:mәnist
harmonium => hɑ:'mәuniәm
harmonization => .hɑ:mәnai'zeiʃәn
harmonize => 'hɑ:mәnaiz
harmonized => ˈhɑ:məˌnaɪzd
harmonizes => ˈhɑ:məˌnaɪziz
harmonizing => ˈhɑ:məˌnaɪzɪŋ
harmony => 'hɑ:mәni
harness => 'hɑ:nis
harness racing => ˈhɑ:nis ˈreisiŋ
harnessed => ˈhɑ:nist
harnesses => ˈhɑ:nisiz
harnessing => ˈhɑ:nisɪŋ
harold => 'hærәld
harp => hɑ:p
harp seal => hɑ:p si:l
Harper => 'hɑ:pә
harpies => ˈhɑ:piz
harpist => 'hɑ:pist
harpists => 'hɑːpɪst
harpoon => hɑ:'pu:n
harpoon gun => hɑ:ˈpu:n ɡʌn
harpooned => hɑ:ˈpu:nd
harpooning => hɑ:ˈpu:nɪŋ
harpoons => hɑ:ˈpu:nz
harps => hɑ:ps
harpsichord => 'hɑ:psikɒ:d
harpsichordist => ˈhɑ:psɪkɔ:dɪst
harpsichords => ˈhɑ:psɪˌkɔ:dz
Harpy => 'hɑ:pi
harquebus => 'hɑ:kwibәs
harridan => 'hæridәn
harried => 'hærid
harrier => 'hæriә(r)
Harriman => 'hærimәn
harris => 'hæris
Harris tweed => 'hæris twi:d
Harrison => 'hærisn
Harrod => 'hærəd
Harrogate => 'hærəɡeit
Harrovian => hә'rәuvjәn
harrow => 'hærәu
harrowed => ˈhærəud
harrower => 'hærəʊər
harrowing => 'hærәuiŋ
harrows => ˈhærəʊz
harrumph => hә'rʌmf
harry => 'hæri
harsh => hɑ:ʃ
harshen => 'hɑ:ʃәn
harshly => 'hɑ:ʃli
harshness => 'hɑ:ʃnis
harslet => 'hɑ:slit
hart => hɑ:t
hartal => 'hɑ:tɑ:l
hartebeest => 'hɑ:tibi:st
hartford => 'hɑ:tfәd
Hartlepool => 'hɑ:tlipu:l
Hartley => 'hɑ:tli
Hartmann => 'hɑ:tmәn
hartshorn => 'hɑ:tshɒ:n
harum-scarum => 'hєәrәm'skєәrәm
haruspex => hә'rʌspeks
haruspicy => hə'rʌspisi
Harvard => 'hɑ:vәd
harvest => 'hɑ:vist
harvest festival => ˈhɑ:vist ˈfestəvəl
harvest home => ˈhɑ:vist həum
harvest moon => ˈhɑ:vist mu:n
harvest mouse => ˈhɑ:vist maus
harvestable => 'ha:vistəbl
harvested => ˈhɑ:vistid
harvester => 'hɑ:vistә
harvesters => 'hɑ:vɪstəz
harvesting => 'hɑ:vistiŋ
harvestman => 'hɑ:vistmæn
harvests => ˈhɑ:vists
harvey => 'hɑ:vi
Haryana => ,hɑ:ri'ɑ:nә
Harz => hɑ:rts
harzburgite => 'hɑ:z,bә:^ait
has => hæz
has-been => 'hæzbin
Hasdrubal => 'hæzdrubəl; hæz'dru'bəl
hash => hæʃ
hashed => hæʃt
Hashemite => 'hæʃimait
hashes => hæʃiz
hashing => 'hæʃiŋ
hashish => 'hæʃi:ʃ
hashtag => 'hæʃtæg
Hasid => 'hæsid
Hasidic => hә'sidik
Hasidism => 'hæsidizәm
haslet => 'heizlet
Hasmonean => ,hæzmə'niːən
hasn't => ˈhæznt
hasp => hæsp
hasped => hɑ:spt
hasping => hɑ:spɪŋ
hasps => hɑ:sps
Hassid => 'hæsid
Hassidism => 'hæsidizәm
hassium => ˈhæsiəm
hassle => 'hæsl
hassled => ˈhæsəld
hassles => ˈhæsəlz
hassling => ˈhæsəlɪŋ
hassock => 'hæsәk
hassocks => ˈhæsəks
hast => hæst
hastate => 'hæsteit
haste => heist
hasted => heistid
hasten => 'heisn
hastened => ˈheɪsənd
hastening => ˈheɪsənɪŋ
hastens => ˈheɪsənz
hastier => ˈheistiə
hastily => 'heistili
hastiness => 'heistinis
hasting => heistɪŋ
hastings => 'heistiŋz
hasty => 'heisti
hasty pudding => ˈheisti ˈpudiŋ
hat => hæt
hat-trick => hæt trik
hatable => 'heitәbl
hatband => 'hætbænd
hatbox => ˈhætbɒks
hatch => hætʃ
hatchback => 'hætʃ'bæk
hatchbacks => ˈhætʃˌbæks
hatcheck => 'hætʃek
hatched => 'hætʃid
hatchel => 'hætʃәl
hatcheries => ˈhætʃəriz
hatchery => 'hætʃәri
hatchet => 'hætʃit
hatchets => ˈhætʃɪts
hatching => 'hætʃiŋ
hatchling => 'hætʃliŋ
hatchment => 'hætʃmәnt
hatchway => 'hætʃwei
hatchways => ˈhætʃweiz
hate => heit
hate crime => heit kraɪm
hate mail => heit meil
hated => heitid
hateful => 'heitful
hatefully => 'heɪtfəlɪ
hater => 'heitә(r)
haters => ˈheitəz
hates => heits
Hatfield => 'hætfi:ld
hatful => 'hætful
hath => hæθ; hәθ, әθ
hatha yoga => ˈhɑ:tə ˈjəʊgə
Hathor => 'hæθɔ:
hating => heitɪŋ
hatless => 'hætlis
hatmaker => 'hæt,meikә(r)
hatpin => 'hætpin
hatred => 'heitrid
hatreds => ˈheitridz
hatstands => 'hæt,stænd
hatted => 'hætid
hatter => 'hætә
hattie => 'hæti
hatting => 'hætiŋ
hauberk => 'hɒ:bә:k
haugh => hɔ:, hɑ:f
haughtily => 'hɒ:tili
haughtiness => 'hɒ:tinis
haughty => 'hɒ:ti
haul => hɒ:l
haul ass => hɔ:l æs
haulage => 'hɒ:lidʒ
hauled => hɔ:ld
hauler => 'hɔ:lә
haulier => 'hɔ:ljә, -liә
hauliers => ˈhɔ:liəz
haulm => hɒ:m
haunch => hɒ:ntʃ
haunches => 'hɔ:ntʃɪz
haunt => hɒ:nt
haunted => 'hɔ:ntid
haunter => hɔ:nt
haunting => 'hɒ:ntiŋ
hauntingly => 'hɔ:ntiŋli
haunts => hɔ:nts
Hausa => 'hausә
hausfrau => 'hajsfraj
haustellate => 'hɔ:stileit
haustellum => hɔ:s'telәm
haustorial => hɔ:'stɔ:riəl
haustorium => hɔ:s'tɔriәm
haut monde => әu'm:nd
hautboy => 'hәubɒi
haute couture => әut ku'tju:r
haute cuisine => ˌəʊt kwɪˈzi:n
hauteur => әu'tә:
Havana => hә'vænә
Havdalah => ,hɑ:vdә'lɑ:,hɑ:v'dɔ:lә
have => hæv
have a bun in the oven => hæv ə bʌn in ðə ˈʌvən
have it out => hæv it aut
have-not => 'hævnɔt
Havel => 'ha:fəl
havelock => 'hævlɒk
haven => 'heivn
haven't => ˈhævnt
havens => ˈheivnz
haver => 'heivә
haversack => 'hævәsæk
haversacks => ˈhævəˌsæks
haversine => 'hævәsi:n
haves => hævz
havildar => 'hævildɑ:
having => 'hæviŋ
havoc => 'hævәk
Havre => 'hɑ:vrə; 'hɑ:və
haw => hɒ:
Hawaii => hә'waii:
Hawaiian => hә'waiiәn
hawala => h'wɑ:lə
hawed => hɒd:
hawfinch => 'hɔ:fintʃ
hawing => 'hɔ:ɪŋ
hawk => hɒ:k
hawk-nosed => 'hɔ:knәjzd
hawker => 'hɒ:kә
hawkers => ˈhɔ:kəz
Hawking => 'hɔ:kiŋ
hawkins => 'hɔ:kinz
hawkish => 'hɒ:kiʃ
hawkmoth => 'hɒ:kmɒθ
hawksbill => 'hɔ:ksbil
hawkshaw => 'hɔ:kʃɔ:
hawkweed => 'hɒ:kwi:d
Haworth => 'hɔ:әθ, 'hɔ:wәθ
haws => hɔ:z
hawse => hɒ:z
hawsepipe => 'hɔ:zpaip
hawser => 'hɒ:zә
hawsers => ˈhɔ:zəz
hawthorn => 'hɒ:θɒ:n
hawthorns => ˈhɔ:θɔ:nz
hay => hei
hay fever => hei ˈfi:və
haybox => 'heibɒks
haycock => 'heikɒk
Haydn => 'haidn
hayes => heiz
hayfield => 'heifi:ld
haylage => 'heileidʒ
Hayley => 'heili
hayloft => 'heilɒft
haymaker => 'heimeikә
haymaking => 'heimeikiŋ
Haymarket => 'heimɑ:kit
haymow => 'heimau
haynes => heinz
hayrick => 'heirik
hayride => 'heiraid
hays => heiz
hayseed => 'heisi:d
haystack => 'heistæk
haystacks => ˈheɪˌstæks
hayward => 'heiwәd
haywire => 'heiwaiә
Haywood => 'heiwud
hazard => 'hæzәd
hazarded => ˈhæzədid
hazarding => ˈhæzədɪŋ
hazardous => 'hæzәdәs
hazardously => 'hæzədəslɪ
hazards => ˈhæzədz
Hazchem => 'hæzkem
haze => heiz
hazed => heizd
hazel => 'heizl
hazel grouse => ˈheɪzəl graʊs
hazelnut => 'heizlnʌt
hazelnuts => ˈheɪzəlˌnʌts
hazels => ˈheɪzəlz
hazes => heiziz
hazier => ˈheɪzi:ə
hazily => 'heizili
haziness => 'heizinis
hazing => 'heiziŋ
hazy => 'heizi
he => hi:
he-man => 'hi:'mæn
he-men => 'hi:mæn
head => hed
head boy => hed bɔi
head case => 'hedkeis
head gasket => hed ˈɡæskit
head girl => hed ɡə:l
head of hair => hed ɔv hɛə
head of state => hed ɔv steit
head sea => hed si:
head start => hed stɑ:t
head teacher => hed ˈti:tʃə
head voice => hed vɔis
head-first => 'hedf'ɜ:st
head-to-head => 'hedtә'hed
headache => 'hedeik
headaches => ˈhedeikiz
headachy => 'hed.eiki
headage => 'hedidʒ
headband => 'hedbænd
headbands => ˈhedˌbændz
headbanger => ˈhedbæŋə(r)
headboard => 'hedbɒ:d
headboards => ˈhedbɔ:dz
headcheese => 'hedtʃi:z
headcount => ˈhedkaʊnt
headdress => 'heddres
headdresses => ˈheddresiz
headed => 'hedid
header => 'hedә
headgear => 'hedgiә
headhunt => 'hedhʌnt
headhunter => 'hedhʌntә
headhunters => ˈhedhʌntəz
headhunting => ˈhedhʌntɪŋ
headier => ˈhedi:ə
headily => 'hedili
headiness => 'hedinis
heading => 'hediŋ
headlamp => 'hedlæmp
headlamps => ˈhedlæmps
headland => 'hedlәnd
headlands => ˈhedləndz
headless => 'hedlis
headlight => 'hedlait
headlights => 'hedlaɪts
headline => 'hedlain
headliner => 'hed,lainә(r)
headlines => ˈhedlainz
headlock => 'hedlɒk
headlong => 'hedlɒŋ
headman => 'hedmәn
headmaster => 'hed'mɑ:stә
headmasters => 'hedm'ɑ:stərz
headmistress => 'hed'mistris
headmistresses => ˈhedˌmɪstrɪsiz
headmost => 'hedmәust
headnote => 'hednәut
headphone => 'hedfәun
headpiece => 'hedpi:s
headquarter => ,hed'kwɔ:tә
headquarters => hed'kwɒ:tәz
headrest => 'hedrest
headrests => ˈhedrests
headroom => 'hedru:m
heads => hedz
heads-up => 'hedz'ʌp
headsail => 'hedsәl,-seil
headscarf => ˈhedskɑ:f
headscarves => ˈhedˌskɑ:fs
headset => 'hedset
headsets => ˈhedsets
headship => 'hedʃip
headships => ˈhedʃips
headshot => hed'ʃɒt
headshrinker => 'hedʃriŋkә
headsman => 'hedzmәn
headspace => 'hedspeis
headspring => 'hedspriŋ
headsquare => 'hedskweә(r)
headstall => 'hedstɒ:l
headstand => 'hedstænd
headstander => 'hedstænd
headstock => 'hedstɒk
headstone => 'hedstәun
headstones => ˈhedˌstəʊnz
headstream => 'hedstri:m
headstrong => 'hedstrɒŋ
headteacher => hed'ti:tʃər
Headteachers => 'hedtiːtʃə
headwaiter => hed'weitә
headwall => 'hedwɔ:l
headward => 'hedwәd
headwater => 'hed,wɔ:tә(r)
headwaters => 'hedwɔ:tә(r)
headway => 'hedwei
headwear => 'hedwɪər
headwinds => ˈhedˌwɪndz
headword => 'hedwә:d
headwords => ˈhedwə:dz
headwork => 'hedwә:k
heady => 'hedi
heal => hi:l
heal-all => 'hi:lɔ:l
healable => 'hi:leɪbl
Heald => hi:ld
healed => hi:ld
healer => 'hi:lә
healers => ˈhi:ləz
healing => 'hi:liŋ
health => 'helθ
health care => helθ kɛə
health centre => helθ ˈsentə
health club => helθ klʌb
health farm => helθ fɑ:m
health food => helθ fu:d
health maintenance organization => hɛlθ ˈmentənəns ˌɔrɡənɪˈzeʃən
health service => helθ ˈsɜːvɪs
health visitor => helθ ˈvizitə
healthcare => 'helθkεә
healthful => 'helθful
healthily => 'helθili
healthiness => 'helθinis
healthy => 'helθi
heap => hi:p
heaped => hi:pt
heaping => 'hi:piŋ
heaps => hi:ps
hear => hiә
heard => hә:d
hearer => 'hiәrә
hearers => ˈhiərəz
hearing => 'hiәriŋ
hearing dog => ˈhiəriŋ dɔɡ
hearing-impaired => 'hɪərɪŋɪmp'eəd
hearken => 'hɑ:kәn
hearken back => ˈhɑ:kən bæk
hearkened => ˈhɑ:kənd
hearkening => ˈhɑ:kənɪŋ
Hearn => hә:n
hearsay => 'hiәsei
hearse => hә:s
hearses => hə:siz
hearst => hә:st
heart => hɑ:t
heart-lung machine => ˈhɑ:tˈlʌŋ
heart-warming => ˈhɑ:tˌwɔ:mɪŋ
heartache => 'hɑ:teik
heartbeat => 'hɑ:tbi:t
heartbeats => ˈhɑ:tbi:ts
heartbreak => 'hɑ:tbreik
heartbreaker => 'ha:tbreɪkə
heartbreaking => 'hɑ:tbreikiŋ
heartbreaks => ˈhɑ:tˌbreɪks
heartbroken => 'hɑ:tbrәukәn
heartburn => 'hɑ:tbә:n
hearted => 'hɑ:tid
hearten => 'hɑ:tn
heartened => ˈhɑ:tnd
heartening => 'hɑ:tәniŋ
heartens => ˈhɑ:tnz
heartfelt => 'hɑ:tfelt
hearth => hɑ:θ
hearthrug => 'hɑ:θrʌg
hearths => hɑ:θs
hearthside => 'hɑ:θsaid
hearthstone => 'hɑ:θstәun
heartier => ˈhɑ:ti:ə
hearties => ˈhɑ:ti:z
heartily => 'hɑ:tili
heartiness => 'hɑ:tinis
heartland => 'hɑ:tlænd
heartlands => ˈhɑ:tˌlændz
heartless => 'hɑ:tlis
heartlessly => 'ha:tlisli
heartrending => 'hɑ:t.rendiŋ
heartsease => 'hɑ:ts,i:z
heartsick => 'hɑ:tsik
heartstring => 'hɑ:tstriŋ
heartstrings => 'hɑ:tstriŋs
heartthrob => 'hɑ:tθrɔb
heartwarming => 'ha:tˌwɔ:mɪŋ
heartwood => 'hɑ:twud
hearty => 'hɑ:ti
heat => hi:t
heat barrier => hi:t ˈbæriə
heat lamp => hi:t læmp
heat lightning => hi:t ˈlaitniŋ
heat up => hi:t ʌp
heat-exchanger => 'hi:tɪkstʃ'eɪndʒər
heat-resistant => 'hi:tri,zistәnt
heat-shock protein => hit ʃɑk ˈproˌtin
heat-treat => 'hi:ttri:t
heated => 'hi:tid
heatedly => 'hi:tidli
heater => 'hi:tә
heaters => ˈhi:təz
heath => hi:θ
heathen => 'hi:ðәn
heathendom => 'hi:ðәndәm
heathenish => 'hi:ðәniʃ
heathenism => 'hi:ðәnizm
heathens => ˈhi:ðənz
heather => 'heðә
heathery => 'heðәri
heathland => 'hi:θlænd
heathrow => 'hi:θrәj
heaths => hi:θs
heathy => 'hi:θi
heating => 'hi:tiŋ
heatproof => 'hi:t'pru:f
heats => hi:ts
heatstroke => 'hi:tstrәuk
heatwave => ˈhi:tweɪv
heave => hi:v
heave to => hi:v tu:
heave-ho => 'hi:v'hәu
heaved => hi:vd
heaven => 'hevn
heaven-sent => 'hevәnsent
heavenliness => 'hevnlinis
heavenly => 'hevnli
heavenly body => ˈhevənli: ˈbɔdi
heavenward => 'hevnwәd
heavenwards => 'hevәnwәdz
heaver => 'hi:vә
heaves => 'hi:vz
heavier-than-air => 'heviәðәn'eә(r)
heavies => ˈheviz
heaviest => 'hevist
heavily => 'hevili
heaviness => 'hevinis
heaving => 'hi:vinŋ
Heaviside => 'hevisaid
heavy => 'hevi
heavy breathing => ˈhevi ˈbri:ðɪŋ
heavy cream => ˈhevi kri:m
heavy going => ˈhevi ˈgəʊɪŋ
heavy hitter => ˈhevi ˈhitə
heavy industry => ˈhevi ˈindəstri
heavy metal => ˈhevi ˈmetl
heavy petting => ˈhevi ˈpetiŋ
heavy-footed => 'hevi'fjtid
heavy-handed => hevi'hændid
heavy-laden => 'hevi'leidәn
heavy-set => ˈhevi set
heavyset => 'hevi'set
heavyweight => 'heviweit
heavyweights => ˈhevi:ˌweɪts
hebdomadal => heb'dɔmәdl
hebe => 'hi:bi
hebephrenia => ,hi:bi'fri:niә
hebetude => 'hebitju:d
Hebraic => hi:'breiik
Hebraism => 'hi:breizәm
Hebraist => 'hi:briist
Hebraistic => ,hi:brei'istik
Hebraize => 'hi:breiaiz
Hebrew => 'hi:bru:
hebrews => 'hi:bru:z
hebridean => ,hebri'di:әn
Hebrides => 'hebridi:z
Hebron => 'hi:brәn
hecatomb => 'hekәtәum. -tu:m
heck => hek
heckelphone => 'hekәlfәjn
heckle => 'hekl
heckled => ˈhekəld
heckler => 'heklә
hecklers => 'heklə
heckles => ˈhekəlz
heckling => ˈhekəlɪŋ
hectare => 'hektɑ:
hectares => ˈhektɛəz
hectic => 'hektik
hecto- => 'hektәj
hectocotylus => ,hektә'kɔtilәs
hectogram => 'hektәgræm
hectolitre => 'hektәj,li:tә(r)
hectometre => 'hektәj,mi:tә(r)
hector => 'hektә
hectored => 'hektəd
hectoring => ˈhektərɪŋ
hectors => 'hektəz
Hecuba => 'hekjubә
hedda => 'hedә
heddle => 'hedl
heddles => 'hedlz
heder => 'heidә
hedge => hedʒ
hedge sparrow => hedʒ ˈspærəʊ
hedged => hedʒ
hedgehog => 'hedʒhɒg
hedgehogs => ˈhedʒˌhɔ:gz
hedger => 'hedʒә(r)
hedgerow => 'hedʒrәu
Hedgerows => 'hedʒrəʊ
hedges => hedʒz
hedonic => hi:'dɒnik
hedonism => 'hi:dәunizm
hedonist => 'hi:dәunist
hedonistic => .hi:dә'nistik
hee-haw => ˈhi: hɔ:
heebie-jeebies => 'hi:bi'dʒi:biz
heed => hi:d
heeded => hi:did
heedful => 'hi:dful
heedfully => 'hi:dfəlɪ
heedfulness => ˊhiːdfulnis
heeding => hi:dɪŋ
heedless => 'hi:dlis
heedlessly => 'hi:dlisli
heedlessness => hi:dlisnis
heeds => hi:dz
heel => hi:l
heelball => 'hi:lbɒ:l
heeled => hi:ld
heeler => 'hi:lә
heeling => 'hi:liŋ
heelpiece => 'hi:lpi:s
heeltap => 'hi:ltæp
heffalump => 'hefәlʌmp
heft => heft
hefted => heftid
heftier => ˈhefti:ə
heftily => ˊheftili
heftiness => ˊheftinis
hefting => heftɪŋ
hefts => hefts
hefty => 'hefti
hegel => 'hei^l
Hegelian => hei'geiliәn
Hegelianism => hei'^i:liәnizәm
hegemonic => .hedʒi'mɒnik
hegemony => hi:'dʒemәni
hegira => 'hedʒirә
heh => hei
heiau => 'heiaj
Heidelberg => 'haidlbә:^
heidi => 'haidi
heifer => 'hefә
heifers => 'hefəz
heigh => hei
heigh-ho => 'hei'hәu
height => hait
heighten => 'haitn
heightened => ˈhaitənd
heightens => ˈhaitənz
Heil => 'haiәl
Heilbronn => 'hailbrɔ:n
Heilong => 'hei'ljŋ
Heilongjiang => 'hei'ljŋ'dʒjɑ:ŋ
hein => æŋ
heine => 'hainә
heinie => 'haini
heinous => 'heinәs
heinously => 'heɪnəslɪ
heinousness => ˊheinәsnis
heir => єә
heirdom => 'eәdәm
heiress => 'eәris
heiresses => ˈeərɪsiz
heirless => 'eәlis
heirloom => 'єәlum
heirlooms => ˈeəˌlu:mz
heirship => 'eәʃip
heisenberg => 'haizәnbә:^
heist => haist
heisted => haistid
heisting => haistɪŋ
heists => haists
Hejaz => he'dʒæz
Hekla => 'heklә
HeLa => 'hi:lә,'he-
held => held
helen => 'helәn
helena => 'helinә, he'li:nә
helene => hә'li:n
helenium => heˈli:niəm
Helens => 'helən
helga => 'hel^ә
heli => 'helɪ
heli- => 'heli
heli-skiing => ˈheliski:ɪŋ
helianthus => .hi:li'ænθәs
helical => 'helikәl
helically => 'helikәli
helices => 'helisi:z
helichrysum => ,heli'kraisәm
helicity => he'lisiti
helicobacter => helɪ'kɒbæktə
helicoid => 'helikɒid
helicoidal => heli'kɔidl
helicon => 'helikәn
heliconia => ,heli'kәuniә
helicopter => 'helikɒptә
helicopter view => ˈhelikɔptə vju:
helicopters => 'helɪkɒptəz
Heligoland => 'heliɡəulænd
Helio => 'hi:liəu
helio- => 'hi:liәj
heliocentric => .hi:liәu'sentrik
Heliogabalus => ,hi:liә'^æbәlәs
heliogram => 'hi:liәgræm
heliograph => 'hi:liәgræf
heliographic => ,hi:liəu'ɡræfik
heliography => .hi:li'ɒgrәfi
heliogravure => .hi:liәgrә'vjuә
heliometer => .hi:li'ɒmitә
Heliopolis => ,hi:li'ɔpəlis
Helios => 'hi:liɒs
helioseismology => hi:li:əʊ'saɪzmələdʒɪ
heliosphere => 'hi:liә,sfiә
heliostat => 'hi:liәstæt
heliotherapy => .hi:liәu'θerәpi
heliotrope => 'hi:liәtrәup
heliotropic => .hi:liә'trɒpik
heliotropism => .hi:li'ɒtrәpizm
heliozoan => ,hi:liәu'zәuәn
helipad => 'helipæd
heliport => 'helipɒ:t
heliports => ˈhelipɔ:ts
helium => 'hi:liәm
helix => 'hi:liks
helixes => ˈhi:liksiz
hell => hel
hell-hole => 'helh'əʊl
hellacious => he'leɪʃəs
Helladic => he'lædik
Hellas => 'helәs
hellbender => 'helbendә
hellcat => 'helkæt
hellebore => 'helibɔ:
hellebores => 'helɪbɔː
helleborine => 'helibәrain
Hellene => 'heli:n
Hellenic => he'lenik
Hellenism => 'helinizm
Hellenist => 'helinist
Hellenistic => .heli'nistik
Hellenize => 'helәnaiz
heller => 'helә
Hellespont => 'helәspɔnt
hellfire => 'helfaiә
hellhole => 'helhәul
hellhound => 'helhajnd
hellion => 'heljәn
hellish => 'heliʃ
hellishly => 'helɪʃlɪ
hello => hә'lәu
hellos => heˈləuz
helluva => 'helәvә
hellward => 'helwәd
helm => helm
Helmand => 'helmənd
helmet => 'helmit
helmeted => ˈhelmɪtɪd
helmets => ˈhelmits
Helmholtz => 'helmhәults
helming => helmɪŋ
helminth => 'helminθ
helminthiasis => ,helmin'θaiәsis
helminthic => hel'minθik
helminthological => helmɪnθə'lɒdʒɪkəl
helminthologist => 'helmɪnθələdʒɪst
helminthology => ,helmin'θɔlәdʒi
helmsman => 'helmzmәn
helo => 'heləʊ
helot => 'helәt
helotism => 'helәtizm
helotry => 'helәtri
help => help
helper => 'helpә
helper cell => ˈhelpə sel
helpful => 'helpful
helping => 'helpiŋ
helpless => 'helplis
helplessness => 'helpləsnəs
helpline => ˈhelplaɪn
helpmate => 'helpmeit
helpmeet => 'helpmi:t
Helsinki => 'helsiŋki
helter-skelter => 'heltә'skeltә
helter-skelters => 'heltə'skeltə
helve => helv
Helvetia => hel'vi:ʃjә
Helvetian => hel'vi:ʃjәn
Helvetic => hel'vetik
hem => hem
hemagglutination => 'hi:mә,^lu:ti'neiʃәn
hemangioma => hi:,mændʒi'әumә
hematite => 'hemәtait
hemato- => 'hemәtәj,'hi:m-
hematocrit => 'hemәtәkrit
hematological => ˌhi:mətə'lɒdʒɪkl
hematology => .hi:mә'tɒlәdʒi
hematoma => ,hi:mә'tәumә
hematoxylin => ,hi:mә'tɔksilin
heme => hi:m
hemerocallis => ,hemәrәj'kælis
hemi- => 'hemi
hemianopia => ,hemiә'nәjpiә
hemicellulose => ,hemi 'seljulәus
Hemichordata => ,hemi'kɔ:deitə
hemichordate => ,hemi'kɔ:deit
hemicycle => 'hemisaikl
hemidemisemiquaver => ,hemi,demi'semikweivә
hemihydrate => ,hemi'haidreit
hemimetabolic => 'hemi,metә'bɔlik
hemimetabolous => ,hemimi'tæbәlәs
hemimorphite => ,hemi'mɔ:fait
Hemingway => 'hemiŋwei
hemiola => ,hemi'әulә
hemiparasite => ,hemi'pærәsait
hemiparesis => ,hemipә'ri:sis
hemipenis => ,hemi'pi:nis
hemiplegia => .hemi'pli:dʒiә
Hemiptera => hi'miptәrә
hemipteran => hi'miptәrәn
hemipterous => hi'miptәrәs
hemisphere => 'hemisfiә
hemispheres => ˈhemiˌsfiəz
hemispheric => 'hemɪˌsfɪrɪk
hemistich => 'hemistik
hemline => 'hemlain
hemlines => ˈhemlainz
hemlock => 'hemlɒk
hemmed => hemd
hemming => 'hemiŋ
hemo- => 'hi:mәj,'he-
hemodialysis => ,hi:mәudai'ælisis
hemodynamic => ,hi:mәudai'næmik
hemoglobin => .hi:mәu'glәubin
hemophilia => .hi:mә'filiә
hemophiliac => .hi:mә'filiæk
hemoptysis => hi'mɔptisis
hemorrhage => 'hemәridʒ
hemorrhoid => 'hemәrɔid
hemorrhoids => 'hemərɔɪdz
hemostasis => hi'mɔstәsis
hemostatic => .hi:mә'stætik
hemp => hemp
hempen => 'hempәn
hempseed => 'hempsi:d
Hempstead => 'hempsted
hems => hemz
hemstitch => 'hemstitʃ
hemstitched => ˈhemstitʃt
hemstitches => ˈhemstitʃiz
hemstitching => ˈhemstitʃɪŋ
hen => hen
hen night => hen nait
hen party => hen ˈpɑ:ti
henbane => 'henbein
henbit => 'henbit
hence => hens
henceforth => hens'fɒ:θ
henceforward => hents'fɔ:wәd
henchman => 'hentʃmәn
henchmen => 'hentʃmən
hendeca- => 'hendekә,hen'dekә
hendecagon => hen'dekәgɒn
hendecasyllabic => ,hendekәsi'læbik
hendecasyllable => 'hendekә.silәbl
henderson => 'hendәsn
hendiadys => hen'daiәdis
Hendon => 'hendən
henge => hendʒ
henhouse => 'henhaus
henhouses => ˈhenhausiz
henley => 'henli
henna => 'henә
hennaed => 'henəd
hennaing => ˈhenərɪŋ
hennas => ˈhenəz
henotheism => 'henәθi:izm
henpeck => 'henpek
henpecked => 'henpekt
henrietta => ,henri'etә
henry => 'henri
hens => henz
hep => hep
heparin => 'hepәrin
heparinize => 'hepәrinaiz
hepatic => hi'pætik
hepatic portal vein => hɪˈpætɪk ˈpɔ:təl vein
hepatica => hi'pætikә
hepatitis => .hepә'taitis
hepato- => 'hepәtәj
hepatocellular => ,hepәtәu'seljulә
hepatocyte => 'hepәtәsait
hepatoma => ,hepә'tәumә
hepatomegaly => .hepәtәu'megәli
hepatopancreas => ,hepәtәu'pæŋkriәs
hepatotoxic => ,hepәtәu' tɔksik
hepatotoxicity => -'sisti
hepatotoxin => ,hepәtәu'tɔksin
hepburn => 'hepbә:n
hepcat => 'hepkæt
Hephaestus => hi'fi:stәs
Hepplewhite => 'heplhwait
heptachlor => 'hetә,klɔ:
heptad => 'heptæd
heptagon => 'heptәgɒn
heptagonal => hep'tægәnәl
heptahedron => .heptә'hi:drәn
heptamerous => hep'tæmәrәs
heptameter => hep'tæmitә
heptane => 'heptein
heptarchy => 'heptɑ:ki
Heptateuch => 'heptәtju:k
heptathlon => hepˈtæθlən
heptavalent => 'heptә,veilәnt
heptyl => 'heptil
Hepzibah => 'hepzəbə
her => hә:
Hera => 'hiәrә
Heracles => 'herәkli:z
Heraclitus => ,herә'klaitәs
Heraklion => hi'rækliәn
herald => 'herәld
heralded => ˈherəldid
heraldic => he'rældik
heralding => ˈherəldɪŋ
heraldist => 'herәldist
heraldry => 'herәldri
heralds => ˈherəldz
Herat => he'rɑ:t
herb => hә:b
herb tea => hə:b ti:
herbaceous => hә'beiʃәs
herbaceous border => hɜ:ˈbeɪʃəs ˈbɔ:də
herbage => 'hә:bidʒ
herbal => 'hә:bәl
herbalism => 'hә:bәlism
herbalist => 'hә:bәlist
herbalists => ˈɜ:bəlɪsts
herbarium => hә:'beәriәm
herbary => 'hә:bәri
herbed => hɜːbd
herbert => 'hә:bәt
herbicide => 'hә:bisaid
herbicides => 'hɜ:bɪsaɪdz
herbivore => 'hә:bivɒ:
herbivores => 'hɜ:bɪvɔ:z
herbivorous => hә'bivәrәs
herby => 'hә:bi
Hercegovina => ,hertsә^әj'vi:nә
Herculaneum => ,həkjə'leiniəm
herculean => ,hә:kju:'ljәn
Hercules => 'hә:kjuli:z
herd => hә:d
herdbook => 'hә:dbuk
herded => hə:did
herders => 'hə:də
herds => hə:dz
herdsman => 'hә:dzmәn
herdsmen => 'hɜːdzmən
here => hiә
here goes => hiə ɡəuz
hereafter => .hiәr'ɑ:ftә
hereat => .hiәr'æt
hereby => hiә'bai
hereditable => hә'reditәbl
hereditament => ,heri'ditәmәnt
hereditarian => hi,redi'teәriәn
hereditarianism => hɪredɪteə'rɪənɪzəm
hereditarily => hi'reditәrili
hereditary => hi'reditәri
heredity => hi'rediti
Hereford => 'herәfәd
Herefordshire => 'herәfәdʃiә
herein => .hiәr'in
hereinafter => .hiәrin'ɑ:ftә
hereinbefore => .hiәrinbi'fɒ:
hereof => .hiәr'ɒv
Herero => hә'rerәu
heresiarch => he'ri:ziɑ:k
heresies => ˈherɪsi:z
heresy => 'herәsi
heretic => 'herәtik
heretical => hi'retikәl
heretics => ˈherɪtɪks
hereto => .hiәr'tu:
heretofore => .hiәtu'fɒ:
hereunder => hiәr'ʌndә
hereunto => .hiәrʌn'tu:
hereupon => hiәrә'pɔn
herewith => hiә'wiθ
heriot => 'heriәt
heritability => ,heritә'bilәti
heritable => 'heritәbl
heritage => 'heritidʒ
heritor => 'heritә
herky-jerky => 'hɜ:ki:dʒ'ɜ:kɪ
herl => hә:l
herm => hә:m
herman => 'hә:mәn
hermaphrodite => hә:'mæfrәdait
hermaphrodite brig => hɚˈmæfrəˌdaɪt brɪɡ
hermaphrodites => hə:ˈmæfrədaits
hermaphroditic => hә:.mæfrә'ditik
hermaphroditism => hә:'mæfrә.daitizm
hermeneutic => .hә:mә'nju:tik
hermeneutical => ˌhə:məˈnju:tikəl
hermetic => hә:'metik
hermeticism => hə:'metisizəm
hermit => 'hә:mit
hermit crab => ˈhə:mit kræb
hermitage => 'hә:mitidʒ
hermits => ˈhə:mits
Hermosillo => ,emɔ'si:jɔ:
hernia => 'hә:niә
hernial => 'hә:niәl
herniate => 'hә:nieit
herniated => ˈhə:nieitid
hero => 'hiәrәu
Herod => 'herәd
Herodian => he'rәjdiәn
Herodotus => hi'rɔdәtәs
heroic => hi'rәuik
heroic couplet => hiˈrəuik ˈkʌplɪt
heroically => hə'rəʊɪklɪ
heroin => 'herәuin
heroine => 'herәuin
heroines => 'herəʊɪnz
heroism => 'herәuizm
heroize => 'hiәrәuaiz
heron => 'herәn
heronry => 'herәnri
herons => 'herənz
herp => hɜːp
herpes => 'hә:pi:z
herpesvirus => ,hә:pi:z'vaiәrәs
herpetic => hә:'petik
herpetology => .hә:pә'tɒlәdʒi
herr => heә
Herrenvolk => 'herәnfɔlk
Herrick => 'herik
herring => 'heriŋ
herring gull => ˈherɪŋ gʌl
herringbone => 'heriŋbәun
herrings => ˈherɪŋz
Herriot => er'jәu
Herrnhuter => 'heәn,hu:tә(r)
hers => hә:z
Herschel => 'hə:ʃəl
herself => hә:'self
herstory => 'hɜ:stɔ:rɪ
Hertfordshire => 'hɑ:(t)fәdʃә(r)
hertz => 'hә:ts
Herzegovina => ,heәtsә^әu'vi:nә
Herzegovinian => ,hə:tsəɡəu'vi:niən
Heshvan => heʃ'vɑ:n, 'heʃvәn
Hesiod => 'hi:siɔd
hesitance => 'hezitәns
hesitancy => 'hezitәnsi
hesitant => 'hezitәnt
hesitate => 'heziteit
hesitated => 'hezɪteɪtɪd
hesitates => ˈheziteits
hesitation => .hezi'teiʃәn
hesitations => ˌhezɪˈteɪʃənz
Hesperian => hes'piriәn
Hesperides => hes'peridi:z
hesperidium => ,hespә'ridiәm
Hesperus => 'hespәrәs
hess => hes
Hesse => 'hesi
hessian => 'hesiәn
hest => hest
hester => 'hestә
Hesvan => 'hesvәn
Hesychast => 'hesikæst
het => het
het up => ˌhet ˈʌp
hetaera => hi'tiәrә
hetero => 'hetәrәu
hetero- => 'hetәrәj
heterocercal => ,herәrә'sә:kl
heterochromatic => 'hetәrәjkrәj'mætik
heterochromatin => ,hetәrәu'krәumәtin
heteroclite => 'hetәrәklait
heteroclitic => ,hetәrәj'klitik
heterocyclic => .hetәrәu'saiklik
heterocyclics => ,hetәrә'saikliks
heterodox => 'hetәrәdɒks
heterodoxy => 'hetәrәdɒksi
heterodyne => 'hetәrәudain
heterodyned => 'het(ə)rə(ʊ)daɪn
heterodynes => 'het(ə)rə(ʊ)daɪn
heterodyning => 'hetәrәu,dainiŋ
heterogametic => ,hetәrәj^ә'metik
heterogamous => ,hәtә'rɔ^әmәs
heterogamy => ,hetә'rɔ^әmi
heterogeneity => ,hetәrәudʒi'ni:iti
heterogeneous => .hetәrәu'dʒi:njәs
heterogeneously => hetәˊrɒgәmәsli
heterogenous => ,hetә'rɔdʒinәs
heterograft => ,hetәrәu'^rɑ:ft
heterojunction => ,hetәrә'dʒʌŋkʃәn
heterologous => ,hetә'rɔlә^әs
heterology => .hetә'rɒlәdʒi
heteromorphic => ,hetәrәu'mɔ:fik
heteromorphism => ,hetәrәu'mɔ:fizәm
heteromorphy => 'hetәrәu,mɔ:fi
heteronomous => ,hetә'rɔnәmәs
heteronomy => .hetә'rɒnәmi
heteronym => 'hetәrәnim
heteronymous => ,hetә'rɔnimәs
heteropolar => ,hetәrәu'pәulә
heteropterous => ,hetә'rɔptәrәs
heterosexism => ,hetәrәj'seksizәm
heterosexual => .hetәrә'sekʃuәl
heterosexuality => ,hetәrәu,seksju'æliti
heterosexuals => ˌhetərəuˈseksjuəlz
heterosis => ,hetә'rәusis
heterostyly => 'hetәrәu,staili
heterotransplant => ,hetәrәutræns'plɑ:nt
heterotroph => 'hetәrәutrɔf
heterotrophic => ,hetәrәj'trɔfik
heterotrophy => 'hetәrәu,trɔfi
heterozygosity => ,hetәrәjzai'^ɔsәti
heterozygote => .hetәrәu'zaigәut
heterozygous => ,hetәrәu'zai^әs
hetman => 'hetmәn
hetmans => 'hetmən
hetty => 'heti
heuchera => 'hju:kәrә, 'hɔi-
heuristic => hju'ristik
hew => hju:
hewed => hju:d
hewer => 'hju:ә
hewett => 'hju:it
hewing => hju:ɪŋ
hewn => 'hju:n
hews => hju:z
hex => heks
hexa- => ˈheksə
hexachord => 'heksәkɒ:d
hexad => 'heksæd
hexadecimal => 'heksәdesimәl
hexagon => 'heksәgәn
hexagonal => hek'sægәnәl
hexagons => 'heksəɡənz
hexagram => 'heksә^ræm
hexahedral => .heksә'hi:drәl
hexahedron => .heksә'hi:drәn
hexamerous => hek'sæmәrәs
hexameter => hek'sæmitә
hexane => hek'sein
hexapla => 'heksәplә
hexaploid => 'heksәplɔid
hexaploidy => heksæp'lɔɪdɪ
hexapod => 'heksәpɒd
hexastyle => 'heksәstail
Hexateuch => 'heksәtju:k
hexavalent => ,heksə'veɪl(ə)nt
hexes => heksiz
hexose => 'heksәus
hexyl => 'heksil
hey => hei
hey presto => heɪ ˈprestəʊ
heyday => 'heidei
heywood => 'heiwud
Hezbollah => ,hezbə'lɑ:
hi => hai
hi-fi => 'haifai
hi-hat => hai hæt
hi-tech => 'haɪ'tek
hiatus => hai'eitәs
hiatus hernia => haɪˈeɪtəs ˈhə:njə
Hiawatha => haiә'wɔ:θә
hibachi => hi'bɑ:tʃi
hibakusha => hi'bɑ:kuʃә
hibernate => 'haibәneit
hibernated => ˈhaɪbəˌneɪtid
hibernates => ˈhaɪbəˌneɪts
hibernating => ˈhaɪbəˌneɪtɪŋ
hibernation => .haibә'neiʃәn
hibernator => 'haɪbəneɪtə
Hibernian => hai'bә:niәn
hibiscus => hai'biskәs
HIC => hik
hic jacet => 'hik'dʒeiset
hiccough => 'hikʌp
hiccoughed => 'hɪkʌp
hiccoughing => 'hɪkʌp
hiccoughs => 'hɪkʌp
hiccup => 'hikʌp
hiccuped => ˈhɪkəpt
hiccupped => ˈhɪkəpt
hiccupping => ˈhɪkəpɪŋ
hiccups => ˈhɪkəps
hiccupy => 'hikʌpi,-kә-
hick => hik
hickey => 'hiki
hickory => 'hikәri
hid => hid
hidalgo => hi'dælgәu
Hidatsa => hi'dɑ:tsɑ:
hidden => 'hidn
hidden agenda => ˈhɪdn əˈdʒendə
hiddenite => 'hidәnait
hide => haid
hide-and-seek => 'haidәn'si:k
hideaway => 'haidә.wei
hideaways => ˈhaidəweiz
hidebound => 'haidbaund
hideous => 'hidiәs
hideously => 'hɪdɪəslɪ
hideout => 'haidaut
hideouts => ˈhaɪdˌaʊts
hidey-hole => ˈhaɪdi həʊl
hiding => 'haidiŋ
hiding place => ˈhaɪdɪŋ pleis
hidrosis => hai'drәusis
hidrotic => hai'drɔtik
hie => hai
hied => haɪd
hierarch => 'haiәrɑ:k
hierarchal => ,haɪə'rɑːkəl
hierarchical => ,haiә'rɑ:kikәl
hierarchically => ,haiə'rækikəli
hierarchies => ˈhaiərɑ:kiz
hierarchization => 'haɪə,rɑːkaɪ'zeɪʃən
hierarchize => 'haiә,rɑ:kaiz
hierarchy => 'haiәrɑ:ki
hieratic => haiә'rætik
hierocracy => ,haiә'rɔkrәsi
hierocratic => ,haiәrәj'krætik
hieroglyph => 'haiәrәglif
hieroglyphic => .haiәrәu'ɡlifik
hieroglyphical => ,haiәrә'^lifikәl
hieroglyphs => haɪə'rəɡlɪfs
hierogram => 'haiәrә^ræm
hierolatry => ,haiә'rɔlәtri
hierology => ,haiә'rɔlәdʒi
hierophant => 'haiәrәfænt
Higginson => 'hi^insn
higgle => 'hi^l
higgled => ˈhiɡld
higgledy-piggledy => 'hi^ldi'pi^ldi
higgler => 'hi^lә(r)
higgling => 'hɪɡlɪŋ
Higgs => hi^z
high => hai
high altar => hai ˈɔ:ltə
high beam => hai bi:m
high chair => hai tʃɛə
high day => hai dei
high fidelity => hai fiˈdeliti
high five => hai faɪv
high hat => hai hæt
high heels => hai hi:lz
high jinks => ˈhaɪˌdʒɪnks
high jump => hai dʒʌmp
high jumper => hai ˈdʒʌmpə
high kick => hai kik
high life => hai laif
high point => hai pɔint
high priest => hai pri:st
high priestess => hai ˈpri:stɪs
high profile => hai ˈprəufail
high relief => hai riˈli:f
high road => hai roʊd
high sign => hai sain
high society => hai səˈsaiəti
high spot => hai spɔt
high street => hai stri:t
high table => hai ˈteibl
high tech => tek
high technology => hai tekˈnɔlədʒi
high water => hai ˈwɔ:tə
high wire => hai ˈwaiə
high-band => 'haɪb'ænd
high-concept => 'hai'kɔnsept
high-density lipoprotein => haɪ ˈdɛnsɪti ˌlɪpoˈproˌtin
high-flier => 'haɪfl'aɪər
high-fliers => 'hai'flaiə
high-flyer => hai ˈflaiə
high-grade => 'hai'^reid
high-handed => hai'hændid
high-hat => 'hai'hæt
high-heeled => 'hai'hi:ld
high-impact => 'haɪ'ɪmpækt
high-key => 'hai'ki:
high-low => 'hai'ləu
high-maintenance => hai ˈmeintinəns
high-pass => 'haɪp'ɑ:s
high-power => 'haɪp'aʊər
high-powered => 'hai'pajәd
high-risk => ˈhaɪˈrɪsk
high-sounding => 'hai'sajndiŋ
high-strung => 'hai'strʌŋ
high-tensile => 'hai'tensail
high-test => 'hai'test
high-toned => 'hai'tәjnd
highball => 'haibɔ:l
highbinder => 'hai,baindә(r)
highborn => 'haibɒ:n
highboy => 'haibɒi
highbrow => 'haibrau
highbrows => ˈhaɪˌbraʊz
higher => 'haiә
higher education => ˈhaɪə ˌedju:ˈkeiʃən
higher-up => 'haiәr'ʌp
Highers => ˈhaɪə(r)
highest => 'haiist
highest common factor => ˈhaiist ˈkɔmən ˈfæktə
highfalutin => haifә'lu:ti:n
Highgate => 'hai^it
highland => 'hailәnd
highlander => 'hailәndә
highlandman => 'hailəndmən
highlands => 'haɪləndz
highlight => 'hailait
highlighted => 'hailaitid
highlighter => 'hai.laitә
highly => 'haili
highly strung => ˈhaɪli strʌŋ
highness => 'hainis
highrise => haɪ'raɪz
highs => haɪ
hight => hait
hightail => 'haiteil
highway => 'haiwei
highwayman => 'haiweimәn
highwaymen => 'haiweimən
hijab => hɪˈdʒɑ:b
hijack => 'haidʒæk
hijacked => ˈhaidʒækt
hijacker => 'haidʒækә
hijackers => ˈhaɪdʒækəz
hijacks => ˈhaidʒæks
Hijaz => hi:'dʒæz
hijinks => 'haidʒiŋks
hijra => 'hɪdʒrə
hike => haik
hiked => haikt
hiker => 'haikә
hikers => ˈhaikəz
hikes => haiks
hiking => 'haikiŋ
hila => 'hailә
hilar => 'hailә
hilarious => hi'lєәriәs
hilariously => hi'lɛəriəsli
hilarity => hi'læriti
Hilary => 'hilәri
Hilda => 'hildә
hill => hil
hill climb => hil klaim
hill-climbing => 'hɪlkl'aɪmɪŋ
Hillary => 'hiləri:
hillbillies => ˈhɪlˌbɪli:z
hillbilly => 'hil.bili
hilled => hɪl
hilliness => 'hilinis
hillock => 'hilәk
hillocks => 'hɪləks
hillocky => 'hɪləkɪ
hillside => 'hilsaid
hillsides => ˈhɪlˌsaɪdz
hilltop => 'hiltɒp
hilltops => ˈhɪlˌtɔps
hillwalking => ˈhɪlwɔ:kɪŋ
hilly => 'hili
hilt => hilt
hilted => hɪltid
hilton => 'hiltәn
hilts => hɪlts
hilum => 'hailәm
hilus => 'hailәs
him => him
Himalaya => ,himə'leiə
Himalayan => hi'mɒlәjәn
Himalayas => ,himә'leiәz
himation => hi'mætiɔn,-әn
himmler => 'himlә
himself => him'self
hin => hin
Hinayana => .hi:nә'jɑ:nә
hind => haind
hindbrain => 'haindbrein
Hindenburg => 'hindәnbjrk
hinder => 'hindә
hindered => ˈhindəd
hindering => ˈhindərɪŋ
hinders => ˈhindəz
Hindi => 'hindi:
Hindley => 'haindli, 'hindli
hindmost => 'haindmәust
Hindoo => 'hin,du:
hindoos => ˈhinˌdu:z
hindquarter => 'haind.kwɒ:tә
hindrance => 'hindrәns
hindrances => ˈhɪndrənsiz
hindsight => 'haindsait
Hindu => 'hindu:
Hinduism => 'hinduizm
Hinduize => 'hindu(:)aiz
hindus => ˈhɪndu:z
Hindustan => .hindu'stɑ:n
Hindustani => .hindu'stɑ:ni
hinge => hindʒ
hingeless => 'hindʒlis
hinges => 'hɪndʒɪz
hinny => 'hini
hinoki => hi'nәjki
hint => hint
hinterland => 'hintәlænd
hinterlands => 'hɪntəlændz
hip => hip
hip flask => hip flɑ:sk
hip hop => hip hɔp
hip pocket => hip ˈpɔkit
hip roof => hip ru:f
hipbone => 'hipbәun
hiphuggers => 'hip,hʌ^әz
hipness => 'hipnis
Hipparchus => hi'pa:kəs
hippeastrum => ,hipi'æstrәm
hipped => hipt
hipped roof => hipt ru:f
hippie => 'hipi:
hippiedom => 'hipidәm
hippies => 'hɪpɪz
hippo => 'hipәu
hippocampal => ,hipә'kæmpәl
hippocampus => ,hipә'kæmpәs
hippocras => 'hipәkræs
Hippocrates => hi'pɒkrәti:z
hippocratic => ,hipəu'krætik
Hippocrene => 'hipәkri:n
Hippodrome => 'hipәdrәum
hippogriff => 'hipә^rif
Hippolytus => hi'pɔlitәs
hippopotamus => .hipә'pɒtәmәs
hippos => ˈhipəuz
hippurate => 'hipjureit
hippus => 'hipәs
hippy => 'hipi
hipshot => 'hɪpʃɒt
hipster => 'hipstә
hipsterism => 'hɪpstɜ:ɪzəm
Hiram => 'haiәrәm
hircine => 'hә:sain
hire => haiә
hireable => 'haiәrәbl
hired man => haɪəd
hireling => 'haiәliŋ
hirelings => ˈhaiəliŋz
hirer => 'haiәrә
hires => ˈhaiəz
hiring => 'haiәriŋ
Hirohito => 'hi:rɔ:'hi:tɔ:
Hiroshima => ,hirә'ʃi:mә
Hirst => hә:st
hirsute => 'hә:sju:t
hirundine => hi'rʌndin, -dain
his => hiz
Hispanic => his'pænik
Hispanicize => his'pænisaiz
hispanics => hisˈpæniks
Hispaniola => ,hispәn'jәjlә
Hispanist => 'hispәnist
hispid => 'hispid
hiss => his
hissed => hist
hisself => hi'self
hisses => hisiz
hissing => 'hisiŋ
hist => hist
histamine => 'histәmi:n
histidine => 'histidi:n, -din
histiocyte => 'histiәsait
histiocytosis => ,histiәusai'tәusis
histochemical => ,histәj'kemikәl
histochemistry => ,histәu'kemistri
histocompatibility => ,histәukәm,pæti'biliti
histogenesis => ,histәu'dʒenisis
histogenetic => ,histәjdʒi'netik
histogenic => - nik
histogeny => his'tɔdʒәni
histogram => 'histәgræm
histologist => his'tɔlәdʒist
histology => hi'stɒlәdʒi
histolysis => his'tɔlisis
histone => 'histәun
histopathologic => 'histәj,pæθә'lɔdʒik
histopathological => 'histәj,pæθә'lɔdʒikәl
histopathologist => hɪstəpæ'θɒlədʒɪst
histopathology => ,histәupә'θɔ:lәdʒi
histoplasmosis => ,histәuplæz'mәusis
historian => hi'stɒ:riәn
historians => hɪs'tɔ:rɪənz
historiated => his'tɔ:rieitid
historic => hi'stɒrik
historic present => hisˈtɔrik ˈprezənt
historical => hi'stɒrikәl
historical linguistics => hisˈtɔrikəl lɪŋˈgwɪstɪks
historical materialism => hisˈtɔrikəl məˈtɪəri:əˌlɪzəm
historically => his'tɔrikәli
historicism => his'tɔ:risizәm
historicity => .histә'risiti
historicize => his'tɔ:risaiz
historicized => hɪ'stɒrɪsaɪz
historiographer => .histɒ:ri'ɒgrәfә
historiography => .histɒ:ri'ɒgrәfi
history => 'histәri
histrionic => .histri'ɒnik
histrionics => ,histri'ɔniks
hit => hit
hit home => hit həum
hit list => hit list
hit man => hit mæn
hit the hay => hit ðə hei
hit-and-miss => 'hitәn'mis
Hitachi => hi'tɑ:tʃi
hitch => hitʃ
hitch-hike => 'hɪtʃ'haɪk
hitch-hiker => hɪtʃ 'haɪkə
hitch-hikes => 'hitʃ'haik
hitchcock => 'hitʃkɔk
hitched => hitʃt
hitcher => 'hɪtʃə
hitchhike => 'hitʃhaik
hitchhiked => ˈhɪtʃˌhaɪkt
hitchhiker => 'hitʃ'haikә
hitchhikes => ˈhɪtʃˌhaɪks
hitchhiking => 'hɪtʃhaɪkɪŋ
hitching => 'hitʃiŋ
hither => 'hiðә
hitherto => .hiðә'tu:
hitherward => 'hiðәwәd
hitler => 'hitlә
Hitlerian => hit'liәriәn
Hitlerism => 'hitlәrizm
Hitlerite => 'hitlәrait
hitman => 'hɪtmæn
hitter => 'hitә
hitters => ˈhitəz
Hittite => 'hitait
hive => haiv
hived => haɪvd
hives => haivz
hiving => haɪvɪŋ
hiya => 'haijә
HMS => ,eitʃ em 'es
HNC => ,eitʃ en 'si:
HND => ,eitʃ en 'di:
HO => hәu
Ho Chi Minh => 'hәj'tʃi:'min
ho ho => ˌhəʊ ˈhəʊ
ho-hum => 'hәu'hʌm
hoagie => 'hәj^i
hoar => hɒ:
hoar frost => ˈhɔ: frɒst
hoard => hɒ:d
hoarded => hɔ:did
hoarder => 'hɒ:dә
hoarding => 'hɒ:diŋ
hoards => hɔ:dz
hoarfrost => 'hɒ:frɒst
hoarhound => 'hɔ:haund
hoariness => 'hɔ:rinis
hoarse => hɒ:s
hoarsely => hɔ:slɪ
hoarsen => 'hɔ:sn
hoarser => hɔ:sə
hoarstone => 'hɒ:stәun
hoary => 'hɒ:ri
hoatzin => hәu'ætsin
hoax => hәuks
hoaxed => həʊkst
hoaxes => həʊksiz
hoaxing => həʊksɪŋ
hob => hɒb
hobart => 'hәubɑ:t
hobbed => hɔbd
hobbes => hɔbz
Hobbesian => 'hɔbziәn
hobbing => 'hɔbiŋ
hobbit => 'hɑbət
hobble => 'hɒbl
hobble skirt => ˈhɔbəl skə:t
hobblebush => 'hɔblbuʃ
hobbled => ˈhɔbəld
hobbledehoy => 'hɔbldi'hɔi
hobbler => 'hɔblә
hobbles => 'hɔblz
hobbling => ˈhɔbəlɪŋ
Hobbs => hɔbz
hobby => 'hɒbi
hobbyhorse => 'hɔbihɔ:s
hobbyist => 'hɔbiist
hobbyists => ˈhɔbiists
hobgoblin => 'hɒbgɒblin
hobnail => 'hɒbneil
hobnailed => 'hɔbneild
hobnob => 'hɒbnɒb
hobnobbed => ˈhɔbnɔbd
hobnobbing => ˈhɔbnɔbɪŋ
hobnobs => ˈhɔbnɔbz
hobo => 'hәubәu
hobos => ˈhəubəuz
hobs => hɔbz
Hobson => 'hɔbsn
hock => hɒk
hocked => hɔkt
hockey => 'hɒki
hocks => hɔks
Hocktide => 'hɔktaid
hocus => 'hәukәs
hocus-pocus => 'hәukәs'pәukәs
hod => hɒd
hodden => 'hɒdәn
Hodeida => hәu'deidә
hodge => hɔdʒ
hodge-podge => 'hɒdʒpɒdʒ
hodgepodge => 'hɒdʒpɒdʒ
hodgkin => 'hɔdʒkin
Hodgson => 'hɔdʒsn
hodiernal => hɔdi'ә:nl
hodman => 'hɔdmәn
hodograph => 'hɔdә^rɑ:f
hodoscope => 'hɔdәskәup
hods => hɔdz
hoe => hәu
hoe in => həu in
hoecake => 'hәukeik
hoed => həud
hoedown => 'hәudaun
hoeing => 'həʊɪŋ
hoer => 'hәjә(r)
hoes => həuz
hof => hɔf
Hofei => 'hә'fei
Hofmann => 'hɔfmәn
hog => hɒg
hog badger => hɔ:g ˈbædʒə
hog-tie => 'hɒɡtaɪ
hogan => 'hәuɡәn
Hogarth => 'hәu^ɑ:θ
Hogarthian => hәj'^ɑ:θjәn
hogback => 'hɒgbæk
hogfish => 'hɒgfiʃ
Hogg => hɔ^
hogged => hɔ^d
hogger => 'hɔ^ә(r)
hoggery => 'hɒgәri
hogget => 'hɒgit
hoggin => 'hɔ^iŋ
hogging => 'hɔ^iŋ
hoggish => 'hɒgiʃ
hoggishly => ˊhɒgiʃli
hogmanay => 'hɔ^mәnei
hognose snake => ˈhɔɡnəuz sneik
hognut => 'hɔ^nʌt
hogs => hɔ:gz
hogshead => 'hɔ^zhed
hogwash => 'hɒgwɒʃ
hogweed => 'hɔ^wi:d
hohenzollern => 'hәuәntsәlәn
hoi polloi => ,hɔipә'lɔi
hoick => hɔik
hoicks => hɒiks
hoist => hɒist
hoisted => hɔistid
hoisting => 'hɔistiŋ
hoists => hɔists
hoity-toity => 'hɒiti'tɒiti
hok => hɒk,hɔːk
hoke => hәuk
hokey => 'hәjki
hokey-pokey => 'hәuki'pәuki
hoki => ˈhəʊki
hokkaido => hɔ'kaidәu
hokku => 'hɒkuː
hokonui => 'hɔkәnji
hokum => 'houkәm
hol => hɔl
Holarctic => hɔ'lɑ:ktik
hold => hәuld
hold court => həuld kɔ:t
hold fast => həuld fɑ:st
hold it => həuld it
hold-ups => 'həʊld'ʌps
holdall => 'hәjldɔ:l
holdalls => ˈhəuldɔ:lz
holdback => 'hәuldbæk
holden => 'hәuldәn
holder => 'hәuldә
holdfast => 'hәuldfɑ:st
holding => 'hәuldiŋ
holding pattern => ˈhəʊldɪŋ ˈpætən
holdout => 'hәuldaut
holdover => 'hәuldәuvә
holdup => 'hәuldʌp
holdups => 'həʊldʌp
hole => hәul
hole-and-corner => ,hәjlәnd'kɔ:nә(r)
hole-in-the-wall => həul in ðə wɔ:l
holey => 'hәuli
holiday => 'hɒlәdi
holiday camp => ˈhɔlədi kæmp
holiday season => ˈhɔlədi ˈsi:zən
holidaymaker => 'hɒlәdi.meikә
holidaymakers => ˈhɔlɪdeɪˌmeɪkəz
holidays => 'hɔlә,deiz
holier-than-thou => 'hәuliәðәn'ðau
holiness => 'hәulinis
holing => 'hәuliŋ
holism => 'hәulizm
holist => 'hәulist
holistic => hәj'listik
holistically => -kli
holla => 'hɔlә
Holland => 'hɒlәnd
hollandaise => ,hɔlәn'deiz
hollandaise sauce => ˌhɒlələndeɪz ˈsɔ:s
Hollander => 'hɒlәndә
Hollands => 'hɒlәndz
holler => 'hɒlә
hollered => ˈhɔləd
hollering => ˈhɔlərɪŋ
Hollerith => 'hәulәriθ
hollers => ˈhɔləz
hollow => 'hɒlәu
hollow-eyed => 'hɔlәjaid
hollow-hearted => 'hɔlәj,hɑ:tid
holloware => 'hɔlәu,weә
hollowed => ˈhɔləud
hollowing => 'hɔlәuiŋ
hollowly => 'hɒlәuli
hollowness => 'hɒlәunis
hollowware => 'hɒlәuwєә
holly => 'hɒli
holly fern => ˈhɔli: fɜ:n
hollyhock => 'hɒlihɒk
Hollywood => 'hɔliwud
Holm => hәum
holm oak => həum əuk
holman => 'hәulmәn
Holme => həulm
Holmesian => 'həulmziən
holmium => 'hәulmiәm
holo => 'hɑlə
holocaust => 'hɔlәkɔ:st
holocausts => ˈhɔləˌkɔ:sts
Holocene => 'hɔlәusi:n
holoenzyme => ,hɔlәu'enzaim
hologram => 'hɔlәu^ræm
holograms => 'hɒləɡræmz
holograph => 'hɒlәugræf
holographic => ,hɔlәu'^ræfik
holography => hɒ'lɒgrәfi
holophrase => 'hɔlәfreiz
holophrasis => hɔ'lɔfrәsis
holophrastic => ,hɔlәu'fræstik
holophytic => ,hɔlәu'fitik
holothurian => hɒlә'θjuriәn
holotype => 'hɔlәu,taip
hols => hɔlz
holstein => 'hɔlstain
holster => 'hәulstә
holstered => 'həʊlstə; 'hɒl-
holsters => ˈhəʊlstəz
holt => hәult
holy => 'hәuli
holy day => ˈhəuli dei
holy terror => ˈhəuli ˈterə
holy water => ˈhəuli ˈwɔ:tə
holystone => 'hәulistәun
holystoned => ˈhəulistəund
holystones => ˈhəulistəunz
holystoning => ˈhəulistəunɪŋ
homage => 'hɒmidʒ
hombre => 'ɔmbә
home => hәum
home banking => həum ˈbæŋkɪŋ
home base => həum beis
home brew => həum bru:
home front => həum frʌnt
home help => həum help
home key => həum ki:
home movie => həum ˈmu:vi
home plate => həum pleit
home port => həum pɔ:t
home range => həum reindʒ
home room => həum ru:m
home run => həum rʌn
home shopping => həum ˈʃɔpɪŋ
home straight => həum streit
home theater => həum ˈθiətə
home-grown => 'hәum'ɡrәun
homebody => 'hәumbɒdi
homebound => 'hәjmbajnd
homeboy => ˈhəʊmbɔɪ
homeboys => ˈhəʊmˌbɔɪz
homebuilder => 'həʊm,bɪldə
homebuilding => 'hәjm,bildiŋ
homebuyer => ˈhəʊmbaɪə(r)
homecoming => 'hәumkʌmiŋ
homecomings => ˈhəumˌkʌmiŋz
homegirl => ˈhəʊmgɜ:l
homegrown => hәum'grәun
homeland => 'hәumlænd
homelands => ˈhəʊmˌlændz
homeless => 'hәumlis
homelike => 'hәumlaik
homeliness => 'hәumlinis
homely => 'hәumli
homemade => 'hәum'meid
homemaker => 'hәummeikә
homemaking => 'hәummeikiŋ
homeobox => həʊ'mi:əʊbɒks
homeomorphic => ,hәumiәu'mɔ:fik
homeomorphism => ,hәumiәu'mɔ:fizm, ,hɔmiә-
homeopath => 'hәumiәpɑ:θ
homeopathic => 'hәumiәu,pæθik
homeopathist => ,hәumi'ɔpәθist
homeopaths => ˈhəumiəpɑ:θs
homeopathy => .hәumi'ɒpәθi
homeosis => ,hәumi'әusis
homeostasis => ,hәumiәu'steisis
homeostatic => ,hәu miәu 'stætik
homeotherm => 'hәumiәθә:m
homeothermal => ,hәumiәu'θә:mәl
homeothermic => ,hәumiәu'θә:mik
homeotherms => 'hәmiә,θә:mz
homeothermy => həʊmi:əʊ'θɜ:mɪ
homeotic => 'həʊmi:əʊtɪk
homeowner => 'hәum.әunә
homepage => 'hәumpeidʒ
homeplace => 'hәjmpleis
homer => 'hәumә
Homeric => hәu'merik
homeroom => 'hәjmru:m
homesick => 'hәumsik
homesite => 'hәumsait
homespun => 'hәjmspʌn
homestead => 'hәumsted
homesteader => 'hәjm,stedә(r)
homesteaders => 'həʊm,stedə
homesteading => 'həʊmsted
homesteads => ˈhəʊmˌstedz
homestretch => 'hәumstretʃ
homestyle => həʊmɪs'taɪl
hometown => hәum'taun
homeward => 'hәumwәd
homeward-bound => 'həʊmwədb'aʊnd
homework => 'hәumwә:k
homey => 'hәumi
homicidal => .hɒmi'saidl
homicide => 'hɒmisaid
homicides => ˈhɑmɪˌsaɪdz
homie => 'hәjmi
homiletic => .hɒmi'letik
homiletics => .hɒmi'letiks
homiliary => hɔ'miliәri
homilies => ˈhɔmiliz
homilist => 'hɔmilist
homily => 'hɒmili
homing => 'hәumiŋ
homing pigeon => ˈhəʊmɪŋ ˈpidʒin
hominid => 'hɒminid
hominoid => 'hɔminɔid
hominy => 'hɒmini
HOMO => 'hәumәu
Homo sapiens => hәjmәj 'sæpienz
homo- => 'hәjmәj, 'hɔmәj
homocentric => .hɒmәu'sentrik
homocercal => ,hɔmәu'sә:kl
homocysteine => ,hәumәu'sisti:in
homoeopath => 'hәumjәupɑ:θ
homoeopathic => ,hәumjәu'pæθik
homoeopathy => ,hәumi'ɔpәθi
homoeosis => ,hәumi'әusis
homoeostasis => ˌhəumiəuˈsteisis
homoerotic => ,hɔmәji'rɔtik
homogametic => ,hәumәu^ә'metik
homogamous => hәu'mɒgәmәs
homogamy => hәu'mɒgәmi
homogenate => hә'mɔdʒineit
homogeneity => .hɒmәdʒe'ni:iti
homogeneous => .hәumә'dʒi:niәs
homogeneousness => hɒməd'ʒi:nɪəsnəs
homogenisation => ˌhəʊmədʒənɑɪ'zeɪʃən
homogenization => ,hәumәdʒәnai'zeiʃәn
homogenize => hɒ'mɒdʒәnaiz
homogenized => həˈmɒdʒənaɪzd
homogenizer => hә'mɔdʒinaizә
homogenizes => həˈmɔdʒəˌnaɪziz
homogenous => hә'mɔdʒinәs
homogeny => hә'mɔdʒini
homograft => 'hɔmәu^rɑ:ft, 'hɔmә-
homograph => 'hɒmәugræf
homographic => hɒməʊɡ'ræfɪk
homoiotherm => hәu'mɔiәθә:m
homoiousian => ˌhəʊmɔɪ'u:sɪən
homolog => 'hɒmәlɒg
homologate => hɒ'mɒlәgeit
homologize => hɒ'mɒlәdʒaiz
homologous => hɒ'mɒlәgәs
homologue => 'hɔmәlɔ^
homology => hɒ'mɒlәdʒi
homomorphic => ,hɔmә'mɔ:fik
homomorphism => ,hɔmә'mɔ:fizm
homonym => 'hɒmәunim
homonymic => .hɒmәu'nimik
homonymous => hɒ'mɒnimәs
homonymy => hɔ'mɔnimi
homophobe => ˈhɔməfəub
homophobia => ,hәumә'fәubiә
homophobic => ,hɔmə'fəubik
homophone => 'hɔmәufәun
homophonic => ,hɔmә'fɔnik
homophonous => hɔ'mɔfәnәs
homophony => hɒ'mɒfәni
homopolar => ,hɔmә'pәulә
homopteran => hәu'mɔptәrәn
homopterous => hɒ'mɒptәrәs
homorganic => ,hәumәɔ:'^ænik
homosexual => .hɒmәu'sekjuәl
homosexuality => -'æliti
homosexuals => hɒmə'sekʃʊəlz
homotransplant => ,hәumәtræns'plɑ:nt
homozygosity => ,hәjmәjzai'^ɔsәti
homozygote => .hәumәu'zaigәut
homozygous => ,hɔmә'zai^әus
Homs => hәums
homunculus => hәu'mʌŋkjulәs
homy => 'hәumi
HON => hʌn
Honan => 'hәj'næn
honcho => 'hɒntʃәu
honda => 'hɔndә
Honduran => hɔn'djuәrәn
Honduras => hɒn'djurәs
hone => hәun
honed => həʊnd
honest => 'ɒnist
honest broker => ˈɔnist ˈbrəʊkə
honestly => 'ɒnistli
honesty => 'ɒnisti
honewort => 'hәun,wә:t
honey => 'hʌni
honey badger => ˈhʌni ˈbædʒə
honey buzzard => ˈhʌni ˈbʌzəd
honey fungus => ˈhʌni ˈfʌŋɡəs
honey locust => ˈhʌni ˈləʊkəst
honeybee => 'hʌnibi:
honeybees => ˈhʌni:ˌbi:z
honeycomb => 'hʌnikәum
honeycombed => ˈhʌnikəʊmd
honeycombing => 'hʌnɪkəʊmɪŋ
honeycombs => ˈhʌnɪkəʊmz
honeycreeper => hənɪk'ri:pər
honeydew => 'hʌnidju:
honeydew melon => ˌhʌnidju: ˈmelən
honeyeater => həʊni':i:tər
honeyed => 'hʌnid
honeymoon => 'hʌnimu:n
honeymooner => 'hʌni,mu:nə
honeymooners => 'hʌni,mu:nə
honeymoons => ˈhʌni:ˌmu:nz
honeypot => ˈhʌnipɒt
honeys => ˈhʌniz
honeysucker => 'hʌnɪ,sʌkə
honeysuckle => 'hʌnisʌkl
honeywort => 'hʌniwɔ:t; -wə:t
hong => hɔŋ
Hong Kong => 'hɔŋ'kɔŋ
hongi => ˊhɒŋi
Honiara => ,hәjni'ɑ:rә
honied => 'hʌnid
honing => 'hәuniŋ
Honiton => 'hɔnitən
honk => hɒŋk
honked => hɔ:ŋkt
honker => 'hɒŋkə
honkers => 'hɔŋkәz
honking => hɔ:ŋkɪŋ
honks => hɔ:ŋks
honky => 'hɒnki
honky-tonk => 'hɔŋkitɔŋk
Honolulu => .hɒnә'lu:lu:
honor => 'ɒnә
honorable => 'ɒnәrәbl
honorand => 'ɔnәrәnd
honorarium => .ɒnә'rєәriәm
honorary => 'ɒnәrәri
honoree => ,ɔnә'ri:
honorific => .ɒnә'rifik
honoring => ˈɔnərɪŋ
honoris causa => hɔ'nɔ:ris'kɔ:sә
honour => 'ɒnә
honourable => 'ɒnәrәbl
honourably => 'ɒnərəblɪ
Honshu => 'hɔnʃu:
hoo => hu:
hoo-ha => 'hu:,hɑ:
hooch => hu:tʃ
hood => hud
hooded => 'hudid
hoodie => 'hjdi
hooding => hudɪŋ
hoodlum => 'hu:dlәm
hoodlums => ˈhu:dləmz
hoodoo => 'hu:du:
hoodooed => ˈhu:du:d
hoodooing => ˈhu:du:ɪŋ
hoodoos => ˈhu:du:z
hoods => hudz
hoodwink => 'hudwiŋk
hoodwinked => ˈhʊdˌwɪŋkt
hoodwinking => ˈhʊdˌwɪŋkɪŋ
hoodwinks => ˈhʊdˌwɪŋks
hoody => ˈhʊdi
hooey => 'hu:i
hoof => hu:f
hoofed => hu:ft
hoofer => 'hu:fә(r)
hoofing => hu:fɪŋ
hoofprint => 'hu:fprint
hoofs => hu:fs
hook => huk
hook and eye => huk ænd ai
hook shot => huk ʃɔt
hook-nosed => 'hjknәjzd
hookah => 'hukә, -kɑ:
hookahs => ˈhukəz
hooke => huk
hooked => hukt
hooker => 'hukә
hookers => ˈhukəz
hookey => 'hu:ki
hooklet => 'hjklit
hookup => 'hukʌp
hookworm => 'hukwә:m
hooky => 'huki
hooligan => 'hu:ligәn
hooligans => ˈhu:lɪgənz
hoolock => 'hu:lɒk
hoon => hun
hoop => hu:p
hoop-la => 'hu:pl'ɑ:
hooped => hu:pt
hooper => 'hu:pә
hooping => 'hu:pɪŋ
hoopla => 'hu:plɑ:
hoopoe => 'hu:pu:
hoops => hu:ps
hoopster => 'hu:pstә(r)
hooray => hu'rei
hoosegow => 'hu:s^au
Hoosier => 'hu:ʒә
hoot => hu:t
hootch => hu:tʃ
hooted => hu:tid
hootenanny => 'hu:tәnæni
hooter => 'hu:tә
hooters => ˈhu:təz
Hooton => 'hu:tәn
hoots => hu:ts
hoover => 'hu:vә
hoovered => ˈhu:vəd
hoovering => ˈhu:vərɪŋ
hoovers => ˈhu:vəz
Hooverville => 'hu:vәvil
hooves => hu:vz
hop => hɒp
hope => hәup
hope chest => həup tʃest
hopeful => 'hәupful
hopefully => 'hәjpfjli
hopefuls => ˈhəupfulz
Hopeh => 'həu'pei
hopeless => 'hәuplis
hopelessness => 'həʊpləsnəs
hoper => 'həupə
hophead => 'hɒphed
Hopi => 'hәupi
hopkins => 'hɔpkinz
Hopkinson => 'hɔpkinsn
hoplite => 'hɒplait
hopped => hɔpt
hopped-up => 'hɔpt'ʌp
hopper => 'hɒpә
hoppers => 'hɒpəz
hopping => 'hɔpiŋ
hopping mad => ˈhɔpiŋ mæd
hopple => hɒpl
hoppy => 'hɔpi
hopsack => 'hɔp,sæk
hopscotch => 'hɒpskɒtʃ
hora => 'hɔ:rә, 'hәurә
horace => 'hɔrәs
horal => 'hɔ:rәl
horary => 'hɒ:rәri
Horatia => hә'reiʃiә
Horatian => hɔ'reiʃiәn
horatio => hɔ'reiʃiәu
horde => hɒ:d
hordes => 'hɔ:dz
horehound => 'hɔ:haund
horizon => hә'raizәn
horizons => hə'raɪznz
horizontal => .hɒri'zɒntәl
horizontality => ,hɔrizɔn'tælәti
hormonal => hɒ:'mәunәl
hormone => 'hɒ:mәun
hormone replacement therapy => ˈhɔ:ˌməʊn riˈpleismənt ˈθerəpi
Hormuz => 'hɔ:mәz,hɔ:'mu:z
horn => hɒ:n
horn of plenty => hɔ:n ɔv ˈplenti
hornbeam => 'hɒ:nbi:m
hornbill => 'hɒ:nbil
hornblende => 'hɒ:nblend
hornbook => 'hɒ:nbuk
Hornby => 'hɔ:nbi
horned => hɒ:nd
horned lark => hɔ:nd lɑ:k
horned poppy => hɔ:nd ˈpɔpi:
horned toad => hɔ:nd təud
horned viper => hɔ:nd ˈvaɪpə
horner => 'hɔ:nә(r)
hornet => 'hɒ:nit
hornets => 'hɔ:nɪts
hornfels => 'hɔ:nfels
hornier => ˈhɔ:ni:ə
horniness => 'hɒ:ninis
hornist => 'hɔ:nist
hornless => 'hɔ:nlis
hornpipe => 'hɔ:npaip
hornswoggle => 'hɒ:nswɒgl
horntail => 'hɔ:nteil
hornworm => 'hɔ:nwә:m
hornwort => 'hɒ:nwә:t
horny => 'hɒ:ni
horologe => 'hɒrәlɒdʒ
horological => .hɒrә'lɒdʒikәl
horology => hɒ'rɒlәdʒi
horopter => hә'rɔptә
horoscope => 'hɔrәskәup
horoscopes => ˈhɔ:rəˌskəʊps
horoscopy => hɒ'rɒskәpi
horrendous => hɒ'rendәs
horrendously => hɔ'rendəsli
horrent => 'hɒrәnt
horrible => 'hɒrәbl
horribly => 'hɒrәbli
horrid => 'hɒrid
horridly => 'hɒrɪdlɪ
horrific => hɒ'rifik
horrifically => hɔ'rifikəli
horrification => ,hɔrifi'keiʃən
horrified => 'hɒrifaid
horrifies => ˈhɔrifaiz
horrify => 'hɒrifai
horrifyingly => 'hɔrifaiiŋli
horripilate => hɔ'ripileit
horror => 'hɒrә
horror-struck => 'hɔrәstrʌk
horrors => 'hɒrəz
hors de combat => ɔ:rdәkjŋ'bɑ:
Horsa => 'hɔ:sə
horse => hɒ:s
horse mushroom => hɔ:s ˈmʌʃrum
horse opera => hɔ:s ˈɔpərə
horse pistol => hɔ:s ˈpistl
horse racing => hɔ:s ˈreisiŋ
horse sense => hɔ:s sens
horse show => hɔ:s ʃəu
horse-drawn => ˈhɔ:sdrɔ:n
horse-trade => 'hɔ:streid
horse-trading => ˈhɔ:sˌtreɪdɪŋ
horseback => 'hɒ:sbæk
horsebean => 'hɒ:sbi:n
horseflesh => 'hɒ:sfleʃ
horseflies => 'hɔːsflaɪ
horsefly => 'hɒ:sflai
horsehair => 'hɔ:sheә(r)
horsehair worm => ˈhɔ:sheə wə:m
horsehide => 'hɒ:shaid
horseleech => 'hɔ:sli:tʃ
horseless => 'hɒ:slis
horseman => 'hɒ:smәn
horsemanship => 'hɒ:smәnʃip
horsemeat => 'hɒ:smi:t
horsemen => 'hɔ:smən
horsemint => hɔ:se'mɪnt
horseplay => 'hɒ:splei
horseplayer => 'hɔ:s,pleiә(r)
horsepower => 'hɒ:spauә
horseradish => hɒ:s'rædiʃ
horseshit => 'hɔ:sʃit,'hɔ:ʃ-
horseshoe => 'hɒ:sʃu:
horseshoe bat => ˈhɔ:ʃʃu: bæt
horseshoe crab => ˈhɔ:ʃʃu: kræb
horseshoeing => 'hɔːsʃuː; -ʃʃ-
horseshoes => ˈhɔ:ʃʃu:z
horsetail => 'hɒ:steil
horsewhip => 'hɒ:swip
horsewhips => ˈhɔ:sˌwips
horsewoman => 'hɒ:swumәn
horsey => 'hɔ:si
horsily => 'hɒ:sili
horsing => 'hɔ:siŋ
Horsley => 'hɔ:sli
horst => 'hɒ:st
horsy => 'hɒ:si
hortation => hɒ:'teiʃәn
hortative => 'hɒ:tәtiv
hortatory => 'hɔ:tәtәri
horticultural => .hɒ:ti'kʌltʃәrәl
horticulturalist => 'hɔ:tɪkʌltʃərəlɪst
horticulture => .hɒ:ti'kʌltʃә
horticulturist => .hɒ:ti'kʌltʃәrist
hortus siccus => 'hɔ:tәs'sikәs
horus => 'hɔ:rәs
hosanna => hәu'zænә
hose => hәuz
Hosea => hәu'zi:ә
hosel => 'hәjzmәn
hosepipe => 'hәjzpaip
hoses => həuziz
hosiery => 'hәjziәri, 'hәjʒәri
hospice => 'hɒspis
hospices => ˈhɔspisiz
hospitable => 'hɒspitәbl
hospitably => 'hɒspitәbli
hospital => 'hɒspitәl
hospital ship => ˈhɔspitəl ʃip
hospitaler => 'hɔspitәlә
hospitalisation => ,hɔspitәlai'zeiʃәn;-li'z-
hospitalism => 'hɔspitәlizәm
hospitalities => ˌhɔspiˈtælitiz
hospitality => .hɒspi'tæliti
hospitalization => ,hɔspitәlai'zeiʃәn
hospitalize => 'hɒspitәlaiz
hospitalized => ˈhɔspɪtlˌaɪzd
hospitalizes => ˈhɔspɪtlˌaɪziz
hospitalizing => 'hɒspɪt(ə)laɪz
hospitaller => 'hɔspitәlә
hospitals => 'hɒspɪtlz
hospodar => 'hɔspәdɑ:(r)
host => hәust
hosta => 'hɔstә
hostage => 'hɒstidʒ
hostages => ˈhɔstidʒz
hostel => 'hɒstәl
hosteller => hɒstl:ɜ
hostelry => 'hɔstәlri
hostels => ˈhɔstəlz
hostess => 'hәustis
hostesses => ˈhəʊstɪsiz
hostie => 'hәjsti
hostile => 'hɒstail
hostility => hɒs'tiliti
hosting => 'hәustiŋ
hostler => 'ɔslә, 'hәslә
hosts => həusts
hot => hɒt
hot button => hɔt ˈbʌtən
hot cake => hɔt keik
hot cross bun => hɔt krɔs bʌn
hot dog => hɔt dɔɡ
hot flash => hɔt flæʃ
hot link => hɔt liŋk
hot metal => hɔt ˈmetl
hot potato => hɔt pəˈteitəu
hot rod => hɔt rɔd
hot shoe => hɔt ʃu:
hot tub => hɔt tʌb
hot-air balloon => hɔt eə(r) bəˈlu:n
hot-rodder => 'hɔt'rɔdə
hot-short => 'hɔt'ʃɔ:t
hot-swap => hɔt swɔp
hot-water bottle => ˈhɔtˈwɔ:tə, -ˈwɔtə
hot-wired => hɔt ˈwaiəd
hot-wiring => hɔt ˈwaɪərɪŋ
hotbed => 'hɒtbed
hotbeds => ˈhɔtˌbedz
hotchpot => 'hɔtʃ,pɔt
hotchpotch => 'hɒtʃpɒtʃ
hotdogger => 'hɔt,dɔ^ә(r)
hotdogs => ˈhɒtˌdɒɡ
hotel => hәu'tel
hotelier => hәj'teliә(r)
hoteliers => həuˈteliəz
hotfoot => 'hɔtfjt
hotfooted => ˈhɔtˌfʊtid
hotfooting => ˈhɔtˌfʊtɪŋ
hotfoots => ˈhɔtˌfʊts
hothead => 'hɒthed
hotheaded => hɒt'hedid
hotheads => ˈhɔthedz
hothouse => 'hɒthaus
hothouses => ˈhɔtˌhaʊsiz
hotline => 'hɔtlain
hotly => 'hɒtli
hotness => 'hɒtnis
hotpot => 'hɒtpɒt
hotpots => ˈhɔtpɔts
hotshot => 'hɒtʃɒt
hotshots => ˈhɔt-ʃɔts
hotspur => 'hɒtspә:
hotted => hɔtid
Hottentot => 'hɔtntɔt
hotter => 'hɔtә(r)
hottie => 'hɔti
hotting => hɔtɪŋ
hottish => 'hɔtiʃ
Houdini => hu:'di:ni
hough => hɔk
hound => haund
houndfish => 'hɑjndfiʃ
hounds => haundz
houndstooth => 'hɑjndztu:θ
hour => auә
hour hand => ˈauə hænd
hourglass => 'auәglæs
houri => 'huәri
hourly => 'auәli
house => haus
house arrest => haus əˈrest
house guest => haus ɡest
house husband => haus ˈhʌzbənd
house martin => haus ˈmɑ:tn
house music => haus ˈmju:zik
house party => haus ˈpɑ:ti
house plant => haus plɑ:nt
house sparrow => haus ˈspærəʊ
house-sit => 'haussit
house-train => 'haustrein
house-training => 'haustrein
house-trains => 'haustrein
houseboat => 'hausbәut
houseboats => ˈhɑusbəuts
housebound => 'hajsbajnd
houseboy => 'hɑjsbɔi
housebreak => 'hɑjsbreik
housebreaker => 'hausbreikә
housebreakers => ˈhausbreikəz
housebreaking => 'hausbreikiŋ
housebroke => 'hɑjsbrәjk
housebroken => 'hɑjs,brәjkәn
housebuilders => 'haʊs,bɪldə
housecarl => haʊs'kɑ:l
housecleaner => 'haʊzkli:nə
housecleaning => 'hauskli:niŋ
housecoat => 'hauskәut
housecoats => ˈhauskəuts
housecraft => 'hajskrɑ:ft
housedress => 'hɑjsdres
housefather => 'hajsfɑ:ðә(r)
housefly => 'hausflai
houseful => 'hausful
houseguest => 'hɑjs^est
household => 'haushәuld
household name => ˈhaushəuld neim
householder => 'haushәuldә
householders => 'haʊshəʊldəz
households => 'haʊshəʊldz
housekeep => 'hauski:p
housekeeper => 'hauski:pә
housekeepers => ˈhaʊsˌki:pəz
housekeeping => 'hauski:piŋ
housekept => 'hɑjskept
houseleek => 'hausli:k
houseless => 'hɑjslis
houselights => haʊs'laɪts
housemaid => 'hausmeid
housemaids => ˈhaʊsˌmeɪdz
houseman => 'hajsmәn
housemaster => 'hausmɑ:stә
housemasters => ˈhausmɑ:stəz
housemate => 'hɑjsmeit
housemen => 'hausməm
housemistress => 'hausmistris
housemother => 'hausmʌðә
houseparent => haʊz'peərənt
housephone => 'hɑjsfәjn
houseplant => 'hɑʊsˌplænt
houseplants => 'hausplɑ:nt, -plænt
houseroom => 'hausru:m
houses => 'hauziz
housetop => 'haustɒp
housetops => 'haʊstɒps
houseware => 'haʊswer
housewares => 'hɑjsweәz
housewarming => 'hauswɒ:miŋ
housewife => 'hauswaif
housewifely => 'hauswaifli
housewifery => 'hauswaifәri
housework => 'hauswә:k
housey => 'hɑjzi
housey-housey => hajzi'hajzi
housing => 'hausiŋ
housing association => ˈhauziŋ əˌsəuʃiˈeiʃən
housing estate => ˈhauziŋ isˈteit
housing project => ˈhauziŋ prəˈdʒekt
Houston => 'hju:stәn
houting => 'hautiŋ
hove => hәuv
hovel => 'hʌvәl
hovelled => 'hɒv(ə)l
hovels => ˈhʌvəlz
hover => 'hʌvә
hovercraft => 'hʌvәkræft
hovered => ˈhɔvəd
hoverer => 'hɒvərər
hoverfly => 'hɔvəflai
hovers => ˈhɔvəz
hovertrain => 'hɔvәtrein
Hovis => 'hәuvis
how => hau
how about => hau əˈbaut
how many => hau ˈmeni
how-do-you-do => 'hajdjj'du:
how-to => 'hau'tu:
howard => 'hauәd
howbeit => .hau'bi:it
howdah => 'haudә
howdahs => 'haʊdə
howdy => 'haudi
howe => hau
however => hau'evә
howff => 'haʊf
Howie => 'haji
howitzer => 'hauitsә
howitzers => ˈhauitsəz
howl => haul
howled => hauld
howler => 'haulә
howlers => ˈhaʊləz
howlet => 'haulit
howling => 'hauliŋ
howls => haulz
Howrah => 'hajrә
howsoever => ,hausәu'evә
howtowdie => haj'tajdi
hoy => hɒi
hoya => hɔiә
hoyden => 'hɒidәn
hoydenish => 'hɒidәniʃ
Hoyle => hɒil
Hrvatska => hәr'vɑ:tskɑ:
Hsia => ʃjɑ:
Hsining => 'ʃi:'niŋ
hua => ,eitʃ,ju:'ei
Huambo => 'wɑ:mbəu
huarache => wә'rɑ:tʃi
hub => hʌb
hub-and-spoke => 'hʌb'ændsp'əʊk
Hubbard => 'hʌbәd
hubbies => ˈhʌbiz
hubble => 'hʌbl
hubble-bubble => 'hʌbl'bʌbl
hubbub => 'hʌbʌb
hubby => 'hʌbi
hubcap => 'hʌbkæp
hubcaps => ˈhʌbkæps
Hubei => 'hu:'bei
hubert => 'hju:bә(:)t
hubris => 'hju:bris
huckaback => 'hʌkәbæk
huckleberry => 'hʌklbәri
huckster => 'hʌkstә
huckstered => 'hʌkstə
hucksterism => 'hʌkstərizəm
hucksters => ˈhʌkstəz
huddle => 'hʌdl
huddles => ˈhʌdlz
Hudson => 'hʌdsn
hue => hju:
hued => hju:d
hues => hju:z
huff => hʌf
huffed => hʌft
huffer => 'hʌfər
huffier => 'hʌfi
huffily => 'hʌfili
huffing => hʌfɪŋ
huffish => 'hʌfiʃ
huffs => hʌfs
huffy => 'hʌfi
hug => hʌg
huge => hju:dʒ
hugely => 'hju:dʒli
hugeness => 'hju:dʒnis
huger => hju:dʒə
huggable => 'hʌɡɡeɪbl
hugged => hʌgɪd
hugger => 'hʌɡər
hugger-mugger => 'hʌgә'mʌgә
huggers => 'hʌɡə
hugging => hʌɡɪŋ
huggins => 'hʌ^inz
hugh => hju:
Hughie => 'hju:i
hugo => 'hju:^әu
hugs => hʌɡz
Huguenot => 'hju:gәnɒt
huh => hʌ
Huhehot => 'hu:,hei'hәjt
huia => 'hu:jә
hula => 'hu:lә
hula hoop => ˈhu:lə hu:p
hulk => hʌlk
hulking => 'hʌlkiŋ
hulks => hʌlks
hull => hʌl
hullabaloo => .hʌlәbә'lu:
hulled => hʌld
hulling => 'hʌliŋ
hullo => hә'lәu
hulls => hʌlz
hum => hʌm
human => 'hju:mәn
human chorionic gonadotrophin => ˈhju:mən ˌkəuriˈɔnik ˌɡɔnədəuˈtrəufin
human interest => ˈhju:mən ˈintrist
human nature => ˈhju:mən ˈneitʃə
human papilloma virus => ˈhjumən ˌpæpəˈlomə ˈvaɪrəs
human race => ˈhju:mən reis
humane => hju:'mein
humanely => hju:'meɪnlɪ
humanise => 'hju:mәnaiz
humanism => 'hju:mәnizm
humanist => 'hju:mәnist
humanistic => .hju:mә'nistik
humanitarian => hju:.mæni'tєәriәn
humanitarianism => hju:mæni'teәriәniz(ә)m
humanitarians => hju:ˌmænɪˈteəri:ənz
humanity => hju:'mæniti
humanization => .hju:mәnai'zeiʃәn
humanize => 'hju:mәnaiz
humanized => 'hju:məˌnaɪzd
humanizes => ˈhju:mənaiziz
humankind => 'hju:mәnkaind
humanly => 'hju:mәnli
humanness => 'hju:mәnis
humanoid => 'hju:mәnɒid
humanoids => 'hjuːmənɒɪd
Humberside => 'hʌmbәsaid
Humbert => 'hʌmbәt
humble => 'hʌmbl
humble-bee => ˈhʌmbl bi:
humbled => ˈhʌmbld
humbleness => 'hʌmblnis
humbler => ˈhʌmblə(r)
humbles => ˈhʌmblz
humblest => 'hʌmbl
humbly => 'hʌmbli
Humboldt => 'hʌmbәult
humbug => 'hʌmbʌg
humbuggery => 'hʌmbʌgәri
humbugs => ˈhʌmˌbʌgz
humdinger => hʌm'diŋgә
humdingers => ˈhʌmˈdɪŋəz
humdrum => 'hʌmdrʌm
hume => hju:m
humectant => hju:'mektәnt
humeral => 'hju:mәrәl
humerus => 'hju:mәrәs
humic => 'hju:mik
humid => 'hju:mid
humidification => hju:,midifi'keiʃәn
humidified => hju(:)ˈmidifaid
humidifier => hju:'midifaiә
humidify => hju:'midifai
humidistat => hju:'midistæt
humidity => hju:'miditi
humidor => 'hju:midɒ:
humification => ,hju:mifi'keiʃәn
humify => 'hju:mifai
humiliate => hju:'milieit
humiliated => hjuˈmilieitid
humiliates => hjuˈmilieits
humiliating => hju:'milieitiŋ
humiliation => hju:.mili'eiʃәn
humiliations => hju:ˌmɪli:ˈeɪʃənz
humiliator => hju:'milieitә(r)
humility => hju:'militi
hummed => hʌmd
hummel => 'hʌmәl
hummer => 'hʌmә
humming => 'hʌmiŋ
hummingbirds => ˈhʌmɪŋˌbɜ:dz
hummock => 'hʌmәk
hummocky => 'hʌmәki
hummus => ˈhʊməs
humongous => hju:'mʌŋ^әs
humor => 'hju:mә
humoral => 'hju:mәrәl
humored => ˈhju:məd
humoresque => .hju:mә'resk
humoring => ˈhju:mərɪŋ
humorist => 'hju:mәrist
humorists => ˈhju:mərists
humorless => 'hju:mәlis
humorlessly => h'ju:mərlezslaɪ
humorous => 'hju:mәrәs
humorousness => h'juːmərəsnəs
humors => ˈhju:məz
humour => 'hju:mә
humoured => 'hjuːmə
humouring => 'hjuːmə
humourless => 'hju:mәlis
humourous => 'hju:mәrәs
humours => ˈhju:məz
humous => 'hju:mәs
hump => hʌmp
humpback => 'hʌmpbæk
humpback bridge => ˈhʌmpbæk bridʒ
humpback whale => ˈhʌmpbæk hweil
humpbacked => 'hʌmpbækt
humpbacks => ˈhʌmpbæks
humped => 'hʌmpt
humph => 'hʌmf
humphrey => 'hʌmfri
humping => 'hʌmpiŋ
humpless => 'hʌmplis
humps => hʌmps
humpty => 'hʌmpti
humpty-dumpty => 'hʌmpti'dʌmpti
humpy => 'hʌmpi
humungous => hju:'mʌŋ^әs
humus => 'hju:mәs
Hun => hʌn
hunch => hʌntʃ
hunchback => 'hʌntʃbæk
hunchbacked => 'hʌntʃbækt
hunchbacks => ˈhʌntʃˌbæks
hunched => hʌntʃt
hunches => hʌntʃiz
hundred => 'hʌndrәd
hundredfold => 'hʌndrәdfәuld
hundredth => 'hʌndrәdθ
hundredths => ˈhʌndrɪdθs
hundredweight => 'hʌndrәdweit
hung => hʌŋ
hung up => hʌŋ ʌp
hung-over => 'hʌŋ'əʊvər
Hungarian => hʌŋ'gєәriәn
Hungary => 'hʌŋgәri
hunger => 'hʌŋgә
hunger strike => ˈhʌŋɡə straik
hungers => ˈhʌŋɡəz
hungover => 'hʌŋ'әjvә(r)
hungrily => 'hʌŋɡrəlɪ
hungriness => 'hʌŋgrinis
hungry => 'hʌŋgi
hunk => hʌŋk
hunker => 'hʌŋkә
hunkered => ˈhʌŋkəd
hunkering => 'hʌŋkərɪŋ
hunkers => 'hʌŋkәs
hunks => hʌŋks
hunky => 'hʌŋki
hunky-dory => .hʌŋki'dɒ:ri
Hunnish => 'hʌniʃ
hunt => hʌnt
huntaway => 'hʌntә,wei
hunted => 'hʌntid
hunter => 'hʌntә
hunter-gatherer => ˈhʌntə ˈɡæðərə(r)
hunter-killer => 'hʌntərk'ɪlər
hunting => 'hʌntiŋ
hunting crop => ˈhʌntɪŋ krɔp
hunting dog => ˈhʌntɪŋ dɔɡ
hunting ground => ˈhʌntɪŋ ɡraund
hunting horn => ˈhʌntɪŋ hɔ:n
Huntingdon => 'hʌntiŋdən
Huntingdonshire => 'hʌntiŋdәnʃiә
huntington => 'hʌntiŋtәn
huntress => 'hʌntris
hunts => hʌnts
huntsman => 'hʌntsmәn
Hupeh => 'hu:'pei
hurdle => 'hә:dl
hurdler => 'hә:dlә
hurdles => ˈhə:dlz
hurdling => 'hә:dliŋ
hurdy-gurdy => 'hә:di'^ә:di
hurl => hә:l
hurled => hə:ld
hurler => 'hә:lә
hurley => 'hә:li
hurling => 'hә:liŋ
Hurlingham => 'hә:liŋәm
hurls => hə:lz
hurly-burly => 'hә:li'bә:li
Huron => 'hjurәn
hurons => ˈhjuərənz
hurrah => hu'rɑ:
hurrahed => hʊˈrɑ:d
hurrahing => hʊˈrɑ:ɪŋ
hurrahs => hʊ'rɑː
hurray => hj'rei
Hurrian => 'huəriən
hurricane => 'hә:rikәn
hurricane deck => ˈhʌrikən dek
hurricane lamp => ˈhʌrikən læmp
hurricanes => 'hʌrɪkənz
hurried => 'hʌrid
hurriedness => ˊhʌridnis
hurry => 'hʌri
hurry-up => 'hʌri'ʌp
hurrying => ˈhʌriŋ
hurst => hә:st
hurt => hә:t
hurtful => 'hә:tful
hurtfully => ˊhәːtfuli
hurtfulness => ˊhәːtfulnis
hurting => hə:tɪŋ
hurtle => 'hә:tl
hurtled => ˈhɜ:tld
hurtles => ˈhɜ:tlz
Husayn => hu'sain
husband => 'hʌzbәnd
husbandman => 'hʌzbәnmәn
husbandmen => 'hʌzbəndmən
husbandry => 'hʌzbәndri
hush => hʌʃ
hush-hush => 'hʌʃ'hʌʃ
hushaby => 'hʌʃәbai
hushed => hʌʃt
hushes => hʌʃiz
husk => hʌsk
husked => hʌsk
huskily => 'hʌskili
huskiness => 'hʌskinis
husking => 'hʌskiŋ
husks => hʌsks
husky => 'hʌski
huss => hʌs
hussar => hu'zɑ:
hussies => ˈhʌsiz
Hussite => 'hʌsait
Hussitism => 'hʌsaitizәm
hussy => 'hʌsi
hustings => 'hʌstiŋz
hustle => 'hʌsl
hustler => 'hʌslә
hustlers => ˈhʌsləz
hustles => ˈhʌslz
hut => hʌt
hutch => hʌtʃ
hutched => hʌtʃ
hutches => hʌtʃiz
hutching => hʌtʃ
hutia => hu:'tiә
hutment => 'hʌtmәnt
hutong => 'hʌtɒŋ
huts => hʌts
Hutt => hʌt
Hutterite => 'hʌtәrait
Huxley => 'hʌksli
huzza => hu'zɑ:
huzzaing => hu'za:
hwyl => 'hu:il
hyacinth => 'haiәsinθ
hyacinthine => haiә'sinθain
hyacinths => ˈhaiəsinθs
Hyacinthus => ,haiә'sinθәs
hyaena => hai'i:nә
hyalin => 'haiәlin
hyaline => 'haiәlin
hyaline membrane disease => ˈhaiəli:n ˈmemˌbreɪn diˈzi:z
hyalite => 'haiәlait
hyaloid => 'haiәlɒid
hyaloid membrane => ˈhaiəlɔid ˈmemˌbreɪn
hyaluronate => haiә'lurә,neit
hybrid => 'haibrid
hybridisation => ,haibridai'zeiʃәn; -di'z-
hybridise => 'haibridaiz
hybridism => 'haibridizәm
hybridity => hai'briditi
hybridizable => 'haibri,daizәbl
hybridization => .haibridai'zeiʃәn
hybridize => 'haibridaiz
hybridized => ˈhaibridaizd
hybridizes => ˈhaibridaiziz
hybridizing => ˈhaibridaizɪŋ
hybrids => ˈhaibridz
hydantoin => hai'dæntәwin
hydathode => 'haidәθәud
hydatid => 'haidәtid
hyde => haid
hydel => hai'del
HYDERABAD => 'haidәrәbɑ:d
hydra => 'haidrә
hydrangea => hai'dreindʒә
hydrangeas => haɪdreɪnd'ʒəz
hydrant => 'haidrәnt
hydrants => ˈhaɪdrənts
hydratable => haidrә'tæbl
hydrate => 'haidreit
hydrated => 'haidreitid
hydrates => ˈhaɪˌdreɪts
hydration => hai'dreiʃәn
hydrator => 'hai,dreitә
hydraulic => hai'drɒ:lik
hydraulics => hai'drɒ:liks
hydrazine => 'haidrәzi:n
hydria => 'haidriә
hydric => 'haidrik
hydride => 'haidraid
hydrilla => hai'drilә
hydro => 'haidrәu
hydro- => 'haidrәj
hydrocarbon => .haidrәu'kɑ:bәn
hydrocarbons => haɪdrə'kɑ:bənz
hydrocele => 'haidrә,si:l
hydrocephalic => ,haidrәjse'fælik
hydrocephalus => ,haidrәu'sefәlәs
hydrochloric => .haidrәu'klɔrik
hydrochloride => ,haidrәu'klɔ:raid
hydrochlorofluorocarbon => ˌhaɪdrəʊklɒrəʊˈflʊərəkɑ:bən
hydrocolloid => .haidrәu'kɒlɒid
hydrocortisone => .haidrәu'kɒ:tizәn
hydrodynamic => .haidrәudai'næmik
hydrodynamical => haɪdrəʊdaɪ'næmɪkəl
hydrodynamicist => ,haidrәjdai'næmisist
hydrodynamics => 'haidrәudai'næmiks
hydroelectric => .haidrәui'lektrik
hydroelectricity => 'haidrәji,lek'trisәti
hydrofoil => 'haidrәu,fɔil
hydrofoils => ˈhaɪdrəˌfɔɪlz
hydrofracturing => ,haidrәj'fræktʃәriŋ
hydrogel => 'haidrәdʒel
hydrogen => 'haidrәdʒәn
hydrogenase => 'haidrәdʒineis
hydrogenate => hai'drɔdʒineit
hydrogenated => haɪˈdrɒdʒəneɪtɪd
hydrogenating => haiˈdrɔdʒineitɪŋ
hydrogenation => ,haidrәdʒә'neiʃәn
hydrogenous => hai'drɒdʒәnәs
hydrogeologist => haɪdrəʊdʒ'ɪɒlədʒɪst
hydrogeology => ,haidrәudʒi'ɔlәdʒi
hydrographer => hai'drɒgrәfә
hydrographic => .haidrә'græfik
hydrographical => haɪdrəʊɡ'ræfɪkəl
hydrography => hai'drɒgrәfi
hydroid => 'haidrɒid
hydrolase => 'haidrәleis
hydrological => .haidrә'lɒdʒikl
hydrologist => hai'drɒlәdʒist
hydrology => hai'drɒlәdʒi
hydrolysate => hai'drɔliseit, -zeit
hydrolyse => 'haidrәlaiz
hydrolysis => hai'drɔlisis
hydrolytic => ,haidrә'litik
hydrolyze => 'haidrәlaiz
hydrolyzed => ˈhaidrəlaizd
hydromagnetic => ,haidrә,mæ^'netik
hydromagnetics => ,haidrәumæ^'netiks
hydromassage => ,haidrәmæ'sɑ:ʒ
hydromechanical => ,haidrәumi'kænikl
hydromechanics => .haidrәmә'kæniks
hydromedusa => ,haidrәumi'dju:sә, -'du:-; -zә
hydromel => 'haidrәmәl
hydrometeor => ,haidrәu'mi:tiә
hydrometer => hai'drɒmitә
hydrometric => ,haidrәj'metrik
hydrometry => hai'drɒmitri
hydronic => hai'drɔnik
hydropathic => .haidrә'pæθik
hydropathist => hai'drɔpәθist
hydropathy => hai'drɒpәθi
hydrophilic => ,haidrәu'filik
hydrophilicity => -'lisiti
hydrophilous => hai'drɔfilәs
hydrophobia => .haidrә'fәubiә
hydrophobic => .haidrә'fәubik
hydrophone => 'haidrәfәun
hydrophyte => 'haidrәfait
hydrophytic => 'haidrәu'fitik
hydroplane => 'haidrәplein
hydroplaned => 'haɪdrəpleɪn
hydroplanes => ˈhaidrəupleinz
hydroplaning => 'haidrә,pleiniŋ
hydroponic => .haidrә'pɒnik
hydroponics => 'haidrәu'pɔniks
hydropower => 'haidrәupauә
hydrops => 'haidrɔps
hydroquinone => .haidrәkwi'nәun
hydrosphere => 'haidrәsfiә
hydrostatic => ,haidrәu'stætik
hydrostatical => ,haidrәu'stætikәl
hydrostatics => .haidrә'stætiks
hydrosulphite => haɪdrəʊ'sʌlfaɪt
hydrotherapy => .haidrәu'θerәpi
hydrothermal => 'haidrәu'θә:mәl
hydrothermally => haɪdrəʊ'θɜ:məlɪ
hydrothorax => ,haidrәu'θɔ:ræks
hydrotropism => hai'drɒtrәpizm
hydrous => 'haidrәs
hydroxide => hai'drɔksaid, -sid
hydroxonium ion => ,hai'drәksәniәm 'aiәn
hydroxyapatite => hai,drɔksi'æpәtait
hydroxyl => hai'drɒksi
hydroxylate => hai'drɔksileit
hydroxylation => hai,drɔksi'leiʃәn
hydrozoan => .haidrә'zәuәn
hyena => hai'i:nә
hyenas => haɪˈi:nəz
hygiene => 'haidʒi:n
hygienic => hai'dʒi:nik
hygienically => haɪ'dʒi:nɪklɪ
hygienics => .haidʒi'eniks
hygienist => 'haidʒi:nist
hygrometer => hai'grɒmitә
hygrometric => ,hai^rәu'metrik
hygrometry => hai'grɒmitri
hygrophilous => ,hai^rә'filәs
hygrophyte => 'hai^rәfait
hygroscope => 'haigrәskәup
hygroscopic => .haigrә'skɒpik
hying => 'haiiŋ
Hyksos => 'hiksɔs
hyla => 'hailә
hylomorphic => ,hailә'mɔ:fik
hylomorphism => ,hailә'mɔ:fizәm
hylozoism => .hailә'zәuizm
hyman => 'haimәn
hymen => 'haimen
hymeneal => .haimә'ni:әl
hymenium => hai'mi:niәm
Hymenoptera => ,haimi'nɔptәrә
hymenopteran => ,haimi'nɔptәrәn
hymenopterous => .haimә'nɒptәrәs
hymens => ˈhaimenz
hymn => him
hymnal => 'himnәl
hymnals => ˈhimnəlz
hymnary => 'himnәri
hymnbook => 'himbuk
hymned => hɪm
hymning => hɪm
hymnodist => 'himnәdist
hymnody => 'himnәdi
hymnographer => him'nɔ^rәfә
hymnography => him'nɔ^rәfi
hymnologist => him'nɒlәdʒist
hymnology => him'nɒlәdʒi
hymns => himz
hyoid => 'haiɒid
hyoscine => 'haiәsi:n
hyoscyamine => ,haiә'saiәmi:n, -min
hyp => hip
hypaesthesia => ,hipis'θi:ziә,-ʒә
hypaethral => hi'pi:θrәl, hai-
hypallage => hai'pælә^i:
hypanthium => hi'pænθiәm, hai-
hype => haip
hyper => 'haipә
hyper- => 'haipә(r)
hyperactive => ,haipә(:)'ræktiv
hyperacusis => ,haipәrә'kju: sis
hyperaemia => .haipә'ri:miә
hyperaesthesia => .haipәrәes'θi:ʒә
hyperalgesia => ,haipәræl'dʒi:ziә
hyperalgesic => -zik
hyperalimentation => ,haipәrәlimen'teiʃәn
hyperbaric => .haipә'bærik
hyperbaton => hai'pә:bәtɔn
hyperbola => hai'pә:bәlә
hyperbolas => haiˈpə:bələz
hyperbole => hai'pә:bәli
hyperbolic => ,haipә:'bɔlik
hyperbolism => hai'pә:bәlizәm
hyperboloid => hai'pә:bәlɔid
hyperborean => .haipә'bɒ:riәn
hypercalcemia => ,haipә,kæl'si:miә
hypercalciuria => haɪpə'kælsɪərɪə
hypercapnia => ,haipә(:)'kæpniә
hypercholesterolaemia => 'haipәkә,lestәrәj'li:miә
hypercholesterolemia => ,haipә(:)kә,lestәrәu'li:mjә
hypercorrect => ,haipәkә'rekt
hypercorrection => -'rekʃәn
hypercritical => .haipә'kritikәl
hypercube => 'haipә,kju:b
hyperdrive => 'haipədraiv
hyperemia => ,haipә(:)'ri(:)miә
hyperesthesia => .haipәres'θi:ziә
hyperextend => ,haipərik'stend
hyperextension => ,haipә,reks'tenʃәn
hyperfine => 'haipә'fain
hyperglycaemia => ˌhaɪpəglaɪˈsi:miə
hypergolic => ,haipә(:)'^ɔlik, -'^ɔl-
hyperinflation => ,haipәrin'fleiʃәn
Hyperion => hai'piriәn
hyperkeratosis => ,haipә(:),kerә'tәusis
hyperkinesis => ,haipәkai'ni:sis
hyperkinetic => ,haipәkai'netik
hyperlipaemia => ,haipәli'pi:miә
hypermarket => .haipә'mɑ:kit
hypermarkets => 'haɪpəmɑ:kɪts
hypermedia => 'haipәmi:diә
hypermetropia => .haipәmi'trәupiә
hypermetropic => .haipәmi'trɒpik
hypermnesia => ,haipәm'ni:ziә
hypernym => ˈhaɪpənɪm
hyperon => 'haipәrɒn
hyperopia => ,haipә(:)'rәupiә
hyperopic => -'rɔpik
hyperparasite => ,haipә(:)'pærә,sait
hyperparasitic => 'haipә,pærә'sitik
hyperparasitism => haipә'pærә,saitizәm
hyperparathyroidism => ,haipә,pærә'θairɔidizәm
hyperplasia => ,haipә(:)'pleiʒiә
hyperrealism => ,haipә'riәlizәm
hypersensitive => .haipә'sensitiv
hypersensitiveness => ,haipә'sensitivnis
hypersensitivity => ,haipәsensi'tiviti
hypersonic => .haipә'sɒnik
hyperspace => 'haipә(:)'speis
hyperspatial => ,haipә'speiʃәl
hypersthene => 'haipә:sθi:n
hypertension => .haipә'tenʃәn
hypertensive => .haipә'tensiv
hyperthermia => ,haipә(:)'θә:mjә
hyperthyroid => ,haipә(:)'θairɔid
hyperthyroidism => .haipә'θairɒidizm
hypertonia => ,haipә'tәuniә
hypertonic => ,haipә(:)'tɔnik
hypertrophied => haiˈpə:trəfid
hypertrophies => haiˈpə:trəfiz
hypertrophy => hai'pә:trәfi
hypertrophying => haiˈpə:trəfiŋ
hyperventilate => ˌhaɪpəˈventɪleɪt
hyperventilation => ,haipә(:)venti'leiʃәn
hypesthesia => ,hipis'θi:zjә
hypethral => hi'pi:θrәl
hypha => 'haifә
hyphal => 'haifәl
hyphen => 'haifәn
hyphenate => 'haifәneit
hyphenated => 'haifәneitid
hyphenation => ,haifә'neiʃәn
hyphened => 'haɪf(ə)n
hyphens => ˈhaifənz
hypnagogic => ,hipnәu'^ɔdʒik
hypno => hɪp'nəʊ
hypnopaedia => ,hipnә'pi:diә
hypnopompic => ,hipnәu'pɔmpik
Hypnos => 'hipnɔs
hypnosis => hip'nәusis
hypnotherapist => hɪpnəʊ'θerəpɪst
hypnotherapy => .hipnә'θerәpi
hypnotic => hip'nɒtik
hypnotically => hɪp'nɒtɪklɪ
hypnotise => 'hipnәtaiz
hypnotism => 'hipnәtizm
hypnotist => 'hipnәtist
hypnotizable => hipnә'taizәbl
hypnotize => 'hipnәtaiz
hypnotized => ˈhɪpnəˌtaɪzd
hypnotizes => ˈhɪpnəˌtaɪziz
hypnotizing => ˈhɪpnəˌtaɪzɪŋ
hypo => 'haipәu
hypo- => 'haipәj
hypoallergenic => ,hipәuælә'dʒenik
hypoblast => 'haipәublɑ:st
hypocalcaemia => haɪpəkæl'ki:mɪə
hypocalcemia => ,haipәukæl'si:miә
hypocaust => 'haipәkɒ:st
hypochlorite => .haipә'klәurit
hypochondria => haipә'kɔndriә
hypochondriac => ,haipәu'kɔndriæk
hypochondriacal => ,haipәukɔn'draiәkәl
hypochondriacs => ˌhaɪpəˈkɔndri:ˌæks
hypochondriasis => ,haipәjkɔn'draiәsis
hypocorism => hai'pɔkәrizәm
hypocoristic => .haipәkә'ristik
hypocotyl => .haipә'kɒtil
hypocrisies => hiˈpɔkrəsiz
hypocrisy => hi'pɒkrәsi
hypocrite => 'hipәkrit
hypocrites => ˈhɪpəˌkrɪts
hypocritical => .hipә'kritikl
hypocritically => ˌhɪpə'krɪtɪklɪ
hypocycloid => ,haipәu'saiklɔid
hypodermic => .haipә'dә:mik
hypodermically => .haipә'dә:mikәli
hypodermics => haɪpə'dɜ:mɪks
hypogastric => .haipә'gæstrik
hypogastrium => 'haipәu'^æstriәm
hypogeal => ,haipәu'dʒi:әl
hypogene => 'haipәdʒi:n
hypogenic => ,haipәu'dʒenik
hypogeum => ,haipәu'dʒi:әm
hypoglossal => ,haipәu'^lɔsl
hypoglossal nerve => ˌhaipəuˈɡlɔsl nə:v
hypoglycaemia => ˌhaɪpəʊglaɪˈsi:miə
hypoglycaemic => 'haɪpəʊɡlaɪki:mɪk
hypoglycemia => ,haipәu^lai'si:miә
hypogonadal => ,haipәu'^ɔnædәl
hypogonadism => ,haipәu'^ɔnæ,dizәm
hypogynous => hai'pɔdʒinәs
hypogyny => hai'pɔdʒәni
hypoid => 'hai,pɔid
hypokalaemia => ˌhaipəkəˈli:miə
hypolimnion => ,haipәu'limniɔn
hypomagnesaemia => 'haipәu,mæ^ni:'si:miә
hypomania => ,haipәu'meiniә
hypomanic => -'mænik
hyponym => ˈhaɪpənɪm
hyponymy => hai'pɔnimi
hypoparathyroidism => ,haipәpærә'θairɔidizm
hypopharyngeal => ,haipәu,færin'dʒi:әl
hypophyseal => hai'pɔfә,si:l
hypophysis => hai'pɒfisis
hypopituitarism => ,haipәupi'tju(:)itәrizm
hypoplasia => ,haipәu'pleizjә
hypospadias => ,haipә'speidiәs
hypospray => 'haipәjsprei
hypostasis => hai'pɒstәsis
hypostasize => hai'pɔstәsaiz
hypostatic => .haipә'stætik
hypostatical => ,haipə'stætikəl
hypostatize => hai'pɔstәtaiz
hypostatized => haɪ'pɒstətaɪz
hypostatizes => haɪ'pɒstətaɪz
hypostatizing => haɪ'pɒstətaɪz
hypostyle => 'haipәustail
hypotactic => ,haipәu'tæktik
hypotaxis => .haipә'tæksis
hypotension => .haipәu'tenʃәn
hypotensive => ,haipәu'tensiv
hypotenuse => hai'pɒtnju:s
hypothalamic => ,haipәjθә'læmik
hypothalamus => .haipә'θælәmәs
hypothec => hai'pɒθik
hypothecary => hai'pɔθikәri
hypothecate => hai'pɒθikeit
hypothecated => haiˈpɔθikeitid
hypothecating => haiˈpɔθikeitɪŋ
hypothecation => hai.pɒθi'keiʃәn
hypothermia => .haipә'θә:miә
hypothesis => hai'pɒθәsis
hypothesise => haɪ'pɒθɪsaɪz
hypothesize => hai'pɔθisaiz
hypothesized => haiˈpɔθisaizd
hypothesizes => haiˈpɔθisaiziz
hypothesizing => haiˈpɔθisaizɪŋ
hypothetical => ,haipәu'θetikәl
hypothetical imperative => ˌhaɪpəˈθɛtɪkəl ɪmˈpɛrətɪv
hypothetically => ˌhaɪpə'θetɪklɪ
hypothetico-deductive => ,haipəu'θetikəudi'dʌktiv
hypothyroid => 'haipәu'θairɔid
hypothyroidism => haipәj'θairɔidiz(ә)m
hypotonia => ,haipә'tәuniә
hypotonic => ,haipәu'tɔnik
hypotonicity => ,haipәjtә'nisәti
hypoventilation => ,haipәu,venti'leiʃәn
hypovolaemia => haɪpɒvə'li:mɪə
hypoxaemia => ,haipɔk'si:miә
hypoxanthine => ,haipәu'zænθi:n, -θin
hypoxia => hai'pɔksiә
hypoxic => haɪ'pɒksɪk
hypsographic => ,hipsә'^ræfik
hypsography => hip'sɔ^rәfi
hypsometer => hip'sɒmitә
hypsometric => ,hipsә'metrik
hyracoid => 'hairәkɔid
hyrax => 'hairæks
hyson => 'haisәn
hyssop => 'hisәp
hysterectomies => ˌhɪstəˈrektəmi:z
hysterectomize => ,histә'rektәmaiz
hysterectomy => .histә'rektәmi
hysteresis => .histә'ri:sis
hysteria => his'tiәriә
hysteric => his'terik
hysterical => his'terikәl
hysterically => hɪ'sterɪklɪ
hysterics => hi'steriks
hysteron proteron => 'histәrɔn'prɔtәrɔn
hystricomorph => hi'straikәjmɔ:f
Hythe => haiθ