W => 'dʌb(ә)lju:
Waadt => wɑ:t
Waal => wɑ:l
waals => wɔ:lz
wack => wæk
wacke => 'wækә
wackier => ˈwæki:ə
wacko => 'wækәj
wacky => 'wæki
waco => 'weikәj
wad => wɒd
wadable => 'weidәbl
wadcutter => 'wɔdkʌtә
wadding => 'wɒdiŋ
waddle => 'wɔdl
waddled => ˈwɔdld
waddles => ˈwɔdlz
waddling => ˈwɔdlɪŋ
waddy => 'wɒdi
wade => weid
waded => weidid
wader => 'weidә
waders => 'weɪdəz
wades => weidz
wadi => 'wɒdi
wading => 'weidiŋ
wading bird => 'wɔdiŋ
wadis => 'wɒdɪz
wads => wɔdz
wafer => 'weifә
wafer-thin => ˈweɪfə θin
wafers => ˈweɪfəz
wafery => 'weifәri
waffle => 'wɒfl
waffle iron => ˈwɔfəl ˈaiən
waffled => ˈwɔfəld
waffles => ˈwɔfəlz
waffling => ˈwɔfəlɪŋ
waft => wɑ:ft
wafted => wɑ:ftid
wafting => wɑ:ftɪŋ
wafts => wɑ:fts
wag => wæg
wage => weidʒ
wage-earner => 'weɪdʒ'ɜ:nər
wager => 'weidʒә
wagered => ˈweɪdʒəd
wagering => ˈweɪdʒərɪŋ
wagers => ˈweɪdʒəz
wagged => wæɡd
waggery => 'wægәri
waggish => 'wægiʃ
waggishly => 'wæɡiʃ
waggle => 'wægl
waggled => ˈwægəld
waggles => ˈwægəlz
waggling => 'wæɡlɪŋ
waggly => 'wæ^li
waging => weidʒɪŋ
wagner => 'wæ^nә
Wagnerian => vɑ:^'niәriәn
wagon => 'wægәn
wagon-lit => vægɔ:n'li:
wagoner => 'wægәnә
wagonette => wæ^ә'net
wagonload => ˈwægənləʊd
wagons => ˈwæɡənz
wags => 'wæɡz
wagtail => 'wægteil
wagtails => ˈwæɡteilz
wah-wah => ˈwɑ: wɑ:
Wahhabi => wә'hɑ:bi, wɑ:-
Wahhabism => wә'hɑ:bizәm, wɑ:-
wahine => wɑ:'hi:nei
wahoo => wɑ:'hu:; 'wɑ:hu:
waif => weif
waifs => 'weɪfs
wail => weil
wailed => weild
wailer => 'weɪlər
wailful => 'weilful
wailing => weilɪŋ
wails => weilz
wain => wein
wainscot => 'weinskәt
wainscoting => 'weinskәtiŋ
wainscots => ˈweɪnskəts
wainwright => 'weinrait
waist => weist
waistband => 'weistbænd
waistbands => ˈweistbændz
waistcoat => 'weistkәut
waistcoats => ˈweskɪts
waistline => 'weistlain
waistlines => ˈweɪstˌlaɪnz
waists => weists
wait => weit
wait-a-bit => 'weitә,bit
waited => weitid
waiter => 'weitә
waiters => ˈweitəz
waiting => 'weitiŋ
waitperson => ˈweɪtpɜ:sn
waitress => 'weitris
waitresses => ˈweɪtrɪsiz
waitron => 'weɪtrɒn
waits => weits
waive => weiv
waived => weɪvd
waiver => 'weivә
waivers => ˈweɪvəz
waives => weɪvz
waka => 'wɑ:kə
Wakashan => wɑ:'kæʃәn, 'wɔ:kәʃɑ:n
wake => weik
wake-robin => 'weik,rɔbin
wake-up call => weik ʌp kɔ:l
wakeboard => 'weikbɔ:d
wakeboarding => ˈweɪkbɔ:dɪŋ
wakefield => 'weikfi:ld
wakeful => 'weikful
wakefully => ˊweikfuli
waken => 'weikn
wakened => ˈweikənd
wakening => ˈweikənɪŋ
wakens => ˈweikənz
wakes => weiks
Waksman => 'wæksmәn
Walachia => wɑ'leikiә
Waldenses => wɔl'densi:z
Waldensian => -siәn
waldo => 'wɔ:ldәu
Waldorf => 'wɔ:ldɔ:f
wale => weil
Waler => 'weilә
Wales => weilz
wali => 'wɑ:li:
walk => wɒ:k
walk away => wɔ:k əˈwei
walk it => wɔ:k it
walk of life => wɔ:k ɔv laif
walk over => wɔ:k ˈəuvə
walk-in => 'wɔ:k,in
walk-on => 'wɔ:kɔn
walk-through => 'wɔ:kθru:
walk-up => 'wɔ:kʌp
walkable => 'wɒ:kәbl
walkabout => 'wɔ:kәbajt
walkabouts => ˈwɔ:kəbauts
walkathon => 'wɔ:kәθɔn
walkaway => 'wɒ:kә.wei
walker => 'wɒ:kә
walkie-talkie => 'wɔ:ki'tɔ:ki
walkies => ˈwɔ:kiz
walking => 'wɒ:kiŋ
walking fern => ˈwɔ:kɪŋ fɜ:n
walking leaf => ˈwɔ:kɪŋ li:f
walkout => 'wɒ:kaut
walkouts => ˈwɔ:kˌaʊts
walkover => 'wɔ:k'әuvә
walkovers => ˈwɔ:kˈəuvəz
walkway => 'wɒ:kwei
walkways => ˈwɔ:kˌweɪz
wall => wɒ:l
wall hanging => wɔ:l ˈhæŋɪŋ
wall rock => wɔ:l rɔk
wall rue => wɔ:l ru:
wall unit => wɔ:l ˈju:nit
wall-eyed => 'wɔ:l'aɪd
wall-less => 'wɔ:llis
wall-mounted => wɔ:l ˈmaʊntɪd
walla => 'wɔlә
wallabies => ˈwɔləbi:z
wallaby => 'wɒlәbi
wallace => 'wɔlis
Wallachia => wɔ'leikiә
wallah => 'wɑ:lә
wallaroo => .wɒlә'ru:
Wallasey => 'wɔlәsi
wallboard => 'wɒ:lbɒ:d
wallcovering => 'wɔ:l,kʌvәriŋ
walled => wɔ:ld
waller => 'wɔlә
wallet => 'wɒlit
wallets => ˈwɔlits
walleye => 'wɔ:lai
wallflower => 'wɔ:lflajә(r)
wallflowers => ˈwɔ:lflauəz
wallies => ˈwɔliz
walling => 'wɔ:liŋ
Wallingford => 'wɔliŋfəd
wallis => 'wɔlis
walloon => wɔ'lu:n
walloons => wɔ'lu:n
wallop => 'wɒlәp
walloped => ˈwɔləpt
walloping => 'wɔlәpiŋ
wallops => ˈwɔləps
wallow => 'wɒlәu
wallowed => ˈwɔləʊd
wallower => 'wɔləuə
wallows => ˈwɔləʊz
wallpaper => 'wɒ:lpeipә
wallpapered => ˈwɔ:lˌpeɪpəd
wallpapering => ˈwɔ:lˌpeɪpərɪŋ
wallpapers => ˈwɔ:lˌpeɪpəz
Wallsend => 'wɔ:lzend
wallwasher => 'wɔ:l,wɔʃә(r), -,wɔ:ʃә(r)
wally => 'weili
Walmsley => 'wɔ:mzli
walnut => 'wɒ:lnәt
walnuts => 'wɔ:lnʌts
walpole => 'wɔ:lpәul
Walpurgisnacht => væl'pjә^isnɑ:kt, vɑ:l-
walrus => 'wɒ:lrәs
walrus moustache => ˈwɔ:lrəs məsˈtɑ:ʃ
Walsall => 'wɔ:lsɔ:l
walsh => wɔ:lʃ
Walt => wɔ:lt
Walter => 'wɔ:ltә(r)
Walter Mitty => ˌwɔ:ltə(r) 'mɪti
waltham => 'wɔ:lθәm
walton => 'wɔ:ltәn
waltz => wɒ:lts
waltzed => wɔ:ltst
waltzer => 'wɔ:lsə
waltzes => wɔ:ltsiz
waltzing => wɔ:ltsɪŋ
Wampanoag => ,wɔmpә'nәjæ^
wampum => 'wɔmpәm
wan => wɒn
wananchi => wɑ:'næntʃi
wand => wɒnd
WANDA => 'wɔndә
wander => 'wɒndә
wandered => ˈwɔndəd
wanderer => 'wɒndәrә
wanderers => ˈwɔndərəz
wandering => 'wɒndәriŋ
wandering albatross => ˈwɔndɵrɪŋ ˈælbətrɔs
wanderings => ˈwɒndərɪŋz
Wanderjahr => 'vɑ:ndәjɑ:
wanderlust => 'wɒndәlʌst
wanderoo => .wɒndә'ru:
wanders => ˈwɔndəz
wands => wɔndz
wane => wein
waned => weɪnd
wanes => weɪnz
waney => 'weini
Wanganui => ,wɔŋə'nui; -'nu:i
wangle => 'wæŋgl
wangled => ˈwæŋgəld
wangler => 'wæŋɡlər
wangles => ˈwæŋgəlz
wangling => ˈwæŋgəlɪŋ
waning => 'weiniŋ
wank => wæŋk
wanked => wæŋkt
wanker => ˈwæŋkə(r)
wankers => ˈwæŋkəz
wanking => 'wæŋkiŋ
wanks => wæŋks
wanna => 'wɔnә
wannabe => ˈwɒnəbi
wannabes => ˈwɔnəˌbi:z
wanned => 'wɒned
wanness => wɒn'nəs
wanning => 'wɒnɪŋ
wans => 'wænz
want => wɒnt
wantage => 'wɔntidʒ
wanted => 'wɔntid. 'wɔ:n-
wanting => 'wɒntiŋ
wanton => 'wɒntәn
wantoned => ˈwɔntənd
wantoning => ˈwɔntənɪŋ
wantons => ˈwɔntənz
WAP => wɔp
wapentake => 'wɒpәnteik
wapiti => 'wɒpiti
war => wɒ:
war dance => wɔ: dɑ:ns
war widow => wɔ: ˈwidəu
war-torn => wɔ: tɔ:n
waratah => 'wɔrәtә, -tɑ:
warbird => 'wɔ:bә:d
warble => 'wɒ:bl
warbled => 'wɔ:bld
warbler => 'wɒ:blә
warblers => ˈwɔ:bləz
warbles => ˈwɔ:blz
warbling => ˈwɔ:blɪŋ
Warburg => 'wɔ:bә:^
ward => wɒ:d
ward heeler => wɔ:d ˈhi:lə
warded => 'wɔ:did
warden => 'wɒ:dn
wardens => 'wɔ:dnz
wardenship => 'wɔ:dәnʃip
warder => 'wɒ:dә
warders => ˈwɔ:dəz
wardress => 'wɒ:dris
wardrobe => 'wɒ:drәub
wardrobe malfunction => ˈwɔ:drəub mælˈfʌŋkʃən
wardrobe mistress => ˈwɔ:drəub ˈmistris
wardrobes => ˈwɔ:drəubz
wardroom => 'wɒ:dru:m
wardship => 'wɒ:dʃip
ware => wєә
warehouse => 'wєәhaus
warehoused => 'weəhaʊs
warehouseman => 'weәhajsmәn
warehouses => ˈwɛəhausiz
warehousing => 'weәhauziŋ
warfare => 'wɒ:fєә
warfarin => 'wɔ:fәrin
warhead => 'wɒ:hed
warheads => 'wɔ:hedz
warhorse => ˈwɔ:hɔ:s
warier => ˈwɛəriə
warily => 'wєәrili
wariness => 'wєәrinis
Wark => wɑ:k
warlike => 'wɒ:laik
warlock => 'wɔ:lɔk
warlord => 'wɒ:lɒ:d
warlords => ˈwɔ:lɔ:dz
warm => wɒ:m
warm down => wɔ:m daun
warm front => wɔ:m frʌnt
warm-blooded => wɔ:m'blʌdid
warm-down => wɔ:m daun
warmed => wɔ:md
warmed-up => 'wɔ:mdʌp
warmer => 'wɒ:mә
warming => 'wɔ:miŋ
warming pan => 'wɔ:miŋ
warmish => 'wɒ:miʃ
warmly => 'wɒ:mli
warmness => 'wɔ:mnis
warmonger => 'wɒ:.mʌŋgә
warmongers => ˈwɔ:ˌmʌŋgəz
warms => wɔ:mz
warmth => wɒ:mθ
warn => wɒ:n
warner => 'wɔ:nә
warning => 'wɒ:niŋ
warning coloration => ˈwɔ:nɪŋ kʌləˈreiʃən
warns => wɔ:nz
warp => wɒ:p
warp speed => wɔ:p spi:d
warpage => 'wɔ:peidʒ
warpath => 'wɔ:pɑ:θ
warped => wɔ:pt
warper => 'wɔ:pә
warping => 'wɔ:piŋ
warplane => 'wɒ:plein
warps => wɔ:ps
warragal => 'wɔriɡæl; -ɡəl; 'wɔ:-
warrant => 'wɒ:rәnt
warrant officer => ˈwɔrənt ˈɔfisə
warrantable => 'wɒ:rәntәbl
warrantee => .wɒ:rәn'ti:
warranter => 'wɒ:rәntә
warrantless => 'wɒrəntlɪs
warranty => 'wɒ:rәnti
warren => 'wɒrәn
warrener => 'wɒrənə
warrens => ˈwɔrinz
warrigal => 'wɔriɡæl
warring => 'wɔ:riŋ
Warrington => 'wɔ:riŋtn
warrior => 'wɒ:riә
warriors => 'wɒrɪəz
warsaw => 'wɔ:sɔ:
warship => 'wɒ:ʃip
warships => 'wɔ:ʃɪps
wart => wɒ:t
warthog => ˈwɔ:thɒg
warthogs => ˈwɔ:tˌhɔ:gz
wartime => 'wɒ:taim
Warton => 'wɔ:tn
warts => wɔ:ts
warty => 'wɒ:ti
warwick => 'wɔrik
Warwickshire => 'wɔrikʃiә
wary => 'wєәri
was => wɒz
wasabi => wəˈsɑ:bi
wash => wɒʃ
wash leather => wɔʃ ˈleðə
wash-and-wear => 'wɔʃәn'weә(r), 'wɔ:ʃ-
wash-hand basin => wɔʃ hænd ˈbeisn
wash-up => 'wɒʃ'ʌp
washable => 'wɔʃәbl
washbasin => 'wɒ:ʃ.beisәn
washbasins => ˈwɔʃˌbeɪsənz
washboard => 'wɒ:ʃbɒ:d
washbowl => 'wɔʃbәjl, 'wɔ:ʃ-
washcloth => 'wɒʃklɒθ
washday => 'wɔʃdei; (?@) 'wɔ:-
washdays => 'wɒʃdeɪ
washdown => 'wɔʃdajn, 'wɔ:ʃ-
washed => wɒʃd
washer => 'wɒʃә
washer-up => ˈwɔʃə ʌp
washerman => 'wɔʃәmәn, 'wɔ:ʃ-
washers => ˈwɔʃəz
washerwoman => 'wɔʃәwjmәn; (?@) 'wɔ:-
washery => 'wɔʃәri
washeteria => ,wɔʃә'tiәriә, ,wɔ:ʃ-
washiness => 'wɒʃinis
washing => 'wɒʃiŋ
washing day => ˈwɔʃɪŋ dei
washing line => ˈwɔʃɪŋ lain
washing powder => ˈwɔʃɪŋ ˈpaudə
washing-up liquid => ˈwɔʃɪŋ ʌp ˈlikwid
Washington => 'wɒʃiŋtn
Washingtonian => ,wɔʃiŋ'tәuniәn
washland => 'wɔʃlænd, 'wɔ:ʃ-
washout => 'wɒʃaut
washouts => ˈwɔʃauts
washrag => 'wɔʃræ^, 'wɔ:ʃ-
washroom => 'wɒʃrum
washrooms => ˈwɔʃˌru:mz
washstand => 'wɒʃstænd
washstands => ˈwɔʃstændz
washtub => 'wɒʃtæb
washy => 'wɒʃi
wasn't => 'wɔznt
wasp => wɒsp
wasp waist => wɔsp weist
waspie => 'wɔspi, 'wɔ:-
waspish => 'wɒspiʃ
waspy => 'wɒspi
wassail => 'wɒseil
wassailed => ˈwɔseild
wassailer => 'wɔseilә(r), -sәlә(r), 'wæ-
wassailing => ˈwɔseilɪŋ
wassails => ˈwɔseilz
wast => wɔst; wәst
wastage => 'weistidʒ
waste => weist
waste bin => weist bin
waste paper => weist ˈpeipə
waste pipe => 'weistpaip
waste-paper basket => west ˈpeɪpər ˈbæskɪt
wastebasket => 'weist.bæskit
wasted => 'weistid
wasteful => 'weistful
wastegate => 'weɪstɪɡət
wasteland => 'weistlænd
wastelands => 'weɪstlændz
wastepaper => 'weist.peipә
wastepaper basket => ˈweistˌpeipə ˈbɑ:skit
waster => 'weistә
wasters => 'weɪstə
wastewater => 'weistwɔ:tә
wasting => 'weistiŋ
wastrel => 'weistrәl
wat => wɑ:t. wɔt
watch => wɒtʃ
watch cap => wɔtʃ kæp
watch case => wɔtʃ keis
watchable => 'wɔtʃәbl, 'wɔ:-
watchband => 'wɒtʃbænd
watchdog => 'wɒtʃdɒg
watchdogs => ˈwɔtʃˌdɔ:gz
watcher => 'wɒtʃә
watchers => ˈwɔtʃəz
watchful => 'wɒtʃful
watchfully => 'wɒtʃfəlɪ
watching => 'wɔtʃiŋ
watchmaker => 'wɒtʃ.meikә
watchmaking => 'wɒtʃ.meikiŋ
watchman => 'wɒtʃmәn
watchmen => 'wɔtʃmən
watchstrap => 'wɒtʃstræp
watchtower => 'wɒtʃ.tauә
watchtowers => ˈwɔtʃˌtaʊəz
watchword => 'wɒtʃwә:d
watchwords => ˈwɔtʃˌwɜ:dz
water => 'wɒ:tә
water bag => ˈwɔ:tə bæɡ
water bear => ˈwɔ:tə bɛə
water beetle => ˈwɔ:tə ˈbi:tl
water biscuit => ˈwɔ:tə ˈbiskit
water bloom => ˈwɔ:tə blu:m
water bug => ˈwɔ:tə bʌɡ
water butt => ˈwɔ:tə bʌt
water cannon => ˈwɔ:tə ˈkænən
water clock => ˈwɔ:tə klɔk
water crowfoot => ˈwɔ:tə ˈkrəufut
water cycle => ˈwɔ:tə ˈsaikl
water deer => ˈwɔ:tə diə
water dropwort => ˈwɔ:tə ˈdrɔpwə:t
water feature => ˈwɔ:tə ˈfi:tʃə
water fountain => ˈwɔ:tə ˈfauntin
water garden => ˈwɔ:tə ˈɡɑ:dn
water gun => ˈwɔ:tə ɡʌn
water hyacinth => ˈwɔ:tə ˈhaiəsinθ
water ice => ˈwɔ:tə ais
water jump => ˈwɔ:tə dʒʌmp
water lettuce => ˈwɔ:tə ˈletis
water level => ˈwɔ:tə ˈlevl
water meadow => ˈwɔ:tə ˈmedəu
water nymph => ˈwɔ:tə nɪmf
water ouzel => ˈwɔ:tə ˈu:z(ə)l
water plantain => ˈwɔ:tə ˈplæntin
water polo => ˈwɔ:tə ˈpəʊləʊ
water rat => ˈwɔ:tə ræt
water softener => ˈwɔ:tə ˈsɔfnə
water sports => ˈwɔ:tə spɔ:ts
water violet => ˈwɔ:tə ˈvaiəlit
water vole => ˈwɔ:tə vəul
water witch => ˈwɔ:tə witʃ
water-based => 'wɔ:təbeist
water-repellent => 'wɔ:tәri,pelәnt, 'wɔ-
water-resistance => 'wɔ:tərrɪz'ɪstəns
water-resistant => 'wɔ:tәri,zistәnt, 'wɔ-
water-soluble => 'wɔ:tərsɒlj'ʊbl
waterbed => ˈwɔ:təbed
waterboarding => 'wɔ:təbɔ:dɪŋ
waterborne => 'wɒtәbɒ:n
waterbuck => 'wɔ:tәbʌk, 'wɔ-
watercolour => 'wɒtә.kælә
watercooler => wɔ:tə'ku:lər
watercourse => 'wɒtәkɒ:s
watercourses => ˈwɔ:təkɔ:siz
watercraft => 'wɒtәkrɑ:ft
watercress => 'wɔ:tәkres
watered => 'wɔ:tәd
watered silk => ˈwɔ:təd silk
watered-down => 'wɔ:tәd'dajn, 'wɔ-
waterfall => 'wɒtәfɒ:l
Waterford => 'wɔ:təfəd; 'wɔ-
waterfowl => 'wɒtәfәul
waterfowler => 'wɔːtə,faʊlə
waterfront => 'wɔ:tәfrʌnt
watergate => 'wɔ:tәɡeit. 'wɔ-
wateriness => 'wɒtәrinis
watering => 'wɔ:tәriŋ
watering can => ˈwɔ:tɵrɪŋ kæn
watering hole => ˈwɔ:tɵrɪŋ həul
waterleaf => 'wɔ:tәli:f, 'wɔ-
waterlily => ˈwɔt:təˌlɪlɪ
waterline => 'wɒtәlain
waterlog => 'wɒtәlɒg
waterlogged => 'wɒtәlɒgd
waterlogging => 'wɒtәlɒgiŋ
Waterloo => ,wɔ:tә'lu:
waterman => 'wɔ:tәmәn
watermark => 'wɒtәmɑ:k
watermarks => ˈwɔ:təmɑ:ks
watermelon => 'wɒtә.melәn
watermelons => ˈwɔ:təˌmelənz
watermill => ˈwɔ:təmɪl
watermills => ˈwɔ:təˌmilz
waterproof => 'wɒtәpru:f
waterproofed => ˈwɔ:təpru:ft
waterproofer => 'wɔ:təpru:fər
waterproofing => 'wɔ:tә.pru:fiŋ. 'wɔ-
waterproofness => 'wɔ:təpru:fnəs
waterproofs => ˈwɔ:təpru:fs
waters => 'wɔ:tәz
waterscape => 'wɔ:tәskeip
watershed => 'wɒtәʃed
watersheds => 'wɔ:təʃedz
waterspout => 'wɒtәspaut
waterspouts => 'wɔːtəspaʊt
Waterstone => 'wɔ:tәstәun
watertight => 'wɒtәtait
waterway => 'wɒtәwei
waterways => 'wɔ:təweɪz
waterweed => 'wɔ:tәwi:d, 'wɔ-
waterwheel => 'wɔ:tәwi:l
waterwheels => 'wɔ:təhwi:l, 'wɔ-
waterwings => 'wɔ:təwɪŋz
waterworks => 'wɒtәwә:ks
watery => 'wɒ:tәri
watkins => 'wɔtkinz
Watson => 'wɔtsn
watt => wɒt
wattage => 'wɒtidʒ
wattages => 'wɒtɪdʒ
Watteau => va'tәu; wɑ:'tәu
watter => 'wɔtә
wattle => 'wɒtl
wattle and daub => ˈwɔtl ænd dɔ:b
wattled => 'wɒtld
wattles => ˈwɔtlz
wattling => ˈwɔtlɪŋ
wattmeter => 'wɒtmitә
Watusi => wɑ:'tu:si
Waugh => wɔ:
waul => wɒ:l
wauled => wɔːl
wauling => wɔːl
wauls => wɔːl
wave => weiv
wave machine => weiv məˈʃi:n
waveband => ˈweɪvbænd
wavebands => ˈweɪvˌbændz
waveform => 'weivfɔ:m
wavefront => 'weivfrʌnt
waveguide => 'weiv^aid
wavelength => 'weivleŋθ
wavelengths => weɪvleŋsθ
waveless => 'weivlis
wavelet => 'weivlit
waver => 'weivә
wavered => ˈweivəd
waveringly => 'weivәriŋli
wavery => 'weɪvərɪ
waves => weivz
wavetable => ˈweɪvteɪbl
wavicle => 'weivikl
wavier => ˈweɪvi:ə
wavily => ˊweivili
waviness => 'weivinis
wavy => 'weivi
wax => wæks
wax bean => wæks bi:n
wax myrtle => wæks ˈmə:tl
wax palm => wæks pɑ:m
waxberry => 'wæksbәri
waxbill => 'wæksbil
waxed => 'wæksid
waxen => 'wæksn
waxer => 'wæksә
waxes => wæksiz
waxiness => 'wæksinis
waxing => 'wæksiŋ
waxwing => 'wækswiŋ
waxwork => 'wækswә:k
waxy => 'wæksi
way => wei
way of life => wei ɔv laif
wayang => 'wɑ:jɑ:ŋ
waybill => 'weibil
waybread => 'weibred
wayfarer => 'wei.fєәrә
wayfarers => ˈweɪˌfeərəz
wayfaring => 'wei.fєәriŋ
wayfaring tree => ˈweifɛəriŋ tri:
waylay => wei'lei
waylaying => ˈweiˈleiŋ
waylays => ˈweiˈleiz
waymark => 'weimɑ:k
wayne => wein
waypoint => ˈweɪpɔɪnt
ways => weiz
wayside => 'weisaid
waysides => ˈweɪˌsaɪdz
wayward => 'weiwәd
waywardly => ˊweiwәdli
waywardness => 'weɪwədnəs
wayzgoose => 'weizgu:s
wazir => wɑ:'ziә(r)
wazzock => wæ'zɒk
we => wi:
we'd => wi:d
we'll => wi:l
we're => wɪə(r)
we've => wi:v
weak => wi:k
weak sister => wi:k ˈsistə
weak-minded => mi:k'maindid
weak-willed => 'wi:kwild
weaken => 'wi:kәn
weakened => ˈwi:kənd
weakener => 'wi:kənər
weakens => ˈwi:kənz
weakest => wi:kɪst
weakfish => 'wi:kfɪʃ
weakling => 'wi:kliŋ
weaklings => ˈwi:kliŋz
weakly => 'wi:kli
weakness => 'wi:knis
weaknesses => 'wi:knəsɪz
weal => wi:l
weald => wi:ld
Wealden => 'wi:ldən
weals => wi:lz
wealth => welθ
wealthily => 'welθili
wealthy => 'welθi
wean => wi:n
weaned => wi:nd
weaner => 'wi:nər
weanling => 'wi:nliŋ
weans => wi:nz
weapon => 'wepәn
weaponization => ,wepәnai'zeiʃәn;-ni'z-
weaponize => ˈwepənaɪz
weaponized => wi:'pənaɪzd
weaponless => 'wepәnlis
weaponry => 'wepәnri
weapons-grade => 'wepənzɡr'eɪd
wear => wєә
wearability => .wεәrә'bilәti
wearable => 'wєәrәbl
wearer => 'wєәrә
wearied => ˈwiərid
wearies => ˈwiəriz
weariless => 'wiәrilis
wearily => 'wiәrili
weariness => 'wiәrinis
wearing => 'wєәriŋ
wearisome => 'wiәrisәm
wears => wɛəz
weary => 'wiәri
wearying => ˈwiəriŋ
weasel => 'wi:zl
weasel-faced => 'wi:zәlfeist
weaselly => 'wi:zəli
weasels => ˈwi:zəlz
weather => 'weðә
weather chart => ˈweðə tʃɑ:t
weather ship => ˈweðə ʃip
weatherbeaten => weðə'bi:tn
weatherboard => 'weðәbɔ:d
weatherboarding => 'weðә,bɔ:diŋ
weathercock => 'weðәkɒk
weathercocks => ˈweðəkɔks
weathering => 'weðәriŋ
weatherize => 'weðәraiz
weatherliness => 'weðәlinis
weatherly => 'weðәli
weatherman => 'weðәmæn
weatherproof => 'weðәpru:f
weatherproofed => ˈweðəpru:ft
weatherproofing => ˈweðəpru:fɪŋ
weatherproofs => ˈweðəpru:fs
weathers => ˈweðəz
weatherstrip => 'weðәstrip
weathertight => 'weðәtait
weathervane => ˈweðəveɪn
weave => wi:v
weaver => 'wi:vә
weavers => ˈwi:vəz
weaves => wi:vz
web => web
webbed => 'webd
webbing => 'webiŋ
webby => 'webi
webcam => 'webkæm
Weber => 'wi:bә
Weberian => vei'biəriən
webmaster => 'webmɑ:stә. -mæs-
Webster => 'webstә
webwork => 'webwə:k
webzine => ˈwebzi:n
wed => wed
wedded => 'wedid
wedding => 'wediŋ
wedding cake => ˈwediŋ keik
wedding dress => ˈwediŋ dres
wedge => wedʒ
wedge-shaped => 'wedʒʃeipt
wedgebill => 'wedʒbɪl
wedges => wedʒz
wedgie => 'wedʒi
Wedgwood => 'wedʒwud
wedlock => 'wedlɒk
Wednesday => 'wenzdi
wee => wi:
wee-wee => 'wi:'wi:
wee-weed => 'wi:wi:
wee-weeing => 'wi:wi:
wee-wees => 'wi:wi:
weed => wi:d
weeder => 'wi:dә
weedicide => 'wi:disaid
weedier => ˈwi:di:ə
weediness => ˊwiːdinis
weedkiller => ˈwi:dkɪlə(r)
weedless => 'wi:dlis
weeds => wi:dz
weedy => 'wi:di
weeing => wi:ɪŋ
week => wi:k
weekday => 'wi:kdei
weekend => 'wi:kend
weekender => 'wi:k.endә
weeklies => ˈwi:kliz
weeklong => 'wi:klɔŋ;-lɔ:ŋ
weekly => 'wi:kli
weeknight => 'wi:knait
weeknights => 'wi:knaits
weeks => wi:ks
weel => wi:l
ween => wi:n
weenie => 'wi:ni
weenier => 'wiːnɪ
weenies => ˈwi:niz
weeniest => 'wiːnɪ
weeny => 'wi:ni
weep => wi:p
weeper => 'wi:pә
weepie => 'wi:pi
weepies => ˈwi:pi:z
weeping => 'wi:piŋ
weeping willow => ˈwi:piŋ ˈwiləu
weeps => wi:ps
weepy => 'wi:pi
wees => wi:z
weever => 'wi:vә(r)
weevil => 'wi:vil
weevils => 'wi:vɪlz
weevily => 'wi:vɪlɪ
weft => weft
Wehrmacht => 'weirmaxt
Weichsel => 'vaiksәl
Weifang => weifɑ:ŋ
weigela => wai'dʒi:lә, -'^i:-
weigh => wei
weigh-in => ˈweɪˌɪn
weighable => 'weiәbl
weighbridge => 'weibridʒ
weighed => weid
weigher => 'weiә
weighing => 'weiiŋ
weighs => weiz
weight => weit
weight belt => weit belt
weight training => weit ˈtreiniŋ
weight-watcher => 'weɪtw'ɒtʃər
weighted => 'weitid
weightier => ˈweɪti:ə
weightily => 'weitili
weightiness => 'weitinis
weighting => 'weitiŋ
weightless => 'weitlis
weightlifter => ˈweitˌliftə
weightlifters => weɪt'lɪftəz
weightlifting => ˈweɪtlɪftɪŋ
weighty => 'weiti
Weimar => 'vaimɑ:
Weimaraner => 'vaimәrɔnә, 'wai-
weiner => 'wi:nә(r)
weir => wiә
weird => wiәd
weirdie => 'wiәdi
weirdo => ˈwɪədəʊ
weirdos => ˈwɪədəʊz
weirs => wiəz
Weismann => 'vaismɑ:n
weiss => wais
Weisswurst => 'vaisvjrst
weka => 'wi:kә
welch => welʃ
welcome => 'welkәm
welcome to => ˈwelkəm tu:
welcomed => ˈwelkəmd
welcomes => ˈwelkəmz
welcoming => ˈwelkəmɪŋ
weld => weld
weldable => 'weldәbl
welder => 'weldә
welders => ˈweldəz
welding => 'weldiŋ
weldon => 'weldәn
welds => weldz
welfare => 'welfєә
welfare worker => ˈwelfɛə ˈwə:kə
welfarism => 'welfєәrizm
welfarist => 'welfεərist
welkin => 'welkin
well => wel
well advised => wel ədˈvaizd
well appointed => wel əˈpɔintid
well built => wel bilt
well connected => wel kəˈnektɪd
well deck => wel dek
well disposed => wel disˈpəuzd
well done => wel dʌn
well formed => wel fɔːmd
well known => wel nəʊn
well read => wel ri:d
well rounded => wel ˈraʊndɪd
well tried => wel traɪd
well-adjusted => 'welədʒ'ʌstɪd
well-advised => welәd'vaizd
well-appointed => welә'pɔintid
well-balanced => wel'bælәnst
well-being => 'welbiiŋ
well-born => 'welb'ɔ:n
well-bred => wel'bred
well-built => 'wel'bɪlt
well-chosen => 'wel'tʃәjzən
well-done => wel'dʌn
well-endowed => welɪn'daʊd
well-established => 'weli'stæbliʃt
well-fed => 'wel'fed
well-founded => wel'fajndid
well-intentioned => welin'tenʃәnd
well-read => wel'ri:d
well-spoken => wel'spәjkәn
well-thought-of => 'wel'θɔ:t,ɔv,-,ʌv
well-thought-out => 'welθ'ɔ:t'aʊt
well-turned-out => 'wel,tə:nd'aut
well-versed => 'welv'ɜ:st
well-wisher => wel'wiʃә(r)
Welland => 'welәnd
welled => wel
weller => 'welә
welles => welz
wellesley => 'welzli
wellhead => 'welhed
wellie => 'welaɪ
wellies => 'welɪz
wellington => 'weliŋtәn
wellingtonia => ,weliŋ'tәjniә
wellingtons => 'welɪŋtənz
wellness => 'welnis
wells => welz
wellspring => 'welspriŋ
welly => ˈweli
wels => welz
Welsbach => 'welzbæk,'velzbɑ:h
Welsh => welʃ
welshed => welʃt
welsher => 'welʃә
welshes => welʃiz
welshing => welʃɪŋ
welshman => 'welʃmәn
Welshwoman => -welʃ,wumən
welt => welt
weltanschauung => 'velt'ɑ:nʃauәŋ
welter => 'weltә
weltered => ˈweltəd
weltering => ˈweltərɪŋ
welters => ˈweltəz
welterweight => 'weltәweit
welting => 'weltɪŋ
welts => 'welts
Weltschmerz => 'veltʃmeәts
welwitschia => wel'witʃiә
Wemyss => wi:mz
wen => wen
Wenceslas => 'wensislɔ:s,-lәs
wench => wentʃ
wenched => wentʃt
wenches => wentʃiz
wenching => wentʃɪŋ
wend => wend
wended => wendid
wendell => 'wendl
wending => wendɪŋ
wends => wendz
wendy => 'wendi
Wensleydale => 'wenzlideil
went => went
wentletrap => 'wentl,træp
Wenzhou => 'wen'dʒəu
were => wә:
weren't => wә:nt, weәnt
werewolf => 'wә:wulf
werewolves => ˈwə:wulfs
werner => 'wә:nә
wert => wә:t; wәt
wes => wes
Weser => 'veizә(r)
wesley => 'wezli, 'wesli
wesleyan => 'wezliәn
Wesleyanism => 'wezliәnizәm,'wes-
Wessex => 'wesiks
west => west
West Indies => 'west 'indiz
West Virginia => 'west vә(:)'dʒinjә
westbound => 'westbajnd
Westbury => 'westberi:
Westcott => 'westkәt
wester => 'westә
westering => 'westәriŋ
westerlies => 'westәliz
westerly => 'westәli
western => 'westәn
western hemisphere => ˈwestən ˈhemiˌsfiə
Western Samoa => 'westәn sә'mәuә
westerners => ˈwestənəz
westernization => ,westәnai'zeiʃən;-ni'z-
westernize => 'westәnaiz
westernized => ˈwestəˌnaɪzd
westernizer => 'westənaɪz
westernizes => ˈwestəˌnaɪziz
westernizing => ˈwestəˌnaɪzɪŋ
westernmost => 'westәnmәust
Westfalen => vest'fɑ:lәn
Westie => 'westi
westing => 'westiŋ
Westinghouse => 'westiŋhaus
Westland => 'westlənd
Westminster => 'westminstә
Westmorland => 'westmәlәnd
weston => 'westәn
Westphalia => west'feiliә, -'feiljә
Westphalian => west'feiliən
westward => 'westwәd
westwardly => 'westwәdli
westwards => 'westwәdz
wet => wet
wet bar => wet bɑːr
wet dock => wet dɔk
wet fly => wet flai
wet rot => wet rɔt
wet suit => wet sju:t
wet-look => wet luk
wet-nurses => 'wetnə:s
weta => 'weitә
wetback => 'wetbæk
wether => 'weðә
wetland => 'wetlænd
wetlands => 'wetlændz
wetly => 'wetli
wetness => 'wetnis
wettable => 'wetәbl
wetter => 'wetә
wetting => 'wetiŋ
wetting agent => 'wetiŋ
wettish => 'wetiʃ
wetware => 'wetweә(r)
Wexford => 'weksfəd
wey => wei
Weymouth => 'weiməθ
whack => hwæk
whacked => hwækt
whacker => 'hwækә
whacking => 'hwækiŋ
whacko => 'hwækәj
whacks => hwæks
whacky => '(h)wæki
whale => hweil
whale shark => hweil ʃɑ:k
whaleback => 'hweilbæk
whaleboat => 'hweilbәut
whalebone => ˈweɪlbəʊn
whalebone whale => ˈhweɪlˌbəʊn hweil
whaler => 'hweilә
whalers => ˈhweɪləz
whales => hweilz
whaling => '(h)weiliŋ
wham => hwæm
whammed => (h)wæmd
whamming => (h)wæmɪŋ
whammo => 'wæmәu
whammy => 'wæmi
whams => (h)wæmz
whang => hwæŋ
Whangarei => ,wɑ:ŋɑ:'rei
whap => wɑ:p, hwɑ:p
whaped => hwɒp
whaping => hwɒp
whapped => 'wæpt
whapping => 'wæpɪŋ
whare => 'hwɔri
wharf => hwɒ:f
wharfage => '(h)wɔ:fidʒ
wharfie => '(h)wɔ:fi
wharfinger => 'hwɒ:findʒә
wharton => '(h)wɔ:tn
what => hwɒt
what about => hwɔt əˈbaut
what goes around comes around => hwɔt ɡəuz əˈraund ˈkɔmiz əˈraund
whatchamacallit => 'wɒtʃəmə,kɔːlɪt
whatever => hwɒt'evә
whatnot => 'hwɒtnɒt
whatsit => ˈwɒtsɪt
whatso => '(h)wɔtsәu
whatsoever => .hwɒtsәu'evә
whaup => wɔ:p, hwɔ:p
wheal => wi:l
wheat => hwi:t
wheatear => 'hwi:tiә
wheaten => 'hwi:tn
wheatgerm => ˈwi:tdʒɜ:m
wheatgrass => 'hwi:tgræs
Wheatley => '(h)wi:tli
wheatmeal => ˈwi:tmi:l
Wheaton => 'hwi:tn
wheats => 'wi:ts
Wheatstone bridge => '(h)wi:tstәun,bridʒ
whee => wi:, hwi:
wheedle => 'hwi:dl
wheedled => ˈhwi:dld
wheedles => ˈhwi:dlz
wheedling => ˈhwi:dlɪŋ
wheel => hwi:l
wheel and axle => hwi:l ænd ˈæksəl
wheel arch => hwi:l ɑ:tʃ
wheel clamp => hwi:l klæmp
wheel lock => hwi:l lɔk
wheelbarrow => 'hwi:l.bærәu
wheelbarrows => ˈhwi:lˌbærəʊz
wheelbase => 'hwi:lbeis
wheelchair => 'hwi:l.tʃєә
wheelchairs => 'wi:ltʃeərz
wheeled => hwi:ld
wheeler => 'hwi:lә
wheeler-dealer => wi:lә(r) 'di:lә(r)
wheelhouse => 'hwi:lhaus
wheelie => ˈwi:li
wheelie bin => 'wiːli ˌbɪn
wheeling => 'hwi:liŋ
wheelman => 'hwi:lmәn
wheels => 'hwi:ls
wheelset => 'hwi:lset
wheelsman => 'hwi:lzmәn
wheelwright => 'hwi:lrait
wheelwrights => ˈwi:lraits
wheely => 'hwi:li
wheen => wi:n, hwi:n
wheeze => hwi:z
wheezed => hwi:zd
wheezes => hwi:ziz
wheezily => 'wi:zɪlɪ
wheeziness => ˊhwiːzinis
wheezingly => '(h)wi:ziŋli
wheezy => 'hwi:zi
whelk => 'hwelk
whelks => welks
whelm => 'hwelm
whelmed => hwelmd
whelming => hwelmɪŋ
whelms => hwelmz
whelp => hwelp
whelped => (h)welpt
whelping => (h)welpɪŋ
whelps => (h)welps
when => hwen
whence => (h)wens
whencesoever => .hwenssәu'evә
whenever => hwen'evә
whensoever => wensәj'evә(r)
where => hwєә
whereabouts => 'hwєәrә.bauts
whereafter => 'hwєәrә.ɑ:ftә
whereas => hwєәr'æz
whereat => (h)weәr'æt
whereby => (h)weә'bai
wherefore => 'hwєәfɒ:
wherefrom => hwєә'frɒm
wherein => hwєәr'in
whereof => hwєәr'ɒv
whereon => hwєәr'ɒn
wheresoever => ,hweәsәj'evә(r)
whereto => hwєә'tu:
whereupon => ,(h)weәrә'pɔn
wherever => hwєәr'evә
wherewith => hwєә'wiθ
wherewithal => 'hwєәwiðɒ:l
wherries => ˈhweri:z
wherry => 'hweri
whet => hwet
whether => 'hweðә
whets => hwets
whetstone => 'hwetstәun
whetstones => ˈ(h)wetstəunz
whetted => hwetid
whetter => 'hwetә(r)
whetting => hwetɪŋ
whew => hwju:
whey => hwei
which => hwitʃ
whichever => hwitʃ'evә
whichsoever => ,hwitʃsәj'evә(r)
whicker => 'wɪkər
whickered => 'wɪkə
whickers => 'wɪkə
whiff => hwif
whiffed => hwɪft
whiffing => hwɪfɪŋ
whiffle => '(h)wifl
whiffletree => 'hwifltri:
whiffs => hwɪfs
whiffy => 'hwifi
Whig => (h)wi^
Whiggery => 'hwi^әri
Whiggish => 'hwi^iʃ
Whiggism => 'hwi^izәm
while => hwail
whiles => hwailz
whilom => 'hwailәm
whilst => wailst
whim => hwim
whimbrel => 'hwimbrәl
whimper => 'hwimpә
whimpered => ˈhwɪmpəd
whimpering => 'wɪmpərɪŋ
whimpers => ˈhwɪmpəz
whims => 'wɪmz
whimsical => 'hwimzikl
whimsicality => .hwimzi'kæliti
whimsically => -kli
whimsies => ˈhwɪmzi:z
whimsy => 'hwimzi
whin => hwin
whinchat => '(h)wintʃæt
whine => hwain
whined => hwaɪnd
whines => hwaɪnz
whiney => 'hwaini
whing => hwiŋ
whinge => wɪndʒ
whinged => hwɪndʒd
whinger => 'hwiŋә
whinges => hwɪndʒz
whining => hwaɪnɪŋ
whiningly => 'wainiŋli
whinnied => ˈhwɪni:d
whinnies => ˈhwɪni:z
whinny => 'hwini
whinnying => ˈhwɪni:ɪŋ
whinstone => 'hwinstәun
whiny => 'waini, 'hwaini
whip => hwip
whip-rounds => 'hwipraund
whipcord => 'wipkɔ:d
whiplash => 'hwiplæʃ
whipless => 'hwiplis
whiplike => 'hwiplaik
whipped => hwipt
whipper => 'hwipә
whipper-in => 'hwipәr'in
whippersnapper => 'hwipә.snæpә
whippet => '(h)wipit
whipping => 'hwipiŋ
whipping boy => 'wipiŋ
whipping cream => ˈhwɪpɪŋ kri:m
whipping post => ˈhwɪpɪŋ pəust
whippletree => 'hwipltri:
whippoorwill => 'wippuәwil
whippy => 'hwipi
whipsaw => '(h)wipsɔ:
whipsawed => ˈ(h)wipsɔ:d
whipsawing => ˈ(h)wipsɔ:ɪŋ
whipsaws => ˈ(h)wipsɔ:z
whipstitch => 'hwipstitʃ
whipstock => 'hwipstɒk
whiptail => ˈhwɪpˌteɪl
whir => hwә:
whirl => hwә:l
whirled => hwə:ld
whirler => '(h)wә:lә
whirligig => 'hwә:ligig
whirlpool => 'hwә:lpu:l
whirlpools => ˈhwɜ:lˌpu:lz
whirls => hwə:lz
whirlwind => 'hwә:lwind
whirlwinds => ˈhwɜ:lˌwɪndz
whirlybird => 'hwә:libә:d
whirr => hwә:
whirred => hwɜ:d
whirring => hwɜ:ɪŋ
whirrs => hwɜ:z
whirs => hwɜ:z
whisht => (h)wiʃt
whisk => hwisk
whisked => hwiskt
whisker => 'hwiskә
whiskered => ˈwɪskəd
whiskey => 'hwiski
whiskeys => ˈhwɪski:z
whisking => hwiskɪŋ
whisks => hwisks
whisky => 'hwiski
whisper => 'hwispә
whispered => 'wɪspəd
whispering => '(h)wispәriŋ
whispers => ˈhwispəz
whispery => '(h)wispәri
whist => hwist
whistle => 'hwisl
whistle-stop => 'hwislstɔp
whistled => ˈhwisld
whistler => 'hwislә
whistles => ˈhwislz
whistling => 'hwisliŋ
whistling swan => ˈ(h)wisliŋ swɔn
whit => hwit
whitaker => 'hwitәkә(r)
white => hwait
white admiral => hwait ˈædmərəl
white ant => hwait ænt
white bass => hwait beis
white cell => hwait sel
white clover => hwait ˈkləʊvə
white dwarf => hwait dwɔ:f
white ensign => hwait ˈensən
white feather => hwait ˈfeðə
white fir => hwait fɜ:
white fish => hwait fiʃ
white goods => hwait ɡudz
white hole => hwait həul
white hope => hwait həup
white knight => hwait nait
white lead => led
white lightning => hwait ˈlaitniŋ
white list => hwait list
white magic => hwait ˈmædʒik
white meat => hwait mi:t
white pine => hwait pain
white poplar => hwait ˈpɔplə
white sauce => hwait sɔ:s
white shark => hwait ʃɑ:k
white slaver => hwait ˈslævə
white space => hwait speis
white tie => hwait tai
white wedding => hwait ˈwediŋ
white whale => hwait hweil
white willow => hwait ˈwiləu
white-collar => 'wait'kɔlә
white-eye => 'waɪt'aɪ
white-footed mouse => 'hwait,futid maus
white-hot => 'wait'hɔt
white-knuckle => 'waɪtn'ʌkl
white-out => hwait aut
white-tailed deer => ˈhwaɪtˌteɪld, ˈwaɪt-
white-tie => hwait tai
white-van man => hwait væn mæn
whitebait => 'hwaitbeit
whitebeam => 'hwaitbi:m
whiteboard => 'hwaitbɔ:d
whitecap => '(h)waitkæp
whitecaps => ˈwaɪtkæps
Whitechapel => 'hwait,tʃæpəl
whited => 'waitid
whited sepulchre => ˈwaitid ˈsepəlkə
Whitefield => '(h)waitfi:ld
whitefish => 'hwaitfiʃ
whiteflies => 'waɪtflaɪ
whitefly => 'hwaitflai
Whitehall => 'waithɔ:l
Whitehead => '(h)wait,hed
whitely => 'hwaitli
whiten => 'hwaitn
whitened => ˈhwaɪtnd
whitener => 'hwaitәnә
whiteness => 'hwaitnis
whitening => 'hwaitniŋ
whitens => ˈhwaɪtnz
whiteout => 'waitaut
whiteouts => 'hwaɪtaʊt
whites => 'waits
whitesmith => 'hwaitsmiθ
whitetail => 'waitteil
whitethorn => 'hwaitθɒ:n
whitethroat => 'waitθrәut
whitewall => 'hwaitwɔ:l
whitewash => 'hwaitwɒʃ
whitewashed => ˈhwaɪtˌwɔʃt
whitewashes => ˈhwaɪtˌwɔʃiz
whitewashing => 'waɪtwɒʃɪŋ
whitewater => 'waɪtˌwɔ:tə
whitewood => 'hwaitwud
whitework => 'wait,wә:k
whitey => 'hwaiti
whither => 'hwiðә
whithersoever => .hwiðәsәu'evә
whiting => 'hwaitiŋ
whitish => 'hwaitiʃ
whitleather => '(h)witleðә
Whitley => '(h)witli:
whitlow => 'hwitlәu
whitman => '(h)witmәn
whitney => '(h)witni
Whitsun => 'hwitsәn
Whitsuntide => '(h)witsʌntaid
whittle => 'hwitl
whittled => ˈhwɪtld
whittles => ˈhwɪtlz
whittling => ˈhwɪtlɪŋ
whiz => hwiz
whiz-bang => 'hwizbæŋ
whizz => hwiz
whizz-kid => hwɪz kid
whizzbang => 'hwizbæŋ
whizzes => 'wɪzɪz
whizzo => 'hwizәj
whizzy => ˈwɪzi
who => hu:
who's => hu:z
whoa => wәu
whodunit => hu:'dʌnit
whodunnit => ˌhu:ˈdʌnɪt
whoever => hu'evә
whole => hәul
whole note => həul nəut
wholefood => ˈhəʊlfu:d
wholegrain => ˈhəʊlgreɪn
wholehearted => 'hәul'hɑ:tid
wholemeal => ˈhəʊlmi:l
wholeness => 'hәulnis
wholes => həulz
wholesale => 'hәulseil
wholesaled => ˈhəʊlˌseɪld
wholesaler => 'hәulseilә
wholesalers => ˈhəʊlˌseɪləz
wholescale => 'hәjlskeil
wholesome => 'hәulsәm
wholesomely => 'həʊlsəmlɪ
wholesomeness => 'həulsəmnis
wholewheat => ˈhəʊlwi:t
wholism => 'hәulizm
wholistic => 'həu'listik
wholly => 'hәuli
whom => hu:m
whomever => ˌhu:mˈevə(r)
whomp => hwɒmp
whomso => 'hu:msәj
whomsoever => ˌhu:mˈevə(r)
whoop => hwu:p
whoop-de-do => 'hu:pdidu:
whooped => hu:pt
whoopee => 'hwupi:
whoopee cushion => ˈ(h)wupi: ˈkuʃən
whooper => 'hu:pә
whooping => 'hu:piŋ
whooping cough => 'hu:piŋ
whooping crane => ˈhu:piŋ krein
whoops => hwu:ps
whoosh => hwu:ʃ
whooshed => (h)wuʃt
whooshes => (h)wuʃiz
whooshing => (h)wuʃɪŋ
whop => hwɒp
whopped => (h)wɔpt
whopper => 'hwɒpә
whoppers => ˈhwɔpəz
whopping => 'hwɒpiŋ
whore => hɒ:
whored => hɔ:d
whoredom => 'hɔ:dәm
whorehouse => 'hɒ:haus
whorehouses => ˈhɔ:ˌhaʊsiz
whoremaster => 'hɔ:,mɑ:stә(r);-,mæs-
whoremonger => 'hɔ:,mʌŋ^ә(r),-,mɔŋ-
whores => hɔ:z
whoring => ˈhɔ:rɪŋ
whorish => 'hɔ:riʃ
whorl => hwә:l
whorled => hwә:ld
whorls => ()hwə:lz
whortleberry => 'hwә:tlbәri
whose => hu:z
whosesoever => həʊzsə'ʊevər
whosever => hu:'zevә(r)
whoso => 'hu:sәu
whosoever => ,hu:sәj'evә(r)
whump => (h)wʌmp
whup => (h)wʌp
why => hwai
whydah => 'hwidә
Whyte => (h)wait
Wicca => 'wikә
Wichita => 'witʃitɔ:
wick => wik
wicked => 'wikid
wickedly => 'wɪkɪdlɪ
wickedness => 'wikidnis
wicker => 'wikә
wicket => 'wikit
wicket gate => ˈwikit ɡeit
wicketkeeper => ˈwɪkɪtki:pə(r)
wickets => ˈwikits
wicking => 'wikiŋ
wickiup => 'wikiʌp
wicklow => 'wikləu
wicks => wɪks
widdershins => 'widәʃinz
widdle => 'widl
wide => waid
wide boy => waid bɔi
wide receiver => waid riˈsi:və
wide-angle => 'waɪd'æŋɡl
wide-band => 'waɪdb'ænd
wide-ranging => ˈwaɪdˈreɪndʒɪŋ
widely => 'waidli
widen => 'waidn
widened => ˈwaidnd
widening => 'waidniŋ
widens => ˈwaidnz
widescreen => ˈwaɪdskri:n
widespread => 'waidspred
widgeon => 'widʒәn
widger => 'widʒә(r)
widget => 'widʒit
widish => 'waidiʃ
widow => 'widәu
widower => 'widәuә
widowers => ˈwɪdəʊəz
widowhood => 'widәuhud
widowing => 'wɪdəʊ
widows => ˈwidəuz
width => widθ
widths => widθs
widthways => 'widθweiz,'witθ-
wield => wi:ld
wielded => wi:ldid
wielding => wi:ldɪŋ
wields => wi:ldz
wieldy => 'wi:ldi
wien => vi:n
wiener => 'vi:nә
Wiesbaden => 'vi:sbɑ:dn
wife => waif
wifehood => 'waifhud
wifeless => 'waiflis
wifely => 'waifli
wifie => 'waifi
wig => wig
Wigan => 'wi^әn
wigeon => 'widʒәn
wigged => wigd
wigging => 'wigiŋ
wiggle => 'wigl
wiggled => ˈwɪgəld
wiggler => 'wiglә
wiggles => ˈwɪgəlz
wiggling => 'wɪɡlɪŋ
wiggly => 'wigli
wiggy => 'wɪɡɪ
Wight => wait
wigless => 'wi^lis
Wigtownshire => 'wi^tәnʃiә(r),-tajn-
wigwag => 'wigwæg
wigwags => 'wɪgwæg
wigwam => 'wigwæm
wigwams => ˈwiɡwæmz
Wilberforce => 'wilbәfɔ:s
wilbur => 'wilbә
wilco => 'wilkәu
wilcox => 'wilkɔks
wild => waild
wild boar => waild bɔ:
wild card => waild kɑ:d
wild duck => waild dʌk
wild ginger => waild ˈdʒindʒə
wild horse => waild hɔ:s
wild hyacinth => waild ˈhaiəsinθ
wild mustard => waild ˈmʌstəd
wild oat => waild əut
wild pitch => waild pitʃ
wild rice => waild rais
wild silk => waild silk
wild type => waild taip
wild-eyed => 'waildaid
wild-goose chase => ˈwaɪldˈgu:s
wildcat => 'wailkæt
wildcats => ˈwaildkæts
wildcatter => 'waild,kætә(r)
wilde => waild
Wildean => 'waildiən
wildebeest => 'wi:ldәbi:st
wilder => 'wildә
wilderness => 'wildәnis
wildernesses => ˈwɪldənɪsiz
wildfire => 'waildfaiә
wildflower => 'waild,flajә(r)
wildfowl => 'waildfaul
wilding => 'waildiŋ
wildish => 'waildiʃ
wildland => 'waildlænd
wildlife => 'waildlaif
wildness => 'waildnis
wilds => waildz
wildwood => 'waildwud
wile => wail
wilfred => 'wilfrid
wilful => 'wilful
wilfully => 'wɪlfəlɪ
wilfulness => 'wɪlfəlnɪs
wilga => 'wil^ә
wilhelm => 'vilhelm,'wil-
Wilhelmina => ,vilhel'mi:nә,,wil-
Wilhelmshaven => 'vilhelmshɑ:fәn
wilier => ˈwaɪli:ə
wilkes => wilks
wilkins => 'wilkinz
wilkinson => 'wilkinsn
will => wil
willa => 'wilә
willard => 'wilɑ:d
willed => wild
willemite => 'wilimait
Willemstad => 'wilәm,stɑ:t
willer => wil
willet => 'wilit
willful => 'wilful
william => 'wiljәm
williams => 'wiljәmz
williamson => 'wiljәmsn
willie => 'wili
willies => 'wiliz
willing => 'wiliŋ
willingly => 'wiliŋli
willis => 'wilis
williwaw => 'wiliwɔ:
Willoughby => 'wilәbi
willow => 'wilәu
willow pattern => ˈwiləu ˈpætən
willows => ˈwiləuz
willowware => 'wilәjweә(r)
willowy => 'wilәji
willpower => 'wilpauә
willy => 'wili
willy-nilly => 'wili'nili
wilma => 'wilmә
Wilmington => 'wilmiŋtən
wilson => 'wilsn
wilt => wilt
wilting => 'wiltiŋ
Wilton => 'wiltәn
wiltshire => 'wiltʃә
wily => 'waili
Wimbledon => 'wimbldәn
wimp => wimp
wimpish => 'wimpiʃ
wimple => 'wimpl
wimpled => ˈwɪmpəld
wimples => ˈwɪmpəlz
wimps => wimps
wimpy => 'wimpi
win => win
win-win => wɪn wɪn
wince => wins
winced => wɪnst
winces => wɪnsiz
wincey => 'winsi
winceyette => 'winsi'et
winch => wintʃ
winched => wɪntʃt
wincher => wɪn(t)ʃ
winches => wɪntʃiz
Winchester => 'wintʃistә
winching => wɪntʃɪŋ
wincing => wɪnsɪŋ
wind => wind
wind chill => ˈwɪnd tʃɪl
wind chime => wind tʃaɪm
wind chimes => ˈwɪnd tʃaɪmz
wind farm => ˈwɪnd fɑ:m
wind gap => wind ɡæp
wind gauge => ˈwɪnd geɪdʒ
wind rose => wind rəuz
wind shear => wind ʃiə
wind sprint => wind sprɪnt
wind turbine => ˈwɪnd tɜ:baɪn
wind-down => ˈwaɪnd daʊn
wind-up => ˈwaɪnd ʌp
windage => 'windidʒ
Windaus => 'vindaus
windbag => 'windbæg
windbaggery => 'wind.bægәri
windblown => 'windblәun
windbound => 'windbaund
windbreak => 'windbreik
windbreaker => 'wind.breikә
windbreaks => 'wɪndbreɪks
windburned => 'windbə:nd
windcheater => 'wind,tʃi:tә(r)
windchest => 'windtʃest
winded => 'windid
winder => waindә
Windermere => 'windəmiə
windfall => 'windfɒ:l
windfalls => ˈwindfɔ:lz
windflower => 'wind,flajә(r)
windgall => 'wind^ɔ:l
Windhoek => 'vinthuk
windhover => 'wind,hɔvә(r),-,hʌvә(r)
windier => ˈwɪndi:ə
windigo => 'wɪndɪɡəʊ
windily => 'wɪndɪlɪ
windiness => 'windinis
winding => 'waindiŋ
winding sheet => ˈwaɪndɪŋ ʃi:t
windjammer => 'winddʒæmә
windlass => 'windlәs
windlasses => ˈwindləsiz
Windle => 'windl
windless => 'windlis
windmill => 'windmil
windmills => ˈwɪndˌmɪlz
window => 'windәu
window box => ˈwindəu bɔks
window dresser => ˈwindəu ˈdresə
window ledge => ˈwindəu ledʒ
window seat => ˈwindəu si:t
window tax => ˈwindəu tæks
windowing => 'windәuiŋ
windows => 'windәjz
windowsill => 'windәusil
windpipe => 'windpaip
windpipes => ˈwɪndˌpaɪps
windproof => 'windpru:f
windrow => 'windrәj
winds => 'waɪndz
windsail => 'windseil
windscreen => 'windskri:n
windscreen wiper => ˈwɪndˌskri:n ˈwaipə
windscreens => wɪndsk'ri:nz
windshield => 'windʃi:ld
windshield wiper => ˈwɪndˌʃi:ld ˈwaipə
windshields => 'wɪndʃi:ldz
windsor => 'winzә
windstorm => 'windstɒ:m
windsurf => 'windsә:f
windsurfed => ˈwɪndˌsɜ:ft
windsurfer => ˈwɪndsɜ:fə(r)
windsurfers => 'wind,sə:fə
windsurfing => 'wind.sә:fiŋ
windsurfs => ˈwɪndˌsɜ:fs
windswept => 'windswept
windward => 'windwәd
Windward Islands => 'windwəd
windy => 'windi
wine => wain
wine bar => wain bɑ:
wine cellar => wain ˈselə
wine glass => wain ɡlɑ:s
wine list => wain list
wine red => wain red
wine taster => wain ˈteistə
wine vinegar => wain ˈviniɡə
wine waiter => wain ˈweitə
wineberry => 'waɪnberɪ
winebibber => 'wain.bibә
winebibbing => 'wain,bibiŋ
wineglass => 'wainglæs
wineglassful => 'wain,^lɑ:sfjl;-^læs-
winegrower => 'wain.grәuә
winemakers => 'wain,meikə
winemaking => 'waɪnmeɪkɪŋ
wineries => ˈwainəriz
winery => 'wainәri
Winesap => 'wainsæp
wineshop => 'wainʃɔp
wineskin => 'wainskin
winey => 'waini
winfield => 'winfi:ld
wing => wiŋ
wing back => wiŋ bæk
wing case => wiŋ keis
wing collar => wiŋ ˈkɔlə
wing commander => wiŋ kəˈmɑ:ndə
wing covert => wiŋ ˈkʌvət
wing mirror => wiŋ ˈmirə
wing tip => wiŋ tip
wingback => 'wiŋbæk
wingbeat => 'wiŋbi:t
wingding => 'wiŋdiŋ
winged => wiŋd
winged bean => wiŋd bi:n
winger => 'wiŋә
wingers => ˈwiŋəz
wingman => 'wiŋmәn
wingnut => 'wɪŋnʌt
wingover => 'wiŋ.әuvә
wingspan => 'wiŋspæn
wingspans => ˈwɪŋˌspænz
wingspread => 'wiŋspred
wingtip => 'wiŋtip
Winifred => 'winifrid
wink => wiŋk
winked => wiŋkt
winking => 'wiŋkiŋ
winkle => 'wiŋkl
winkle-picker => 'wiŋkl,pikә
winkled => ˈwiŋkld
Winkler => 'wiŋklə
winkles => ˈwiŋklz
winkling => ˈwiŋklɪŋ
winless => 'winlis
winnable => 'winәbl
winner => 'winә
winning => 'winiŋ
winning post => ˈwɪnɪŋ pəust
winnipeg => 'winipe^
winnow => 'winәu
winnowed => 'wɪnəʊd
winnower => 'winәuә
winnowing => 'wɪnəʊɪŋ
winnows => ˈwɪnəʊz
wino => 'wainәu
winslow => 'winzlәj
winsome => 'winsәm
winston => 'winstәn
winter => 'wintә
winter cherry => ˈwintə ˈtʃeri:
winter cress => ˈwintə kres
winter flounder => ˈwintə ˈflaʊndə
winter jasmine => ˈwintə ˈdʒæzmɪn
winter solstice => ˈwintə ˈsɔlstis
winter sports => ˈwintə spɔ:ts
winter squash => ˈwintə skwɔʃ
winterberry => 'wintәbəri
winterbourne => 'wintәbɔ:n
wintergreen => 'wintә'^ri:n
winterization => ,wintәri'zeiʃәn
winterize => 'wintәraiz
winterized => ˈwintəraizd
winterizing => ˈwintəraizɪŋ
winterless => 'wintәlis
winterly => 'wintәli
wintersweet => 'wintә'swi:t
Winterthur => 'vintәtjә(r)
wintertime => 'wintәtaim
wintery => 'wintәri
Winthrop => 'winθrәp
wintriness => 'wintrinis
wintry => 'wintri
wipe => waip
wiped => waipt
wiped out => ˈwaɪptˈaʊt
wipeout => 'waipaut
wiper => 'waipә
wipers => ˈwaipəz
wipes => waips
wiping => 'waipiŋ
wire => 'waiә
wire grass => ˈwaiə ɡrɑ:s
wire stripper => ˈwaiə ˈstripə
wire wool => ˈwaiə wul
wire-haired => 'waɪərh'eərd
wire-to-wire => 'waɪərt'əw'aɪər
wired => 'waiәd
wireframe => 'waɪəfreɪm
wireless => 'waiәlis
wirelesses => ˈwaɪəlɪsiz
wireline => 'waiəlain
wireman => 'waiәmәn
wirepuller => 'waiә,pjlә(r)
wirer => 'waiәrә
wiretap => 'waiәtæp
wiretapped => ˈwaiəˌtæpt
wiretapper => 'waiә,tæpә(r)
wiretaps => ˈwaiəˌtæps
wireworm => 'waiәwә:m
wirily => 'waiәrili
wiring => 'waiәriŋ
wiry => 'waiәri
wis => wis
Wisconsin => wis'kɒnsin
wisdom => 'wizdәm
wise => waiz
wise woman => waiz ˈwumən
wiseacre => 'waiz.eikә
wisecrack => 'waizkræk
wisecracked => 'waɪzkræk
wisecracking => 'waɪzkrækɪŋ
wisecracks => ˈwaizkræks
wisely => 'waizli
Wiseman => 'waizmәn
wisenheimer => 'waɪzənhaɪmə
wisent => 'wi:zәnt
wish => wiʃ
wish list => wiʃ list
wish-wash => 'wiʃwɔʃ
wishbone => 'wiʃbәun
wishbones => ˈwiʃbəunz
wished => wiʃt
wishes => wiʃiz
wishful => 'wiʃful
wishful thinking => 'wiʃfjl
wishfully => 'wɪʃfəlɪ
wishing => 'wiʃiŋ
wishy-washy => 'wiʃiwɔʃi; (?@) 'wiʃiwɔ:ʃi
wisp => wisp
wisps => wɪsps
wispy => 'wispi
wist => wist
wisteria => wi'stiәriә
wistful => 'wistful
wistfully => 'wɪstfəlɪ
wistfulness => 'wɪstflnəs
wit => wit
witch => witʃ
witch grass => witʃ ɡrɑ:s
witch hazel => witʃ ˈheɪzəl
witchcraft => 'witʃkræft
witched => witʃt
witchery => 'witʃәri
witchetty => 'witʃiti
witching => 'witʃiŋ
witching hour => ˈwitʃiŋ ˈauə
witchlike => 'wɪtʃlaɪk
witchweed => 'witʃwi:d
witchy => 'wɪtʃi
witenagemot => .witinәgi'mәut
with => wið
with it => wið it
withal => wi'ðɒ:l
withdraw => wið'drɒ:
withdrawal => wið'drɒ:l
withdrawals => wiðˈdrɔ:əlz
withdrawn => wið'drɔ:n
withdraws => wiðˈdrɔ:z
withdrew => wið'dru:, wiθ-
withe => wiθ
wither => 'wiðә
withering => 'wiðәriŋ
witheringly => 'wiðəriŋli
witherite => 'wiðәrait
withers => 'wiðәz
withershins => 'wiðәʃinz
withheld => 'wið'held
withhold => wið'hәuld
withholding => wið'hәuldiŋ. wiθ-
withholding tax => wið'hәjldiŋ
withholds => ˈwiðhəudz
withies => ˈwiðiz
within => wi'ðin
without => wi'ðaut
withstand => wið'stænd
withstanding => wiðˈstændɪŋ
withstands => wiðˈstændz
withy => 'wiði
witless => 'witlis
witling => 'witliŋ
witloof => 'wɪtˌləʊf
witness => 'witnis
witnessed => ˈwitnist
witnesses => ˈwitnisiz
witt => wit
witted => 'witid
witter => ˈwɪtə(r)
witticism => 'witisizm
witticisms => ˈwitisizəmz
wittier => ˈwɪti:ə
wittily => 'witili
wittiness => 'witinis
witting => 'witiŋ
wittingly => 'witiŋli
wittol => 'witl
witty => 'witi
Witwatersrand => wit'wɔ:tәz,rænd, vәt'vɑ:tәs,rɑ:nt
wivern => 'waivәn
wives => waivz
wiz => wiz
wizard => 'wizәd
wizardly => 'wizәdli
wizardry => 'wizәdri
wizards => 'wɪzədz
wizen => 'wizn
wizened => 'wiznd
wo => wә u
woad => wәud
wobbegong => 'wɔbi^ɔŋ
wobble => 'wɒbl
wobbled => ˈwɔbəld
wobbler => 'wɒblә
wobbles => 'wɒblz
wobbliness => 'wɔbli
wobbling => 'wɔbliŋ
wobbly => 'wɒbli
Woburn => 'wəubən
Wodehouse => 'wudhaus
Woden => 'wәjdən
wodge => wɔdʒ
woe => wәu
woebegone => 'wәubi.gɒn
woeful => 'wәuful
woes => wəʊz
wog => wɔ^
woggle => ˈwɒgl
wogs => 'wɒɡz
wok => wɔk
woke => wәuk
woken => 'wәukәn
woks => wɔks
wold => wәuld
wolf => wulf
wolf whistle => wulf ˈhwisl
wolfberry => 'wjlfbəri
wolfe => wulf
wolfgang => 'wulf^æŋ
wolfhound => 'wulfhaund
wolfhounds => ˈwulfhaundz
wolfing => wʊlf
wolfish => 'wulfiʃ
wolfishly => 'wʊlfɪʃlɪ
wolfman => 'wʊlfmæn
wolfram => 'wulfrәm
wolframite => 'wulfrәmait
wolfskin => 'wulfskin
Wollaston => 'wulәstәn
wollastonite => 'wulәstәnait
Wolof => 'wәulɔ:f
Wolseley => 'wulzli
Wolsey => 'wulzi
Wolverhampton => 'wjlvә,hæmptәn
wolverine => 'wjlvәri:n
woman => 'wumәn
womanhood => 'wjmәnhjd
womanise => 'wjmәnaiz
womaniser => 'wjmәnaizә(r)
womanish => 'wjmәniʃ
womanist => 'wʊmənɪst
womanize => 'wjmәnaiz
womanized => ˈwumənaizd
womanizer => 'wʊmənaɪzə(r)
womanizing => ˈwʊmənaɪzɪŋ
womankind => 'wjmәnkaind
womanless => 'wʊmənlɪs
womanlike => 'wjmәnlaik
womanliness => 'wʊmənlɪnəs
womanly => 'wumәnli
womb => wu:m
wombat => 'wɒmbәt
wombats => ˈwɔmbəts
wombs => wu:mz
women => 'wimin
womenfolk => 'wiminfәuk
WOMENS => 'wɪmɪn
womyn => 'wimin
won => wʌn
won't => wəʊnt
wonder => 'wʌndә
wonderful => 'wʌndәful
wondering => 'wʌndәriŋ
wonderingly => ˈwʌndrɪŋli
wonderland => 'wʌndәlænd
wonderlands => ˈwʌndəlændz
wonderment => 'wʌndәmәnt
wonderstruck => 'wʌndәstrʌk
wondrous => 'wʌndrәs
wondrously => 'wʌndrəslɪ
wonga => 'wɔŋә
wonk => wɔŋk
wonky => 'wɒŋki
wont => wɒnt
wonted => 'wɒntid
wonton => 'wɒn'tɒn
woo => wu:
wood => wud
wood anemone => wud əˈneməni
wood mouse => wud maus
wood nymph => wud nɪmf
wood pigeon => wud ˈpidʒin
wood thrush => wud θrʌʃ
wood warbler => wud ˈwɔ:blə
Woodbine => 'wudbain
woodblock => ˈwʊdblɒk
woodbox => 'wjdbɔks
woodcarver => 'wjd,kɑ:vә(r)
woodcarving => 'wud.kɑ:viŋ
woodchat => 'wjdtʃæt
woodchip => 'wʊdtʃɪp
woodchuck => 'wud,tʃʌk
woodcock => 'wudkɒk
woodcraft => 'wudkræft
woodcut => 'wudkʌt
woodcutter => 'wud.kʌtә
woodcutters => ˈwʊdˌkʌtəz
woodcutting => 'wud.kʌtiŋ
wooded => 'wudid
wooden => 'wudn
woodenly => 'wʊdnlɪ
woodenness => 'wʊdənnɪs
woodentop => 'wudəntɔp
Woodhouse => 'wjdhajs
woodiest => 'wudi
woodiness => 'wudinis
woodland => 'wudlænd
woodlander => 'wjdlәndә(r) , -,læn-
woodlark => 'wjdlɑ:k
woodless => 'wudlis
woodlice => ˈwʊdlaɪs
woodlot => 'wudlɒt
woodlouse => ˈwʊdlaʊs
woodman => 'wudmәn
woodnote => 'wudnәut
woodpecker => 'wudpekә
woodpeckers => ˈwʊdˌpekəz
woodpile => 'wudpail
woodpiles => ˈwudˌpailz
woodrow => 'wudrәu
woodruff => 'wudrʌf
woods => wjdz
woodshed => 'wjdʃed
Woodside => 'wjdsaid
woodsman => 'wudzmәn
woodstock => 'wjdstɔk
woodsy => 'wudzi
woodward => 'wudwɔ:d
woodwind => 'wudwind
woodwinds => ˈwʊdwɪndz
woodworker => 'wud.wә:kә
woodworking => 'wud.wә:kiŋ
woodworm => 'wudwә:m
woody => 'wudi
woody nightshade => ˈwʊdi: ˈnaɪtˌʃeɪd
wooed => wu:d
wooer => 'wu:ә
woof => wu:f
woofer => 'wu:fә
woofs => wʊf
woofter => 'wjftә(r),'wu:-
wooing => wu:ɪŋ
wool => wul
woolen => 'wulin
Wooler => 'wulә
woolf => wulf
woollen => 'wulin
woollens => ˈwʊlənz
woollier => ˈwʊli:ə
woollies => ˈwʊli:z
woolliness => 'wulinis
woolly => 'wuli
woolly bear => ˈwʊli: bɛə
woolly mammoth => ˈwʊli: ˈmæməθ
woolly rhinoceros => ˈwʊli: raɪˈnɔsərəs
woolly-headed => 'wjli,hedid
woolman => 'wjlmәn
Woolmark => 'wjlmɑ:k
woolmen => 'wʊlmən
woolpack => 'wjlpæk
woolshed => 'wulʃed
woolworth => 'wulwә:θ
wooly => 'wuli
woomera => 'wu:mәrә
woomph => wu:mf,wjmf
Woop Woop => 'wu:p,wu:p
woopie => 'wu:pi
woos => wu:z
woosh => wuʃ
wooshed => wʊʃ
wooshes => wʊʃ
wooshing => wʊʃ
woozy => 'wu:zi
wop => wɒp
wops => wɔps
Worcester => 'wustә
Worcestershire => 'wjstәʃiә(r)
Worcs => wə:ks
word => wә:d
word break => wə:d breik
word of mouth => wə:d ɔv mauθ
word order => wə:d ˈɔ:də
word salad => wə:d ˈsæləd
word square => wə:d skwɛə
wordage => 'wә:didʒ
wordbook => 'wә:dbuk
wordily => 'wә:dili
wordiness => 'wә:dinis
wording => 'wә:diŋ
wordless => 'wә:dlis
wordlessly => ˈwɜ:dlɪslɪ
wordplay => ˈwɜ:dpleɪ
wordsearch => ˈwɜ:dsɜ:tʃ
wordsmith => 'wә:dsmiθ
wordsworth => 'wә:dzwә(:)θ
wordy => 'wә:di
wore => wɒ:
work => wә:k
work ethic => wə:k ˈeθik
work experience => wə:k iksˈpiəriəns
work of art => wə:k ɔv ɑ:t
work surface => wə:k ˈsə:fis
workability => .wә:kә'biliti
workable => 'wә:kәbl
workaday => 'wә:kәdei
workaholic => .wә:kә'hɒlik
workaholics => ˌwɜ:kəˈhɔ:lɪks
workaround => 'wә:kә.raund
workbasket => 'wә:k.bæskit
workbench => 'wә:kbentʃ
workbenches => ˈwɜ:kˌbentʃiz
workbooks => ˈwɜ:kˌbʊks
workbox => 'wә:kbɒks
workdays => ˈwɜ:kˌdeɪz
worked => wә:kt
worker => 'wә:kә
workflow => 'wɜ:kfləʊ
workforces => ˈwɜ:kˌfɔ:siz
workhorses => ˈwə:khɔ:siz
workhouses => ˈwə:khausiz
working => 'wә:kiŋ
working class => ˈwɜ:kɪŋ klɑ:s
working girl => ˈwɜ:kɪŋ ɡə:l
working group => ˈwɜ:kɪŋ ɡru:p
working party => ˈwɜ:kɪŋ ˈpɑ:ti
workingman => 'wә:kiŋmæn
workless => 'wә:klis
workload => 'wә:klәud
workloads => 'wɜ:kləʊdz
workman => 'wә:kmәn
workmanship => 'wә:kmәnʃip
workmates => ˈwɜ:kmeɪts
workout => 'wә:kaut
workouts => ˈwɜ:kˌaʊts
workpeople => wɜ:k'pi:pl
workpiece => 'wә:kpi:s
workpieces => 'wɜ:kpi:sɪz
workplaces => ˈwə:kpleisiz
workroom => 'wә:krum
workshop => 'wә:kʃɒp
workshops => ˈwə:kʃɔps
workstation => 'wә:k.steiʃәn
workstations => ˈwə:ksteiʃənz
worktable => 'wә:kteibl
workweek => 'wә:kwi:k
world => wә:ld
world language => wɜː(r)ld ˈlæŋɡwidʒ
world music => wɜː(r)ld ˈmju:zik
world view => wɜː(r)ld vju:
world war => wɜː(r)ld wɔ:
world wide => wɜː(r)ld waid
worldliness => 'wә:ldlinis
worldling => 'wә:ldliŋ
worldly => 'wә:ldli
worlds => wɜː(r)ldz
worldview => 'wɜ:ldvju:
worldwide => 'wә:ldwaid
worm => wә:m
worm lizard => wə:m ˈlɪzəd
wormhole => 'wә:mhәul
worming => 'wә:miŋ
worms => wә:mz. vɔ:rms
wormseed => 'wә:msi:d
wormwood => 'wә:mwud
wormy => 'wә:mi
worn => wɒ:n
worn out => wɔ:n aut
worn-out => wɔ:n-'aut
worried => 'wʌrid
worrier => 'wʌriә
worriers => ˈwʌriəz
worriment => 'wʌrimәnt
worrisome => 'wʌrisәm
worrit => 'wʌrit
worry => 'wʌri
worrying => 'wʌriiŋ
worryingly => 'wʌrɪɪŋlɪ
worrywart => 'wʌriwɒ:t
worse => wә:s
worsen => 'wә:sn
worsened => ˈwɜ:sənd
worsening => 'wɜ:snɪŋ
worsens => ˈwɜ:sənz
worship => 'wә:ʃip
worshiper => 'wә:ʃipә
worshipful => 'wә:ʃipful
worshiping => ˈwə:ʃipɪŋ
worshipped => 'wə:ʃip
worshippers => 'wɜːʃɪpə
worships => ˈwə:ʃips
worst => wә:st
worsted => 'wustid
wort => wә:t
worth => wә:θ
worthier => ˈwə:ðiə
worthies => ˈwə:ðiz
worthily => 'wә:ðili
worthiness => 'wә:ðinis
worthless => 'wә:θlis
worthwhile => 'wә:θ'hwail
worthy => 'wә:ði
wot => wɔt
would => wud
would-be => 'wudbi:
wouldn't => ˈwʊdnt
wouldst => wjdst
wound => wu:nd
wound-up => 'waʊnd'ʌp
woundwort => 'wu:ndwә:t
wove => wәuv
wove paper => wəʊv ˈpeipə
woven => 'wәuvәn
wow => wau
wowed => waʊd
wowing => waʊɪŋ
wows => waʊz
wowser => 'wauzә
WRAC => ræk
wrack => ræk
wracked => ræk
wracks => ræk
WRAF => ræf
wraith => reiθ
wraiths => reɪθs
wrangle => 'ræŋgl
wrangled => ˈræŋgəld
wrangler => 'ræŋglә
wranglers => ˈræŋɡləz
wrangles => ˈræŋgəlz
wrangling => ˈræŋgəlɪŋ
wrap => ræp
wraparound => 'ræpәraund
wrapped => ræpt
wrapper => 'ræpә
wrappers => ˈræpəz
wrapping => 'ræpiŋ
wrasse => ræs
wrath => rɒ:θ
wrathful => 'rɒ:θful
wrathfully => 'ræθfəli
wrathy => 'rɔ:θi
wreak => ri:k
wreaked => ri:kt
wreaking => ri:kɪŋ
wreaks => ri:ks
wreath => ri:θ
wreathe => ri:ð
wreathed => ri:ðd
wreathes => ri:ðz
wreathing => 'ri:ðiŋ
wreaths => ri:ðz
wreck => rek
wreckage => 'rekidʒ
wrecked => rekt
wrecker => 'rekә
wreckers => ˈrekəz
wreckfish => 'rekfiʃ
wrecking => 'rekiŋ
wrecking ball => ˈrekiŋ bɔ:l
wrecks => reks
wren => ren
wrench => 'rentʃ
wrenched => rentʃt
wrenches => rentʃiz
wrenching => 'rentʃiŋ
wrens => renz
wrest => rest
wrested => restid
wresting => restɪŋ
wrestle => 'resl
wrestled => ˈresld
wrestler => 'reslә
wrestlers => 'resləz
wrestles => ˈreslz
wrestling => 'resliŋ
wrests => rests
wretch => retʃ
wretched => 'retʃid
wretchedly => 'retʃɪdlɪ
wretchedness => 'retʃɪdnəs
wretches => retʃiz
wriggle => 'rigl
wriggled => ˈrɪgəld
wriggler => 'ri^lә
wriggles => ˈrɪgəlz
wriggling => ˈrɪgəlɪŋ
wriggly => 'rigli
wright => rait
Wrigley => 'rigli:
wring => riŋ
wringer => 'riŋә
wrings => riŋz
wrinkle => 'riŋkl
wrinkled => 'riŋkld
wrinkling => 'riŋkliŋ
wrinkly => 'riŋkli
wrist => rist
wristband => 'ristbænd
wristlet => 'ristlit
wrists => rɪsts
wristwatch => 'ristwɒtʃ
wristwatches => ˈrɪstˌwɔtʃiz
wristy => 'risti
writ => rit
writ large => rɪt lɑ:dʒ
writable => 'raitәbl
write => rait
write-down => 'raitdaun
write-off => 'rait,ɔf
write-protect => 'raitprәj,tekt
writer => 'raitә
writer's cramp => ˈraɪtəz
writerly => 'raɪtəlɪ
writes => raits
writhe => raið
writhed => raɪðd
writhen => 'riðәn
writhes => raɪðz
writhing => raɪðɪŋ
writing => 'raitiŋ
writing pad => ˈraitiŋ pæd
writings => 'raitiŋz
writs => rɪts
written => 'ritn
wrong => rɒŋ
wrong-foot => rɔŋ fut
wrong-headed => ˈrɔ:ŋˈhedɪd, ˈrɔŋ-
wrongdoer => 'rɒŋ'du:ә
wrongdoers => ˈrɔ:ŋˌdu:əz
wrongdoing => 'rɒŋ'du:iŋ
wrongdoings => ˈrɔŋˈdu:iŋz
wronged => rɒŋd
wrongful => 'rɒŋful
wrongfully => 'rɔŋfjli
wronghead => 'rɔŋhed;'rɔ:ŋ-
wrongheaded => rɒŋ'hedid
wronging => rɔŋɪŋ
wrongs => rɔŋz
wrote => rәut
wroth => rɒ:θ
wrought => rɒ:t
wrought-up => 'rɔ:tʌp
wrung => r ʌŋ
wry => rai
wrybill => 'raibil
wryly => raɪlɪ
wryneck => 'rainek
wulfenite => 'wulfәnait
wunderkind => 'vundәkint
Wundt => vunt
Wuppertal => 'vjpәrtɑ:l
wurst => wә:st
wurtzite => 'wә:tsait
wushu => 'wu:'ʃu:
wuss => wʊs
wussy => 'wʌsɪ
wuther => 'wʌðə
Wyandot => 'waiәndɔt
wyatt => 'waiәt
wye => wai
wyes => waɪ
Wykehamist => 'wikәmist
wynd => waind
Wyoming => wai'әumiŋ
wysiwyg => 'wiziwi^
wyvern => 'waivә:n