waddingtons => Waddington
waldensians => Waldensian
waldrons => Waldron
wales => wale
walkmans => walkman
waring => ware
washingtonians => Washingtonian
waterstones => Waterstone
watteaus => Watteau
wcs => WC
weas => WEA
weberians => Weberian
wednesdays => Wednesday
weer => wee
wessons => Wesson
westlands => Westland
westphalians => Westphalian
whigs => Whig
whiteheads => Whitehead
whittakers => Whittaker
wights => Wight
wilberforces => Wilberforce
wilcocks => Wilcock
willems => Willem
willetts => Willett
willeys => Willey
wilts => wilt
winters => winter
wittons => Witton
womens => women
woodbines => Woodbine
woodlands => woodland
woodscrews => woodscrew
woolies => wooly
woolleys => Woolley
woosters => Wooster
ws => W
wyeth => Wyeth