E => i:
e'en => i:n
e'er => eә
e-business => ɪ'bɪznɪs
e-commerce => 'i:kɒmɜ:s
e-tailer => ˈi:ˌteɪlə
e-zine => ˈi:ˌzi:n
each => i:tʃ
Eadwine => 'edwin
eager => 'i:gә
eagerness => 'i:gәnis
eagle => 'i:gl
eagle eye => ˈi:ɡl ai
eagle owl => ˈi:ɡl aul
eagle ray => ˈi:ɡl rei
eaglet => 'i:glit
eagre => 'eigә
Ealing => 'i:liŋ
ear => iә
ear lobe => iə ləʊb
ear shell => iə ʃel
ear-splitting => ˈɪəˌsplɪtɪŋ
earache => 'iәreik
eardrum => 'iәdrʌm
eardrums => ˈɪəˌdrʌmz
eared => iәd
eared seal => iəd si:l
earflap => 'iәflæp
earful => 'iәful
earhole => 'iәhәul
earl => ә:l
earldom => 'ә:ldәm
earless => 'iәlis
earliest => 'iәliist
earliness => 'ә:linis
earlobe => 'iәlәub
earlobes => ˈɪəˌləʊbz
earlock => 'ɪəlɒk
early => 'ә:li
early closing => ˈɜrli ˈkləuziŋ
earmark => 'iәmɑ:k
earmarked => ˈɪəˌmɑ:kt
earmarks => ˈɪəˌmɑ:ks
earmuff => 'iәmʌf
earn => ә:n
earn-out => ə:n aut
earned => ә:nd
earned run => ɜ:nd rʌn
earner => 'ә:nә
earners => 'ə:nəz
earnest => 'ә:nist
earning => 'ә:niŋ
earnings => 'ә:niŋ
earns => ə:nz
earphone => 'iәfәun
earphones => ˈɪəfəʊnz
earpiece => 'iәpi:s
earpieces => ˈiəpi:siz
earplug => 'iәplʌg
earplugs => 'ɪəplʌɡz
earring => 'iәriŋ
earshot => 'iәʃɒt
earth => ә:θ
earth mother => ə:θ ˈmʌðə
earth mover => ə:θ ˈmu:və
earth science => ə:θ ˈsaiəns
earth tremor => ə:θ ˈtremə
earthbound => '\\\\:θbajnd
earthed => ɜ:θt
earthen => 'ә:θәn
earthenware => 'ә:θәnweә
earthiness => 'ә:θinis
earthing => 'ә:θiŋ
earthlight => 'ә:θlait
earthliness => 'ә:θlinis
earthling => 'ә:θliŋ
earthlings => ˈə:θliŋz
earthly => 'ә:θli
earthmover => 'ә:θmu:vә
earthnut => 'ә:θnʌt
earthquake => 'ә:θkweik
earths => ə:θs
earthshine => 'ә:θʃain
earthstar => '\\\\:θstɑ:(r)
earthward => 'ә:θwәd
earthwards => '\\\\:θwәdz
earthwork => '\\\\:θw\\\\:k
earthworks => 'ɜ:θwɜ:ks
earthworm => 'ә:θwә:m
earthworms => ˈɜ:θˌwɜ:mz
earthy => 'ә:θi
earwax => 'iәwæks
earwig => 'iәwi^
earwigging => 'iə,wiɡiŋ
earwigs => ˈiəwiɡz
earwitness => 'iә'witnis
earworm => 'iәwә:m
ease => i:z
easeful => 'i:zful
easel => 'i:zәl
easels => ˈi:zəlz
easement => 'i:zmәnt
easer => 'i:zә
eases => i:ziz
easier => 'i:ziә
easily => 'i:zili
easiness => 'i:zinis
easing => 'i:ziŋ
east => i:st
East Flanders => i:st 'flɑ:ndәz
East London => i:st'lʌndәn
eastbound => 'i:stbaund
Eastbourne => 'i:stbɔ:n
Easter => 'i:stә
easterlies => 'i:stәlis
easterly => 'i:stәli
eastern => 'i:stәn
easterner => 'i:stәnә(r)
easternmost => 'i:stәnmәust
Eastertide => 'i:stәtaid
easting => 'i:stiŋ
eastman => 'i:stmәn
Easton => 'i:stən
eastward => 'i:stwәd
eastwardly => 'i:stwәdli
eastwards => 'i:stwәdz
easy => 'i:zi
easy-care => ˈi:zi kɛə
easygoing => 'i:zigәuiŋ
eat => i:t
eat in => i:t in
eat-in => i:t in
eatable => 'i:tәbl
eaten => 'i:tәn
eater => 'i:tә
eateries => ˈi:təriz
eaters => ˈi:təz
eatery => 'i:tәri
eating => 'i:tiŋ
eating apple => ˈi:tiŋ ˈæpl
eating disorder => ˈi:tiŋ disˈɔ:də
eaton => 'i:tn
eats => i:ts
eau => әu
eau de toilette => ˌəʊ də twɑ:ˈlet
eau de vie => ,әjdә'vi:
eave => i:v
eaves => i:vz
eavesdrop => 'i:vzdrɒp
eavesdropped => ˈi:vzˌdrɔpt
eavesdropper => 'i:vzdrɒpә
eavesdroppers => 'i:vz,drɔpə
eavesdropping => 'i:vzdrɒpiŋ
eavesdrops => ˈi:vzˌdrɔps
eb => eb
ebb => eb
ebbed => ebd
ebbing => ebɪŋ
ebbs => ebz
EBCDIC => 'epsidik
Ebenezer => ,ebi'ni:zә
Ebola fever => i:'bəʊlə fi:və(r)
ebon => 'ebәn
Ebonics => 'ebəniks
ebonies => 'eb(ə)nɪ
ebonite => 'ebәnait
ebonize => 'ebәnaiz
ebony => 'ebәni
Eboracum => i'bɔ:rəkəm
Ebro => 'eibrәj
ebullience => i'bʌljәns
ebullient => i'bʌljәnt
ebullition => .ebә'liʃәn
EC => ek
ecad => 'i:kæd
ecbolic => ek'bɒlik
eccentric => ik'sentrik
eccentrically => ik'sentrikli
eccentricities => ˌeksenˈtrɪsɪti:z
eccentricity => .eksen'trisiti
ecchymosis => eki'mәusis
eccles => 'eklz
ecclesial => i'kli:ziәl
ecclesiarch => i'kli:ziɑ:k
Ecclesiastes => i,kli:zi'æsti:z
ecclesiastic => i.kli:zi'æstik
ecclesiastical => i.kli:zi'æstikәl
ecclesiastically => ɪkli:s'ɪæstɪklɪ
ecclesiasticism => i.kli:zi'æstisizm
ecclesiastics => iˌkli:ziˈæstiks
Ecclesiasticus => i,kli:zi'æstikәs
ecclesiology => i.kli:zi'ɒlәdʒi
eccrine => 'ekrin, 'ekrain
ecdysiast => ek'diziæst
ecdysis => 'ekdisis
ecdysone => 'ekdisәjn
echelon => 'eʃәlɒn
echelons => ˈeʃəˌlɔnz
echeveria => ,etʃi'veriә, ek-
echidna => e'kidnә
echinoderm => i'kainәdә:m
echinoid => i'kainɔid
echinus => e'kainәs
echiuran => 'etʃɪərən
echiuroid => ,i:ki'juә,rɔid
echo => 'ekәu
echocardiogram => 'ekәj'kɑ:diә^ræm
echocardiograph => et'ʃəʊkɑ:dɪəʊɡræf
echocardiography => ,ekәu,kɑ:di'ɔ^rәfi
echoed => ˈekəud
echoes => ˈekəuz
echoey => 'ekəʊiː
echogram => 'ekәu,^ræm
echograph => 'ekәu,^rɑ:f
echoic => e'kәuik
echoing => 'ekәuiŋ
echolalia => ,ekәu'leiliә
echoless => e'kəʊles
echolocation => ekәjlәj'keiʃ(ә)n
echopraxia => ,ekәu'præksjә
echovirus => 'ekәj,vaiәrәs
echt => ekt
eclair => ɪˈkleə(r)
eclairs => i'kleə(r)
eclampsia => ek'læmpsiә
eclectic => ek'lektik
eclectically => ek'lektikәli
eclecticism => ek'lektisizm
eclectics => ek'lektiks
eclipse => i'klips
eclipsed => iˈklipst
eclipses => iˈklipsiz
ecliptic => i'kliptik
eclogite => 'eklәdʒait
eclogue => 'eklɒg
eclosion => i'klәuʒәn
eco- => ˈi:kəʊ
ecocentric => ,ekə'sentrik
ecocide => 'ekәusaid
ecocline => 'ekәuklain
ecofeminist => ,əkəu'feminist
ecological => .i:kә'lɒdʒikәl
ecologist => i:'kɒlәdʒist
ecologists => i:ˈkɔlədʒɪsts
ecology => i:'kɒlәdʒi
econobox => i:kɒ'nəʊbɒks
econometric => i,kɔnә'metrik
econometrician => i,kɔnәmә'triʃәn
econometrics => i.kɒnә'metriks
economic => .i:kә'nɒmik
economic rent => ˌɪkəˈnɔmik rent
economical => .i:kә'nɒmikәl
economically => i:kә'nɔmikәli
economics => .i:kә'nɒmiks
economies => iˈkɔnəmiz
economise => i'kɔnәmaiz
economism => i'kɔnәmizәm
economist => i:'kɒnәmist
economistic => i(:)kɔnә'mistik
economists => ɪ'kɒnəmɪsts
economization => i.kɒnәmai'zeiʃәn
economize => i'kɒnәmaiz
economized => ɪˈkɔnəˌmaɪzd
economizer => i'kɒnәmaizә
economizes => ɪˈkɔnəˌmaɪziz
economizing => ɪˈkɔnəˌmaɪzɪŋ
economy => i'kɒnәmi
economy-size => ɪ'kɒnəmi:s'aɪz
ecosphere => 'i:kәu,sfiә
ecossaise => e'kɒseɪɪz
ecosystem => 'i:kәu.sistәm
ecosystems => ˈekəʊˌsɪstəmz
ecotage => 'ekәtɑ:ʒ
ecoterrorism => ˈi:kəʊterərɪzəm
ecotone => 'i:kәutәun
ecotour => ekə'tɜ:
ecotourism => ˈi:kəʊtʊərɪzəm
ecotoxicology => ekətɒksɪ'kɒlədʒɪ
ecotype => 'i:kәutaip
ECOWAS => e'kəuəs
ecru => 'eikru:
ecstasies => ˈekstəsiz
ecstasy => 'ekstәsi
ecstatic => ik'stætik
ecstatically => ik'stætikli
ectoderm => 'ektәudә:m
ectogene => 'ektәudʒi:n
ectogenesis => ,ektәu'dʒenisis
ectomorph => 'ektәmɒ:f
ectomorphic => ,ektә'mɔ:fik
ectomorphy => 'ektәmɔ:fi
ectoparasite => ,ektәu'pærәsait
ectoparasitic => 'ektəʊ,pærə'sɪtɪk
ectopic => ek'tɔpik
ectoplasm => 'ektәuplæzәm
ectoproct => 'ektәuprɔkt
ectotherm => 'ektәuθә:m
ectothermic => ek'təʊθɜ:mɪk
ectropion => ek'trәupjәn
Ecuador => 'ekwәdɒ:
Ecuadorian => .ekwә'dɒ:riәn
ecumenical => ,i:kju(:)'menikәl
ecumenism => 'ekjuminizәm
eczema => 'eksimә
edacious => i'deiʃәs
edacity => i'dæsәti
Edam => 'i:dәm
edamame => e'dɑ:meɪm
edaphic => i'dæfik
Edda => 'edә
eddie => 'edi
eddied => ˈedi:d
eddies => ˈedi:z
Eddington => 'ediŋtәn
eddo => 'edәu
eddy => 'edi
eddying => 'ediiŋ
Ede => ei'dei
edelweiss => 'eidәlvais
edema => i(:)'di:mә
Eden => 'i:dn
edentate => i:'denteit
edentulous => i:'dentjulәs
edgar => 'ed^ә
edge => edʒ
edge city => edʒ ˈsiti
edged => edʒd
edgeless => 'edʒlis
edger => 'edʒә
edgeways => 'edʒweiz
edgewise => 'edʒwaɪz
Edgeworth => 'edʒwә:θ
edgier => ˈedʒi:ə
edgily => 'edʒili
edginess => 'edʒinis
edging => 'edʒiŋ
edgy => 'edʒi
edh => 'eð
edibility => .edi'biliti
edible => 'edibl
edible snail => ˈedibl sneil
edict => 'i:dikt
edictal => i:'diktәl
edicts => ˈi:ˌdɪkts
Edie => 'i:di
edification => .edifi'keiʃәn
edifice => 'edifis
edifices => ˈedəfɪsiz
edified => ˈedəˌfaɪd
edifies => ˈedəˌfaɪz
edify => 'edifai
edifying => 'edifaiiŋ
Edinburgh => 'edinbәrә
Edirne => e'diəne
Edison => 'edisn
edit => 'edit
editable => 'editəbl
edith => 'i:diθ
editing => 'editiŋ
editio princeps => i'diʃiә 'prinseps
edition => i'diʃәn
editions => ɪ'dɪʃnz
editor => 'editә
editorial => .edi'tɒ:riәl
editorialist => ,edi'tɔ:riәlist
editorialize => .edi'tɒ:riәlaiz
editorialized => ediˈtɔ:riəlaizd
editorializes => ediˈtɔ:riəlaiziz
editorializing => ediˈtɔ:riəlaizɪŋ
editorially => .edi'tɔ:riәli
editorials => ˌediˈtɔ:riəlz
editorship => 'editәʃip
editress => 'editris
editrix => 'edɪtrɪks
edmond => 'edmәnd
edmonton => 'edmәntәn
edmund => 'edmәnd
EDNA => 'ednә
EDTA => ,i:,di:,ti:'ei
educability => .edjukә'biliti
educate => 'edjukeit
educated => 'edjukeitid
educates => ˈedju:keits
educating => ˈedju:keitɪŋ
education => .edju'keiʃәn
educational => .edju'keiʃәnl
educationalist => ,edju(:)'keiʃәnәlist
educationally => .edju'keiʃәnli
educationist => .edju'keiʃәnist
educationists => ˌedju(:)ˈkeiʃənists
educative => 'edjukәtiv
educator => 'edjukeitә
educators => 'edʒʊkeɪtəz
educe => i'dju:s
educed => iˈdju:st
educes => iˈdju:siz
educible => i'dju:sәbl
educing => iˈdju:sɪŋ
eduction => i'dʌkʃәn
edulcorate => i'dʌlkәreit
edulcorated => ɪ'dʌlkəreɪt
edulcorates => ɪ'dʌlkəreɪt
edulcorating => ɪ'dʌlkəreɪt
edutainment => ˌedjuˈteɪnmənt
edward => 'edwәd
edwardian => ed'wɔ:djәn
Edwards => 'edwәdz
edwin => 'edwin
Edwina => 'edwinә
eek => i:k
eel => i:l
eelgrass => 'i:lgrɑ:s
eeling => 'i:liŋ
eelpout => 'i:lpaut
eelworm => 'i:lwә:m
eely => 'i:li
eerie => 'iәri
eerier => ˈɪəri:ə
eeriness => 'iәrinis
eery => 'iәri
ees => 'i:z
eff => ef
effable => 'efәbl
efface => i'feis
effaced => ɪˈfeɪst
effacement => ɪ'feɪsmənt
effaces => ɪˈfeɪsiz
effacing => ɪˈfeɪsɪŋ
effect => i'fekt
effective => i'fektiv
effectively => i'fektivli
effectiveness => i'fektivnis
effectivity => i,fek'tivәti
effector => i'fektә
effectual => i'fektʃuәl
effectually => i'fektʃuәli
effectuate => i'fektʃueit
effectuated => iˈfektjueitid
effectuates => iˈfektjueits
effectuating => iˈfektjueitɪŋ
effectuation => i.fektʃu'eiʃәn
effed => ef
effeminacy => i'feminәsi
effeminate => i'feminit
effeminately => ɪ'femɪnətlɪ
effendi => e'fendi
efferent => 'efәrәnt
effervesce => .efә'ves
effervesced => ˌefəˈvest
effervescence => .efә'vesns
effervescent => .efә'vesnt
effervesces => ˌefəˈvesiz
effervescing => ˌefəˈvesɪŋ
effete => i'fi:t
efficacious => .efi'keiʃәs
efficaciously => ˌefə'keɪʃəslɪ
efficaciousness => efiˊkeiʃәsnis
efficacy => 'efikәsi
efficiencies => iˈfiʃənsiz
efficiency => i'fiʃәnsi
efficient => i'fiʃәnt
efficiently => i'fiʃәntli
effigies => e'fɪdʒɪz
effigy => 'efidʒi
effing => ˈefɪŋ
effleurage => ,eflә'rɑ:dʒ
effloresce => .eflɒ:'res
effloresced => ˌeflɔ:ˈrest
efflorescence => .eflɒ:'resәns
efflorescent => .eflɒ:'resәnt
effloresces => ˌeflɔ:ˈresiz
efflorescing => ˌeflɔ:ˈresɪŋ
effluence => 'efluәns
effluent => 'efluәnt
effluents => 'eflʊənts
effluvia => i'flu:vjә
effluvium => i'flu:viәm
efflux => 'eflʌks
effort => 'efәt
effortful => 'efәtfjl
effortless => 'efәtlis
effortlessly => 'efətləslɪ
effrontery => i'frʌntәri
effs => ef
effulgence => i'fʌldʒәns
effulgent => i'fʌldʒәnt
effuse => i'fju:z
effused => iˈfju:zd
effuses => iˈfju:ziz
effusing => iˈfju:zɪŋ
effusion => i'fju:ʒәn
effusions => ɪf'ju:ʒnz
effusive => i'fju:siv
effusively => ɪ'fju:sɪvlɪ
effusiveness => iˊfjuːsivnis
Efik => 'efik
eft => eft
EFTA => 'eftә
egad => i:'^æd
egalitarian => i.gæli'tєәriәn
egalitarianism => i.ɡæli'tεәriәnizәm
egest => i:'gest
egested => i:ˈdʒestid
egesting => i:ˈdʒestɪŋ
egests => i:ˈdʒests
egg => eg
egg cream => eɡ kri:m
egg cup => eɡ kʌp
egg roll => eɡ rəul
egg timer => eɡ ˈtaɪmə
egg tooth => eɡ tu:θ
egg white => eɡ hwait
egg-bound => 'e^bajnd
Eggar => 'e^ә(r)
eggbeater => 'egbi:tә
egger => 'e^ә(r)
egghead => 'eghed
eggheads => ˈeɡhedz
eggless => 'eɡlɪs
eggnog => ˈegnɒg
eggplant => 'egplɑ:nt
eggplants => 'eɡplɑ:nts
eggshell => 'egʃel
eggshells => ˈeɡʃelz
eggy => ˈeɡi
eglantine => 'eglәntain
ego => 'egәu. 'i:gәu
ego trip => ˈeɡəu trip
ego-ideal => 'eɡəʊaɪd'ɪəl
egocentric => .egәu'sentrik
egocentricity => ,e^әjsen'trisәti
egoism => 'egәuizm
egoist => 'egәuist
egoistic => .egәu'istik
egoistical => .egәu'istikәl
egoistically => .egәu'istikli
egoists => ˈi:ɡəuists
egomania => .egәu'meiniә
egomaniac => ,i:^әj'meinjæk,,e^-
egomaniacal => ,i:^әjmә'naiәkәl
egos => ˈeɡəuz
egotism => 'egәutizm
egotist => 'egәutist
egotistic => .egәu'tistik
egotistical => .egәu'tistikәl
egotize => 'egәutaiz
egregious => i'gri:dʒiәs
egregiously => ɪɡ'ri:dʒɪəəslɪ
egress => 'i:gres
egresses => 'iːgres
egret => 'i:gret
Egypt => 'i:dʒipt
Egyptian => i'dʒipʃәn
Egyptianization => i,dʒipʃәnai'zeiʃәn;-ni'z-
Egyptianize => i'dʒipʃәnaiz
Egyptologist => i:dʒip'tɒlәdʒist
Egyptology => i:dʒip'tɒlәdʒi
eh => ei
eicosapentaenoic acid => 'aikəusə,pentəi'nəuik
eider => 'aidә
eiderdown => 'aidәdaun
eiderdowns => ˈaidədaunz
eidetic => ai'detik
eidetically => 'aɪdtɪklɪ
eidolon => ai'dәulɒn
eidos => 'aidɔs,'ei-
eiffel => 'aifәl
eigenfrequency => 'ai^әn,fri:kwәnsi
eigenfunction => 'aigәnfʌŋkʃәn
eigenstate => 'eɪdʒenzteɪt
eigenvalue => 'aigәnvælju:
eigenvector => 'ai^әn,vektә(r)
eight => eit
eight ball => eɪt bɔ:l
eighteen => 'ei'ti:n
eighteenmo => ei'ti:nmәu
eighteenth => ei'ti:nθ
eightfold => 'eitfәuld
eighth => eitθ
eighth note => eɪtθ nəut
eighthly => 'eitθli
eighths => eɪtθs
eightieth => 'eitiiθ
eightpence => 'eitpәns
eightsome => 'eitsәm
eighty => 'eiti
eightyfold => ˊeitifould
eina => 'eɪnɑ:
Eindhoven => 'aint,həuvən; 'eint-
einkorn => 'ainkɔ:n
Einstein => 'ainstain
Einsteinian => ain'stainiәn
einsteinium => ain'stainiәm
eire => 'eәrә(r)
eirenic => ai'ri:nik
eirenicon => ai'ri:nikɒn
Eisenhower => 'aizәn.hauә
eisteddfod => ais'teðvɒd
eisteddfods => aisˈtedvɔdz
either => 'i:ðә
ejaculate => i'dʒækjuleit
ejaculated => ɪˈdʒækjəˌleɪtid
ejaculates => ɪˈdʒækjəˌleɪts
ejaculating => ɪˈdʒækjəˌleɪtɪŋ
ejaculation => i.dʒækju'leiʃәn
ejaculator => i'dʒækjuleitә
ejaculatory => i'dʒækjulәtәri
eject => i'dʒekt
ejecta => i'dʒektә
ejection => i'dʒekʃәn
ejection seat => iˈdʒekʃən si:t
ejective => i'dʒektiv
ejectment => i'dʒektmәnt
ejector => i'dʒektә
ejector seat => iˈdʒektə si:t
ejects => iˈdʒekts
ejido => e'hi:ðәj
Ekaterinburg => i'kætәrinb\\\\:^
eke => i:k
eked => i:kt
ekes => i:ks
ekka => 'ekɑ:
Ekman => 'ekmәn
el => el
el cheapo => elˈtʃi:pəu
El Salvador => el'sælvәdɔ:
elaborate => i'læbәreit
elaborated => iˈlæbəreitid
elaborately => i'læbәreitli
elaborateness => iˊlæbәritnis
elaborating => iˈlæbəreitɪŋ
elaboration => i.læbә'reiʃәn
elaborative => i'læbәrәtiv
Elamite => 'i:lәmait
elan => ei'lɑŋ
eland => 'i:lәnd
elapse => i'læps
elapses => iˈlæpsiz
elapsing => iˈlæpsɪŋ
elasmobranch => i'læsmәubræŋk
elastase => i'læsteis
elastic => i'læstik
elastically => i'læstikli
elasticated => ɪˈlæstɪkeɪtɪd
elasticity => i.læs'tisiti
elasticize => i'læstisaiz
elasticized => i'læstisaizd
elastin => i'læstin
elastomer => i'læstәmә(r)
elastomeric => ɪˌlæstə'merɪk
elastoplast => i'læstәplɑ:st;-plæst
Elat => ei'lɑ:t
elate => i'leit
elated => i'leitid
elatedly => i'leitidli
elates => ɪˈleɪts
elating => ɪˈleɪtɪŋ
elation => i'leiʃәn
elba => 'elbә
Elbe => elb
Elbert => 'elbәt
elbow => 'elbәu
elbow-to-elbow => ˈelbəu tu: ˈelbəu
elbowed => ˈelbəud
elbowing => ˈelbəuɪŋ
elbows => ˈelbəuz
Elbrus => el'bru:z
Elche => 'eltʃei
eld => eld
elder => 'eldә
elder statesman => ˈeldə ˈsteitsmən
elderberries => ˈeldəˌberi:z
elderberry => 'eldә.beri
elderly => 'eldәli
elders => ˈeldəz
eldership => 'eldәʃip
eldest => 'eldist
Eldorado => eldә'rɑ:dәj
Eldridge => 'eldridʒ
eldritch => 'eldritʃ
Eleanor => 'elənə; -nɔ:
Eleatic => ,eli'ætik
elecampane => elikæm'pein
elect => i'lekt
electable => i'lektәbl
elected => i'lektid
electing => iˈlektɪŋ
election => i'lekʃәn
electioneer => i.lekʃә'niә
electioneered => ilekʃəˈniəd
electioneers => ilekʃəˈniəz
elective => i'lektiv
electively => e'lektɪvlɪ
elector => i'lektә
electoral => i'lektәrәl
electoral roll => ɪˈlektərəl rəul
electorally => i'lektərəli
electorate => i'lektәrit
electorates => iˈlektərits
electors => ɪˈlektəz
electorship => ɪ'lektəʃɪp
electra => i'lektrә
electress => i'lektris
electret => i'lektrit
electric => i'lektik
electric blue => iˈlektrik blu:
electric fence => iˈlektrik fens
electric guitar => iˈlektrik ɡiˈtɑ:
electric organ => iˈlektrik ˈɔ:ɡən
electric ray => iˈlektrik rei
electric-arc furnace => ɪˈlɛktrɪk ɑrk ˈfɚnɪs
electrical => i'lektrikәl
electrical storm => iˈlektrikəl stɔ:m
electrically => i'lektrikәli
electrician => .ilek'triʃәn
electricians => elekt'rɪʃnz
electricity => .ilek'trisiti
electrics => i'lektriks
electrification => i.lektrifi'keiʃәn
electrified => ɪ'lektrɪfaɪd
electrify => i'lektrifai
electrifying => i'lektrifaiiŋ
electro => i'lektrәu
electro-optic => e'lektrəʊ'ɒptɪk
electro-optical => e'lektrəʊ'ɒptɪkl
electroactive => elektrə'ʊæktɪv
electrocardiogram => ilektrәj'kɑ:diәj^ræm
electrocardiograph => ilektrәj'kɑ:diәj^rɑ:f
electrocautery => i,lektrәj'kɔ:tәri
electrochemical => i.lektәu'kemikәl
electrochemistry => i,lektrәj'kemistri
electrochromic => elektrəʊk'rəʊmɪk
electrocoagulation => i'lektrәjkәj,æ^jj'leiʃәn
electroconvulsive => i,lektrәjkәn'vʌlsiv
electrocorticogram => i,lektrәj'kɔ:tikә^ræm
electrocute => i'lektrәkju:t
electrocuted => ilektrəkju:tid
electrocutes => ilektrəkju:ts
electrocuting => ilektrəkju:tɪŋ
electrocution => i.lektrә'kju:ʃәn
electrode => i'lektrәud
electrodermal => i,lektrәj'd\\\\:mәl
electrodes => e'lektrəʊdz
electrodialysis => i,lektrәjdai'ælisis
electrodynamic => i,lektrәjdai'næmik
electrodynamics => ilektrәjdai'næmiks
electroencephalogram => ilektrәjen'sefәlәj^ræm
electroencephalograph => ilektrәjen'sefәlәj^rɑ:f
electroencephalography => i'lektrәjen,sefә'lɔ^rәfi
electrogenic => i,lektrә'dʒenik
electrojet => i'lektrәdʒet
electrokinetic => i,lektrәjkai'netik
electroless => i'lektrәlis
electrolier => i,lektrә'liә(r)
electroluminescence => i'lektrәj,lju:mi'nesәns
electroluminescent => -әnt
electrolyse => i,lektrәlaiz
electrolysis => .ilek'trɒlisis
electrolyte => i'lektrәlait
electrolytes => ɪ'lektrəˌlaɪts
electrolytic => i.lektrә'litik
electrolytical => i,lektrәj'litikәl
electrolytically => ilektrouˊlitikәl
electromagnet => i.lektrәu'mægnit
electromagnetic => ilektrәj'mæ^nitik
electromagnetics => i,lektrәjmæ^'netiks
electromagnetism => ilektrәj'mæ^nitiz(ә)m
electromagnets => ɪˌlektrəʊˈmægnɪts
electromechanical => i,lektrәjmi'kænikәl
electrometer => .ilek'trɒmitә
electrometric => i,lektrә'metrik
electrometry => i,lek'trɔmitri
electromotive => i.lektrә'mәutiv
electromyogram => i,lektrәj'maiә^ræm
electromyograph => i,lektrәj'maiә^rɑ:f;-^ræf
electromyographic => ɪ'lektrəʊ,maɪə'ɡræfɪk
electromyographically => i'lektrəu'maiə,ɡræfikəli
electromyography => i,lektrәjmai'ɔ^rәfi
electron => i'lektrɒn
electronegative => i.lektrәu'negәtiv
electronic => .ilek'trɒnik
electronic publishing => ilekˈtrɔnik ˈpʌblɪʃɪŋ
electronic tagging => ilekˈtrɔnik ˈtæɡiŋ
electronica => ,ilek'trɔnikə
electronics => .ilek'trɒniks
electrons => e'lektrɒnz
electronvolt => 'elektrɒnvəʊlt
electronystagmography => i'lektrәj,nistæ^'mɔ^rәfi
electrophile => i'lektrәfail
electrophilic => i,lektrәj'filik
electrophorese => i,lektrәfә'ri:s
electrophoresis => i,lektrәfә'ri:sis
electrophoretic => i,lektrәfә'retik
electrophorus => .ilek'trɒfәrәs
electrophysiological => i'lektrәj,fiziә'lɔdʒikəl
electrophysiologically => i'lektrəu,fiziəlɔdʒikəli
electrophysiology => i'lektrәj,fizi'ɔlәdʒi
electroplate => .ilek'trɒpleit
electroplated => iˈlektrəupleitid
electroplater => elektrəʊp'leɪtə
electroplates => iˈlektrəupleits
electroplating => i'lektrәj,pleitiŋ
electroplexy => i'lektrәj,pleksi
electropolish => i'lektrәj,pɔliʃ
electroporate => elektrəʊpɔ:'reɪt
electropositive => i.lektrәu'pɒzitiv
electroreceptor => elektrɔ:rɪ'septə
electroretinogram => i,lektrәj'retinә^ræm
electroscope => i'lektrәskәup
electroscopic => i,lektrə'skɔpik
electroshock => i'lektrәuʃɒk
electrostatic => i.lektrә'stætik
electrostatics => i.lektrәu'stætiks
electrosurgery => i,lektrәu'sә:dʒәri
electrosurgical => - dʒikəl
electrotechnics => i'lektrәu'tekniks
electrotechnology => i,lektrәutek'nɔlәdʒi
electrotherapeutical => i'lektrәuθerә'pju:tikәl
electrotherapist => i,lektrәj'θerәpist
electrotherapy => i.lektrәu'θerәpi
electrothermal => i,lektrәj'θ\\\\:məl
electrotype => i'lektrәtaip
electrotyper => e'lektrəʊtaɪpɜ:
electrovalence => i.lektrәu'veilәns
electrovalent => i,lektrәj'veilәnt
electrum => i'lektrәm
elects => iˈlekts
electuary => i'lekjuәri
eleemosynary => .elii:'mɒsinәri
elegance => 'eligәns
elegant => 'eligәnt
elegiac => .eli'dʒaiәk
elegiac couplet => ˌeliˈdʒaiək ˈkʌplɪt
elegies => ˈelədʒi:z
elegist => 'elidʒist
elegize => 'elidʒaiz
elegy => 'elidʒi
Elektra => i'lektrə; 'eliktrə
element => 'elimәnt
elemental => .eli'mentәl
elementalism => elɪ'mentlɪzəm
elementary => .eli'mentәri
elements => 'elimәnts
elemi => 'elimi
elena => ә'leinә,'elәnә
elenchus => i'leŋkәs
elephant => 'elifәnt
elephant ear => ˈelifənt iə
elephant grass => ˈelifənt ɡrɑ:s
elephant seal => ˈelifənt si:l
elephantiasis => .elifәn'taiәsis
elephantine => .eli'fæntain
elephants => 'elɪfənts
elevate => 'eliveit
elevated => 'eliveitid
elevates => ˈeliveits
elevating => ˈelɪveɪtɪŋ
elevation => .eli'veiʃәn
elevations => ˌeləˈveɪʃənz
elevator => 'eliveitә
elevators => 'elɪveɪtəz
elevatory => 'eliveitәri
eleven => i'levn
eleven-plus => ɪˈlevən plʌs
elevenfold => i'levnfәuld
elevenses => i'levәnziz
eleventh => i'levnθ
eleventh hour => ɪˈlevənθ ˈauə
elevon => 'elivɒn
ELF => elf
elf-lock => 'elflɒk
elfin => 'elfin
elfish => 'elfiʃ
Elgar => 'el^ә
elgin => 'elgin
Elia => 'i:liә
elias => i'laiәs
elicit => i'lisit
elicitation => i.lisi'teiʃәn
elicited => iˈlisitid
eliciting => ɪ'lɪsɪtɪŋ
elicits => iˈlisits
elide => i'laid
elided => ɪˈlaɪdid
elides => ɪˈlaɪdz
eliding => ɪˈlaɪdɪŋ
eligibility => .elidʒә'biliti
eligible => 'elidʒәbl
eligibly => 'elidʒәbli
elijah => i'laidʒә
eliminable => i'liminәbl
eliminate => i'limineit
eliminated => iˈlimineitid
eliminates => iˈlimineits
eliminating => iˈlimineitɪŋ
elimination => i.limi'neiʃәn
eliminator => i'limineitә
Elinor => 'elinə; -,nɔ:
ELINT => i'lint
eliot => 'eljәt
Elisabeth => i'lizәbәθ
Elisabethville => i'lizәbәθvil
elise => e'li:z
elisha => i'laiʃә
elision => i'liʒәn
elite => ei'li:t
elites => eiˈli:ts
elitism => ei'litizm
elitist => ei'litist
elitists => ɪˈliːtɪsts
elixir => i'liksә
elixirs => ɪ'lɪksəz
elizabeth => i'lizәbәθ
Elizabethan => i.lizә'bi:θәn
elk => elk
elks => elks
ell => el
ella => 'elә
ellen => 'elin
ellie => 'eli
Elliot => eli'ɔt
ellipse => i'lips
ellipsis => i'lipsis
ellipsoid => i'lipsɒid
ellipsoidal => .elip'sɒidl
elliptic => i'liptik
elliptical => i'liptikәl
elliptically => i'liptikәli
ellipticity => .elip'tisiti
ellis => 'elis
elm => elm
elmer => 'elmә
elmy => 'elmɪ
elocution => .elә'kju:ʃәn
elocutionary => .elә'kju:ʃәnәri
elocutionist => .elә'kju:ʃәnist
elodea => i'lәudiә
Elohim => e'lәuhim
Elohist => e'lәuhist
eloise => 'elәwi:z,,elә'wi:z
elongate => 'i:lɒŋgeit
elongated => ˈi:lɒŋgeɪtɪd
elongates => ɪˈlɔ:ŋˌgeɪts
elongating => i:'lɒŋɡeɪtɪŋ
elongation => .i:lɒŋ'geiʃәn
elongations => ɪˌlɔ:ŋˈgeɪʃənz
elope => i'lәup
eloped => ɪˈləʊpt
elopement => i'lәupmәnt
elopes => ɪ'ləʊp
eloping => ɪˈləʊpɪŋ
eloquence => 'elәkwәns
eloquent => 'elәkwәnt
elsa => 'elsә
Elsan => 'elsæn
else => els
elsewhere => 'elshwєә
Elspeth => 'elspeθ
Elster => 'elstә
elton => 'eltәn
eluant => 'eljuәnt
eluate => 'eljuit, 'eljuwit, -,weit
elucidate => i'lu:sideit
elucidated => ɪˈlu:sɪˌdeɪtid
elucidates => ɪˈlu:sɪˌdeɪts
elucidating => ɪˈlu:sɪˌdeɪtɪŋ
elucidation => i.lu:si'deiʃәn
elucidative => ɪ'lu:sɪdeɪtɪv
elucidator => i'lu:sideitә
elucidatory => ɪ'lu:sɪdeɪtərɪ
elude => i'lu:d
eluded => ɪˈlu:did
eludes => ɪˈlu:dz
eluding => ɪˈlu:dɪŋ
eluent => 'eljjәnt
Elul => 'elul
elusion => i'lu:ʒәn
elusive => i'lu:siv
elusively => i'lju:sivli
elute => i'lju:t
elutes => ɪ'l(j)uːt
eluting => ɪ'lu:tɪŋ
elution => i'lju:ʃәn
elutriate => i'lju:trieit
elutriation => i,lju:tri'eiʃәn
elvan => 'elvәn
elver => 'elvә
elves => elvz
Elvira => el'vaiәrә
elvish => 'elviʃ
Elwyn => 'elwin
ely => 'i:li
Elysian => i'liʒiәn
Elysium => i'liʒiәm
elytron => 'elitrɔn
Elzevir => 'elziviә
EM => em
em- => ɪm
emaciate => i'meisieit
emaciated => i'meisieitid
emaciates => ɪˈmeɪʃi:ˌeɪts
emaciating => ɪˈmeɪʃi:ˌeɪtɪŋ
emaciation => i.meisi'eiʃәn
emalangeni => ,eimɑ:lɑ:ŋ'geini:
emanate => 'emәneit
emanated => ˈeməˌneɪtid
emanates => ˈeməˌneɪts
emanating => ˈeməˌneɪtɪŋ
emanation => .emә'neiʃәn
emancipate => i'mænsipeit
emancipated => i'mænsipeitid
emancipating => ɪˈmænsəˌpeɪtɪŋ
emancipation => i.mænsi'peiʃәn
emancipator => i'mænsipeitә
emancipatory => i'mænsipәtәri
emanuel => i'mænjuәl
emasculate => i'mæskjuleit
emasculated => i'mæskjuleitid
emasculates => iˈmæskjuleits
emasculating => iˈmæskjuleitɪŋ
emasculation => i.mæskju'leiʃәn
emasculator => ɪ'mæskjʊleɪtə
emasculatory => ɪ'mæskjʊlətərɪ
embalm => im'bɑ:m
embalmed => ɪm'ba:md
embalmer => ɪm'bɑ:mə(r)
embalms => emˈbɑ:mz
embank => im'bæŋk
embanked => imˈbæŋkt
embanking => imˈbæŋkɪŋ
embankment => im'bæŋkmәnt
embankments => ɪm'bæŋkmənts
embanks => imˈbæŋks
embargo => im'bɑ:gәu
embargoed => emˈbɑ:ɡəud
embargoes => emˈbɑ:ɡəuz
embargoing => emˈbɑ:ɡəuɪŋ
embark => im'bɑ:k
embarkation => .embɑ:'keiʃәn
embarked => imˈbɑ:kt
embarking => imˈbɑ:kɪŋ
embarks => imˈbɑ:ks
embarrass => im'bærәs
embarrassed => im'bærәst
embarrassedly => im'bærәstli
embarrasses => ɪm'bærəs; em-
embarrassing => im'bærәsiŋ
embarrassingly => im'bærәsiŋli
embarrassment => im'bærәsmәnt
embarrassments => emˈbærəsmənts
embassage => 'embәsidʒ
embassies => ˈembəsiz
embassy => 'embәsi
embattle => im'bætl
embattled => ɪmˈbætld
embay => im'bei
embayment => im'beimәnt
embed => im'bed
embedded => im'bedid
embeddedness => ɪmbe'dɪdnəs
embedding => em'bediŋ
embeds => imˈbedz
embellish => im'beliʃ
embellished => emˈbelɪʃt
embellishes => emˈbelɪʃiz
embellishing => emˈbelɪʃɪŋ
embellishment => im'beliʃmәnt
embellishments => imˈbeliʃmənts
ember => 'embә
embezzle => im'bezl
embezzled => emˈbezəld
embezzlement => im'bezlmәnt
embezzler => im'bezlә
embezzles => emˈbezəlz
embezzling => emˈbezəlɪŋ
embitter => im'bitә
embittered => emˈbɪtəd
embittering => emˈbɪtərɪŋ
embitters => emˈbɪtəz
emblazon => im'bleizn
emblazoned => imˈbleizənd
emblazoning => imˈbleizənɪŋ
emblazonment => ɪmb'leɪzənmənt
emblazons => imˈbleizənz
emblem => 'emblәm
emblematic => ,embli'mætik
emblematical => .embli'mætikәl
emblematically => embliˊmætikәli
emblematist => em'blemәtist
emblematize => em'blemәtaiz
emblement => 'emblmәnt
emblements => 'embl(i)mәnts
emblems => embləmz
embodied => imˈbɔdid
embodies => imˈbɔdiz
embodiment => im'bɒdimәnt
embody => im'bɒdi
embodying => imˈbɔdiŋ
embolden => im'bәuldn
emboldened => emˈbəʊldənd
emboldens => emˈbəʊldənz
embolectomy => ,embә'lektәmi
embolic => em'bɔlik
embolism => 'embәlizm
embolisms => ˈembəlizəmz
embolization => ,embәlai'zeiʃən,-li'z-
embolus => 'embәlәs
embonpoint => ,ɔŋbjŋ'pwæŋ
embosom => im'buzәm
emboss => im'bɒs
embosser => ɪm'bɒsə
embosses => emˈbɔ:siz
embossing => im'bɔsiŋ
embouchure => ,ɔmbu'ʃuә, 'ɔmbu,ʃuә
embourgeoisement => ,embuә'ʒwɑ:zmәnt
embowed => im'bәjd
embowel => im'bauәl
embower => im'bauә, em-
embowered => ɪm'baʊəd
embowers => ɪm'baʊə; em-
embrace => im'breis
embraceable => im'breisəbl
embraced => imˈbreist
embracer => im'breisә(r)
embraces => imˈbreisiz
embracing => imˈbreisɪŋ
embrasure => im'breiʒә
embrasures => 'ɪmbreɪʒəz
embrittle => em'britl
embrittlement => em'britlmәnt
embrocation => embrou'keiʃәn
embroider => im'brɒidә
embroiderer => ɪmb'rɔɪdərə
embroideries => imˈbrɔidəriz
embroidering => ɪm'brɔɪdɚrɪŋ
embroiders => emˈbrɔɪdəz
embroidery => im'brɒidәri
embroil => im'brɒil
embroiled => imˈbrɔil
embroiling => emˈbrɔɪlɪŋ
embroilment => ɪmb'rɔɪlmənt
embroils => emˈbrɔɪlz
embryo => 'embriәu
embryo- => 'embri:əʊ
embryogenesis => ,embriәj'dʒenisis
embryogenic => ,embriәj'dʒenik
embryogeny => .embri'ɒdʒәni
embryologic => ,embriә'lɔdʒik
embryological => ˌembrɪə'lɒdʒɪkl
embryologically => ,embrɪə'lɒdʒɪkəlɪ
embryologist => .embri'ɒlәdʒist
embryology => .embri'ɒlәdʒi
embryonal => ,embri'әunәl
embryonic => .embri'ɒnik
embryos => 'embriәuz
embus => im'bʌs
emcee => 'em'si:
emceed => ˈemˈsi:d
emceeing => ˈemˈsi:ɪŋ
emcees => ˈemˈsi:z
emend => i'mend
emendation => .i:men'deiʃәn
emended => ɪˈmendid
emending => ɪˈmendɪŋ
emends => ɪ'mend
emerald => 'emәrәld
emeralds => ˈemərəldz
emerge => i'mә:dʒ
emergence => i'mә:dʒәns
emergency => i'mә:dʒәnsi
emergency services => ɪˈmɚdʒənsi /ˈsɜːvɪsis/
emergent => i'mә:dʒәnt
emerges => iˈmə:dʒz
emerita => i'merәtә
emeritus => i'meritәs
emersed => i'mә:st
emersion => i'mә:ʒәn
emerson => 'emәsn
emery => 'emәri
emery board => ˈeməri bɔ:d
emesis => 'emәsis
emetic => i'metik
emetics => ɪ'metɪks
emetine => 'emәti:n
emic => 'i:mik
emigrant => 'emigrәnt
emigrate => 'emigreit
emigrated => ˈemiɡreitid
emigrates => ˈemiɡreits
emigrating => ˈemiɡreitɪŋ
emigration => .emi'greiʃәn
emile => ei'mi:l
Emilia => i'miliә
emily => 'emәli
eminence => 'eminәns
eminences => ˈemənənsiz
eminent => 'eminәnt
emir => ә'miә
emirate => e'miәrit
Emirates => əˈmɪrets
emirs => e'mɪəz
emissaries => ˈemɪˌseri:z
emissary => 'emisәri
emission => i'miʃәn
emissions => ɪˈmɪʃənz
emissive => i'misiv
emissivity => .emi'siviti
emit => i'mit
emits => iˈmits
emitter => i'mitә
emitters => ɪ'mɪtəz
Emlyn => 'emlin
emma => 'emә
emmanuel => i'mænjuәl
Emmeline => 'emili:n, -lain
emmenagogue => i'menәgɒg
Emmental => 'emənta:l
emmer => 'emә
emmet => 'emit
Emmy => 'emi
emollience => i'mɔljәns
emollient => i'mɒliәnt
emollients => ɪˈmɔljənts
emolument => i'mɒljumәnt
emoluments => ɪ'mɒljʊmənts
emote => i'mәut
emoted => ɪˈməʊtid
emotes => ɪˈməʊts
emoticon => i'mәutikɔn
emoting => ɪˈməʊtɪŋ
emotion => i'mәuʃәn
emotional => i'mәuʃәnәl
emotionalism => i'mәuʃәnlizәm
emotionalist => i'mәuʃәnәlist
emotionality => i.mәuʃә'næliti
emotionalize => i'mәuʃәnәlaiz
emotionally => i'mәuʃәnәli
emotionless => i'mәuʃәnlis
emotive => i'mәutiv
emotively => iˊmoutivli
emotivism => i'məuti,vizəm
emotivity => i,mәu'tiviti
empanada => ,empә'nɑ:dә
empanel => im'pænl
empath => em'pɑ:θ
empathetic => em'pæθik. .empә'θetik
empathic => em'pæθik
empathically => em'pæθikəli
empathise => 'empəθaiz
empathize => 'empәθaiz
empathized => ˈempəθaizd
empathizes => ˈempəθaiziz
empathizing => ˈempəθaizɪŋ
empathy => 'empæθik
Empedocles => em'pedəkli:z
empennage => 'empenidʒ
emperor => 'empәrә
emperor moth => ˈempərə mɔθ
emperor penguin => ˈempərə ˈpeŋɡwin
emperors => ˈempərəz
emperorship => 'empәrәʃip
emphasis => 'emfәsis
emphasised => 'emfəsaɪz
emphasize => 'emfәsaiz
emphasized => ˈemfəsaizd
emphasizes => ˈemfəsaiziz
emphatic => im'fætik
emphatically => im'fætikәli
emphysema => .emfi'si:mә
empire => 'empaiә
empire-building => ˈemˌpaɪə
empiric => em'pirik
empirical => em'pirikәl
empiricism => em'pirisizm
empiricist => em'pirisist
emplace => im'pleis, em-
emplaced => imˈpleist
emplacement => im'pleismәnt
emplacements => imˈpleismənts
emplaces => imˈpleisiz
emplacing => imˈpleisɪŋ
emplane => im'plein
employ => im'plɒi
employability => em'plɔɪ'bɪlətɪ
employable => im'plɒiәbl
employee => .emplɒi'i:
employer => im'plɒiә
employers => ɪmp'lɔɪəz
employing => imˈplɔiŋ
employment => im'plɒimәnt
employs => imˈplɔiz
empolder => im'pәjldә(r)
emporia => emˈpɔ:riə
emporium => em'pɒ:riәm
empower => im'pauә
empowered => emˈpaʊəd
empowering => ɪm'paʊərɪŋ
empowerment => ɪm'paʊəmənt
empowers => emˈpaʊəz
empress => 'empris
empressement => ә:pres'mә
empresses => emp'rɪsɪz
emptied => 'emptid
emptier => 'emptaiә
emptily => 'emptili
emptiness => 'emptinis
empty => 'empti
empty nester => ˈempti ˈnestə
emptying => 'emptiiŋ
empurple => im'pә:pl
empurpled => em'pɜ:pəld
empyema => .empai'i:mә
empyreal => .empai'ri:әl
empyrean => .empai'ri:әn
EMU => 'i:mju:
emulate => 'emjuleit
emulated => ˈemjuleitid
emulates => ˈemjuleits
emulating => ˈemjuleitɪŋ
emulation => .emju'leiʃәn
emulative => 'emjuleitiv
emulator => 'emjuleitә
emulous => 'emjulәs
emulously => 'emjʊləslɪ
emulsifiable => i'mʌlsifaiәbl
emulsification => i.mʌlsifi'keiʃәn
emulsified => ɪˈmʌlsəˌfaɪd
emulsifier => i'mʌlsifaiә
emulsifiers => ɪ'mʌlsɪfaɪəz
emulsifies => ɪˈmʌlsəˌfaɪz
emulsify => i'mʌlsifai
emulsifying => ɪ'mʌlsɪfaɪɪŋ
emulsion => i'mʌʃәn
emulsion paint => ɪˈmʌlʃən peint
emulsioned => ɪ'mʌlʃ(ə)n
emulsions => ɪ'mʌlʃnz
emulsive => i'mʌlsiv
emus => ˈi:mju:z
en => en
en bloc => ɑŋ 'blɔk
en clair => ɔŋˈklɛə
en masse => ɑŋ 'mæs
en passant => en ˈpæsənt
en prise => en praɪz
en route => ɔn'ru:t
en suite => en swi:t
Ena => 'enə
enable => i'neibl
enabled => i'neibl
enables => iˈneiblz
enabling => iˈneiblɪŋ
enact => i'nækt
enacted => iˈnæktid
enacting => iˈnæktɪŋ
enaction => i'nækʃən
enactive => i'næktiv
enactment => i'næktm(ә)nt
enactments => enˈæktmənts
enacts => iˈnækts
enalapril => e'nælæprɪl
enamel => i'næml
enameled => ɪ'næməld
enameling => i'næmәliŋ
enamelled => ɪˈnæmld
enameller => enæ'mələ
enamels => iˈnæməlz
enamelware => i'næmlwєә
enamor => i'næmә
enamored => i'næmәd
enamoring => ɪˈnæmərɪŋ
enamors => ɪˈnæməz
enamour => i'næmә
enamouring => i'næmə
enanthema => ,enәn'θi:mә
enantiomer => i'næntiәumә
enantiomeric => en,æntiə'merik
enantiomorph => i'næntiәumɔ:f
enantiomorphism => i,næntiә'mɔ:fizәm
enargite => i'nɑ:dʒait
enarthrosis => .enɑ:'θrәusis
enation => e'neɪʃn
encage => in'keidʒ
encamp => in'kæmp
encamped => inˈkæmpt
encamping => inˈkæmpɪŋ
encampment => in'kæmpmәnt
encampments => inˈkæmpmənts
encamps => ɪn'kæmp; en-
encapsidate => in'kæpsideit
encapsulate => in'kæpsәleit
encapsulates => enˈkæpsəˌleɪts
encapsulating => enˈkæpsəˌleɪtɪŋ
encapsulation => in,kæpsju'leiʃәn
encase => in'keis
encased => enˈkeɪst
encasement => in'keismәnt
encases => enˈkeɪsiz
encash => in'kæʃ
encashable => ɪn'kæʃəbl
encasing => in'keisiŋ
encaustic => en'kɒ:stik
enceinte => en'seint
Enceladus => en'selәdәs
encephalic => ,ensi'fælik
encephalitic => en,sefә'litik
encephalitis => .ensefә'laitis
encephalization => en,sefәlai'zeiʃәn
encephalo- => en'sefәlәj, in- , en'kefәlәj
encephalogram => en'sefәlәgræm
encephalograph => en'sefәlәgræf
encephalography => en.sefә'lɒgrәfi
encephalomyelitis => en,sefәlәumaiә'laitis
encephalon => en'sefәlɒn
encephalopathy => en,sefә'lɔpәθi
enchain => in'tʃein
enchant => in'tʃænt
enchanted => ɪnˈtʃɑ:ntɪd
enchanter => in'tʃæntә
enchanters => in'tʃɑ:ntə, en-
enchanting => in'tʃæntiŋ
enchantingly => in'tʃa:ntiŋli
enchantment => in'tʃæntmәnt
enchantments => ɪnˈtʃɑ:ntmənts
enchantress => in'tʃæntris
enchants => inˈtʃɑ:nts
enchase => in'tʃeis
enchased => inˈtʃeist
enchilada => ,entʃi'lɑ:dә
enchiladas => ˌentʃiˈlɑ:dəz
enchiridion => ,enkaiә'ridiәn
encina => en'si:nә
encipher => in'saifә
enciphered => enˈsaɪfəd
enciphering => enˈsaɪfərɪŋ
enciphers => enˈsaɪfəz
encircle => in'sә:kl
encircled => enˈsɜ:kəld
encirclement => in'sә:klmәnt
encircles => enˈsɜ:kəlz
enclasp => en'klɑ:sp
enclave => en'cleiv
enclaves => 'enkleɪvz
enclitic => in'klitik
enclitics => ɪn'klɪtɪk; en-
enclose => in'klәuz
enclosed => in'klәuzd
encloses => inˈkləuziz
enclosing => inˈkləuzɪŋ
enclosure => in'klәuʒә
enclosures => enk'ləʊʒəz
encode => in'kәud
encoder => in'kәudә
encodes => enˈkəʊdz
encoding => in'kәudiŋ
encomiast => en'kәumiæst
encomiastic => en.kәumi'æstik
encomienda => en,kəumi'endə
encomium => en'kәumjәm
encomiums => enˈkəʊmi:əmz
encompass => in'kʌmpәs
encompassed => enˈkʌmpəst
encompasses => enˈkʌmpəsiz
encompassing => enˈkʌmpəsɪŋ
encompassment => en'kʌmpəsmənt
encopresis => en,kәj'pri:sis
encore => ɒŋ'kɒ:
encored => ˈɔnˌkɔ:d
encores => ˈɔnˌkɔ:z
encoring => ˈɔnˌkɔ:ɪŋ
encounter => in'kauntә
encounter group => inˈkauntə ɡru:p
encountering => inˈkauntərɪŋ
encounters => inˈkauntəz
encourage => in'kʌridʒ
encouragement => in'kʌridʒmәnt
encourages => inˈkʌridʒz
encouraging => in'kʌridʒiŋ
encouragingly => ɪn'kʌrɪdʒɪŋlɪ
encroach => in'krәutʃ
encroached => enˈkrəʊtʃt
encroaches => enˈkrəʊtʃiz
encroaching => ɪn'krəʊtʃɪŋ
encroachment => in'krәutʃmәnt
encroachments => eŋ'krəʊtʃm(ə)nt
encrust => in'krʌst
encrustation => in,krʌs'teiʃәn
encrustations => inˌkrʌsˈteiʃənz
encrusting => inˈkrʌstɪŋ
encrusts => inˈkrʌsts
encrypt => in'kript
encrypted => inˈkriptid
encrypting => inˈkriptɪŋ
encryption => -'kripʃən
encrypts => inˈkripts
enculturation => in,kʌltʃә'reiʃən
encumber => in'kʌmbә
encumbered => enˈkʌmbəd
encumbering => enˈkʌmbərɪŋ
encumbers => enˈkʌmbəz
encumbrance => in'kʌmbrәns
encumbrances => en'kʌmbrənsɪz
encyclical => en'siklikәl
encyclopaedia => en,saiklәu'pi:diә
encyclopaedic => en,saiklәu'pi:dik
encyclopedia => in.saiklәu'pi:diә
encyclopedias => ensaɪklə'pi:dɪəz
encyclopedic => en,saiklәu'pi:dik
encyclopedism => en,saiklәj'pi:dizəm
encyclopedist => en,saiklәu'pi:dist
encyst => en'sist
encystation => ,ensis'teiʃәn
encysted => 'ensɪstɪd
end => end
end game => end ɡeim
end organ => end ˈɔ:ɡən
end result => end riˈzʌlt
end run => end rʌn
end zone => end zəun
end-around => 'endər'aʊnd
end-stopped => 'endstɔpt
endanger => in'deindʒә
endangered => in'deindʒәd
endangering => enˈdeɪndʒərɪŋ
endangerment => ɪn'deɪndʒəmənt
endangers => enˈdeɪndʒəz
endarterectomy => en,dɑ:tә'rektɔmi
endarteritis => ,endɑ:tә'raitis
endear => in'diә
endeared => enˈdɪəd
endearing => in'diәriŋ
endearingly => in'diəriŋli
endearment => in'diәmәnt
endearments => enˈdɪəmənts
endears => enˈdɪəz
endeavor => in'devә
endeavored => enˈdevəd
endeavoring => enˈdevərɪŋ
endeavors => enˈdevəz
endeavour => in'devә
endeavoured => inˈdevəd
endeavouring => inˈdevərɪŋ
endeavours => inˈdevəz
endemic => en'demik
endemically => en'demɪklɪ
endemicity => .endi'misiti
endemism => 'endimizəm
endergonic => ,endә'^ɔnik
enders => 'endәz
endgame => 'endɡeim
endgate => 'endgeit
ending => 'endiŋ
endite => in'dait
endive => 'endaiv
endives => ˈendivz
endless => 'endlis
endlessly => 'endlisli
endlessness => 'endləsnəs
endmost => 'endmәust
endnote => 'endnәut
endocardial => ,endәu'kɑ:diәl
endocarditis => .endәukɑ:'daitis
endocardium => .endәu'kɑ:diәm
endocarp => 'endәukɑ:p
endocentric => .endәu'sentrik
endocrine => .endәu'krain
endocrine gland => ˈendəukrain ɡlænd
endocrinology => .endәukri'nɒlәdʒi
endocytosis => ,endәusai'tәusis
endocytotic => ,endəusai'tɔtik
endoderm => 'endәudә:m
endodermis => .endә'dә:mis
endogamous => en'dɒgәmәs
endogamy => en'dɒgәmi
endogenic => ,endәu'dʒenik
endogenous => en'dɔdʒәnәs
endolithic => ,endәj'liθik
endolymph => 'endәulimf
endometriosis => ,endәu,mi:tri'әusis
endometritis => .endәumi'traitis
endometrium => ,endәu'mi:triәm
endomorph => 'endәmɒ:f
endomorphic => .endә'mɒ:fik
endonuclease => ,endә'nju:kli,eis
endoparasite => .endә'pærәsait
endoparasitic => 'endəu,pærə'sitik
endopeptidase => ,endәu'peptideis
endophyte => 'endәfait
endoplasm => 'endәuplæzm
endoplasmic => ˌendə'plazmɪk
endopodite => en'dɔpәdait
endorphins => en'dɔ:fɪnz
endorsable => in'dɔ:sәbl
endorse => in'dɒ:s
endorsed => enˈdɔ:st
endorsee => .endɒ:'si:
endorsement => in'dɒ:smәnt
endorsements => en'dɔ:smənts
endorser => in'dɒ:sә
endorses => enˈdɔ:siz
endoscope => 'endәskәup
endoscopic => en,dɔs'kɔpik
endoscopy => en'dɔskәpi
endoskeletal => ,endәu'skelitl
endoskeleton => .endә'skelitәn
endosperm => 'endәspә:m
endospore => 'endәuspɔ:
endosymbiosis => 'endәj,simbai'әjsis
endosymbiotic => 'endəʊ,sɪmbaɪ'ɒtɪk
endothelium => .endәu'θi:liәm
endotherm => 'endәθә:m
endothermic => ,endәj'θ\\\\:mik
endothermy => 'endәθ\\\\:mi
endotoxin => .endә'tɒksin
endotracheal => ,endәu,trә'kiәl
endow => in'dau
endowed => ɪn'daʊ
endowing => inˈdauɪŋ
endowment => in'daumәnt
endowment mortgage => enˈdaʊmənt ˈmɔ:ɡidʒ
endowments => ɪn'daʊmənt
endows => inˈdauz
endpaper => 'endpeipә
endplay => 'endplei
endpoint => 'end.pɔint
endrin => 'endrin
endue => in'dju:
endued => enˈdu:d
endues => enˈdu:z
enduing => enˈdu:ɪŋ
endurable => in'djuәrәbl
endurance => in'djuәrәns
endure => in'djuә
endured => inˈdjuəd
endures => inˈdjuəz
enduring => in'djuәriŋ
enduringly => ɪn'djʊərɪŋlɪ
enduro => in'djjәrәj
endways => 'endweiz
Endymion => en'dimiәn
enema => 'enimә
enemas => ˈeniməˈenəməz
enemies => 'enəmɪz
enemy => 'enimi
energetic => .enә'dʒetik
energetically => .enә'dʒetikәli
energetics => .enә'dʒetiks
energies => ˈenədʒiz
energise => 'enәdʒaiz
energising => 'enədʒaɪz
energize => 'enәdʒaiz
energized => 'enədʒaɪzd
energizer => 'enәdʒaizә
energizes => ˈenəˌdʒaɪziz
energizing => 'enədʒaɪzɪŋ
energumen => ,enә:'^ju:mәn
energy => 'enәdʒi
enervate => 'enәveit
enervated => 'enә:veitid
enervates => ˈenəˌveɪts
enervating => ˈenəˌveɪtɪŋ
enervation => .enә'veiʃәn
enfant => ɔŋ'fɔŋ
enfant terrible => ɑfɑŋ te'ri:bl
enfeeble => in'fi:bl
enfeebled => inˈfi:bld
enfeeblement => enfi:bl'mənt
enfeebles => inˈfi:blz
enfeebling => inˈfi:blɪŋ
enfeoff => in'fef
enfeoffed => inˈfeft
enfeoffing => inˈfefɪŋ
enfeoffment => in'fefmәnt
enfeoffs => inˈfefs
enfetter => in'fetә
enfield => 'enfi:ld
enfilade => ,enfi'leid
enfiladed => ˌenfiˈleidid
enfilades => ˌenfiˈleidz
enfilading => ˌenfiˈleidɪŋ
enfleurage => ɑ:nflæ'rɑ:ʒ
enflurane => en'fljәrein
enfold => in'fәuld
enfolded => enˈfəʊldid
enfolding => enˈfəʊldɪŋ
enfolds => enˈfəʊldz
enforce => in'fɒ:s
enforceable => in'fɔ: sәbl
enforced => in'fɔ:sid
enforcement => in'fɒ:smәnt
enforcers => in'fɔ:sə
enforces => inˈfɔ:siz
enforcing => inˈfɔ:sɪŋ
enfranchise => in'fræntʃaiz
enfranchised => enˈfrænˌtʃaɪzd
enfranchisement => -tʃizmәnt
enfranchises => enˈfrænˌtʃaɪziz
enfranchising => enˈfrænˌtʃaɪzɪŋ
engage => in'geidʒ
engaged => in'geidʒd
engagement => in'geidʒdmәnt
engagement ring => inˈɡeidʒmənt riŋ
engagements => en'ɡeɪdʒmənts
engages => ɪnˈɡeɪdʒz
engaging => in'geidʒiŋ
engagingly => ɪn'ɡeɪdʒɪŋlɪ
engels => 'en^әls
engender => in'dʒendә
engendered => enˈdʒendəd
engendering => enˈdʒendərɪŋ
engenders => enˈdʒendəz
engine => 'endʒin
engine block => ˈendʒin blɔk
engineer => .endʒi'niә
engineering => .endʒi'niәriŋ
engineering science => ˌendʒiˈniəriŋ ˈsaiəns
enginery => 'endʒinri
engirdle => in'^ә:dl
englacial => en'^leiʃәl
England => 'iŋglәnd
englander => 'iŋ^lәndә(r)
English => 'iŋgliʃ
Englishman => 'iŋgliʃmәn
Englishness => 'iŋgliʃnis
Englishwoman => 'iŋgliʃwumәn
englishwomen => 'ɪŋɡlɪʃwɪmɪn
englobe => en'^lәub
engorge => in'gɒ:dʒ
engorged => en'gɔ:dʒd
engorgement => in'^ɔ:dʒmәnt
engorges => inˈɡɔ:dʒz
engorging => inˈɡɔ:dʒɪŋ
engraft => in'grɑ:ft
engrafted => inˈɡrɑ:ftid
engrafting => inˈɡrɑ:ftɪŋ
engrafts => inˈɡrɑ:fts
engrailed => eŋ'reɪld
engrain => in'grein
engrained => in'^reind
engram => 'engræm
engrave => in'greiv
engraved => inˈɡreivd
engraver => in'greivә
engravers => inˈɡreivəz
engraves => inˈɡreivz
engraving => in'greiviŋ
engross => in'grәus
engrossed => in'^rәjst
engrosses => enˈgrəʊsiz
engrossing => in'^rәusiŋ
engrossment => in'^rәjsmәnt
engulf => in'gʌlf
engulfed => enˈgʌlft
engulfing => enˈgʌlfɪŋ
engulfs => enˈgʌlfs
enhance => in'hæns
enhanced => in'hɑ:nst. -'hænst
enhancement => in'hɑ:nsmәnt
enhancements => ɪn'hɑ:nsmənts
enhancer => in'hɑ:nsә
enhances => inˈhɑ:nsiz
enhancing => inˈhɑ:nsɪŋ
enharmonic => .enhɑ:'mɒnik
enid => 'i:nid
enigma => i'nigmә
enigmas => ɪˈnɪgməz
enigmatic => .enig'mætik
enigmatical => .enig'mætikәl
enigmatically => ˌenɪɡ'mætɪklɪ
enisle => in'ail
Eniwetok => ,eni'wi:tɔk
enjambement => in'dʒæmmәnt
enjambment => in'dʒæmmәnt
enjoin => in'dʒɒin
enjoined => enˈdʒɔɪnd
enjoining => enˈdʒɔɪnɪŋ
enjoins => enˈdʒɔɪnz
enjoy => in'dʒɒi
enjoyable => in'dʒɒiәbl
enjoyably => in'dʒɒiәbli
enjoyed => ɪn'dʒɔɪd
enjoying => end'ʒɔɪɪŋ
enjoyment => in'dʒɒimәnt
enjoyments => enˈdʒɔɪmənts
enjoys => inˈdʒɔiz
enkindle => in'kindl
enkindled => enˈkɪndld
enkindles => enˈkɪndlz
enkindling => enˈkɪndlɪŋ
enlace => in'leis
enlaced => inˈleist
enlaces => inˈleisiz
enlacing => inˈleisɪŋ
enlarge => in'lɑ:dʒ
enlarged => inˈlɑ:dʒd
enlargement => in'lɑ:dʒmәnt
enlargements => enˈlɑ:dʒmənts
enlarger => in'lɑ:dʒә
enlarges => inˈlɑ:dʒz
enlarging => in'lɑ:dʒiŋ
enlighten => in'laitn
enlightened => in'laitnd
enlightenment => in'laitmәnt
enlightens => inˈlaitənz
enlist => in'list
enlistee => in,lis'ti:
enlister => en'lɪstə
enlisting => inˈlistɪŋ
enlistment => in'listmәnt
enlistments => ɪnˈlɪstmənts
enlists => inˈlists
enliven => in'laivn
enlivened => enˈlaɪvənd
enlivening => enˈlaɪvənɪŋ
enlivens => enˈlaɪvənz
enmesh => in'meʃ
enmeshed => ɪn'meʃd
enmeshes => enˈmeʃiz
enmeshing => enˈmeʃɪŋ
enmities => ˈenmɪti:z
enmity => 'enmәti
ennead => 'eniæd
enneagram => e'ni:ɡrəm
Ennis => 'enis
Enniskillen => ,eni'skilәn
ennoble => i'nәubl
ennobled => iˈnəubld
ennoblement => ɪ'nəʊblmənt
ennobles => iˈnəublz
ennobling => iˈnəublɪŋ
ennui => 'ɒnwi:
enoch => 'i:nɔk
enoki => e'nəʊki:
enology => i:'nɒ:lәdʒi
enormities => ɪˈnɔ:mɪti:z
enormity => i'nɒ:miti
enormous => i'nɒ:mәs
enormously => i'nɒ:mәsli
enosis => e'nәusis
enough => i'nʌf
enough said => iˈnʌf sed
enplane => in'plein
enplanes => en'pleɪn
enprint => en'print
enquire => in'kwaiә
enquired => inˈkwaiəd
enquirers => in'kwaiərə(r)
enquires => inˈkwaiəz
enquiries => inˈkwaiəriz
enquiringly => ɪn'kwaɪərɪŋlɪ
enquiry => in'kwaiәri
enrage => in'reidʒ
enraged => enˈreɪdʒd
enraging => enˈreɪdʒɪŋ
enrapt => in'ræpt
enrapture => in'ræptʃә
enraptured => ɪnˈræptʃəd
enraptures => enˈræptʃəz
enrapturing => enˈræptʃərɪŋ
enrich => in'ritʃ
enriched => in'ritʃt
enriches => inˈritʃiz
enriching => inˈritʃɪŋ
enrichment => in'ritʃmәnt
enrico => en'ri:kәj
Enrique => enrik
enrobe => in'rәub
enrol => in'rәul
enroll => in'rәul
enrollee => in,rәu'li:
enrollment => in'rәulmәnt
enrolment => in'rәulmәnt
enrolments => en'rəʊlmənts
enrols => inˈrəulz
Enschede => ,ensxə'dei
ensconce => in'skɒns
ensconced => enˈskɔnst
ensconces => enˈskɔnsiz
ensconcing => enˈskɔnsɪŋ
ensemble => ɒn'sɒŋblә
ensembles => ɒn'sɒmblz
enshrine => in'ʃrain
enshrined => enˈʃraɪnd
enshrinement => enʃ'raɪnmənt
enshrines => enˈʃraɪnz
enshrining => enˈʃraɪnɪŋ
enshroud => in'ʃraud
enshrouded => inˈʃraudid
enshrouding => inˈʃraudɪŋ
enshrouds => inˈʃraudz
ensiform => 'ensifɒ:m
ensign => 'ensain
ensigns => ˈensənz
ensilage => 'ensilidʒ
ensile => en'sail
ensiling => 'ensɪlɪŋ
enslave => in'sleiv
enslaved => enˈsleɪvd
enslavement => in'sleivmәnt
enslaver => in'sleivә
enslaves => enˈsleɪvz
enslaving => enˈsleɪvɪŋ
ensnare => in'snєә
ensnared => enˈsneəd
ensnares => enˈsneəz
ensnaring => enˈsneərɪŋ
ensnarl => in'snɑ:l
Ensor => 'ensɔ:
ensorcell => inˈsɔ:səl
ensorcellment => en'sɔ:selmənt
ensoul => in'sәul
enstatite => 'enstәtait
ensue => en'su:
ensued => inˈsju:d
ensues => inˈsju:z
ensure => in'ʃuә
ensured => inˈʃuəd
ensures => inˈʃuəz
ensuring => inˈʃuərɪŋ
enswathe => in'sweið, -'swɑ:ð
entablature => en'tæblәtʃә
entablement => en'teiblmәnt
entail => in'teil
entailed => inˈteild
entailing => inˈteilɪŋ
entails => inˈteilz
entamoeba => entә'mi:bә
entangle => in'tæŋgl
entangled => ɪnˈtæŋgld
entanglement => in'tæŋglmәnt
entanglements => ɪnˈtæŋglmənts
entangles => enˈtæŋgəlz
entangling => enˈtæŋgəlɪŋ
entasis => 'entәsis
Entebbe => en'tebә
entelechy => en'telәki
entellus => en'telәs
entente => ɒŋ'tɒŋt
ententes => ə:nˈtɑ:nts
enter => 'entә
enteral => 'entәrәl
enteric => en'terik
enteritis => .entә'raitis
enterococcus => ,entәrәu'kɔkәs
enterocoel => entərəʊ'ku:l
enterocoelic => ,entərəu'si:lik
enterocolitis => ,entә,rәukә'laitis
enterocyte => entərə'saɪt
enteropathy => ,entә'rɔpәθi
enterostomy => ,entә'rɔstәmi
enterotomy => ,entә'rɔtәmi
enterotoxigenic => ,entәrәtɔksi'dʒenik
enterotoxin => ,entәrәu'tɔksin
enterovirus => ,entәrәu'vaiәrәs
enterprise => 'entәpraiz
enterprise zone => ˈentəpraiz zəun
enterpriser => 'entәpraizә(r)
enterprising => 'entәpraiziŋ
enters => ˈentəz
entertain => .entә'tein
entertained => ˌentəˈteind
entertainer => .entә'teinә
entertainers => ˌentəˈteɪnəz
entertaining => .entә'teiniŋ
entertainingly => ,entə'teiniŋli
entertainment => .entә'teinmәnt
entertainments => entə'teɪnmənts
entertains => ˌentəˈteinz
enthalpies => 'enθ(ə)lpɪ; en'θælpɪ
enthalpy => en'θælpi
enthral => in'θrɔ:l
enthrall => in'θrɒ:l
enthralled => ɪnˈθrɔ:ld
enthralling => in'θrɒ:liŋ
enthrals => ɪnˈθrɔ:lz
enthrone => in'θrәun
enthroned => enθ'rəʊnd
enthronement => in'θrәunmәnt
enthrones => inˈθrəunz
enthroning => inˈθrəunɪŋ
enthuse => in'θju:z
enthused => enˈθu:zd
enthuses => enˈθu:ziz
enthusiasm => in'θju:ziæzәm
enthusiasms => inˈθju:ziæzəmz
enthusiast => in'θju:ziæst
enthusiastic => in.θju:zi'æstik
enthusiastically => in.θju:zi'æstikli
enthusiasts => ɪn'θju:zɪæsts
enthusing => enˈθu:zɪŋ
enthymeme => 'enθimi:m
entice => in'tais
enticed => enˈtaɪst
enticement => in'taismәnt
enticer => en'taɪsə
entices => enˈtaɪsiz
enticing => in'taisiŋ
enticingly => en'taisiŋli
entire => in'taiә
entirely => in'taiәli
entirety => in'taiәti
entitative => 'entiteitiv
entities => ˈentitiz
entitle => in'taitl
entitled => in'taitld
entitlements => inˈtaitlmənts
entitles => inˈtaitlz
entitling => inˈtaitlɪŋ
entity => 'entiti
entomb => in'tu:m
entombed => inˈtu:md
entombing => inˈtu:mɪŋ
entombment => en'tu:mmənt
entombs => inˈtu:mz
entomological => .entәmә'lɒdʒikәl
entomologist => .entәmә'lɒdʒist
entomology => .entә'mɒlәdʒi
entomophagous => entәu'mɔfә^әs
entomophagy => ,entәu'mɔfәdʒi
entomophilous => .entә'mɒfilәs
entomophily => ,entәu'mɔfili
entoproct => 'entә,prɔkt
entoptic => en'tɔptik
entourage => ,ɔntu'rɑ:ʒ
entourages => ˌɔntʊˈrɑ:ʒz
entrails => 'entreilz
entrain => in'trein
entrained => inˈtreind
entraining => in'treiniŋ
entrainment => in'treinmәnt
entrains => inˈtreinz
entrammel => in'træmәl
entrance => 'entrәns
entrancement => 'entrənsment
entrances => ˈentrənsiz
entranceway => 'entrәns,wei
entrancing => 'entrәnsiŋ
entrancingly => inˊtraːnsiŋli
entrant => 'entrәnt
entrants => ˈentrənts
entrap => in'træp
entrapment => in'træpmәnt
entrapped => enˈtræpt
entrapping => enˈtræpɪŋ
entraps => enˈtræps
entre nous => 'ɔntrә 'nu:
entreat => in'tri:t
entreated => enˈtri:tid
entreaties => enˈtri:ti:z
entreating => enˈtri:tɪŋ
entreats => enˈtri:ts
entreaty => in'tri:ti
entrechat => ,ɑ:ntrә'ʃɑ:
entree => 'ɒntrei
entrees => ˈɔntreɪz
entremets => 'ɔntrәmei
entrench => in'trentʃ
entrenches => enˈtrentʃiz
entrenching => enˈtrentʃɪŋ
entrenchment => in'trentʃmәnt
entrepot => 'ɒntrәpәu
entrepreneur => .ɒntrәprә'nә:
entrepreneurial => ˌɒntrəprə'nɜ:rɪəl
entrepreneurialism => ,ɔntrəprə'nə:
entrepreneurs => ɒntrəprə'nɜ:z
entrepreneurship => ,ɑntrəprə'nɝʃɪp
entresol => 'ɔntrәsɔl
entropic => en'trəʊpɪk
entropion => en'trәjpiɔn
entropy => 'entrәpi
entrust => in'trʌst
entrusted => ɪnˈtrʌstid
entrusting => ɪnˈtrʌstɪŋ
entrustment => 'ɪntrʌstment
entrusts => ɪnˈtrʌsts
entry => 'entri
entry-level => ˈentri:ˌlevəl
entryist => 'entriist
entryway => 'entri,wei
entwine => in'twain
entwined => enˈtwaɪnd
entwines => enˈtwaɪnz
entwining => enˈtwaɪnɪŋ
enucleate => i'nju:klieit
enucleated => iˈnju:klieitid
enucleates => iˈnju:klieits
enucleating => iˈnju:klieitɪŋ
enumerable => i'nju:mәrәbl
enumerate => i'nju:mәreit
enumerated => ɪˈnu:məˌreɪtid
enumerates => ɪˈnu:məˌreɪts
enumerating => ɪˈnu:məˌreɪtɪŋ
enumeration => i.nju:mә'reiʃәn
enumerative => i'nju:mәreitiv
enumerator => i'nju:mәreitә
enunciate => i'nʌnsieit
enunciated => ɪˈnʌnsi:ˌeɪtid
enunciates => ɪˈnʌnsi:ˌeɪts
enunciating => ɪ'nʌnsɪeɪt
enunciation => i.nʌnsi'eiʃәn
enunciative => i'nʌnʃiәtiv
enunciator => i'nʌnsieitә
enure => i'njuә
enured => ɪn'jʊəd
enuresis => .enju'ri:sis
enuretic => ,enju'retik
envelop => in'velәp
envelope => 'envәlәup
envelopes => 'envələʊps
enveloping => enˈveləpɪŋ
envelopment => in'velәpmәnt
envenom => in'venәm
envenomate => in'venәmeit
envenomation => in,venә'meiʃәn
envenomed => inˈvenəmd
envenoming => inˈvenəmɪŋ
envenoms => inˈvenəmz
enviable => 'enviәbl
enviably => 'envɪəblɪ
envied => 'envid
envier => 'enviә
envies => ˈenviz
envious => 'enviәs
enviously => 'enviәsli
enviro => in'vairə
environ => in'vaiәrәn
environed => inˈvaiərənd
environing => inˈvaiərənɪŋ
environment => in'vairәnmәnt
environmental => in.vaiәrәn'mentәl
environmentalism => in,vaiәrәn'mentlizm
environmentalist => in,vaiәrәn'mentlist
environmentalists => inˌvaiərənˈmentəlists
environmentally friendly => enˌvaɪrənˈmentlɪ ˈfrendli
environs => in'vaiәrәnz
envisage => in'vizidʒ
envisaged => inˈvizidʒd
envisages => inˈvizidʒz
envisaging => inˈvizidʒɪŋ
envision => in'viʒәn
envisioned => enˈvɪʒənd
envisioning => enˈvɪʒənɪŋ
envisions => enˈvɪʒənz
envoi => 'envɔi
envoy => 'envɒi
envoys => ˈenˌvɔɪz
envy => 'envi
enwrap => in'ræp
enwrapped => inˈræpt
enwrapping => inˈræpɪŋ
enwraps => inˈræps
enwreathe => in'ri:ð
enzootic => ,enzәu'ɔtik
enzymatic => .enzai'mætik
enzyme => 'enzaim
enzymes => 'enzaɪm
enzymic => en'zaimik
enzymologist => ,enzai'mɔlədʒist
enzymology => ,enzai'mɔlәdʒi
eo ipso => 'i(:)əu'ipsəu
Eocene => 'i:әsi:n
eohippus => .i:әu'hipәs
EOKA => ei'әjkә
eolith => 'i:әuliθ
eon => 'i:әn
Eos => 'i:ɒs
eosin => 'i:әsin
eosinophil => ,i:әu'sinәfil
eosinophilia => ,i:ә,sinә'filiә
eosinophilic => -'filik
epact => 'i:pækt
eparch => 'epɑ:k
eparchy => 'epɑ:ki
epaulet => 'epәlet
epaulets => 'epəlet
epaulette => 'epәulet
epaxial => ep'æksiәl
epee => ei'pei
epeirogenesis => i,pairәu'dʒenәsis
epeirogenic => i,pairәj'dʒenik
epeirogeny => ,epai'rɔdʒini
ependyma => e'pendimә
epenthesis => e'penθisis
epergne => i'pә:n
epexegesis => e,peksi'dʒi:sis
epexegetic => e,peksi'dʒetik
epexegetical => epeksɪd'ʒetɪkəl
epexegetically => e,peksi-'dʒetikəli
ephah => 'i:fә
ephebe => i'fi:b, 'efi:b
ephebic => i'fi:bik
ephedra => i'fedrә
ephedrine => i'fedrin
ephemera => i'femәrә
ephemeral => i'femәrәl
ephemerality => i.femә'ræliti
ephemeris => i'femәris
ephemeris time => iˈfeməris taim
ephemerist => i'femərist
Ephemeroptera => i,femə'rɔptərə
ephemeropteran => i,femə'rɔptərən
ephesian => i'fi:ʒәn
Ephesians => i'fi:ʒiәnz
Ephesus => 'efisәs
ephod => 'i:fɒd
ephor => 'efɒ:
ephors => ˈefɔz
Ephraim => 'i:freiim
ephyra => 'efәrә
epibenthic => e'paɪbenθɪk
epibenthos => ,epi'benθɔs
epiblast => 'epiblɑ:st
epic => 'epik
epical => 'epikәl
epically => ˊepikәli
epicanthic => ,epi'kænθik
epicardial => ,epi'kɑ:diәl
epicardium => ,epi'kɑ:diәm
epicedium => .epi'si:diәm
epicene => 'episi:n
epicenter => 'episentә
epicentral => .epi'sentrәl
epicentre => 'episentә(r)
epicentres => ˈepisentəz
epicondylar => epɪkən'dɪlɑ:
epicondyle => ,epi'kɔndail
epicondylitis => 'epi,kɔndi'laitis
epicontinental => ,epi,kɔnti'nentәl
epicormic => epi'kɔ:mik
epicotyl => ,epi'kɔtil
epicritic => ,epi'kritik
Epictetus => ,epik'ti:tәs
epicure => 'epi.kjuә
epicurean => .epikju'ri:әn
Epicureanism => .epikju'ri:әnizm
epicurism => 'epikjurizm
Epicurus => ,epi'kjuәrәs
epicuticle => ,epi'kju:tikl
epicycle => 'episaikl
epicyclic => ,epi'saiklik
epicycloid => ,epi'saiklɔid
epicycloidal => epɪsaɪk'lɔɪdl
Epidaurus => ,epi'dɔ:rəs
epideictic => ,epi'daiktik
epidemic => .epi'demik
epidemiologist => 'epi,di:mi'ɔlәdʒist
epidemiology => ,epi,di:mi'ɔlәdʒi
epidermal => ,epi'd\\\\:mәl
epidermic => epi'dә:mik
epidermis => .epi'dә:mis
epidermoid => ,epi'dә:mɔid
epidermolysis => ,epidә'mɔlәsis
epidiascope => .epi'daiәskәup
epididymis => ,epi'didimis
epidote => 'epidәut
epidural => ,epi'djuәrәl
epifauna => ,epә'fɔ:nә
epifaunal => ,epi'fɔ:nəl
epigastric => ,epi'^æstrik
epigastrium => .epi'gæstriәm
epigeal => ,epi'dʒiәl
epigene => 'epi,dʒi:n
epigenesis => .epi'dʒenisis
epigenesist => ,epi'dʒenәsist
epigenetic => ,epidʒi'netik
epiglottal => ,epi'^lɔtәl
epiglottis => .epi'glɒtis
epigone => 'epigәun
epigram => 'epigræm
epigrammatic => .epigrә'mætik
epigrammatist => epi'græmәtist
epigrammatize => epi'græmәtaiz
epigrams => ˈepɪˌgræmz
epigraph => 'epigræf
epigrapher => e'pi^rәfә
epigraphic => epi'græfik
epigraphist => e'pi^rәfist
epigraphy => e'pigrәfi
epigynous => i'pidʒinәs
epigyny => -ni
epilate => 'epileit
epilation => ,epi'leiʃәn
epilator => letə
epilepsy => 'epilepsi
epileptic => .epi'leptik
epileptics => ˌepəˈleptɪks
epileptogenic => epi,leptә'dʒenik
epilimnion => ,epә'limnjәn
epilithic => ,epә'liθik
epilogue => 'epilɒg
epilogues => ˈepəˌlɔ:gz
epimer => 'epimә
epimeric => ,epɪ'merɪk
epimeron => ,epi'miәrɔn
epimysium => ,epi'miziәm
epinephrine => ,epi'nefrin, -ri:n
epiphanic => ,epi'fænik
Epiphany => i'pifәni
epiphenomenal => ,epifә'nɔminәl
epiphenomenon => .epifi'nɒminәn
epiphora => i'pifәrә
epiphyllum => 'ɪpɪfɪləm
epiphysis => i'pifisis
epiphytal => ,epi'faitəl
epiphyte => 'epifait
epiphytic => .epi'fitik
Epirus => e'paiərəs
episcopacy => i'piskәpәsi
episcopal => i'piskәpәl
episcopalian => i.piskә'peiljәn
episcopalianism => ɪpɪskəpeɪl'jənɪzəm
episcopalism => i'piskәpәlizәm
episcopate => i'piskәpit
episcope => 'episkәup
episematic => ,episi'mætik
episiotomy => i,pi:zi'ɔtәmi
episode => 'episәud
episodic => .epi'sɒdik
episome => 'epәsәum
epistasis => i'pistәsis
epistatic => ,epә'stætik
epistaxis => ,epi'stæksis
episteme => ɪpɪs'təm
epistemic => ,epi'sti:mik
epistemically => ɪpɪs'temɪklɪ
epistemological => ,episti(:)mә'lɔdʒikәl
epistemologist => ɪpɪstə'mɒlədʒɪst
epistemology => i.pisti:'mɒlәdʒi
episternum => ,epis'tә:nәm
Epistle => i'pisl
epistles => ɪˈpɪsəlz
epistolary => i'pistәlәri
epistrophe => i'pistrәfi
epistyle => 'epistail
epitaph => 'epitɑ:f
epitaphs => 'epɪtɑ:fs
epitaxial => ,epi'tæksiәl
epitaxy => 'epitæksi
epithalamic => ,epiθә'læmik
epithalamium => .epiθә'leimiәm
epithalamiums => ˌepiθəˈleimiəmz
epithalamus => ,epi'θælәmәs
epithelial => .epi'θi:liәl
epithelium => .epi'θi:liәm
epithet => 'epiθet
epithetic => ,epi'θetik
epithetical => ,epi'θetikәl
epithetically => epiˊθetikәli
epithets => ˈepəˌθets
epitome => i'pitәmi
epitomes => ɪˈpɪtəmi:z
epitomist => ɪ'pɪtəmɪst
epitomize => i'pitәmaiz
epitomized => iˈpitəmaizd
epitomizes => iˈpitəmaiziz
epitomizing => iˈpitəmaizɪŋ
epitope => 'epitәup
epizoic => ,epi'zәuik
epizoite => ,epi'zәuait
epizoon => ,epi'zәuɔn
epizootic => .epizәu'ɒtik
epoch => 'i:pɒk
epoch-making => 'i:pɒk.meikiŋ
epochal => 'epɒkәl
epode => 'epәud
eponym => 'eipәunim
eponymous => i'pɒnimәs
epos => 'epɒs
epoxide => e'pɔksaid
epoxy => e'pɒksi
epsilon => ep'sailәn. 'epsilɔn
epsom => 'epsәm
Epsom salts => 'epsәm
epstein => 'epstain
epyllion => e'piliәn
eqn => 'ekn
equability => .ekwә'biliti
equable => 'ekwәbl
equably => 'ekwәbli
equal => 'i:kwәl
equal opportunity => ˈi:kwəl ˌɔpəˈtju:niti
equal temperament => ˈi:kwəl ˈtempərəmənt
equal to => ˈi:kwəl tu:
equalisation => ˌi:kwəlaɪ'zeɪʃən
equalise => 'i:kwәlaiz
equaliser => 'i:kwәlaizә(r)
equalitarian => i.kwɒli'tєәriәn
equalities => i:ˈkwɔlitiz
equality => i:'kwɒliti
equalization => .i:kwәlai'zeiʃәn
equalize => 'i:kwәlaiz
equalized => ˈi:kwəlaizd
equalizer => 'i:kwәlaizә
equalizes => ˈi:kwəlaiziz
equalizing => 'i:kwәlaiziŋ
equalled => ˈi:kwəld
equalling => i:k'wəlɪŋ
equally => 'i:kwәli
equanimity => .i:kwә'nimiti
equanimous => i'kwænimәs
equant => i(:)'kwɔnt
equate => i'kweit
equated => ɪˈkweɪtid
equates => ɪˈkweɪts
equating => ɪ'kweɪtɪŋ
equation => i'kweiʃәn
equational => i'kweiʃәnl
equative => i'kweitiv
equator => i'kweitә
equatorial => .ekwә'tɒ:riәl
Equatorial Guinea => ,ekwә'tɔ:riәl'^ini
equerry => 'ekwәri
equestrian => i'kwestriәn
equestrianism => i'kwestriәnizәm
equestrienne => i.kwestri'en
equi- => 'i:kwi
equiangular => .i:kwi'æŋgjulә
equid => 'ekwid
equidistance => .i:kwi'distәns
equidistant => .i:kwi'distәnt
equidistantly => ,i:kwi'distənt
equifinal => ,i:kwi'fainәl
equilateral => .i:kwi'lætәrәl
equilibrate => .i:kwi'laibreit
equilibrated => ˌi:kwiˈlaibreitid
equilibrates => ˌi:kwiˈlaibreits
equilibrating => ˌi:kwiˈlaibreitɪŋ
equilibration => .i:kwilai'breiʃәn
equilibria => i:kwɪ'lɪbrɪə
equilibrist => i:'kwilibrist
equilibrium => .i:kwi'libriәm
equine => 'i:kwain
equinoctial => .i:kwә'nɒkʃәl
equinoctial point => ˌi:kwiˈnɔkʃəl pɔint
equinoctial year => ˌi:kwiˈnɔkʃəl jə:
equinox => 'i:kwәnɒks
equinoxes => i:kwɪ'nɒksɪz
equip => i'kwip
equipage => 'ekwipidʒ
equipartition => ,i:kwipɑ:'tiʃәn
equipment => i'kwipmәnt
equipoise => 'ekwipɒiz
equipollence => .i:kwi'pɒlәns
equipollent => .i:kwi'pɒlәnt
equipotent => i:kwi'pәutәnt
equipotential => .i:kwipә'tenʃәl
equiprobability => ,i:kwiprɔbә'biliti
equiprobable => ,i:kwi'prɔbәbl
equips => iˈkwips
equisetum => .ekwi'si:tәm
equitability => ekwɪtə'bɪlɪtɪ
equitable => 'ekwitәbl
equitableness => 'ekwɪtəblnəs
equitably => 'ekwitәbli
equitant => 'ekwitәnt
equitation => .ekwi'teiʃәn
equites => 'ekwiti:z
equity => 'ekwiti
equivalence => i'kwivәlәns
equivalency => i'kwivәlәnsi
equivalent => i'kwivәlәnt
equivalent to => iˈkwivələnt tu:
equivalents => ɪk'wɪvələnts
equivocal => i'kwivәkl
equivocally => ɪ'kwɪvəkəlɪ
equivocate => i'kwivәkeit
equivocated => ɪˈkwɪvəˌkeɪtid
equivocates => ɪˈkwɪvəˌkeɪts
equivocating => ɪˈkwɪvəˌkeɪtɪŋ
equivocation => i.kwivә'keiʃәn
equivocator => i'kwivәkeitә
equivoque => 'ekwivәjk
Equuleus => i'kwju:liәs
Er => ʌ:, ә:,ә
era => 'iәrә
eradicable => i'rædikәbl
eradicant => i'rædikәnt
eradicate => i'rædikeit
eradicated => i'rædikeitid
eradicates => ɪˈrædɪˌkeɪts
eradicating => ɪˈrædɪˌkeɪtɪŋ
eradication => i,rædi'keiʃәn
eradicator => i'rædikeitә
erasable => i'reisәbl
erase => i'reis
erased => i'reizd
eraser => i'reisә
erasers => ɪ'reɪsəz
erases => iˈreiziz
erasmus => i'ræzmәs
Erastian => i'ræstʃәn
Erastus => i'ræstәs
erasure => i'reiʃә
Erato => 'erәtәu
Eratosthenes => ,erә'tɔsθini:z
erbium => 'ә:biәm
ere => eә
Erebus => 'eribәs
Erechtheum => ,erek'θi:әm
erect => i'rekt
erected => iˈrektid
erectile => i'rektil
erection => i'rekʃәn
erections => ɪˈrekʃənz
erector => i'rektә
erects => iˈrekts
eremite => 'erimait
eremitic => .eri'mitik
eremitical => ,eri'mitikəl
erethism => 'eriθizm
Erevan => ,jeәri'vɑ:n
erewhile => єә'hwail
erf => \\\\:f
Erfurt => 'erfurt
erg => ә:^
ergative => '\\\\:^әtiv
ergo => 'ә:^әu
ergocalciferol => ,ә:^әukæl'sifәrɔl
ergodic => ә:'^ɔdik
ergodicity => ,ә:^ә'disiti
ergometer => ә:'^ɔmitә
ergometrine => ә:^ә'metri:n
ergonomic => ,\\\\:^әj'nɔmik
ergonomically => ,ə:gə'nɔmikəli
ergonomics => .ә:gәu'nɒmiks
ergonomist => ә:'gɒnәmist
ergosphere => 'ә:^әsfiә
ergosterol => ә:'^ɔstәrɔl
ergot => 'ә:gәt
ergotamine => ә:'^ɔtәmi:n
ergotism => 'ә:gәtizәm
eric => 'erik
erica => 'erikә
ericaceous => .eri'keiʃәs
Eridanus => i'ridәnәs
Erie => 'iәri
erigeron => i'ridʒәrɔn
Erin => 'iәrin
Erinys => i'rinis, i'rainis
eristic => e'ristik
Eritrea => ,eri'tri(:)ә
erk => ә:k
Erlanger => 'ә:læŋә
erm => ɜ:m
ermine => 'ә:min
ermined => '\\\\:mind
ermines => ˈə:minz
ern => ә:n
erne => ә:n
ernest => 'ә:nist
Ernie => 'ә:ni:
Ernst => ɛrnst
erode => i'rәud
erodes => ɪˈrəʊdz
erodible => i'rәudәbl
eroding => ɪˈrəʊdɪŋ
erogenous => i'rɒdʒinәs
erogenous zone => ɪˈrɒdʒənəs zəʊn
eros => 'irɒs
erosion => i'rәuʒәn
erosive => i'rәusiv
erotic => i'rɒtik
erotica => i'rɔtikә
eroticise => i'rɔti,saiz
eroticism => i'rɒtisizm
eroticize => i'rɔtisaiz
erotism => 'erәtizәm
erotogenic => i,rɔtәu'dʒenik
erotology => irә'tɔlәdʒi
erotomania => i.rɒtәu'meiniә
erotomaniac => i,rɔtәj'meiniæk
err => ә:
errancy => 'erәnsi
errand => 'erәnd
errands => ˈerəndz
errant => 'erәnt
errantry => 'erәntri
errata => e'rɑ:tә
erratic => i'rætik
erratically => i'rætikәli
erraticism => ɪ'rætɪsɪzəm
erratum => e'rɑ:tәm
erred => ə:d
erring => 'ә:riŋ
Errol => 'εrəl
erroneous => i'rәuniәs
erroneousness => i'rəuni:əsnis
error => 'erә
error bar => ˈerə bɑ:
errs => ə:z
ersatz => eә'zɑ:tz
Erse => ә:s
erst => ә:st
erstwhile => 'ә:stwail
erubescent => .eru:'besәnt
eructation => .i:rʌk'teiʃәn
erudite => 'eru:dait
eruditely => 'eru:daɪtlɪ
erudition => .eru:'diʃәn
erupt => i'rʌpt
erupted => iˈrʌptid
erupting => iˈrʌptɪŋ
eruption => i'rʌpʃәn
eruptions => ɪˈrʌpʃənz
eruptive => i'rʌptiv
erupts => iˈrʌpts
erwin => 'ә:win
eryngium => i'rindʒiәm
eryngo => i'riŋ^әu
erysipelas => .eri'siplәs
erysipeloid => ,eri'sipilɔid
erythema => .eri'θi:mә
erythrism => 'eriθrizәm, i'riθrizәm
erythritol => i'riθritɔl
erythroblast => i'riθrәublæst
erythroblastic => i,riθrәj'blæstik
erythroblastosis => i,riθrәublæs'tәusis
erythrocyte => i'riθrәsait
erythrogenic => i,riθrә'dʒenik
erythroid => 'eriθrɔid
erythromycin => i.riθrәu'maisin
erythropoiesis => i,riθrәupɔi'i:sis
erythropoietic => - pɔi'etik
erythropoietin => i,riθrә'pɔiәtin
Erzgebirge => 'erts^ә,bir^ә
Erzurum => 'erzə,ru:m
Esau => 'i:sɔ:
Esbjerg => 'esbjer
escabeche => ,eskә'beʃ
escadrille => .eskә'dril
escalade => .eskә'leid
escaladed => ˌeskəˈleidid
escalades => ˌeskəˈleidz
escalading => ˌeskəˈleidɪŋ
escalate => 'eskәleit
escalated => ˈeskəleitid
escalates => ˈeskəleits
escalating => ˈeskəleitɪŋ
escalation => .eskә'leiʃәn
escalator => 'eskәleitә
escalators => 'eskəleɪtəz
escallonia => ,eskә'lәuniә
escallop => is'kɔlәp
escalope => ˈeskəlɒp
escalopes => eskə'ləʊps
escapable => is'keipәbl
escapade => .eskә'peid
escapades => ˈeskəˌpeɪdz
escape => i'skeip
escapee => i.skei'pi:
escapees => ɪˌskeɪˈpi:z
escapement => is'keipmәnt
escaper => ɪs'keɪpər
escapes => isˈkeips
escapism => is'keipizәm
escapist => is'keipist
escapists => ɪ'skeɪpɪst
escapologist => ,eskei'pɔlәdʒist
escapology => .eskei'pɒlәdʒi
escargot => eskar'^әu, eskar'^o
escarole => 'eskәrәul
escarpment => is'kɑ:pmәnt
escarpments => iˈskɑ:pmənts
Escaut => es'kәj
eschar => 'eskɑ:
eschatological => .eskәtә'lɒdʒikәl
eschatology => .eskә'tɒlәdʒi
escheat => is'tʃi:t
Escherichia => ,eʃә'rikiә
eschew => is'tʃu:
eschewal => ɪst'ʃu:əl
eschewed => esˈtʃu:d
eschewing => esˈtʃu:ɪŋ
eschews => esˈtʃu:z
escolar => 'eskә,lɑ:
Escorial => ,eskɔri'ɑ:l
escort => 'eskɒ:t
escorted => ˈeskɔ:tid
escorting => ˈeskɔ:tɪŋ
escritoire => .eskri:'twɑ:r
escrow => 'eskrәu
escudo => e'sku:dәu
esculent => 'escju:lәnt
escutcheon => i'skʌtʃәn
esemplastic => ,esem'plæstik
eserine => 'esә,rin
Esfahan => ,esfə'hɑ:n
esker => 'eskә(r)
Eskimo => 'eskimәu
eskimos => ˈeskəˌməʊz
Esme => 'ezmi
Esmond => 'ezmənd
ESOL => 'esәl
esophageal => i(:),sɔfә'dʒi(:)әl
esophagitis => i,sɔfә'dʒaitis
esophagus => i:'sɒfәgәs
esoteric => .esәu'terik
esoterica => .esәu'terikә
esoterically => esəʊ'terɪklɪ
esoterics => ,esə'terɪk; ,iːsə-
espadrille => 'espәdril
espalier => is'pæljә
espaliered => ɪ'spæljə; e-
esparto => e'spɑ:tәu
especial => i'speʃәl
especially => i'speʃәli
Esperantist => .espә'ræntist
Esperanto => .espә'ræntәu
espial => i'spaiәl
espied => ɪˈspaɪd
espies => ɪˈspaɪz
espionage => .espiә'nɑ:ʒ
esplanade => .esplә'neid
espousal => i'spauzl
espouse => i'spauz
espoused => ɪˈspaʊzd
espouses => ɪˈspaʊziz
espousing => ɪˈspaʊzɪŋ
espressivo => ,espre'si:vәu
espresso => e'spresәu
espressos => ˈespresəuz
esprit => es'pri:
esprit de corps => espri:dә'kɔ:
espy => i'spai
espying => ɪˈspaɪŋ
Esquimau => 'eskimәu
esquire => i'skwaiә
ess => es
essay => 'esei. e'sei
essaying => ˈeseiŋ
essayist => 'eseiist
essayistic => -'istik
essayists => ˈeseiists
essays => ˈeseiz
esse => 'esi
essen => 'esn
essence => 'esns
essences => 'esnsɪz
Essene => 'esi:n, e'si:n
essential => i'senʃәl
essentialism => i'senʃәlizәm
essentialist => ˌɪ'senʃəlɪst
essentiality => i.senʃi'æliti
essentialize => i'senʃәlaiz
essentially => i'senʃәli
Essequibo => ,esə'kwi:bəu
esses => 'esiz
Essex => 'esiks
ESSO => 'i:səu
establish => i'stæbliʃ
established => is'tæbliʃt
establisher => i'stæbliʃ
establishes => isˈtæbliʃiz
establishing => isˈtæbliʃɪŋ
establishment => i'stæbliʃmәnt
establishmentarian => i,stæbliʃmәn'teәriәn
establishmentarianism => ɪstæblɪʃmən'teərɪənɪz
establishments => isˈtæbliʃmənts
estaminet => estɑ:mi'ne
estancia => es'tɑ:nsjɑ:
estate => i'steit
estate car => isˈteit kɑ:
esteem => i'sti:m
esteeming => isˈti:mɪŋ
esteems => isˈti:mz
estella => e'stelә
Estelle => es'tel
ester => 'estә
esterase => 'estәreis
esterified => es'terifaid
esterifies => esˈterifaiz
esterify => es'terifai
esterifying => esˈterifaiŋ
esther => 'estә
esthete => 'esθi:t
esthetic => es'θetik
esthetics => i:s'θetiks
estimable => 'estimәbl
estimate => 'estimeit
estimating => 'estimeitiŋ
estimation => .esti'meiʃәn
estimations => ˌestəˈmeɪʃənz
estimative => 'estimeitiv
estimator => 'estimeitә
estival => i:'staivl
estivate => 'i:stiveit
estivated => ˈestiveitid
estivates => ˈestiveits
estivating => ˈestiveitɪŋ
estivation => .i:sti'veiʃәn
eston => 'estɔn
Estonia => es'tәuniә
Estonian => es'tәuniәn
estop => i'stɒp
estoppel => i'stɒpl
estopping => ɪs'tɒppɪŋ
estovers => es'tәuvәz
estradiol => ,estrә'daiәul, -ɔ:l
estrange => i'streindʒ
estranged => i'streindʒd
estrangement => i'streindʒmәnt
estrangements => ɪsˈtreɪndʒmənts
estreat => i'stri:t
estriol => 'estraiәul
estrogen => 'estrәdʒәn
estrogenic => ,estrә'dʒenik
estrone => 'estrәun
estrous => 'i:strәs, 'es-
estrus => 'estrәs
estuarial => ,estju'eәriәl
estuaries => ˈestʃu:ˌeri:z
estuarine => 'estjuәrin
estuary => 'estjuәri
esurient => i'sjuәriәnt
Et => 'i:ti:
et cetera => it'setrә
ETA => 'i:tә
etagere => eɪtɪd'ʒeə
etalon => 'etәlәn
etcetera => it'setәrә
etceteras => it'setrәz
etch => etʃ
etchant => 'etʃәnt
etched => 'etʃid
etcher => 'etʃә
etches => etʃiz
etching => 'etʃiŋ
eternal => i'tә:nl
eternalize => i(:)'tә:nәlaiz
eternally => i't\\\\:nәli
eternity => i'tә:niti
eternity ring => ɪˈtɜ:nɪti: riŋ
eternize => i'tә:naiz
eth => eð
ethacrynic acid => ˌeθəˈkrɪnɪk
ethambutol => eθ'æmbjjtɔl
ethan => 'i:θәn
ethanal => 'eθәnæl
ethanamide => i'θænә,maid
ethane => 'eθein
ethanol => 'eθәnәul
ethel => 'eθәl
Ethelred => 'eθәlred
ethene => 'eθi:n
ether => 'i:θә
ethereal => i'θiriәl
ethereality => i.θiәri'æliti
etherealize => i'θiәriәlaiz
etherealized => i(:)ˈθiəriəlaizd
etherealizes => i(:)ˈθiəriəlaiziz
etherealizing => i(:)ˈθiəriəlaizɪŋ
ethereally => i'θiәriәli
etheric => 'i:θerɪk
etherization => .i:θәrai'zeiʃәn
etherize => 'i:θәraiz
ethic => 'eθik
ethical => 'eθikәl
ethicality => ,eθi'kæliti
ethicist => 'eθisist
ethicists => 'eθɪsɪst
ethics => 'eθiks
Ethiopia => .i:θi'әupiә
Ethiopian => .i:θi'әupiәn
ethiopians => ˌi:θiˈəupjənz
Ethiopic => .i:θi'ɒpik
ethmoid => 'eθmɒid
ethmoidal => eθ'mɔidәl
ethnic => 'eθnik
ethnic cleansing => ˈeθnik ˈklenziŋ
ethnic minority => ˈeθnik maiˈnɔriti
ethnical => 'eθnikәl
ethnically => 'eθnikli
ethnicity => eθ'nisәti
ethno- => 'eθnәj
ethnoarchaeology => 'eθnәj,ɑ:ki'ɔlәdʒi
ethnobotanic => ,eθnaubə'tænik; ,eθnəubə'tænikəl
ethnobotanical => ,eθnәjbә'tænikəl
ethnobotanist => eθnəʊ'bɒtənɪst
ethnobotany => ,eθnәu'bɔtәni
ethnocentric => ,eθnәu'sentrik
ethnocentricity => ,igosɛn'trɪsɪti
ethnocentrism => .eθnәu'sentrizm
ethnocide => 'eθnәjsaid
ethnogenesis => ,eθnәj'dʒenisis
ethnographer => eθ'nɒgrәfә
ethnographic => ˌeθnə'ɡræfɪk
ethnographical => eθnə'gra:fikəl
ethnographically => ,eθnə'ɡræfikəli
ethnography => eθ'nɒgrәfi
ethnohistorian => ,eθnәjhis'tɔ:riәn
ethnohistoric => ,eθnәjhis'tɔrik
ethnohistorical => ,eθnәjhis'tɔrikəl
ethnohistory => 'eθnәj,histəri
ethnolinguist => ,eθnəʊ'lɪŋɡwɪst
ethnolinguistic => ,eθnəʊlɪŋ'ɡwɪstɪk
ethnolinguistics => .eθnɒliŋ'gwistiks
ethnologic => .eθnә'lɔdʒik.-kәl
ethnological => ,eθnәu'lɔdʒikәl
ethnologist => eθ'nɒlәdʒist
ethnology => eθ'nɒlәdʒi
ethnomethodology => 'eθnәj,meθә'dɔlәdʒi
ethnomusicological => 'eθnәj,mju:zikә'lɔdʒikəl
ethnomusicologist => eθnɒmju:zɪ'kɒlədʒɪst
ethnomusicology => ,eθnәu,mjuzi'kɔlәdʒi
ethnoscience => 'eθnәu,saiәns
ethogram => 'eθәu^ræm
ethological => ,eθә'lɔdʒikәl
ethologist => i'θɔlәdʒist
ethology => i(:)'θɔlәdʒi
ethos => 'i:θɔs
ethyl => 'eθil, 'i:θail
ethyl alcohol => 'eθil
ethylbenzene => ,eθil'benzi:n
ethylene => 'eθili:n
ethylenediamine => 'eθәli:n'daiәmi:n
ethyne => 'eθain
etic => 'etik
etiolate => 'i:tiәuleit
etiolated => ˈi:tiəleɪtɪd
etiolation => .i:tiәu'leiʃәn
etiology => ,i:ti'ɔlәdʒi
etiquette => eti'ket
etna => 'etnә
Eton => 'i:tn
etonian => i(:)'tәunjәn, -niәn
Etruria => i'truәriә
Etruscan => i'trʌskәn
etude => ei'tju:d
etui => e'twi:
etymological => .etimә'lɒdʒikl
etymologically => ˌɪtɪmə'lɒdʒɪkəlɪ
etymologies => ˌetəˈmɔlədʒi:z
etymologist => .eti'mɒlәdʒist
etymologize => .eti'mɒlәdʒaiz
etymology => .eti'mɔlәdʒi
etymon => 'etimɒn
eubacterial => ju:'bæktɪərɪəl
eubacterium => ,ju:bæk'tiәriәm
Euboea => ju:'bi(:)ә
eucalyptus => .ju:kә'liptәs
eucaryote => ju:'kæri,әut
Eucharist => 'ju:kәrist
eucharistic => ,ju:kə'ristik
euchre => 'ju:kә
euchromatin => ju:'krәumәtin
Euclid => 'ju:klid
Euclidean => ju:'klidiәn
eucrite => 'ju:krait
eudaemonic => ,ju:di'mɔnik
eudaemonism => ju:'di:mәnizəm
eudaemonistic => ju:,di:mə'nistik
eudiometer => .ju:di'ɒmitә
eudiometric => ,ju:diә'metrik
eudiometrical => ,ju:diә'metrikәl
eudiometry => ,ju:di'ɔmitri
eugene => ju:'ʒein, 'ju:dʒi:n
Eugenia => ju:'dʒi: njә
eugenic => ju:'dʒenik
eugenically => ju:'dʒenikli
eugenicist => ju:'dʒenisist
eugenics => ju:'dʒeniks
eugenist => 'ju:dʒinist
eugenol => 'ju:dʒinɔl
euglena => ju:'gli:nә
euglenoid => ju:'^lenɔid
euhedral => ju:'hi:drәl
eukaryote => ju'kæriәut
eukaryotic => u:keəri':ɒtɪk
eulachon => 'ju:lәkɔn
eulogies => ˈju:lədʒi:z
eulogise => 'ju:lәdʒaiz
eulogist => 'ju:lәdʒist
eulogistic => ,ju:lә'dʒistik
eulogium => ju'lәudʒiәm
eulogize => 'ju:lәdʒaiz
eulogized => ˈju:ləˌdʒaɪzd
eulogizes => ˈju:ləˌdʒaɪziz
eulogizing => ˈju:ləˌdʒaɪzɪŋ
eulogy => 'ju:lәdʒi
Eumenides => ju:'menidi:z
eunice => 'ju:nis
eunuch => 'ju:nәk
eunuchoid => 'ju:nәkɔid
eunuchoidism => -'kɔidizm
eunuchs => 'ju:nəks
euonymus => ju:'ɔnimәs
eupeptic => ju:'peptik
euphausiid => ju:'fɔ:zɪɪd
euphemism => 'ju:fәmizm
euphemisms => 'ju:fəmɪzəmz
euphemistic => .ju:fә'mistik
euphemistically => ˌju:fə'mɪstɪklɪ
euphemize => 'ju:fәmaiz
euphonic => ju:'fɒnik
euphonious => ju:'fәuniәs
euphonium => ju:'fәuniәm
euphonize => 'ju:fәnaiz
euphony => 'ju:fәni
euphorbia => ju:'fɒ:biә
euphoria => ju:'fɒ:riә
euphoriant => ju'fɔ:riәnt
euphoric => ju:'fɔrik
Euphrates => ju:'freiti:z
euphuism => 'ju:fjuizm
euphuist => 'ju:fjuist
euphuistic => ,ju:fju(:)'istik
euphuistically => juːfju(ː)ˊistikәli
euploid => 'ju:plɔid
euploidy => 'ju:plɔidi
Eurasia => ju'reiʒә
Eurasian => ju'reiʒәn
Euratom => jjә'rætәm
eureka => juә'ri:kә
eurhythmic => ju:'riθmik
eurhythmics => ju:'riðmiks
Euripides => ju'ripәdi:z
euro => 'juәrәu
eurobond => 'juәrәubɔnd
Eurocentric => ,jjәrәj'sentrik
Eurocentrism => ,juərəu'sentrizəm
Eurocheque => 'jjәrәjtʃek
Eurocommunism => ,juərəu'kɔmjunizəm
Eurocrat => 'juәrәkræt
eurocurrency => 'jjәrәj,kʌrәnsi
Eurodollar => 'juәrәudɒlә
Euroland => 'juərəu,lænd
Euromarket => 'juәrәmɑ:kit
Europa => juә'rәupә
Europe => 'juәrәp
European => .juәrә'pi:әn
europeanisation => ˌjʊərəpi:ənaɪ'zeɪʃn
Europeanism => ,juәrә'pi(:)әnizәm
Europeanize => .juәrә'pi:әnaiz
europeans => ˌjʊərəˈpi:ənz
europium => ju'rәupiәm
euros => 'ju:rәus
EUROTUNNEL => 'juərəu,tʌnəl
Eurovision => 'juәrәviʒәn
Eurozone => 'juərəuzəun
euryhaline => ,juәri'heilain, -'hælain
eurypterid => jjə'riptәrid
eurythermal => ,jjәri'θ\\\\:məl
eurythmic => juә'riðmik
eurythmics => jjə'riðmiks
eurythmy => 'ju:rɪðmɪ
eurytopic => ,juәri'tɔpik
eusocial => ju:'sәjʃəl
eusol => 'ju:sɔl
Eustace => 'ju:stәs
Eustachian tube => ju:'steiʃjәn
eustatic => ju:'stætik
eutectic => ju:'tektik
eutectoid => ju:'tektɔid
Euterpe => ju:'tә:pi
euthanasia => .ju:θә'neizjә
euthanize => 'ju:θәnaiz
eutherian => ju:'θiәriәn
euthyroid => ju:'θaiәrɔid
eutrophic => ju'trɔfik, -'trәufik
eutrophicate => ju'trɔfikeit
eutrophication => ju:,trɔfi'keiʃən
eva => 'i:vә
evacuant => i'vækjuәnt
evacuate => i'vækjueit
evacuates => iˈvækjueits
evacuating => iˈvækjueitɪŋ
evacuation => i.vækju'eiʃәn
evacuations => ɪˌvækju:ˈeɪʃənz
evacuee => i.vækju'i:
evacuees => iˌvækju:ˈi:z
evadable => i'veidәbl
evade => i'veid
evaded => iˈveidid
evader => i'veidә(r)
evades => ɪ'veɪd
evaginate => i'vædʒineit
evagination => i,vædʒi'neiʃәn
evaluable => i'væljjәbl
evaluate => i'væljueit
evaluates => iˈvæljueits
evaluation => i.vælju'eiʃәn
evaluations => ɪvælj'ʊeɪʃnz
evaluative => i'væljueitiv
evaluator => i'væljjeitә(r)
evan => 'evən
evanesce => .i:vә'nes
evanescence => .i:vә'nesns
evanescent => .i:vә'nesnt
evangel => i'vændʒel
evangelic => .i:væn'dʒelik
evangelical => ,i:væn'dʒelikәl
evangelicalism => ,i:væn'dʒelikәlizәm
evangelically => i:vænd'ʒelɪklɪ
evangelisation => i,vændʒə-lai'zeiʃən; -li'z-
evangelise => i'vændʒәlaiz
evangelising => i'vændʒəlaiz
evangelism => i'vændʒәlizm
evangelist => i'vændʒilist
evangelistic => i.vændʒә'listik
evangelists => iˈvændʒilists
evangelize => i'vændʒәlaiz
evangelized => iˈvændʒilaizd
evangelizes => iˈvændʒilaiziz
evangelizing => iˈvændʒilaizɪŋ
evans => 'evәnz
evaporable => i'væpәrәbl
evaporate => i'væpәreit
evaporated => i'væpәreitid
evaporates => iˈvæpəreits
evaporating => i'væpә,reitiŋ
evaporation => i.væpә'reiʃәn
evaporative => i'væpәrәtiv
evaporator => i'væpәreitә
evaporite => i'væpә,rait
evapotranspiration => i,væpәu,trænspi'reiʃәn
evasion => i'veiʒәn
evasions => ɪˈveɪʒənz
evasive => i'veisiv
evasively => ɪ'veɪsɪvlɪ
evasiveness => i'veisivnis
eve => i:v
evection => i'vekʃәn
evelyn => 'i:vlin, 'evlin
even => 'i:vәn
even-aged => 'i:vn'eɪdʒɪd
even-handed => i:v(ә)n'hændid
even-steven => 'i:vən'sti:vən
even-toed ungulate => ˈivən tod ˈʌŋɡjəlɪt
evenhandedness => 'i:vən'hændidnis
evening => 'i:vniŋ
evening class => ˈi:vniŋ klɑ:s
evening primrose => ˈi:vniŋ ˈprɪmˌrəʊz
evenings => 'i:vniŋz
evenly => 'i:vәnli
evenness => 'i:vәnnis
evens => 'i:vәnz
evensong => 'i:vәnsɒŋ
event => i'vent
event horizon => iˈvent həˈraizən
eventer => i'ventə
eventful => i'ventful
eventide => 'i:vәntaid
eventing => ɪˈventɪŋ
eventless => i'ventlis
eventual => i'ventʃuәl
eventualities => ɪˌventʃu:ˈælɪti:z
eventuality => i.ventʃu'æliti
eventually => i'ventʃuәli
eventuate => i'ventʃueit
eventuated => ɪˈventʃu:ˌeɪtid
eventuates => ɪˈventʃu:ˌeɪts
eventuating => ɪˈventʃu:ˌeɪtɪŋ
eventuation => i,ventʃu'eiʃən
ever => 'evә
Everard => 'evәrɑ:d
Everest => 'evәrist
everett => 'evәrit
evergreen => 'evәgri:n
evergreens => 'evəɡri:nz
everlasting => .evә'læstiŋ
evermore => .evә'mɒ:
eversible => i'vә:sibl
eversion => i'vә:ʃәn
evert => i(:)'vә:t
everted => iˈvə:tid
everting => iˈvə:tɪŋ
everts => iˈvə:ts
every => 'evri
everybody => 'evribɒdi
everyday => 'evri'dei
everydayness => 'evri'deinis
everyman => 'evrimæn
everyone => 'evriwʌn
everyplace => 'evripleis
everything => 'evriθiŋ
everywhere => 'evrihwєә
Everywoman => 'evri,wjmәn
Evesham => 'i:vʃəm
evict => i'vikt
evicted => ɪˈvɪktid
evicting => ɪˈvɪktɪŋ
eviction => i'vikʃәn
evictions => i(:)ˈvikʃənz
evictor => i'viktә
evicts => ɪˈvɪkts
evidence => 'evidәns
evidences => ˈevidənsiz
evident => 'evidәnt
evidential => .evi'denʃәl
evidentiary => ,evi'denʃәri
evidently => 'evidәntli
evil => 'i:vl
evilly => 'i:vli
evilness => 'i:vəlnəs
evils => ˈi:vəlz
evince => i'vins
evinced => ɪˈvɪnst
evinces => ɪˈvɪnsiz
evincing => ɪˈvɪnsɪŋ
eviscerate => i'visәreit
eviscerated => ɪˈvɪsəˌreɪtid
eviscerates => ɪˈvɪsəˌreɪts
eviscerating => ɪˈvɪsəˌreɪtɪŋ
Evita => e'vi:tɑ:
evocation => .evә'keiʃәn
evocations => ˌevəuˈkeiʃənz
evocative => i'vɒkәtiv
evoke => i'vәuk
evoked => iˈvəukt
evokes => iˈvəuks
evoking => iˈvəukɪŋ
evolute => 'i:vәlu:t
evolution => .i:vә'lu:ʃәn
evolutional => .i:vә'lu:ʃәnl
evolutionarily => ,i:və,lu:ʃən'ærili
evolutionary => ,i:vә'lu:ʃәnәri
evolutionism => .i:vә'lu:ʃәnizm
evolutionist => .i:vә'lu:ʃәnist
evolutive => ,i:vә'lu:tiv, 'ev-
evolvable => i'vɔlvәbl
evolve => i'vɒlv
evolves => iˈvɔlvz
evzone => 'evzәun
Ewan => 'ju:әn
ewe => ju:
ewe-necked => 'ju:nekt
ewer => 'ju:ә
ewers => ˈju:əz
ewes => ju:z
ex => eks
ex gratia => eks'^reiʃiә
ex libris => eks'laibris
ex nihilo => eksˈnaihiləu
ex officio => eks ә'fiʃiәj
ex post => eks'pәjst
ex post facto => 'eks pәust 'fæktәu
ex-con => eks kɔn
ex-directory => ,eksdi'rektәri
ex-service => 'eks'sә:vis
ex-serviceman => eks's\\\\:vismәn
ex-servicemen => 'ekss'ɜ:vɪsmen
ex-voto => 'eksv'əʊtəʊ
exa- => ˈeksə-
exacerbate => ek'sæsәbeit
exacerbated => ɪgˈzæsəˌbeɪtid
exacerbates => ɪgˈzæsəˌbeɪts
exacerbating => ɪgˈzæsəˌbeɪtɪŋ
exacerbation => ek.sæsә'beiʃәn
exact => ig'zækt
exacta => i^'zæktә
exactable => ig'zæktәbl
exacting => ig'zæktiŋ
exaction => ig'zækʃәn
exactitude => ig'zæktitju:d
exactly => i^'zæktli
exactness => ig'zæktnis
exactor => ig'zæktә
exacts => iɡˈzækts
exaggerate => ig'zædʒәreit
exaggerated => ig'zædʒәreitid
exaggeratedly => ig'zædʒəreitidli
exaggerates => iɡˈzædʒəreits
exaggerating => iɡˈzædʒəreitɪŋ
exaggeration => ig.zædʒә'reiʃәn
exaggerative => ig'zædʒәrәtiv
exaggerator => ig'zædʒәreitә
exalt => ig'zɒ:lt
exaltation => .egzɒ:l'teiʃәn
exalted => ig'zɒ:ltid
exaltedly => igˊzɒːltidli
exalting => ɪg'zɔ:ltɪŋ
exalts => ɪgˈzɔ:lts
exam => ig'zæm
exam paper => iɡˈzæm ˈpeipə
examen => ig'zeimәn
examinable => i^'zæminәbl
examination => ig.zæmi'neiʃәn
examinations => iɡˌzæmiˈneiʃənz
examine => ig'zæmin
examinee => ig.zæmi'ni:
examiner => ig'zæminә
examiners => ɪɡ'zæmɪnəz
examines => iɡˈzæminz
example => ig'zæmpl
exanthema => ,eksæn'θi:mә
exarch => 'eksɑ:k
exarchate => 'eksɑ:keit
exasperate => ig'zæspәreit
exasperated => ɪgˈzæspəreɪtɪd
exasperates => ɪgˈzæspəˌreɪts
exasperating => ig'zæspәreitiŋ
exasperation => ig.zæspә'reiʃәn
Excalibur => eks'kælibә
excavate => 'ekskәveit
excavated => ˈekskəˌveɪtid
excavates => ˈekskəˌveɪts
excavation => .ekskә'veiʃәn
excavations => ˌekskəˈveɪʃənz
excavator => 'ekskәveitә
excavators => 'ekskəveɪtəz
exceed => ik'si:d
exceeding => ik'si:diŋ
exceedingly => ik'si:diŋli
exceeds => ikˈsi:dz
excel => ik'sel
excellence => 'ekslәns
excellencies => ˈeksələnsi:z
Excellency => 'ekslәnsi
excellent => 'ekslәnt
excels => ikˈselz
excelsior => ek'selsiɒ:
excentric => ik'sentrik
except => ik'sept
excepting => ik'septiŋ
exception => ik'sepʃәn
exceptionable => ik'sepʃәnәbl
exceptional => ik'sepʃәnәl
exceptionality => ɪksepʃə'nælɪtɪ
excepts => ikˈsepts
excerpt => 'eksә:pt
excerpted => 'eksɜːpt
excerpting => 'eksɜːpt
excerption => ek'sә:pʃәn
excess => ik'ses
excessive => ik'sesiv
excessively => ik'sesivli
excessiveness => ɪk'sesɪvnɪs
exchange => iks'tʃeindʒ
exchange rate => iksˈtʃeindʒ reit
exchangeability => iks,tʃindʒә'biliti
exchangeable => iks'tʃeindʒәbl
exchanged => iksˈtʃeindʒd
exchanger => iks'tʃeindʒә
exchangers => iks'tʃeindʒə
exchequer => iks'tʃekә
excimer => ek'saimә
excipient => ik'sipiәnt
excise => ek'saiz
exciseman => ek'saizmәn
excises => ˈekˌsaɪziz
excision => ek'siʒәn
excisional => ɪk'sɪʒənəl
excitability => ik.saitә'biliti
excitable => ik'saitәbl
excitably => ikˊsaitәbli
excitant => 'eksitәnt
excitation => .eksai'teiʃәn
excitative => ek'saitәtiv
excitatory => ek'saitәtәri
excite => ik'sait
excited => ik'saitid
excitedly => ik'saitidli
excitement => ik'saitmәnt
excitements => ikˈsaitmənts
exciter => ik'saitә
excites => ikˈsaits
exciting => ik'saitiŋ
excitingly => ik'saitiŋli
exciton => 'iksitɔn
exclaim => iks'kleim
exclaimed => iksˈkleimd
exclaiming => iksˈkleimɪŋ
exclaims => iksˈkleimz
exclamation => .eksklә'meiʃәn
exclamations => ˌekskləˈmeɪʃənz
exclamatory => ik'sklæmәtәri
exclave => 'ekskleiv
exclosure => iks'klәuʒә
excludable => iks'klu:dəbl
exclude => iks'klu:d
excluded => iksˈklu:did
excluder => iks'klu:dә
excludes => iksˈklu:dz
exclusion => ik'sklu:ʒәn
exclusion zone => ɪkˈsklu:ʒən zəun
exclusionary => ɪkˈsklu:ʒənri
exclusionist => ik'sklu:ʒәnist
exclusions => ɪksk'lu:ʒnz
exclusive => ik'sklu:siv
exclusively => ik'sklu:sivli
exclusiveness => ik'sklu:sivnis
exclusives => iksˈklu:sivz
exclusivism => iks'klu:sivizәm
exclusivist => iks'klu:sivist
exclusivity => ,eksklu:'siviti
excogitate => eks'kɒdʒiteit
excogitated => ɪkˈskɔdʒɪˌteɪtid
excogitates => ɪkˈskɔdʒɪˌteɪts
excogitating => ɪkˈskɔdʒɪˌteɪtɪŋ
excogitation => eks,kɔdʒi'teiʃәn
excommunicant => ,ekskә'mju:nikәnt
excommunicate => .ekskә'mju:nikeit
excommunicated => ˌekskəˈmju:nɪˌkeɪtid
excommunicates => ˌekskəˈmju:nɪˌkeɪts
excommunicating => ˌekskəˈmju:nɪˌkeɪtɪŋ
excommunication => 'ekskә,mju:ni'keiʃәn
excommunications => 'ekskə,mju:ni'keiʃən
excommunicatory => -kәtәri
excoriate => ek'skɒ:rieit
excoriated => ɪkˈskɔ:ri:ˌeɪtid
excoriates => ɪkˈskɔ:ri:ˌeɪts
excoriating => ɪkˈskɔ:ri:ˌeɪtɪŋ
excoriation => .ekskɒ:ri'eiʃәn
excrement => 'ekskrimәnt
excremental => ,ekskrә'mentәl
excrescence => ik'skresns
excrescences => iksˈkresnsiz
excrescent => ik'skresnt
excreta => ek'skri:tә
excrete => ek'skri:t
excreted => ɪkˈskri:tid
excretes => ɪkˈskri:ts
excreting => ɪkˈskri:tɪŋ
excretion => ek'skri:ʃәn
excretive => ek'skri:tiv
excretory => 'ekskrәtәri
excruciate => iks'kru:ʃieit
excruciating => iks'kru:ʃieitiŋ
excruciatingly => ɪk'skru:ʃɪeɪtɪŋlɪ
excruciation => ik,skru:ʃi'eiʃәn
exculpate => 'ekskʌlpeit
exculpated => ˈekskəlˌpeɪtid
exculpates => ˈekskəlˌpeɪts
exculpating => ˈekskəlˌpeɪtɪŋ
exculpation => .ekskʌl'peiʃәn
exculpatory => eks'kʌlpәtәri
excurrent => ek'skʌrәnt
excursion => ik'skә:ʒәn
excursionist => ik'sk\\\\:ʃәnist
excursions => iksˈkə:ʃənz
excursive => ik'skә:siv
excursively => eksˊkәːsivli
excursiveness => eksˊkәːsivnis
excursus => ek'skә:sәs
excusable => iks'kju:zәbl
excusably => ɪk'skju:zəblɪ
excusal => iks'kju:zәl
excusatory => iks'kju:zәtәri
excuse => ik'skju:z
excused => iksˈkju:zd
excuses => iksˈkju:ziz
excusing => ik'skju:ziŋ
exeat => 'eksiæt
exec => i^'zek
execrable => 'eksikrәbl
execrably => ˊeksikrәbli
execrate => 'eksikreit
execrated => ˈeksɪˌkreɪtid
execrates => ˈeksɪˌkreɪts
execrating => ˈeksɪˌkreɪtɪŋ
execration => .eksi'kreiʃәn
execrative => 'eksɪkreɪtɪv
execratory => eksɪkreɪ'tərɪ
execs => ɪɡ'zeks
executable => 'eksikju:tәbl
executant => ig'zekjutәnt
execute => 'eksikju:t
executed => ˈeksikju:tid
executes => ˈeksikju:ts
execution => .eksi'kju:ʃәn
executioner => .eksi'kju:ʃәnә
executioners => ˌeksɪˈkju:ʃənəz
executions => ˌeksiˈkju:ʃənz
executive => ig'zekjutiv
executor => ig'zekjutә
executorial => ig.zekju'tɒ:riәl
executors => ɪgˈzekjətəz
executorship => i^'zekjjtәʃip
executory => e^'zekjutәri
executrix => ig'zekjutriks
exedra => ik'si:drә, 'eksi-
exegesis => .eksi'dʒi:sis
exegete => 'eksidʒi:t
exegetic => ,eksi'dʒetik
exegetical => ,eksi'dʒetikәl
exemplar => ig'zemplә
exemplarily => ig'zemplәrili
exemplariness => ig'zemplәrinis
exemplars => ɪɡ'zempləz
exemplary => ig'zemplәri
exemplification => i^,zemplifi'keiʃәn
exemplified => ɪɡˈzɛmpləˌfaɪd
exemplifies => ɪɡˈzɛmpləˌfaɪz
exemplify => ig'zemplifai
exemplifying => ɪɡˈzɛmpləˌfaɪŋ
exemplum => ig'zemplәm
exempt => ig'zempt
exempted => iɡˈzemptid
exempting => iɡˈzemptɪŋ
exemption => ig'zempʃәn
exemptions => ɪgˈzempʃənz
exempts => iɡˈzempts
exenteration => i^,zentә'reiʃәn
exequatur => .eksi'kweitә
exequies => 'eksikwiz
exequy => 'eksikwi
exercisable => 'eksәsaizәbl
exercise => 'eksәsaiz
exercise bike => ˈeksə baik
exercise book => ˈeksə buk
exercised => ˈeksəd
exerciser => 'eksәsaizә
exercising => 'eksəsaɪzɪŋ
exercycle => 'eksә,saikl
exergonic => ,eksә'^ɔnik
exergue => ek'sә:g
exert => ig'zә:t
exerted => i^'zә:tid
exerting => iɡˈzə:tɪŋ
exertion => ig'zә:ʃәn
exertions => ɪgˈzɜ:ʃənz
exerts => iɡˈzə:ts
exes => 'eksiz
exeter => 'eksәtә
exeunt => 'eksiʌnt
exfiltrate => eks'filtreit
exfiltration => ,eksfil'treiʃәn
exfoliate => eks'fәulieit
exfoliating => eksˈfəulieitɪŋ
exfoliation => eks,fәjli'eiʃәn
exhalable => 'eksheɪləbl
exhalation => .ekshә'leiʃәn
exhale => eks'heil
exhaled => eksˈheɪld
exhales => eksˈheɪlz
exhaust => ig'zɒ:st
exhausted => iɡ'zɔ:stid
exhaustedly => iɡ'zɔ:stid
exhaustibility => ig.zɒ:stә'biliti
exhaustible => ig'zɒ:stibl
exhausting => i^'zɔ:stiŋ
exhaustion => ig'zɒ:stʃәn
exhaustive => ig'zɒ:stiv
exhaustively => ɪɡ'zɔ:stɪvlɪ
exhaustiveness => ɪɡ'zɔ:stɪvnəs
exhausts => iɡˈzɔ:sts
exhibit => ig'zibit
exhibiting => iɡˈzibitɪŋ
exhibition => .eksi'biʃәn
exhibitioner => .eksi'biʃәnә
exhibitionism => .eksi'biʃәnizm
exhibitionist => .eksi'biʃәnist
exhibitor => i^'zibitә(r)
exhibitors => ɪɡ'zɪbɪtəz
exhilarate => ig'zilәreit
exhilarated => ɪgˈzɪləˌreɪtid
exhilarating => ig'zilәreitiŋ
exhilaratingly => igˊzilәreitiŋli
exhilaration => ig.zilә'reiʃәn
exhort => ig'zɒ:t
exhortation => .egzɒ:'teiʃәn
exhortative => i^'zɔ:tәtiv
exhortatory => ɪɡ'zɔ:tətərɪ
exhorted => ɪgˈzɔ:tid
exhorting => ɪgˈzɔ:tɪŋ
exhorts => ɪgˈzɔ:ts
exhumation => .ekshju:'meiʃәn
exhume => ig'zju:m
exhumed => ɪgˈzu:md
exhumes => ɪgˈzu:mz
exhuming => ɪgˈzu:mɪŋ
exigence => 'eksidʒәns
exigency => 'eksidʒәnsi
exigent => 'eksidʒәnt
exigible => 'eksidʒibl
exiguity => .eksi'gju:iti
exiguous => eg'zigjuәs
exile => 'eksail
exiles => ˈeksailz
exilic => e^'zilik
exiling => ˈeksailɪŋ
exine => 'eksi:n
exist => ig'zist
existed => iɡˈzistid
existence => ig'zistәns
existences => iɡˈzistənsiz
existent => ig'zistәnt
existential => .egzis'tenʃәl
existentialism => e^zi'stenʃәliz(ә)m
existentialist => ,e^zis'tenʃәlist
existentialists => ˌeɡzisˈtenʃəlists
existing => i^'zistiŋ
exit => 'eksit
exit poll => ˈeksit pəul
exit visa => ˈeksit ˈvi:zə
exited => ˈeksitid
exiting => ˈeksitɪŋ
exits => ˈeksits
Exmoor => 'eksmuə
exoatmospheric => 'eksәj,ætmәs'ferik
exobiological => 'eksəu,baiə'lɔdʒikəl
exobiologist => eɡ'zəʊbaɪələdʒɪst
exobiology => .eksәubai'ɒlәdʒi
exocarp => 'eksәukɑ:p
exocentric => ,eksәu'sentrik
exocet => 'eksə,set
exocrine => 'eksәkrain
exocytosis => ,eksәusai'tәusis
exodermis => ,eksәu'dә:mis
exodus => 'eksәdәs
exoenzyme => ,eksәu'enzaim
exogamous => -mәs
exogamy => ek'sɒgәmi
exogenic => ,eksәu'dʒenik
exogenous => ek'sɒdʒinәs
exogenously => ek'sɔdʒənəs
exonerate => ig'zɒnәreit
exonerated => ɪgˈzɔnəˌreɪtid
exonerates => ɪgˈzɔnəˌreɪts
exonerating => ɪgˈzɔnəˌreɪtɪŋ
exoneration => ig.zɒnә'reiʃәn
exonerative => ig'zɒnәreitiv
exonuclease => ,eksәu'nju:klieis
exopeptidase => ,eksәu'peptideis
exophthalmic => ,eksɔf'θælmik
exophthalmos => ,eksɔf'θælmɔs
exoplanet => ek'sɒpleɪnɪt
exopodite => ik'sɔpәdait
exorbitance => i^'zɔ:bitәns
exorbitant => ig'zɒ:bitәnt
exorbitantly => ig'zɔ:bitəntli
exorcise => 'eksɒ:saiz
exorcised => ˈeksɔ:saɪzd
exorcises => ˈeksɔ:saɪziz
exorcising => ˈeksɔ:saɪzɪŋ
exorcism => 'eksɔ:sizәm
exorcisms => ˈeksɔ:ˌsɪzəmz
exorcist => 'eksɔ:sist
exorcize => 'eksɔ:saiz
exorcized => ˈeksɔ:saɪzd
exorcizes => ˈeksɔ:saɪziz
exorcizing => ˈeksɔ:saɪzɪŋ
exordial => ek'sɒ:diәl
exordium => ek'sɒ:diәm
exoskeletal => ,eksəu'skelitəl
exoskeleton => ,eksәu'skelitәn
exosphere => 'eksәsfiә
exospheric => ,eksәj'sferik
exostosis => ,eksɔs'tәusis
exoteric => .eksәu'terik
exothermic => .eksәu'θә:mik
exothermically => ,eksəu'θə:mikəli
exotic => ig'zɒtik
exotic dancer => iɡˈzɔtik ˈdɑ:nsə
exotica => eɡ'zɔtikә
exoticism => ig'zɒtisizm
exotoxin => .eksәu'tɒksin
expand => ik'spænd
expandable => ik'spændәbl
expanded => ik'spendid
expander => ik'spændә
expanding => iks'pændiŋ
expands => iksˈpændz
expanse => ik'spæns
expanses => ɪkˈspænsiz
expansibility => ik.spænsi'biliti
expansible => ik'spænsәbl
expansile => ik'spænsail
expansion => ik'spænʃәn
expansionary => ik'spænʃәnәri
expansionism => ik'spænʃәnizm
expansionist => ik'spænʃәnist
expansionistic => ik,spænʃə'nistik
expansions => iksˈpænʃənz
expansive => ik'spænsiv
expansively => ɪk'spænsɪvlɪ
expansivity => ,ikspæn'siviti
expat => ˈeksˈpeɪt
expatiate => ek'speiʃieit
expatiated => eksˈpeiʃieitid
expatiates => eksˈpeiʃieits
expatiating => eksˈpeiʃieitɪŋ
expatiation => ek.speiʃi'eiʃәn
expatriate => eks'peitrieit
expatriates => ekˈspeɪtri:ˌeɪts
expatriation => eks.peitri'eiʃәn
expect => iks'pekt
expectable => ɪks'pektəbl
expectancy => ik'spektәnsi
expectant => iks'pektәnt
expectation => .ekspek'teiʃәn
expectations => ekspek'teɪʃnz
expecting => ikˈspektiŋ
expectorant => eks'pektәrәnt
expectorants => eks'pektərənts
expectorate => eks'pektәreit
expectorated => eksˈpektəreitid
expectorates => eksˈpektəreits
expectorating => eksˈpektəreitɪŋ
expectoration => ek.spektә'reiʃәn
expects => iksˈpekts
expedience => ik'spi:djәns
expediency => ik'spi:djәnsi
expedient => ik'spi:diәnt
expediently => ik'spi:diәntli
expedients => ɪkˈspi:di:ənts
expedite => 'ekspidait
expedited => ˈekspɪˌdaɪtid
expediter => 'ekspidaitә
expedites => ˈekspɪˌdaɪts
expediting => ˈekspɪˌdaɪtɪŋ
expedition => .ekspi'diʃәn
expeditionary => .ekspi'diʃәnәri
expeditions => ekspɪ'dɪʃnz
expeditious => .ekspi'diʃәs
expeditiousness => ekspiˊdiʃәsnis
expel => ik'spel
expelled => iksˈpeld
expellee => ekspә'li:
expeller => iks'pelә
expels => iksˈpelz
expend => ik'spend
expendability => ɪk,spendə'bɪlətɪ
expendable => iks'pendәbl
expendables => ɪks'pendəblz
expended => iksˈpendid
expending => iksˈpendɪŋ
expenditure => ik'spenditʃә
expenditures => ɪks'pendɪtʃəz
expends => iksˈpendz
expense => ik'spens
expensive => ik'spensiv
expensiveness => iksˊpensivnis
experience => ik'spiәriәns
experienced => ik'spiәriәnst
experiencer => ik'spiəriənsə
experiences => iksˈpiəriənsiz
experiential => ik.spiәri'enʃәl
experiment => ik'sperimәnt
experimental => ik.speri'mentәl
experimentalism => ik,speri'mentәlizәm,ek,s-
experimentalist => ik,speri'mentәlist,ek,s-
experimentally => ik.speri'mentli
experimentation => eks,perimen'teiʃәn
experiments => iksˈperimənts
expert => 'ekspә:t
expertise => .ekspә:'ti:z
expertize => 'ekspәtaiz
expertness => 'ekspɚtnɪs
expiable => 'ekspiәbl
expiate => 'ekspieit
expiated => ˈekspi:ˌeɪtid
expiates => ˈekspi:ˌeɪts
expiating => ˈekspi:ˌeɪtɪŋ
expiation => .ekspi'eiʃәn
expiator => 'ekspieitә(r)
expiatory => 'ekspiәtәri
expiration => .ekspi'reiʃәn
expiratory => ik'spaiәrәtәri
expire => ik'spaiә
expires => iksˈpaiəz
expiring => iksˈpaiərɪŋ
expiry => ik'spairi
explain => ik'splein
explainer => 'eksplә.neitә
explaining => iksˈpleinɪŋ
explanandum => ,eksplә'nændәm
explanans => ek'spleinænz
explanation => .eksplә'neiʃәn
explanations => eksplə'neɪʃnz
explanatorily => ik'splænәtәrili
explanatory => ik'splænәtәri
explant => eks'plænt
expletive => eks'pli:tiv
expletives => ɪksp'li:tɪvz
explicable => 'eksplikәbl
explicandum => ,eksplә'kændәm
explicans => 'eksplә,kænz
explicate => 'eksplikeit
explicated => ˈeksplɪˌkeɪtid
explicates => ˈeksplɪˌkeɪts
explicating => ˈeksplɪˌkeɪtɪŋ
explication => .ekspli'keiʃәn
explicative => ik'splikәtiv,'eksplikei-
explicatory => ik'splikәtәri,'eks-
explicit => ik'splisit
explicitness => iks'plisitnis
explode => ik'splәud
exploded => iks'plәudid
exploder => ik'splәudә
explodes => iksˈpləudz
exploding => iksˈpləudɪŋ
exploit => 'eksplɒit
exploitable => iks'plɔitәbl
exploitation => .eksplɒi'teiʃәn
exploitative => iks'plɔitәtiv
exploited => iksˈplɔitid
exploitive => iks'plɔitiv
exploits => iksˈplɔits
exploration => .eksplә'reiʃәn
explorations => eksplə'reɪʃnz
explorative => eks'plɔ:rәtiv
exploratory => iks'plɔ:rәtәri
explore => ik'splɒ:
explorer => ik'splɒ:rә
explores => ɪkˈsplɔː(r)
exploring => iks'plɔ:riŋ
explosion => ik'splәuʒәn
explosions => ɪksp'ləʊʒnz
explosive => ik'splәusiv
explosiveness => ɪksp'ləʊsɪvnəs
expo => 'ekspәu
exponent => ik'spәunәnt
exponential => .ekspәu'nenʃәl
exponentially => ˌekspə'nenʃəlɪ
exponentiate => ,ekspәu'nenʃieit
exponentiation => 'ekspәj,nenʃi'eiʃәn
exponents => ɪks'pəʊnənts
export => ik'spɒ:t
exportable => eks'pɒ:tәbl
exportation => ,ekspɔ:'teiʃәn
exporter => ik'spɒ:tә
exporters => ɪks'pɔ:təz
expose => ik'spәuz
exposed => ik'spәuzd
exposes => ikˈspəuziz
exposition => .ekspә'ziʃәn
expositions => ekspə'zɪʃnz
expositor => ik'spɒzitә
expository => ik'spɒzitәri
expostulate => ik'spɔstjuleit
expostulated => ɪkˈspɔstʃəˌleɪtid
expostulates => ɪkˈspɔstʃəˌleɪts
expostulating => ɪkˈspɔstʃəˌleɪtɪŋ
expostulation => ik.spɒstʃә'leiʃәn
expostulator => ik'spɒstjuleitә
expostulatory => ik'spɒstjulәtәri
exposure => ik'spәuʒә
exposures => iksˈpəuʒəz
expound => ik'spaund
expounded => ɪkˈspaʊndid
expounding => ɪkˈspaʊndɪŋ
expounds => ɪkˈspaʊndz
express => ik'spres
expressed => iksˈprest
expresses => iksˈpresiz
expressible => ik'spresәbl
expressing => iksˈpresɪŋ
expression => ik'spreʃәn
expression mark => iksˈpreʃən mɑ:k
expressional => ik'spreʃәnl
expressionism => k'spreʃәniz(ә)m
expressionist => ik'spreʃәnist
expressionistic => ik,spreʃә'nistik
expressionless => ik'spreʃәnlis
expressive => ik'spresiv
expressivity => ,ekspre'siviti
expressly => ik'spresli
expresso => eks'presәu
expressway => ik'spreswei
expressways => ɪksp'resweɪz
expropriate => eks'prәuprieit
expropriated => ekˈsprəʊpri:ˌeɪtid
expropriates => ekˈsprəʊpri:ˌeɪts
expropriating => ekˈsprəʊpri:ˌeɪtɪŋ
expropriation => eks.prәupri'eiʃәn
expulsion => ik'spʌlʃәn
expulsions => ɪkˈspʌlʃənz
expulsive => ik'spʌlsiv
expunction => ik'spʌŋkʃәn
expunge => ik'spʌndʒ
expunged => ɪkˈspʌndʒd
expungement => ɪks'pʌndʒmənt
expunger => ɪk'spʌn(d)ʒ; ek-
expunges => ɪkˈspʌndʒz
expunging => ɪkˈspʌndʒɪŋ
expurgate => 'ekspә:geit
expurgated => ˈekspəˌgeɪtid
expurgates => ˈekspəˌgeɪts
expurgating => ˈekspəˌgeɪtɪŋ
expurgation => .ekspә'geiʃәn
expurgator => 'ekspәgeitә
expurgatory => ik'sp\\\\:^әtәri
exquisite => 'ekskwizit
exquisitely => 'ekskwizitli
exsanguinate => eks'sæŋgwineit
exsanguine => eks'sæŋgwin
exsert => ek'sә:t
exserted => ek's\\\\:tid
exserting => ekˈsə:tɪŋ
exserts => ekˈsə:ts
exsolution => ,eksә'lu:ʃәn
extant => ek'stænt
extemporaneous => ik.stempә'reiniәs
extemporaneously => ekstempə'reiniəsli
extemporaneousness => ik,stempərə'ni:əti
extemporarily => ik'stempәrәrili
extemporary => iks'tempәrәri
extempore => ik'stempәri
extemporization => ik,stempәrai'zeiʃәn;-ri'z-
extemporize => ik'stempәraiz
extemporized => ɪkˈstempəˌraɪzd
extemporizes => ɪkˈstempəˌraɪziz
extemporizing => ɪkˈstempəˌraɪzɪŋ
extend => ik'stend
extend to => iksˈtend tu:
extendable => ek'stendәbl
extended => ik'stendid
extended family => iksˈtendid ˈfæmili
extender => iks'tendә
extendible => ik'stendәb(ә)l
extensibility => ik.stensi'biliti
extensible => ik'stensәbl
extensile => ik'stensail. -sil
extension => ik'stenʃәn
extensional => iks'tenʃәnәl
extensive => ik'stensiv
extensiveness => ɪks'tensɪvnəs
extensometer => ,eksten'sɔmitә
extensor => ik'stensә
extent => ik'stent
extenuate => ik'stenjueit
extenuated => ɪkˈstenju:ˌeɪtid
extenuates => ɪkˈstenju:ˌeɪts
extenuating => eks'tenjueitiŋ
extenuation => ik.stenju'eiʃәn
extenuatory => ik'stenjuәtәri
exterior => ik'stiәriә
exterior angle => eksˈtiəriə ˈæŋɡl
exteriority => ekstiәri'ɔriti
exteriorize => eks'tiәriәraiz
exteriorized => eksˈtiəriəraizd
exteriorizes => eksˈtiəriəraiziz
exteriorizing => eksˈtiəriəraizɪŋ
exteriors => eksˈtiəriəz
exterminate => ik'stә:mineit
exterminated => ɪkˈstɜ:məˌneɪtid
exterminates => ɪkˈstɜ:məˌneɪts
exterminating => ɪkˈstɜ:məˌneɪtɪŋ
extermination => ik.stә:mi'neiʃәn
exterminator => ik'stә:mәneitә
exterminators => ikˈstə:mineitəz
exterminatory => ik'stә:minәtәri
extern => eks'tә:n
external => ik'stә:nl
externalism => ik'stә:nәlizm
externalist => ik'stə:nəlist
externality => .ekstә:'næliti
externalize => ik'stә:nәlaiz
externalized => eksˈtə:nəˌlaizd
externalizes => eksˈtə:nəˌlaiziz
externalizing => eksˈtə:nəˌlaizɪŋ
externals => ɪkˈstɜ:nlz
exteroception => ekstərəʊ'sepʃn
exteroceptive => ,ekstәrәu'septiv
extinct => ik'stiŋkt
extinction => ik'stiŋkʃәn
extinguish => ik'stiŋgwiʃ
extinguishable => ɪks'tɪŋɡwɪʃəbl
extinguished => ɪks'tɪŋwɪʃt
extinguisher => ik'stiŋ^wiʃә(r)
extinguishers => ɪkˈstɪŋgwɪʃəz
extinguishes => iksˈtiŋɡwiʃiz
extinguishing => iks'tiŋ^wiʃiŋ
extinguishment => iks'tiŋ^wiʃmәnt
extirpate => 'ekstә:peit
extirpated => ˈekstəˌpeɪtid
extirpates => ˈekstəˌpeɪts
extirpating => ˈekstəˌpeɪtɪŋ
extirpation => .ekstә:'peiʃәn
extol => ik'stәul
extolled => ɪkˈstəʊld
extolling => ɪkˈstəʊlɪŋ
extolment => ɪks'təʊlm'ənt
extols => ɪkˈstəʊlz
extort => ik'stɒ:t
extorted => ɪkˈstɔ:tid
extorting => ɪkˈstɔ:tɪŋ
extortion => ik'stɒ:ʃәn
extortionate => ik'stɒ:ʃәnәt
extortionately => ik'stɔ:ʃənətli
extortioner => ik'stɒ:ʃәnә
extortionist => ik'stɔ:ʃәnә.-ʃәnist
extortive => ik'stɔ:tiv
extorts => ɪkˈstɔ:ts
extra => 'ekstrә
extra time => ˈekstrə taim
extra- => 'ekstrә
extra-curricular => 'ekstrə kə'rɪkjələ(r)
extracellular => ,ekstrә'seljulә
extracellularly => ekstrə'seljʊləlɪ
extracorporeal => ,ekstrәkɔ:'pɔ:riәl
extract => ik'strækt
extractability => ɪkstræktə'bɪlɪtɪ
extractable => ik'stræktәbl
extracted => iks'træktid
extracting => iks'træktiŋ
extraction => ik'strækʃәn
extractions => ɪkˈstrækʃənz
extractive => ik'stræktiv
extractor => ik'stræktә
extractors => ɪkst'ræktəz
extracts => iksˈtrækts
extracurricular => .ekstrәkә'rikjulә
extraditable => 'ekstrәdaitәbl
extradite => 'ekstrәdait
extradited => ˈekstrəˌdaɪtid
extradites => ˈekstrəˌdaɪts
extraditing => ˈekstrəˌdaɪtɪŋ
extradition => .ekstrә'diʃәn
extraditions => ekstrə'dɪʃ(ə)n
extrados => eks'treidɔs
extradural => ,ekstrә'djuәrәl
extrafloral => 'ekstrә'flɔ:rәl
extragalactic => ,ekstrә^ә'læktik
extrajudicial => ,ekstrәdʒu(:)'diʃәl
extralegal => .ekstrә'li:gl
extralimital => ,ekstrә'limitәl
extralinguistic => ,ekstrәliŋ'^wistik
extramarital => .ekstrә'mæritl
extramundane => ,ekstrә'mʌndein
extramural => .ekstrә'mjuәrәl
extramusical => ,ekstrә'mju:zikәl
extraneous => ek'streiniәs
extranet => 'ekstrənet
extraordinaire => ,ekstrә,ɔ:di'neә
extraordinaries => ɪkˈstrɔːd(ə)n(ə)ri; ekˈstrɔːd(ə)n(ə)ri; ˌekstrəˈɔːdɪn(ə)ri
extraordinarily => ik'strɔ:dθnәrili
extraordinary => ik'strɒ:dәnәri
extrapolate => ek'stræpәleit
extrapolated => ɪkˈstræpəˌleɪtid
extrapolates => ɪkˈstræpəˌleɪts
extrapolating => ɪkˈstræpəˌleɪtɪŋ
extrapolation => .ekstæpә'leiʃәn
extrapolations => ek,stræpə'leɪʃən
extrapyramidal => ,ekstrәpi'ræmidәl
extrasensory => .ekstrә'sensәri
extrasolar => ,ekstrә'sәulә
extrasystole => ,ekstrә'sistәli
extraterrestrial => ,ekstrәtә'restriәl
extraterrestrials => ˌekstrətəˈrestri:əlz
extraterritorial => 'ekstrә,teri'tɔ:riәl
extraterritoriality => -'æliti
extratextual => ,ekstrə'tekstjuəl; -tʃuəl
extratropical => ,ekstrә'trɔpikәl
extrauterine => ,ekstrә'ju:tәrain
extravagance => ik'strævәgәns
extravagances => ɪkˈstrævəgənsiz
extravagancy => ɪk'strævəgənsɪ
extravagant => ik'strævgәnt
extravagantly => ɪk'strævəɡəntlɪ
extravaganza => eks,trævә'^ænzә
extravaganzas => ɪkˌstrævəˈgænzəz
extravasate => ik'strævәseit
extravasated => eksˈtrævəseitid
extravasates => eksˈtrævəseits
extravasating => eksˈtrævəseitɪŋ
extravasation => ik.strævә'seiʃәn
extravascular => ,ekstrә'væskjulә
extravehicular => ,ekstrәvi'hikjulә
extraversion => ,ekstrә'vә:ʃәn
extravert => 'ekstrәvә:t
extraverted => 'ekstrəvə:tid
extrema => iks'tri:mә
Extremadura => ,estremɑ:'ðu:rɑ:
extreme => ik'stri:m
extreme unction => iksˈtri:m ˈʌŋkʃən
extremely => ik'stri:mli
extremeness => iksˊtriːmnis
extremism => ik'stri:mizm
extremist => iks'tri:mist
extremists => ɪkst'ri:mɪsts
extremities => ɪks'tremɪtɪs
extremity => ik'stremiti
extremophile => ɪks'təi:məfɪl
extremum => ik'stri:mәm
extricable => 'ekstrikәbl
extricate => 'ekstrikeit
extricated => ˈekstrɪˌkeɪtid
extricates => ˈekstrɪˌkeɪts
extricating => ˈekstrɪˌkeɪtɪŋ
extrication => .ekstri'keiʃәn
extrinsic => ek'strinsik
extrinsically => eks'trinsikəli
extrorse => eks'trɔ:s
extroversion => .ekstrә'vә:ʃәn
extrovert => 'ekstrәuvә:t
extroverted => 'ekstrәuvә:tid
extroverts => 'ekstrəvɜ:ts
extrude => ek'stru:d
extruded => ɪkst'ru:dɪd
extruder => eks'tru:dә
extrudes => eksˈtru:dz
extrusion => ek'stru:ʒәn
extrusions => ɪkst'ru:ʒnz
extrusive => ek'stru:siv
exuberance => ig'zju:bәrәns
exuberant => ig'zju:bәrәnt
exuberantly => ɪɡ'zju:bərəntlɪ
exudate => 'eksu:deit
exudation => .eksju:'deiʃәn
exudative => i^'zju:dәtiv
exude => ig'zju:d
exuded => ɪgˈzu:did
exudes => ɪgˈzu:dz
exuding => ɪgˈzu:dɪŋ
exult => ig'zʌlt
exultant => ig'zʌltәnt
exultantly => ɪɡ'zʌltəntlɪ
exultation => .egzʌl'teiʃәn
exulted => ɪgˈzʌltid
exulting => ɪgˈzʌltɪŋ
exultingly => ɪɡ'zʌltɪŋlɪ
exults => ɪgˈzʌlts
exurb => 'ekzә:b
exurban => eks'\\\\:bәn
exurbanite => e^'zә:bәnait
exurbia => e^'zә:biә
exuviae => i^'zju:vii:
exuvial => ig'zu:viәl
exuviate => ig'zu:vieit
exuviated => ɪg'zjuːvɪeɪt; eg-
exuviates => ɪg'zjuːvɪeɪt; eg-
exuviating => ɪg'zjuːvɪeɪt; eg-
exuviation => i^,zju:vi'eiʃәn
Exxon => 'ɛksan
eyas => 'aiәs
eye => ai
eye candy => ai ˈkændi
eye contact => ai ˈkɔntækt
eye level => ai ˈlevl
eye shadow => ai ˈʃædəu
eye socket => ai ˈsɔkit
eye strain => ai strein
eye tooth => ai tu:θ
eye-catcher => 'ai,kætʃә(r)
eye-opening => 'ai,әjpәniŋ
eyeball => 'aibɒ:l
eyeballed => ˈaɪˌbɔ:ld
eyeballs => ˈaɪˌbɔ:lz
eyebath => ˈaɪbɑ:θ
eyeblack => 'aiblæk
eyebright => 'aibrait
eyebrow => 'aibrau
eyecup => 'aikʌp
eyed => aid
eyedrop => 'aidrɒp
eyedropper => 'aidrɒpә
eyeful => 'aiful
eyeglass => 'aiglæs
eyehole => 'aihәjl
eyelash => 'ailæʃ
eyelashes => 'aɪlæʃɪz
eyeless => 'ailis
eyelet => 'ailit
eyelets => 'aɪlɪts
eyelid => 'ailid
eyeliner => 'ailainә
eyepatch => 'aipætʃ
eyepiece => 'aipi:s
eyepieces => ˈaipi:siz
eyeshade => 'aiʃeid
eyeshot => 'aiʃɔt
eyesight => 'aisait
eyesore => 'aisɒ:
eyesores => ˈaɪˌsɔ:z
eyespot => 'aispɒt
eyestalk => 'aistɒ:lk
eyestrain => 'aistrein
Eyetie => 'aiti
eyewall => 'aiwɔ:l
eyewash => 'aiwɒʃ
eyewater => 'ai,wɔ:tә(r)
eyewear => ˈaɪweə(r)
eyewitness => ai'witnis
eyewitnesses => ˈaɪˈwɪtnɪsiz
eyot => eit, 'eiәt
eyra => 'eәrә,'aiәrә
eyre => єә
EYRES => eə
eyrie => 'iәri
eyrir => 'eiriә
ezekiel => i'zi:kjәl
ezra => 'ezrә