N => en
n't => nt
n-tuple => 'entj'u:pl
n-type => 'ent'aɪp
NA => nɑ:, nә
Na-Dene => nɑ:'deini; ,nɑ:dei'nei
NAACP => ,en dʌbəl ,ei si: 'pi:
NAAFI => 'næfi, 'nɑ:-
naan => nɑ:n
nab => næb
nabbed => næbd
nabe => neib
Nablus => 'nɑ:blәs, nɑ:'blu:s
nabob => 'neibɔb
nabs => næbz
Nacala => nɑ:'kɑ:lɑ:
nacarat => 'nækәræt
nacelle => nә'sel
nacho => 'nɑ:tʃәj
nacre => 'neikә
nacreous => 'neikriәs
NAD => næd
nada => 'nædә
nadine => nei'di:n
nadir => 'nei.diә
nae => nei
naevus => 'ni:vәs
naff => næf
NAFTA => 'næftə
nag => næg
Nagaland => 'nɑ:^әlænd
nagana => nә'^ɑ:nә
nagasaki => ,næ^ә'sɑ:ki
nagged => næɡd
nagger => 'næ^ә(r)
nagging => 'nægiŋ
naggy => 'næɡɪ
Nagorno-Karabakh => nɑ:'ɡɔ:nəu'kɑ:rɑ:'bɑ:k
nagoya => nɑ:'^әujɑ:
Nagpur => 'nɑ:^'pjә(r)
nags => nægz
nah => nɑ:
Naha => 'nɑ:hɑ:
Nahuatl => 'nɑ:wɑ:tl
Nahum => 'neiәm
naiad => 'naiæd
naif => nɑ:'i:f
nail => neil
nail brush => neil brʌʃ
nail polish => neil ˈpɔliʃ
nail scissors => neil ˈsizəz
nail varnish => neil ˈvɑ:niʃ
nail-biter => 'neɪlb'aɪtə
nail-biting => 'neil,baitiŋ
nailbrush => 'neilbrʌʃ
nailed => neild
nailer => 'neilә
nailery => 'neilәri
nailhead => 'neilhed
nailing => 'neiliŋ
nailless => 'neillis
nainsook => 'neinsuk
Nairn => nεən
Nairnshire => 'neәnʃiә(r)
Nairobi => nai'rәubi
naissant => 'neisәnt
naive => nɑ:'i:v
naiveness => 'naɪi:vnes
naivete => nɑ:'i:vtei
naivety => nɑ:'i:vti
Najaf => 'nædʒæf
naked => 'neikid
naked mole rat => ˈneikid məʊl ræt
nakedness => 'neikidnis
naker => 'neikә
Nakhichevan => ,nɑ:kətʃə'vɑ:n
NALGO => 'nælɡəu
naloxone => 'nælәksәun
naltrexone => næl'treksәjn
NAM => nɑ:m
Namaqualand => nә'mɑ:kwәlænd
namaskar => nә'mʌskɑ:(r)
namaste => 'nʌmәstei
namby-pamby => 'næmbi'pæmbi
name => neim
name tag => neim tæɡ
name-calling => 'neim,kɔ:liŋ
name-child => 'neimtʃaild
name-drop => 'neimdrɔp
name-dropper => 'neɪmdr'ɒpə
nameable => 'neimәbl
namecheck => ˈneɪmtʃek
named => neimd
namedrop => 'neim,drɔp
nameless => 'neimlis
namely => 'neimli
Namen => 'nɑ:mәn
nameplate => 'neimpleit
namesake => 'neimseik
namesakes => ˈneɪmˌseɪks
nametag => 'neim,tæɡ
Namibia => nә'mi:biә
Namibian => nə'mibiən
naming => 'neimiŋ
namma => 'næmә
Namur => nɑ:'muə; -'mju:ə
nan => næn
NANA => 'nɑ:nɑ:
Nanaimo => nә'naimәj
nance => 'nɑ:nsei
Nanchang => 'nɑ:n'tʃɑ:ŋ
nancy => 'nænsi
NAND => nænd
nanette => nә'net
nanjing => 'næn'dʒiŋ
nankeen => næŋ'ki:n
nanking => næn,kiŋ
nanna => 'nænә
nannies => ˈnæni:z
Nanning => 'næn'niŋ
nannofossil => ,nænә'fɔsl
nanny => 'næni
nanny goat => ˈnæni: ɡəut
nannygai => 'næni^ai
nano- => 'nænәj, 'neinәj
nanobot => næ'nəʊbɒt
nanocomposite => ,nænə(ʊ)'kɒmpəzɪt
nanogram => 'neinә,^ræm
nanomachine => 'neinәmә,ʃi:n
nanometer => 'neinә,mi:tә
nanometre => ˈnænəʊmi:tə(r)
nanoparticle => 'nænəʊpɑ:tɪkl
nanoplankton => 'nænәj,plæŋktәn, 'nei-
nanosecond => 'nænәusekәnd
nanostructure => næ'nɒstrʌktʃər
nanotech => 'nænəʊtek
nanotechnology => ˌnænəʊtekˈnɒlədʒi
nanotube => neɪnəʊtjʊb
nanowire => nænə'ʊaɪər
Nansen => 'nænsn
nant => nænt
Nantes => nænts
naoh => ne'ɪə
naomi => 'neiәmi
naos => 'neiɔs, 'nɑ:-
nap => næp
napalm => 'neipɑ:m
napalmed => ˈneipɑ:md
napalms => ˈneipɑ:mz
nape => neip
napery => 'neipәri
napes => 'næps
Naphtali => 'næftәlai
naphtha => 'næfθә
naphthalene => 'næfθәli:n
naphthalic => ,næf'θælik; ,næp-
naphthene => 'næfθi:n
naphthenic => næf'θi:nik
naphthol => 'næfθәθl
Napier => 'neipiә
napkin => 'næpkin
napkin ring => ˈnæpkin riŋ
napkins => 'næpkɪnz
Naples => 'neiplz
napless => 'næplis
Napoleon => nә'pәuljәn
Napoleonic => nәpәuli'ɔnik
Napoli => 'nɑ:pɔli
nappa => 'nɑ:pә
nappe => næp
napped => 'næpt
napper => 'næpә
nappies => ˈnæpi:z
napping => 'næpiŋ
nappy => 'næpi
naproxen => nә'prɔksin
Nara => 'nɑ:rә
narc => nɑ:k
narcissi => nɑ:'sisai
narcissism => nɑ:'sisizm
narcissist => nɑ:'sisist
narcissistic => ,nɑ:si'sistik
narcissistically => ,nɑ:si'sistik
narcissus => nɑ:'sisәs
narco => 'nɑ:kәj
narcolepsy => 'nɑ:kәlepsi
narcoleptic => ,nɑ:kә'leptik
narcosis => nɑ:'kәusis
narcoterrorism => nɑ:kə'terərɪzəm
narcotic => nɑ:'kɒtik
narcotism => 'nɑ:kәtizm
narcotization => ,nɑ:kәtai'zeiʃәn; -ti'z-
narcotize => 'nɑ:kәtaiz
nard => nɑ:d
nardoo => 'nɑ:'du:
nares => 'neәri:z, 'nei-
narghile => 'nɑ:^ili
narial => 'neәriәl
naris => 'nєәris
nark => nɑ:k
narked => nɑ:kt
narking => nɑːk
narks => nɑːk
narky => 'nɑ:ki
Narragansett => ,nærә'^ænsit
narrate => nә'reit
narrated => ˈnærˌeɪtid
narrates => ˈnærˌeɪts
narrating => ˈnærˌeɪtɪŋ
narration => nә'reiʃәn
narrations => nə'reɪʃnz
narrative => 'nærәtiv
narratively => 'nærətɪvlɪ
narratives => 'nærətɪvz
narratology => ,nærә'tɔlәdʒi
narrators => næˈreɪtəz
narrow => 'nærәu
narrow boat => ˈnærəu bəut
narrow gauge => ˈnærəu ɡeidʒ
narrow-minded => 'nærәu'maindid
narrowcast => 'nærәjkɑ:st; -kæst
narrowed => ˈnærəud
narrowing => 'nærәuiŋ
narrowly => 'nærәuli
narrowness => 'nærәunis
narrows => 'nærәjz
narthex => 'nɑ:θәks
Narvik => 'nɑ:vik
narwhal => 'nɑ:hwәl. -hwɑ:l
nary => 'nεәri
NASA => 'næsә
nasal => 'neizl
nasal concha => ˈneɪzəl ˈkɔŋkə
nasality => nei'zæliti
nasalization => .neizәlai'zeiʃәn
nasalize => 'neizәlaiz
nasally => 'neizәli
nascency => 'næsәnsi, 'nei-
nascent => 'næsnt
naseberry => 'neizberi
Naseby => 'neizbi
nash => næʃ
nashi => næ'ʃaɪ
nashville => 'næʃvil
Nasmyth => 'neizmiθ
nasogastric => ,neizәj'^æstrik
nasopharyngeal => ,neizәjfә'rindʒiәl
nasopharynx => ,neizәu'færiŋks
nassau => 'næsɔ:
Nasser => 'na:sə
nastic => 'næstik
nastier => ˈnɑ:stiə
nastily => 'nɑ:stili
nastiness => 'nɑ:stinis
nasturtium => nә'st\\\\:ʃәm; (?@) næ-
nasturtiums => nəˈstə:ʃəmz
nasty => 'nɑ:sti
nat => nɑ:t
natal => 'neitl
Natalia => nә'tæljә, -'tɑ:l-
natalie => 'nætәli
natality => nei'tæliti
natant => 'neitәnt
Natasha => nә'tɑ:ʃә
natation => nei'teiʃәn
natatorial => ,neitә'tɔ:riәl
natatorium => .neitә'tɒ:riәm
natatory => 'neitәtәri
natch => nætʃ
nates => 'neiti:z
nathan => 'neiθәn
nathaniel => nә'θænjәl
natheless => 'neiθlis, 'næθ-
nation => 'neiʃәn
nation state => ˈneiʃən steit
national => 'næʃәnәl
national costume => ˈnæʃənəl ˈkɔstju:m
national government => ˈnæʃənəl ˈɡʌvənmənt
national monument => ˈnæʃənəl ˈmɔnjumənt
national park => ˈnæʃənəl pɑ:k
national service => ˈnæʃənəl ˈsɜːvɪs
nationalisation => ,næʃәnәlai'zeiʃәn; -li'z-
nationalise => 'næʃәnәlaiz
nationalism => 'næʃәnәlizm
nationalist => 'næʃәnәlist
nationalistic => .næʃәnә'listik
nationalists => 'næʃnəlɪsts
nationality => .næʃә'nælәti
nationalization => .næʃәnәlai'zeiʃәn
nationalize => 'næʃәnәlaiz
nationalizer => 'næʃənəlaizə
nationalizes => ˈnæʃənəˌlaɪziz
nationalizing => ˈnæʃənəˌlaɪzɪŋ
nationally => 'næʃәnәli
nationals => 'næʃnəlz
nationhood => 'neiʃәnhud
nationwide => 'neiʃәnwaid
native => 'neitiv
native cat => ˈneitiv kæt
native speaker => ˈneitiv ˈspi:kə
natively => 'neitivli
natives => 'neɪtɪvz
nativism => 'neitivizm
nativist => 'neitivist
nativity => nә'tiviti
nativity play => nəˈtɪvɪti: plei
NATO => 'neitәj
natriuresis => ,neitriju'ri:sis
natriuretic => ,neitrijjә'retik
natron => 'neitrɒn
natter => 'nætә
natterjack => 'nætәdʒæk
nattier => 'nætiә(r)
nattily => 'nætili
nattiness => 'nætinis
natty => 'næti
Natufian => nә'tu:fiәn
natural => 'nætʃәrәl
natural childbirth => ˈnætʃərəl ˈtʃaɪldˌbɜ:θ
natural food => ˈnætʃərəl fu:d
natural gas => ˈnætʃərəl ɡæs
natural history => ˈnætʃərəl ˈhistəri
natural theology => ˈnætʃərəl θi:ˈɔlədʒi:
naturalise => 'nætʃәrәlaiz
naturalised => 'nætʃərəlaiz
naturalism => 'nætʃәrәlizm
naturalist => 'nætʃәrәlist
naturalistic => .nætʃәrә'listik
naturalists => ˈnætʃərələsts
naturalization => nætʃәrәlai'zeiʃәn
naturalize => 'nætʃәrәlaiz
naturalized => 'nætʃərəlaɪzd
naturalizes => ˈnætʃərəˌlaɪziz
naturalizing => 'nætʃrəlaɪzɪŋ
naturally => 'nætʃәrәli
naturalness => 'nætʃәrәlnis
nature => 'neitʃә
nature reserve => ˈneitʃə riˈzə:v
nature trail => ˈneitʃə treil
naturism => 'neitʃәrizәm
naturist => 'neitʃәrist
naturopath => 'neitʃәrәpæθ
naturopathic => ,neitʃәrә-'pæθik
naturopathy => .neitʃә'rɒpәθi
Naugahyde => 'nɔ:^әhaid
naught => nɒ:t
naughtier => ˈnɔ:tiə
naughtiness => 'nɔ:tinis
naughty => 'nɒ:ti
nauplius => 'nɔ:pliәs
Nauru => nɑ:'u:ru:
nausea => 'nɒ:ʃjә
nauseate => 'nɒ:sieit
nauseated => 'nɔ:zieitid, -ʃi-
nauseates => ˈnɔ:zi:ˌeɪts
nauseating => 'nɒ:sieitiŋ
nauseatingly => 'nɔ:zieitiŋli
nauseous => 'nɒ:ʃiәs
nauseously => ˊnɒːsjәsli
nautch => nɒ:tʃ
nautical => 'nɒ:tikәl
nautiloid => 'nɔ:tilɔid
nautilus => 'nɒ:tilәs
navaid => 'næveid
navajo => 'nævәhәj
naval => 'neivl
naval architect => ˈneivəl ˈɑ:kitekt
Navaratri => .nʌvə'rʌtri
navarin => nɑ:vɑ:'rɑ:ŋ
Navarre => nә'vɑ:(r)
nave => neiv
navel => 'neivl
navel orange => ˈneɪvəl ˈɔrindʒ
navels => ˈneɪvəlz
navelwort => 'neivәlwә:t
naves => neɪvz
navicular => nә'vikjuәlә
navies => ˈneiviz
navigability => .nævigә'biliti
navigable => 'nævigәbl
navigate => 'nævigeit
navigated => ˈnævɪˌgeɪtid
navigates => ˈnævɪˌgeɪts
navigation => .nævi'geiʃәn
navigator => 'nævigeitә
navvies => ˈnæviz
navvy => 'nævi
navy => 'neivi
navy bean => ˈneivi bi:n
naw => nɔ:
Nawab => nә'wɑ:b
Naxalite => 'næksәlait
Naxos => 'næksɔs
nay => nei
Nayarit => ,nɑ:jɑ:'ri:t
naysay => 'neisei
naysayers => 'neiseiə
Nazarene => .næzә'ri:n
Nazareth => 'næzәriθ
Nazca => 'nɑ:zkɑ:; -kə
Nazi => 'nɑ:tsi
Nazidom => 'nɑ:tsidәm, 'næt-
Nazify => 'nɑ:tsifai
Naziism => 'nɑ:tsiizәm, 'næt-
Nazirite => 'næzirait
Nazism => 'nɑ:tsizәm, 'næt-
Ndola => n'dәulɑ:
ne => nei
ne plus ultra => 'ni:plʌs'ʌltrә
ne'er => neә
ne'er-do-well => 'neә du:wel
Neanderthal => ni'ændәtɑ:l
neap => ni:p
neap tide => ˈni:p taɪd
Neapolitan => niә'pɔlitәn
near => niә
near enough => niə iˈnʌf
near gale => niə ɡeil
near money => niə ˈmʌni
near-death experience => nɪr dɛθ ɪkˈspɪriəns
near-sightedness => 'nɪərs'aɪtɪdnəs
near-term => 'nɪərt'ɜ:m
nearby => 'niәbai
Nearctic => ni:'ɑ:ktik
neared => nɪə
nearly => 'niәli
nearness => 'niәnis
nearshore => 'niәʃɔ:(r)
nearside => 'niәsaid
nearsighted => niә'saitid
neat => ni:t
neaten => 'ni:tn
neatened => ˈni:tnd
neatening => ˈni:tnɪŋ
neatens => ˈni:tnz
neath => ni:θ
neatly => 'ni:tli
neatness => 'ni:tnis
neatnik => 'ni:tnik
neb => neb
nebbish => 'nebiʃ
Nebraska => ni'bræskә
nebula => 'nebjulә
nebulae => 'nebjulә
nebular => 'nebjulә
nebulize => 'nebjulaiz
nebulizer => 'nebjulaizә
nebulosity => .nebju'lɒsiti
nebulous => 'nebjulәs
nebuly => 'nebjuli
necessarian => nesi'seәriәn
necessaries => ˈnesəsəriz
necessarily => 'nesisәrili
necessary => 'nesisәri
necessitarian => ni.sesi'tєәriәn
necessitarianism => nisesi'teәriәniz(ә)m
necessitate => ni'sesiteit
necessitated => niˈsesiteitid
necessitates => niˈsesiteits
necessitating => nɪ'sesɪteɪtɪŋ
necessities => nɪ'sesɪtɪz
necessitous => ni'sesitәs
necessity => ni'sesәti
neck => nek
neck of the woods => nek ɔv ðə wudz
Neckar => 'nekə; -kɑ:
neckband => 'nekbænd
neckcloth => 'nekklɒθ
necked => nekt
neckerchief => 'nekәtʃif
neckerchiefs => ˈnekətʃifs
necking => 'nekiŋ
necklace => 'neklis
necklaced => 'neklɪs
necklaces => ˈneklisiz
necklet => 'neklit
neckline => 'neklain
necklines => ˈnekˌlaɪnz
neckpiece => 'nekpi:s
necktie => 'nektai
neckwear => 'nekwєә
necro- => 'nekrәj
necrobiosis => ,nekrәubai'әusis
necrological => ,nekrə'lɔdʒikəl
necrologist => ne'krɔlәdʒist
necrology => ne'krɒlәdʒi
necromancer => 'nekrәumænsә
necromancy => 'nekrәumænsi
necromantic => nekrə'mæntɪk
necrophile => 'nekrәfail
necrophilia => .nekrә'filiә
necrophiliac => ,nekrəu'filiæk
necrophilic => ,nekrəu'filik
necrophobia => ,nekrә'fәubiә
necropolis => ne'krɒpәlis
necropsy => 'nekrɒpsi
necrosis => ne'krәusis
necrotic => ne'krɒtik
necrotized => 'nekrətaiz
necrotizing => 'nekrә,taiziŋ
necrotizing fasciitis => ˌnekrətaɪzɪŋ fæʃiˈaɪtɪs
nectar => 'nektә
nectarean => nek'teәriәn
nectareous => nek'teәriәs
nectaries => ˈnektəriz
nectariferous => ,nektә'rifәrәs
nectarine => 'nektәri:n
nectarivorous => nektә'rivәrәs
nectarous => nek'teәrәs
nectary => 'nektәri
NED => ned
neddy => 'nedi
Nederland => 'neidәrlɑ:nt
need => ni:d
needful => 'ni:dful
needfully => 'ni:dfəlɪ
needfulness => ni:d'fəlnəs
Needham => 'ni:dәm
neediness => 'ni:dinis
needing => ni:dɪŋ
needle => 'ni:dl
needlecord => ˈni:dlkɔ:d
needlecraft => 'ni:dlkrɑ:ft; -kræft
needlefish => 'ni:dlfiʃ
needlepoint => 'ni:dlpɒint
needless => 'ni:dlis
needlewoman => 'ni:dlwumәn
needlewomen => 'ni:dlwɪmɪn
needlework => 'ni:dlwә:k
needleworker => ni:dlwɜ:'kər
needling => 'ni:dliŋ
needn't => 'ni:dnt
needs => ni:dz
needy => 'ni:di
neep => ni:p
nef => nef
nefarious => ni'feәriәs
nefariously => nɪ'feərɪəslɪ
nefariousness => niˊfєәriәsnis
negate => ni'geit
negated => nɪˈgeɪtid
negates => nɪˈgeɪts
negating => nɪˈgeɪtɪŋ
negation => ni'geiʃәn
negative => 'negәtiv
negative equity => ˈneɡətiv ˈekwiti
negatived => ˈneɡətivd
negatively => 'ne^әtivli
negativing => ˈneɡətivɪŋ
negativism => 'negәtivizm
negativist => 'negәtivist
negativistic => ,ne^әti'vistik
negativity => .negә'tiviti
negator => ni'^eitә
negatory => 'negәtәri
negentropy => ne^'entrәpi
Negev => 'ne^ev
neglect => ni'glekt
neglected => ni'^lektid
neglectful => ni'glektful
neglectfully => nɪɡ'lektfəlɪ
neglecting => niˈɡlektɪŋ
neglects => niˈɡlekts
negligee => .negli:'ʒei
negligees => ˌneglɪˈʒeɪz
negligence => 'neglidʒәns
negligent => 'neglidʒәnt
negligently => 'neglidʒəntli
negligible => 'neglidʒәbl
negotiability => ni.gәuʃiә'biliti
negotiable => ni'gәuʃiәbl
negotiant => ni'gәuʃiәnt
negotiate => ni'gәuʃieit
negotiated => niˈɡəuʃieitid
negotiates => niˈɡəuʃieits
negotiation => ni.gәuʃi'eiʃәn
negotiator => ni'gәuʃieitә
negress => 'ni:gris
Negrillo => ni'gritәu
Negrito => ni'gri:tәu
negritude => 'ne^ritju:d, 'ni:^ri-
negro => 'ni:grәu
Negroid => 'ni:grɒid
negroni => 'ni:^rәni
negus => 'ni:gәs
Nehemiah => .ni:i'maiә
nehru => 'neiru:
neigh => nei
neighbor => 'neibә
neighbored => ˈneibəd
neighborhood => 'neibәhud
neighborhoods => 'neɪbɔ:hʊdz
neighboring => 'neibәriŋ
neighborly => 'neibәli
neighbour => 'neibә
neighbourhood => 'neibәhud
neighbourhoods => ˈneibəhudz
neighbouring => 'neibәriŋ
neighbourless => 'neibәlis
neighbourly => 'neibәli
neighbours => ˈneibəz
neighed => neɪd
neighing => neɪŋ
neighs => neɪz
Neilson => 'ni:lsn
Neisse => 'naisə
neither => 'naiðә
Nejd => nedʒd, neid
nek => nek
nekton => 'nektәn
nell => nel
nellie => 'neli
Nelly => 'neli
nelson => 'nelsn
nematic => ni'mætik
nematocidal => ,nemәtә'saidәl, ni,mætә-
nematocide => 'nemәtәsaid
nematocyst => 'nemәtәusist
nematode => 'nemәtәud
nematodes => ne'meɪtəʊdi:z
nematology => nemә'tɔlәdʒi
nematomorph => 'nemətəmɔ:f; nə'mætəmɔ:f
Nembutal => 'nembjutɔ:l, -tæl
nemertean => ni'mә:tiәn
nemertine => ni'm\\\\:tain,'nemә-
nemesia => ni'mi:siә,-ʒә
nemesis => 'nemisis
nemo => 'ni:mәu
Nene => 'nei,nei
neo- => ni:әj
neo-Gothic => ,ni:əu'ɡɔθik
neo-liberal => 'ni:əʊl'ɪbərəl
neoclassic => .ni:әu'klæsik
neoclassical => 'ni:әuklæsikәl
neoclassicism => .ni:әu'klæsisizm
neoclassicist => ,ni:əu'klæsist
neocolonial => ,ni:әjkә'lәjniәl
neocolonialism => 'ni(:)әukә'lәuniәlizәm
neocolonialist => ,ni:әjkә'lәjniәlist
neocon => ,ni:əu'kɔn
neoconservatism => ,ni:əukəu'sə:vətizəm
neoconservative => ,ni:әjkәn's\\\\:vәtiv
neocortex => ,niәu'kɔ:teks
neocortical => ,niːəʊ'kɔːtɪkəl
neodymium => .ni:әu'dimiәm
Neogene => 'ni(:)әudʒi:n
Neogrammarian => 'ni:әu^rә'meәriәn
neoliberal => ˌni:əʊ'lɪbərəl
neoliberalism => ,niәu'libәrәlizәm
neolithic => .ni:әu'liθik
neologism => ni:'ɒlәdʒizm
neologist => ni:'ɒlәdist
neologize => ni:'ɒlәdʒaiz
neomycin => .ni:әu'maisin
neon => 'ni:ɒn
neonatal => ,ni:әu'neitәl
neonate => 'ni:әuneit
neonatologist => ,ni:әjnei'tɔlәdʒist
neonatology => ,ni:әunә'tɔlәdʒi
neontology => ,ni:ɔn'tɔlәdʒi
neopaganism => ,ni:əu'peiɡənizəm
neophyte => 'ni:әufait
neophytes => 'ni:əfaɪts
neoplasia => 'ni(:)әu'pleizʒә, -ʒiә
neoplasm => 'ni(:)әuplæzәm
neoplasticism => ,ni:әj'plæstisizәm
neoplatonic => ,ni:əuplə'tɔnik
Neoplatonism => .ni:әu'pleitәnizm
neoprene => 'ni:әupri:n
Neoptolemus => ,ni:ɔp'tɔlәmәs
neostigmine => ,ni:әu'sti^mi:n
neotenous => ni'ɔtənəs
neoteny => ni(:)'ɔtini, 'niәtini
neoteric => .ni:әu'terik
neotropical => ,ni:әj'trɔpikәl
NEP => nep
Nepal => ni'pɒ:l
Nepalese => .nepә'li:z
Nepali => ni'pɒ:li
nepenthes => ne'penθi:z
neper => 'neipә, 'ni:pә
nepheline => 'nefilin,-li:n
nephelinite => 'nefilinait
nephelometer => .nefi'lɒmitә
nephew => 'nefju:
nephews => ˈnefju:z
nephology => ne'fɒlәdʒi
nephrectomy => ne'frektәmi
nephridial => -iәl
nephridiopore => ne'fridiәpɔ:
nephridium => ni'fridiәm
nephrite => 'nefrait
nephritic => ne'fritik
nephritis => ne'fraitis
nephrology => ni'frɔlәdʒi
nephron => 'nefrɔn
nephropathy => ni'frɔpәθi
nephrosis => ne'frәusis
nephrotic => ne'frɔtik
nephrotoxic => ,nefrә'tɔksik
nephrotoxicity => nefrəʊtɒk'sɪsɪtɪ
nepotism => 'nepәtizm
nepotist => 'nepәtist
nepotistic => ,nepə'tistik
Neptune => 'neptju:n
Neptunian => 'neptjuniәn, -njәn
Neptunism => 'neptju:nizәm
Neptunist => 'neptju:nist
neptunium => nep'tju:niәm
nerd => nә:d
nerdish => ˈnə:diʃ
nerds => nɜ:dz
nerdy => 'nɜːdi
Nereid => 'niәriid
Nereus => 'niәrju:s
nerine => ni'raini
nerite => 'nerait
neritic => ni'ritik
Nernst => neәnst
nero => 'niәrәu
neroli => 'niәrәli
nervation => nә:'veiʃәn
nerve => nә:v
nerve gas => nə:v ɡæs
nerve-wracking => 'n\\\\:v,rækiŋ
nerved => n\\\\:vd
nerveless => 'nә:vlis
nervily => nɜ:'vɪlɪ
nervine => 'nә:vi:n
nerviness => 'nә:vinis
nerving => 'nә:viŋ
nervous => 'nә:vәs
nervous breakdown => ˈnə:vəs ˈbreikdaun
nervous system => ˈnə:vəs ˈsistəm
nervure => 'nә:vjuә
nervy => 'nә:vi
nescience => 'neʃiәns
nescient => 'neʃiәnt
nesh => neʃ
ness => nes
Nessie => 'nesi
Nessus => 'nesәs
nest => nest
nest box => nest bɔks
nest egg => nest eɡ
nested => 'nestid
nester => 'nestә
nestful => 'nestfjl
nesting => 'nestiŋ
nestle => 'nesl
nestled => ˈnesəld
nestles => ˈnesəlz
nestling => 'nesliŋ
nestor => 'nestɔ:, -tә
Nestorian => ne'stɒ:riәn
nests => nests
net => net
netball => 'netbɒ:l
netful => 'netfjl
nether => 'neðә
Netherlander => 'neðәlәndә
Netherlandish => 'neðәlәndiʃ
Netherlands => 'neðәlәndz
nethermost => 'neðәmәust
netizen => ˈnetɪzn
netsuke => 'netsu:'kei
nett => net
netted => 'netid
netter => 'netә
netting => 'netiŋ
nettle => 'netl
nettlerash => ˈnetlræʃ
nettles => ˈnetlz
nettlesome => 'netlsәm
netty => 'neti
network => 'netwә:k
networker => ˈnetwə:kə
neume => n'ju:m
neur- => njjәr;njәr
neural => 'njuәrәl
neural tube => ˈnjuərəl tju:b
neuralgia => nju'rældʒә
neuralgic => nju'rældʒik
neuraminidase => ,njuә'minәdeis
neurasthenia => .njurәs'θi:niә
neurasthenic => .njurәs'θenik
neurectomy => njuә'rektәmi
neurilemma => njuәri'lemә, nuә-
neurilemmal => nɜ:raɪ'leməl
neuritic => ,njjә'ritik
neuritis => nju'raitis
neuro- => 'njjәrәj; (?@) njrәj
neuroanatomical => 'njjәrәj,ænә'tɔmikәl
neuroanatomist => n'jʊərənətəmɪst
neuroanatomy => ,njuәrәuә'nætәmi
neurobehavioral => nju:rəʊbɪheɪ'vi:əʊrəl
neurobiological => ,njuərəu,baiə'lɔdʒikəl
neurobiology => ,njuәrәubai'ɔlәdʒi
neuroblast => 'njuәrәublɑ:st
neuroblastoma => ,njuәrәblæs'tәumә
neurochemical => ,njjәrәj'kemikəl
neurochemist => ,njjәrәj'kemist
neurochemistry => ,njuәrә'kemistri
neurodevelopmental => nərəʊdi:'veləpmentl
neuroendocrine => ,nju:rә'endәkrain
neuroepithelial => 'njjәrәj,epi'θi:liәl
neuroepithelium => njuәrәuepi'θiliәm
neurofibril => njuәrәu'faibril
neurofibroma => ,njjәrәjfai'brәjmә
neurogenesis => ,njuәrә'dʒenisis
neurogenic => njuәrәu'dʒenik
neuroglia => nju'rɔ^liә, nu-
neurohormone => njuәrәu'hɔ:mәun
neurohypophysis => njuәrәuhai'pɔfisis
neuroleptic => ,njuәrә'leptik
neurolinguistics => ,njjәrәjliŋ'^wistiks
neurological => .njurә'lɒdʒikl
neurologically => .njuә'lɔdʒikәli
neurologist => nju'rɒlәdʒist
neurology => nju'rɒlәdʒi
neuroma => nju'rәumә, nu-
neuromast => 'njuәrәu,mæst
neuromuscular => njuәrәu'mʌskjulә, nuәr-
neuron => 'njuәrɔn
neurone => 'njuәrɔn
neuropath => 'njurәpæθ
neuropathic => .njurә'pæθik
neuropathological => njʊərəʊpæθə'lɒdʒɪkl
neuropathologist => njʊərəʊpə'θɒlədʒɪst
neuropathology => ,njuәrәupә'θɔlәdʒi, ,nuә-
neuropathy => nju'rɒpәθi
neuropeptide => ,njjәrә'peptaid
neuropharmacological => 'njʊərəʊ,fɑːməkə'lɒdʒɪkəl
neuropharmacology => 'njuәrәu,fɑ:mә'kɔlәdʒi
neurophysiology => ,njuәrәu,fizi'ɔlәdʒi, ,nuә-
neuropsychiatry => ,njuәrәusi'kaiәtri
neuropsychology => ,njjәrәjsai'kɔlәdʒi
neuropteran => nju'rɔptәrәn, nuә-
neuropterous => njjә'rɔptәrәs
neuroscience => ,njuәrәu'saiәns
neuroscientist => 'njʊərəʊsaɪəntɪst
neurosis => nju'rәusis
neurosurgeon => ,njjәrәj's\\\\:dʒәn
neurosurgery => , njuәrәu'sә:dʒәri, nuә-
neurosurgical => ˌnjʊərəʊˈsɜ:dʒɪkl
neurotic => nju'rɒtik
neurotically => njuə'rɔtikəli
neurotics => nʊˈrɔtɪks
neurotomy => nju'rɔtәmi
neurotoxic => ,njuәrәu'tɔksik, nuә-
neurotoxicity => ,njuərəutɔk'sisəti
neurotoxin => ,njuәrәu'tɔksin, nuә-
neurotransmission => ,njuәrә,trænz'miʃәn
neurotransmitter => ,njuәrәtræns'mitә
neurotrophic => ,njjәrәj'trɔfik
neurotropic => ,njuәrәu'trɔpik, ,nuәr-
neurotropism => njjә'rɔtrәpizәm
neurovascular => ,njjәrәj'væskjjlә(r)
neuston => 'nju:stɔn, 'nu:-
neuter => 'nju:tә
neutered => 'njuːtə
neutering => 'njuːtə
neuters => 'njuːtə
neutral => 'nju:trәl
neutralisation => ,nju:trәlai'zeiʃәn;-li'z-
neutralise => 'nju:trәlaiz
neutralised => 'nju:trəlaiz
neutralism => 'nju:trәlizm
neutralist => 'nju:trәlist
neutrality => nju:'træliti
neutralization => ,nju:trәlai'zeiʃәn
neutralize => 'nju:trәlaiz
neutralized => ˈnu:trəˌlaɪzd
neutralizer => 'nju:trәlaizә
neutralizes => ˈnu:trəˌlaɪziz
neutrally => 'nju:trәli
neutrals => n'ju:trəlz
neutrino => nju:'tri:nәu
neutrinos => nu:ˈtri:nəʊz
neutron => 'nju:trɒn
neutron star => ˈnu:ˌtrɔn stɑ:
neutrons => 'nju:trɒnz
neutropenia => ,nju:trәu'pi:niә
neutropenic => nju:t'rəʊpenɪk
neutrophil => 'nju:trәfil
neutrophilic => ,nju:trә'filik
Nevada => ni'vædә
Nevadan => ni'vædәn
never => 'nevә
never-ending => 'nevәr,endiŋ
never-never => 'nevә'nevә
never-never land => ˈnevəˈnevə lænd
nevermore => .nevә'mɒ:
nevertheless => .nevәðә'les
Neville => 'nevil
Nevin => 'nevin
Nevis => 'ni:vis,'ne-
nevus => 'ni:vәs
new => nju:
New Caledonia => 'nju:,kæli'dәunjә
New Delhi => nju:'deli
New Guinea => nju: '^ini
New Hampshire => nju: 'hæmpʃiә
New Hebrides => nju: 'hebridi:z
New Jersey => nju: 'dʒә:zi
New Jerusalem => nju:dʒә'ru:sәlәm
new man => nju: mæn
New Mexico => nju: 'meksikәu
new moon => nju: mu:n
New Orleans => nju: 'ɔ:liәnz
new town => nju: taun
new wave => nju: weiv
New Year => 'nju:'jә:
New York => 'nju: 'jɔ:k
New Yorker => ,nju:'jɔ:kә(r)
New Zealand => nju: 'zi:lәnd
New Zealander => ,nju: 'zi:lәndә(r)
new-fashioned => 'nju:'fæʃənd
new-found => nju: faund
new-laid => 'nju:leid
new-mown => 'nju:məun
newborn => 'nju:bɒ:n
newbuilding => 'nju:,bildiŋ
newcastle => 'nju:,kɑ:sl
newcomer => nju:'kʌmә
newcomers => ˈnu:ˌkʌməz
newel => 'nju:әl
newell => 'nju:әl
newfangled => 'nju:fæŋgld
newfound => 'nju:fajnd
Newfoundland => ,nju:fәnd'lænd
Newfoundlander => nju(:)'faundlәndә
Newgate => 'nju:git
Newham => 'nju:әm
newie => 'nju:i:
newish => 'nju:iʃ
newly => 'nju:li
newly-wed => ˈnu:li: wed
newlywed => 'nju:liwed
Newman => 'nju:mәn
Newmarket => 'nju:,mɑ:kit
newness => 'nju:nis
news => nju:z
news-sheet => nju:z ʃi:t
news-stand => nju:z stænd
newsagent => 'nju:zeidʒәnt
newsagents => ˈnju:zˌeɪdʒɵnts
newsboy => 'nju:zbɒi
newscast => 'nju:zkɑ:st
newscaster => 'nju:z.kɑ:stә
newscasters => 'nuzkæstɚ
newsdesk => 'nju:zdesk
newsflash => 'nju:zflæʃ
newsflashes => 'nuzflæʃ
newshound => 'nju:zhajnd
newsie => 'nju:zi
newsletter => 'nju:z.letә
newsletters => ˈnu:zˌletəz
newsmaker => 'nju:z.meikә
newsman => 'nju:zmæn
newsmen => 'njuːzmæn
newspaper => 'nju:z.peipә
newspaperman => 'nju:s,peipәmæn,'nju:z-
newspapermen => 'njuːzpeɪpə,mæn; -'njuːs-
newspaperwoman => 'nju:s,peipә,wjmәn,'nju:z-
newspeak => 'nju:spi:k
newspeople => 'nju:z,pi:pl
newsprint => 'nju:zprint
newsreader => 'nju:zri:dә
newsreel => 'nju:zri:l
newsroom => 'nju:zru:m
newsrooms => ˈnju:zrumz
newsstand => 'nju:zstænd
newsstands => 'njuːzstænd
newsvendor => nju:z'vendər
Newsweek => nju:zwi:k
newswoman => 'nju:z,wumən
newsworthy => 'nju:zwә:ði
newsy => 'nju:si
newt => nju:t
newton => 'nju:tn
Newtonian => nju:'tәuniәn
newts => nju:ts
Newyorican => ,nju:jɔ'ri:kәn
next => 'nekst
next-door => 'nekstdɔ:(r)
nexus => 'neksәs
ngaio => 'naiәj
Ngbandi => әŋ'bɑ:ndi
ngoma => әŋ'^әjmә,-'^ɔmә
ngultrum => ŋ'ɡʌltrəm
ngwee => eŋ'^wi
niacin => 'naiәsin
Niagara => nai'æ^әrә
Niamey => ,nja:'mei
nib => nib
nibbed => 'nɪbbed
nibble => 'nibl
nibbled => ˈnɪbəld
nibbler => 'niblә
nibbling => 'nibliŋ
Nibelung => 'ni:bəluŋ
Nibelungenlied => ,ni:bә'luŋ^әnli:t
niblet => 'niblit
niblick => 'niblik
nibs => nibz
NIC => nik
nicad => 'nikæd
Nicaea => nai'si:ә
Nicaragua => ,nikә'rɑ:^wә, ,nikә'ræ^juә
nice => nais
nice-looking => 'nais'ljkiŋ
nicely => 'naisli
niceness => naɪsnəs
nicest => 'naɪsɪst
niceties => ˈnaɪsɪti:z
nicety => 'naisәti
niche => nitʃ
niched => 'nɪtʃt
niches => nɪtʃiz
nicholas => 'nikәlәs
Nicholson => 'nikәlsn
nick => nik
nick-nack => 'nɪkn'æk
nickel => 'nikl
nickelodeon => ,nikә'lәudiәn
nickels => ˈnikəlz
nicker => 'nikә
nickered => ˈnikəd
nickering => ˈnikərɪŋ
nickers => ˈnikəz
nicking => 'nikiŋ
nickname => 'nikneim
nicknames => ˈnikneimz
Nicol => 'nikəl
Nicolas => 'nɪkələs
nicole => ni'kәjl
Nicolette => ,nikә'let
Nicolson => 'nikәlsn
nicosia => ,nikәu'si(:)ә
nicotiana => ni,kәuʃi'einә
nicotinamide => .nikә'tinәmaid
nicotinamide adenine dinucleotide => ˌnikəˈtinəmaid ˈædəni:n daiˈnju:kliəˌtaid
nicotine => 'nikәti:n
nictation => nik'teiʃәn
nictitating membrane => ˈnɪktɪˌteɪtɪŋ
nidation => nai'deiʃәn
nide => naid
nidicolous => nai'dikәlәs
nidification => .nidifi'keiʃәn
nidifugous => nai'difju^әs
nidus => 'naidәs
niece => ni:s
nieces => ni:siz
Niedersachsen => 'ni:dәr,zɑ:ksәn
niello => ni'elәu
nielloed => ni'elәud
nielsbohrium => ni: lz'bәjriәm
Niersteiner => 'niәstainә
Nietzsche => 'ni:tʃә
Nietzschean => 'ni:tʃiәn
niff => nif
niffy => 'nifi
Niflheim => 'nivәlheim
niftier => ˈniftiə
nifty => 'nifti
nig-nog => 'niɡnɔɡ
nigel => 'naidʒәl
Niger => 'naidʒә
Nigeria => nai'dʒiriә
Nigerian => nai'dʒiriәn
niggard => 'nigәd
niggardly => 'ni^әdli
nigger => 'nigә
niggerhead => 'ni^әhed
niggle => 'nigl
niggled => ˈnɪgəld
niggles => ˈnɪgəlz
niggling => 'ni^liŋ
nigh => nai
night => nait
night crawler => nait ˈkrɔ:lə
night depository => nait diˈpɔzitəri
night light => nait lait
night owl => nait aul
night porter => nait ˈpɔ:tə
night safe => nait seif
night watchman => nait ˈwɔtʃmən
night-long => ˈnaɪtˌlɔ:ŋ, -ˌlɔŋ
night-time => nait taim
nightbird => 'naɪtbɜ:d
nightcap => 'naitkæp
nightcaps => ˈnaitkæps
nightclothes => 'naitklәjðz
nightclub => 'naitklʌb
nightclubs => ˈnaɪtˌklʌbz
nightdress => 'naitdres
nightdresses => 'naɪtdres
nightfall => 'naitfɒ:l
nightgowns => ˈnaɪtˌgaʊnz
nighthawk => 'naithɔ:k
nightie => 'naiti:
nighties => ˈnaitiz
nightingale => 'naitingeil
nightingales => ˈnaɪtnˌgeɪlz
nightjar => 'naitdʒә(r)
nightlong => 'naitlɒŋ
nightly => 'naitli
nightmare => 'naitmєә
nightmares => 'naɪtmeəz
nightmarish => 'nait,meәriʃ
nights => naits
nightshade => 'naitʃeid
nightshift => 'naɪtʃɪft
nightshirt => 'naitʃә:t
nightshirts => 'naɪtʃɜːt
nightside => 'naitsaid
nightspot => ˈnaɪtspɒt
nightstand => 'naitstænd
nightstick => 'naitstik
nightsticks => 'naɪtstɪk
nightwatchman => naɪtˈwɒtʃmən
nightwear => 'naitweә(r)
nigra => 'ni^rә
nigrescence => nai'gresns
nigrescent => nai'gresnt
nigritude => 'nigritju:d
nihil obstat => 'naihil'ɔbstæt
nihilism => 'naiilizm
nihilist => 'naiilist
nihilistic => .naii'listik
nihility => nai'hiliti
Niigata => 'ni:i:'^ɑ:tɑ:
Nike => 'naiki:
nikko => 'ni:kәj
nil => nil
nil desperandum => ,despe'rɑ:ndu:m
Nile => nail
nilgai => 'nil^ai
Nilgiri Hills => 'nilɡəri:
Nilotic => nai'lɔtik
nilpotent => 'nilpәutәnt
nim => nim
nimble => 'nimbl
nimbleness => 'nimblinis
nimbler => ˈnɪmblə(r)
nimblest => ˈnɪmblɪst
nimbly => 'nimbli
nimbostratus => .nimbәu'streitәs
nimbus => 'nimbәs
nimby => ˈnɪmbi
niminy-piminy => 'nimini'pimini
Nimrod => 'nimrɒd
nina => 'ni:nә
nincompoop => 'ninkәmpu:p
nincompoops => 'nɪŋkəmpuːp
nine => nain
nine-to-five => 'naɪnt'əf'aɪv
nine-to-fiver => 'naintə'faivə
ninefold => 'nainfәuld
ninepence => 'naipәns
ninepins => 'nainpinz
nineteen => .nain'ti:n
nineteenth => .nain'ti:nθ
nineties => ˈnaɪnti:z
ninetieth => 'naintiiθ
ninety => 'nainti
ninety-nine => 'nainti'nain
Nineveh => 'ninivi
Ningxia => 'niŋ'ʃjɑ:
ninhydrin => nin'haidrin
ninja => 'nindʒә
ninnies => ˈniniz
ninny => 'nini
ninon => 'ninŋ
Nintendo => nin'tendәj
ninth => nainθ
ninthly => 'nainθli
niobium => nai'әubiәm
nip => nip
nipa => 'ni:pә
nipped-in => 'nipt'in
nipper => 'nipә
nipping => 'nipiŋ
nipple => 'nipl
nipples => ˈnɪpəlz
nipplewort => nɪpl'wɜ:t
nippon => ni'pɔn, 'nip-
nippy => 'nipi
nirvana => nә:'vɑ:nә
Nisan => ni:'sɑ:n,'nisәn
nisei => ni:ˈseɪ, ˈni:ˌseɪ
nisi => 'naisai
nisin => 'naisin
Nissen => 'nisәn
Nissen hut => 'nis(ә)n
nit => nit
nit-pick => 'nitpik
nit-picker => nit ˈpɪkə
nite => nait
niter => 'naitә
nitinol => 'nitinɔl
nitpick => 'nitpik
nitrate => 'naitreit
nitrated => 'naɪtreɪtɪd
nitrates => ˈnaɪˌtreɪts
nitrating => 'naɪtreɪtɪŋ
nitration => nai'treiʃәn
nitrazepam => nai'treizipæm
nitre => 'naitә
nitric => 'naitrik
nitride => 'naitraid
nitriding => 'naitraidiŋ
nitrification => .naitrifi'keiʃәn
nitrified => ˈnaitrifaid
nitrifies => ˈnaitrifaiz
nitrify => 'naitrifai
nitrile => 'naitrail
nitrite => 'naitrait
nitro => 'naitrәu
nitro group => ˈnaitrəu ɡru:p
nitro- => 'naitrәj
nitrobenzene => .naitrә'benzi:n
nitrocellulose => .naitrә'seljәlәus
nitrochalk => .naitrә'tʃɒ:k
nitrofurantoin => ,naitrəu'fjuə'ræntɔin
nitrogen => 'naitrәdʒәn
nitrogen narcosis => ˈnaitrədʒən nɑ:ˈkəusis
nitrogenous => nai'trɒdʒәnәs
nitroglycerin => 'naitrәu'^lisәri:n
nitroglycerine => 'naitrәu'^lisәri:n
nitromethane => ,naitrә'meθein
nitrophilous => 'naitrәfailәs
nitrosamine => 'naitrәsә'mi:n
nitrous => 'naitrәs
nits => nits
nitty => 'niti
nitty-gritty => 'niti'griti
nitwit => 'nitwit
nitwits => 'nɪtwɪt
nitwitted => nit'witid
Niue => ni'u:ei
nival => 'naivәl
nivation => nai'veiʃәn
niveous => 'niviәs
nix => niks
nixed => nikst
nixon => 'niksn
Nizam => nai'zæm
no => nәu
no ball => nəʊ bɔ:l
no chance => nəu tʃɑ:ns
no comment => nəu ˈkɔment
no contest => nəu kənˈtest
no fair => nəu fɛə
no fear => nəʊ fiə
no offence => nəu əˈfens
no one => nəu wʌn
no place => nəu pleis
no problem => nəu ˈprɔbləm
no time => nəu taim
no-account => 'nәjә'kajnt
no-ball => ,nәj'bɔ:l
no-fly zone => ˈnəʊˈflaɪ
no-frills => ˈnəʊˈfrɪlz
no-good => 'nәu^ud
no-hitter => 'nәj'hitә(r)
no-knock => 'nәu'nɔk
no-load => 'nәjlәjd
no-no => 'nәjnәj
no-nonsense => 'nәj'nɔnsәns
no-score draw => nəʊ skɔ: drɔ:
no-see-um => nəu'si:əm
no-show => 'nәjʃәj
no-trump => 'nәu'trʌmp
no-win => 'nәuwin
no-win situation => ˈnəuwin ˌsitjuˈeiʃən
Noachian => nәj'eikiәn
Noah => 'nәuә
Noam => 'nәjәm
nob => nɒb
nobble => 'nɒbl
nobbled => ˈnɔbld
nobbler => 'nɒblә
nobbles => ˈnɔblz
nobbling => ˈnɔblɪŋ
nobbut => 'nɔbәt
nobby => 'nɒbi
Nobel => 'nәubel
Nobelist => nәu'belist
nobelium => nәu'bi:liәm
nobiliary => nәu'biliәri
nobility => nәu'biliti
noble => 'nәubl
nobleman => 'nәublmәn
noblemen => 'nəʊb(ə)lmən
nobleness => 'nәublnis
nobles => ˈnəublz
noblesse => nәu'bles
noblesse oblige => nәj'bles ɔ'bli:ʒ
noblewoman => 'nәublwumәn
nobly => 'nәubli
nobodies => ˈnəubədiz
nobody => 'nәubɒdi
nobs => nɔbz
nociceptive => ,nәusi'septiv
nociceptor => ,nәusi'septә
nock => nɔk
nocked => nɔkt
nocking => nɔkɪŋ
nocks => nɔks
noctambulism => nɒk'tæmbjulizm
noctambulist => nɔk'tæmbjjlist
noctiluca => .nɒkti'lu:kә
noctilucent cloud => ˌnɔktiˈlju:snt klaud
noctuid => 'nɔktʃuid
noctule => 'nɔktju:l
nocturn => 'nɔktә:n
nocturnal => nɒk'tә:nәl
nocturnally => nɒk'tɜ:nælaɪ
nocturne => nɒk'tә:n
nocuous => 'nɒkjuәs
nod => nɒd
nodal => 'nәudl
noddies => ˈnɔdiz
nodding => 'nɔdiŋ
noddle => 'nɒdl
noddles => 'nɒd(ə)l
noddy => 'nɒdi
node => nәud
nodical => 'nɒdikәl
nodose => nәu'dәus
nodosity => nәu'dɒsiti
nods => nɔdz
nodular => 'nɒdjulә
nodulated => 'nɔdjjleitid;-dʒә-
nodulation => ,nɔdju'leiʃәn
nodule => 'nɒdʒu:l
nodules => 'nɒdju:lz
nodulose => 'nɔdjjlәjs;-dʒә-
nodus => 'nәudәs
NOE => 'nәjә
Noel => nәu'el
noes => nəʊz
noetic => nәu'etik
Nofretete => ,nɔfre'ti:ti
nog => nɒg
Nogai => nә'^ai
noggin => 'nɒgin
nogging => 'nɒgiŋ
noggins => 'nɒgɪn
nohow => 'nәuhau
noir => nwɑ:
noise => nɒiz
noiseless => 'nɒizlis
noiselessly => 'nɔɪzləslɪ
noisemaker => 'nɒiz.meikә
noises => 'nɒizis
noisette => nwɑ:'zet
noisily => 'nɒizili
noisiness => 'nɒizinis
noisome => 'nɔisәm
noisomeness => 'nɔɪsəmnəs
noisy => 'nɒizi
nolan => 'nәulәn
nolens volens => 'nәulenz'vәulenz
noli me tangere => 'nuәlai mi: 'tændʒiri
nolle prosequi => 'nɔli'prɔsәkwai
nolo contendere => 'nәulәu kәn'tendәri
nom de guerre => ˌnɒm də ˈgeə(r)
nom de plume => nɔm dә 'plu:m
nomad => 'nәumәd
nomadic => nәu'mædik
nomadically => nouˊmædikәli
nomadism => nәu'mædizm
nomads => ˈnəʊˌmædz
nomarch => 'nɔmɑ:k
nomarchy => 'nɔmɑ:ki,-әki
nombril => 'nɔmbril
nome => nәum
nomen => 'nәumen
nomenclatural => ,nəʊmən'kleɪtʃərəl
nomenclature => 'nәumәnkleitʃә
nomenklatura => nəʊmeŋkleɪ'tərə
nomic => 'nәumik
nominal => 'nɒminl
nominalism => 'nɔminәliz(ә)m
nominalist => 'nɔminәlist
nominalistic => .nɒminә'listik
nominalization => ,nɔminəlai'zeiʃən, -li'z-
nominalize => 'nɔminә,laiz
nominally => 'nɒminәli
nominate => 'nɒmineit
nominates => ˈnɔmineits
nominating => ˈnɔmineitɪŋ
nomination => .nɒmi'neiʃәn
nominations => ˌnɔməˈneɪʃənz
nominative => 'nɒminәtiv
nominator => 'nɒmineitә
nominee => .nɒmi'ni:
nominees => nɒmɪ'ni:z
nomogram => 'nәumәgræm
nomography => nәu'mɒgrәfi
nomological => ,nɔmә'lɔdʒikәl,,nәjmә-
nomothetic => ,nɔmә'θetik
non => nɔn
non compos mentis => nɔn'kɔmpәs'mentis
non placet => nɔn'pleisit
non possumus => 'nɔn'pɔsjumәs
non sequitur => nɔn'sekwitә
non- => nɔn
non-aligned => ˈnɔnəˈlaind
non-allergenic => ,nɔnælə'dʒenik
non-bank => 'nɔn'bæŋk
non-believer => ,nɔnbi'li:və
non-belligerent => 'nɒnbɪl'ɪdʒərənt
non-biodegradable => ˌnɔnˌbaiəudiˈɡreidəbl
non-com => 'nɒnk'ɒm
non-combatant => ˌnɔnkəmˈbætənt
non-combatants => 'nɒnkɒmb'ətənts
non-commissioned officer => ˌnɔnkəˈmiʃənd ˈɔfisə
non-committally => ,nɔnkɔ'mitəli
non-competitive => 'nɒnkəmp'etətɪv
non-compliance => ˌnɔnkəmˈplaiəns
non-conducting => 'nɒnkənd'ʌktɪŋ
non-contributory => ˌnɔnkənˈtribjutəri
non-destructive => 'nɒndɪstr'ʌktɪv
non-directional => 'nɒndɪr'ekʃənl
non-drinker => 'nɒndr'ɪŋkər
non-driver => 'nɒndr'aɪvər
non-Euclidean => ,nɔnju:'klidiәn
non-event => nɔni'vent
non-existent => nʌnig'zistənt
non-fat => 'nɒnf'æt
non-ferrous => 'nʌn'ferəs
non-fiction => nɒn 'fɪkʃn
non-functional => 'nɒnf'ʌŋkʃənl
non-human => nɔnˈhju:mən
non-ism => 'nɔnizəm
non-linear => nɒn 'lɪnɪə(r)
non-linearity => 'nɒnlaɪn'ərɪtɪ
non-magnetic => 'nɒnmæɡn'etɪk
non-member => 'nɒnm'embər
non-metal => 'nɒnm'etl
non-moral => 'nɒnm'ɒrəl
non-natural => 'nɒnn'ætʃrəl
non-negative => 'nɒnneɡət'ɪv
non-parametric => 'nɒnpærəm'etrɪk
non-party => 'nɒnp'ɑ:tɪ
non-payment => nɔn'peimәnt
non-reader => 'nɒn,riːdə
non-return => 'nɒnrɪt'ɜ:n
non-sectarian => 'nɒnsekt'eərɪən
non-skid => 'nɒnsk'ɪd
non-smoker => nɔnˈsməukə
non-smokers => nɔn'sməukə
non-smoking => nɒn 'sməʊkɪŋ
non-starter => nɔnˈstɑ:tə
non-swimmer => 'nɒnsw'ɪmər
non-U => 'nɔnju:
non-uniform => 'nɒnj'u:nɪfɔ:m
non-use => 'nɒnj'u:s
non-user => 'nɔn'ju:zə
non-verbal => nɑ:n'vɜ:rbəl
non-violence => ˌnɔnˈvaiələns
non-violent => ˌnɔnˈvaɪələnt
non-volatile => 'nʌnˌvɒlətaɪl
non-white => nɒn waɪt
non-word => nɔn'wə:d
nona => 'nәunә
nonage => 'nәunidʒ
nonagenarian => .nɒnәdʒi'nєәriәn
nonaggression => .nɒnә'greʃәn
nonaggressive => 'nɔnә'^resiv
nonagon => 'nɒnәgɒn
nonagonal => nɔn'æɡənəl
nonagricultural => ,nɔnæ^ri'kʌltʃәrәl
nonalcoholic => .nɒnælkә'hɒlik
nonane => 'nɔnein
nonary => 'nәunәri
nonathlete => 'nɔn'æθli:t
nonbank => 'nɔn'bæŋk
noncaloric => ,nɔnkә'lɔrik
noncanonical => ,nɔnkә'nɔnikәl
nonce => nɒns
nonchalance => 'nɒnʃәlәns
nonchalant => 'nɒnʃәlәnt
nonchalantly => 'nɒnʃələntlɪ
noncircular => ,nɔn'sә:kjulә
noncom => 'nɔnkәm
noncombatant => nɒn'kɒmbәtәnt
noncommercial => .nɒnkә'mә:ʃәl
noncommissioned => .nɒnkә'miʃәnd
noncommittal => .nɒnkә'mitәl
noncommittally => ,nɔnkɔ'mitəli
noncompliance => .nɒnkәm'plaiәns
noncompliant => 'nɔnkәm'plaint
nonconformism => 'nɔnkәn'fɔmizәm
nonconformist => 'nɔnkәn'fɔmist
nonconformists => ˌnɔnkənˈfɔ:mɪsts
nonconformity => .nɒnkәn'fɒ:miti
nonconsumptive => ,nɔnkәn'sʌmptiv
noncontributory => 'nɔnkәn'tribjutәri
nonda => 'nɔndə
nondairy => 'nɔn'deәri
nondenominational => nɒndɪnɒmɪ'neɪʃənl
nondescript => 'nɒndiskript
nondiabetic => 'nɔndaiә'betik
nondiscretionary => 'nɔndis'kreʃәnәri
none => nʌn
nonentities => nɔnˈentɪti:z
nonentity => nɒn'entiti
nonequivalent => 'nɔni'kwivәlәnt
nones => nәunz
nonesuch => 'nʌnsʌtʃ
nonet => nәu'net
nonetheless => ,nʌnðә'les
nonexistence => .nɒnig'zistәns
nonexistent => .nɒnig'zistәnt
nonfeasance => nɒn'fi:zәns
nonferrous => 'nɔn'ferәs
nonfigurative => nɔn'fi^jjrәtiv
nonflammable => nɒn'flæmәbl
nonfunctional => nɒn'fʌŋkʃənl
nong => nɔŋ
nongovernmental => nɒnɡʌvnmenlt
nonjudgmental => nɒndʒʌdʒ'mentl
nonlinear => nɒn'liniә
nonlinearity => ,nɔnlini'æriti
nonlinguistic => nɒnlɪŋɡ'wɪstɪk
nonmagnetic => 'nɔnmæ^'netik
nonmaterial => 'nɔnmә'tiәriәl
nonmedical => nɔn'medikәl
nonmember => 'nɒnmembә
nonmetallic => .nɒnmi'tælik
nonobjective => .nɒnәb'dʒektiv
nonoccurrence => ,nɔnә'kʌrәns;-'k\\\\:-
nonpareil => 'nɔnpәrәl
nonpayment => nɒn'peimәnt
nonperformance => .nɒnpә'fɒ:mәns
nonplus => 'nɒnplʌs
nonplussing => nɔnˈplʌsɪŋ
nonporous => 'nɔn'pɔ:rәs
nonprofit => nɒn'prɒfit
nonreactive => 'nɔnri'æktiv
nonrecognition => nɒn.rekәg'niʃәn
nonrefundable => ,nɔnri'fʌndәbl
nonrelativistic => 'nɔnrelәti'vistik
nonrenewable => ˌnɒnrɪ'nju:əb
nonrepresentational => 'nɔn,reprizen'teiʃәnәl
nonreproductive => 'nɔn,ri:prә'dʌktiv
nonresidential => 'nɔn,rezi'denʃәl
nonsense => 'nɒnsәns
nonsensical => nɒn'sensikl
nonsexual => 'nɔn'seksjuәl
nonsignificant => 'nɔnsi^'nifikәnt
nonskid => nɒn'skid
nonsmoker => nɒn'smәukә
nonsmokers => nɔn'sməukə
nonsterile => 'nɒnsteraɪl
nonsteroidal => 'nɒnstərɔɪdl
nonstop => nɒn'stɒp
nonsuch => 'nɔnsʌtʃ
nonsuit => nɒn'su:t
nonthermal => 'nɔn'θә:mәl
nontoxic => 'nɔn'tɔksik
nontraditional => .nɔntrә'diʃәnәl
nontrivial => 'nɔn'triviәl
nonuniform => 'nɔn'ju:nifɔ:m
nonverbal => nɔn'vә:bәl
nonviable => nɒn'vaiәbl
nonviolence => nɒn'vaiәlәns
nonviolent => nɒn'vaiәlәnt
nonviolently => nɒn'vaɪələntlɪ
nonvolatile => 'nɔn'vɔlәtail
nonyl => 'nɔnil, 'nәu-
noodle => 'nu:dl
nook => nuk
nookie => 'njki
nooks => nʊks
nooky => 'nuki
noon => nu:n
noonday => 'nu:ndei
nooning => 'nu:niŋ
noontide => 'nu:ntaid
noontime => 'nu:ntaim
noose => nu:s
noosed => nu:st
nooses => nu:siz
noosing => nu:sɪŋ
noosphere => 'nәuәsfiә
Nootka => 'nu:tkә
nootropic => nu:t'rɒpɪk
nopal => 'nәupәl
nope => nәup
nor => nɒ:
nora => 'nɔ:rә
noradrenaline => ,nɔ:rә'drenәlin
Norbert => 'nɔ:bәt
nord => nɔ:d
Nordic => 'nɒ:dik
Nordrhein-Westfalen => 'nəutrainvest'fɑ:lən
noreen => 'nɔ:ri:n, nɔ:'ri:n
norepinephrine => 'nɔ,repi'nefrin
Norfolk => 'nɒ:fәk
Norge => 'nɔ:r^ә
noria => 'nɔ:riә
norite => 'nɔ:rait
nork => nɔ:k
norm => nɒ:m
Norma => 'nɒ:mә
normal => 'nɒ:ml
normalcy => 'nɒ:mlsi
normalisation => ,nɔ:məlai'zeiʃən
normalise => 'nɔ:mәlaiz
normalised => 'nɔ:məlaɪzd
normality => nɒ:'mæliti
normalization => .nɒ:mәlai'zeiʃәn
normalize => 'nɒ:mәlaiz
normalizer => 'nɔ:mәlaizә
normalizes => ˈnɔ:məˌlaɪziz
normalizing => 'nɔ:mәlaiziŋ
normally => 'nɒ:mәli
norman => 'nɔ:mәn
Normandy => 'nɒ:mәndi
Normanesque => .nɒ:mә'nesk
Normanism => 'nɔ:mәnizm
Normanize => 'nɒ:mәnaiz
normative => 'nɒ:mәtiv
normed => 'nɔ:md
norming => 'nɔ:mɪŋ
normotensive => ,nɔ:mәu'tensiv
Norn => nɒ:n
norris => 'nɔris
Norroy => 'nɔrɔi
norse => nɔ:s
Norseman => 'nɒ:smәn
norsemen => 'nɔ:smən
Norsk => nɔ:sk
norte => 'nɔ:tei
North => nɒ:θ
North Carolina => 'nɔ:θ,kærә'lainә
North Dakota => 'nɔ:θdә'kәutә
North Dakotan => 'nɔ:θdә'kәutәn
north-east => nɔ:θ iːst
north-easterly => nɔ:θ ˈi:stəli:
north-eastern => ˌnɔ:θˈi:stən
north-eastward => nɔ:θˈi:stwəd, nɔ:rˈi:st-
north-north-east => nɔ:θ nɔ:θ iːst
north-north-west => nɔ:θ nɔ:θ west
north-west => nɔ:θ west
north-westerly => nɔ:θ ˈwestəli:
north-western => ˌnɔ:θˈwestən
north-westward => ,nɔːθ'westwəd
Northallerton => nɔ:'θælәtәn
Northampton => nɔ:'θæmptən; nɔ:θ'hæmptən
Northamptonshire => nɔ:'θæmptәnʃiә
northbound => 'nɒ:θbaund
Northcliffe => 'nɔ:θklif
northeast => .nɒ:θ'i:st
northeaster => .nɒ:θ'i:stә
northeasterly => 'nɔ:θ'i:stәli
northeastern => .nɒ:θ'i:stәn
northeastward => .nɒ:θ'i:stwәd
northeastwards => nɔ:θ'i:stwәdz
norther => 'nɔ:ðә
northerly => 'nɒ:ðәli
northern => 'nɒ:ðәn
northerner => 'nɔ:ðәnә
northerners => 'nɔːð(ə)nə
northernmost => 'nɒ:ðәnmәust
Northfield => 'nɔ:θ'fi:ld
northing => 'nɒ:θiŋ
northland => 'nɒ:θlәnd
Northman => 'nɒ:θmәn
northmen => 'nɔ:θmən
Northumberland => nɔ:'θʌmbәlәnd
Northumbria => nɔ:'θʌmbriә
northumbrian => nɔ:'θʌmbriәn
northward => 'nɒ:θwәd
northwardly => 'nɔ:θwәdli
northwards => 'nɔ:θwәdz
northwest => .nɒ:θ'west
northwester => .nɒ:θ'westә
northwesterly => nɔ:θ'westәli
northwestern => .nɒ:θ'westәn
northwestward => 'nɔ:θ'westwәd
northwestwards => nɔ:θ'westwәdz
norton => 'nɔ:tәn
Norway => 'nɒ:wei
Norwegian => nɒ:'wi:dʒәn
nose => nәuz
nose candy => nəuz ˈkændi
nose flute => nəuz flu:t
nose guard => nəuz ɡɑ:d
nose job => nəuz dʒɔb
nose ring => nəuz riŋ
nose-cone => 'nəʊzk'əʊn
nosebags => 'nəuzbæɡ
noseband => 'nәuzbænd
nosebleed => 'nәuzbli:d
nosecone => 'nəʊzkəʊn
nosed => 'nәuzd
nosedived => 'nozdaɪv
nosediving => 'nozdaɪv
nosegay => 'nәuzgei
nosegays => 'nəʊzgeɪ
noseless => 'nәjzlis
nosema => 'nәusi:mә
nosepiece => 'nәuzpi:s
nosey => 'nәuzi
nosh => nɒʃ
nosh-up => nɔʃ ʌp
noshed => nɒʃ
noshes => nɒʃ
noshing => nɒʃ
nosily => 'nәuzili
nosiness => 'nәuzinis
nosing => 'nәuziŋ
nosocomial => ,nɔsә'kɔmiәl
nosode => 'nɔsәud
nosography => nәu'sɒgrәfi
nosology => nәu'sɒlәdʒi
nostalgia => nɒs'tældʒiә
nostalgic => nɒs'tældʒik
nostalgically => nɔˈstældʒɪkəlɪ
nostalgist => nɔ'stældʒist, nә-
nostoc => 'nɔstɔk
Nostradamus => ,nɔstrә'deimәs
nostril => 'nɒstril
nostrils => 'nɒstrəlz
nostrum => 'nɒstrәm
nostrums => ˈnɔstrəmz
nosy => 'nәuzi
not => nɒt
not cricket => nɔt ˈkrikit
not exactly => nɔt ɪgˈzæktli:
not necessarily => nɔt ˈnesisərili
not-for-profit => 'nɒtf'ɔ:rpr'ɒfɪt
nota bene => ,nәutә 'bi:ni
notabilities => ˌnəʊtəˈbɪlɪti:z
notability => .nәutә'biliti
notable => 'nәutәbl
notables => 'nəʊtəbəlz
notably => 'nәjtbәli
notal => 'nәutl
notam => 'nәjtæm
notaphily => nәj'tæfili
notarial => nәu'tєәriәl
notaries => ˈnəʊtəri:z
notarize => 'nәutәraiz
notarized => ˈnəʊtəˌraɪzd
notarizes => ˈnəʊtəˌraɪziz
notarizing => ˈnəʊtəˌraɪzɪŋ
notary => 'nәutәri
notate => 'nәuteit
notated => ˈnəuteitid
notates => ˈnəuteits
notating => ˈnəuteitɪŋ
notation => nәu'teiʃәn
notations => nəʊ'teɪʃnz
notch => nɒtʃ
notchback => 'nɔtʃbæk
notched => nɔtʃt
notcher => 'nɔtʃә
notches => nɔtʃiz
notching => 'nɔtʃiŋ
note => nәut
notebook => 'nәutbuk
notebooks => ˈnəutbuks
notecard => ˈnəʊtkɑ:d
notecase => 'nәjtkeis
noted => 'nәutid
notelet => 'nәutlit
notepaper => 'nәut.peipә
noteworthy => 'nәutwә:ði
nothing => 'nʌθiŋ
nothingness => 'nʌθiŋnis
nothosaur => 'nɔθәsɔ:
notice => 'nәutis
noticeable => 'nәutisәbl
noticeboard => ˈnəʊtɪsbɔ:d
noticeboards => 'notɪsbɔrd
noticed => 'nəʊtɪst
noticing => ˈnəutisɪŋ
notifiable => 'nәutifaiәbl
notification => .nәutifi'keiʃәn
notified => ˈnəutifaid
notify => 'nәutifai
noting => 'nәutiŋ
notion => 'nәuʃәn
notional => 'nәuʃәnәl
notionally => 'nəuʃənəli
notions => 'nəʊʃnz
notitia => nәj'tiʃiә
notochord => 'nәutәkɒ:d
Notogaea => 'nәutә'dʒi:ә
notoriety => .nәutә'raiәti
notorious => nәu'tɒ:riәs
notornis => nәu'tɔ:nis
notoungulate => ,nәjtәj'ʌŋ^jjlit, -leit
Nottingham => 'nɒtiŋәm
Nottinghamshire => 'nɔtiŋәmʃiә(r)
Notts => nɔts
notum => 'nәutәm
notwithstanding => .nɒtwiθ'stændiŋ
Nouadhibou => ,nwɑ:di'bu:
Nouakchott => nu'ɑ:kʃɔt
nougat => 'nu:gɑ:
nougatine => ,nu:^ә'ti:n
nought => nɒ:t
noughties => 'nɔtiz
noughts => nɔ:ts
noumenal => 'nauminl
noumenon => 'nauminәn
noun => naun
nounal => 'naunl
nouns => 'naʊnz
nourish => 'nә:riʃ
nourished => 'nʌrɪʃt
nourishes => ˈnʌriʃiz
nourishing => 'nә:riʃiŋ
nourishment => 'nә:riʃmәnt
nous => naus
nouveau => nu:'vәj
nouveau riche => nu:vәj 'ri:ʃ
nouvelle => nu:'vel
nouvelle cuisine => ˌnu:vel kwɪˈzi:n
nouvelle vague => nu:ˈvel veiɡ
nova => 'nәuvә
Nova Lisboa => ,nəuvəli:ʒ'bɔ:ə
Nova Scotia => 'nәuvә'skәuʃә
novaculite => nәu'vækjulait
novate => 'nәuveit
novation => nәu'veiʃәn
Novaya Zemlya => 'nɔ:vɑ:jɑ:zem'ljɑ:
novel => 'nɒvl
novelese => ,nɔvә'li:z
novelette => .nɒvә'let
novelettes => nɒvə'let
novelettish => nɒvə'letɪʃ
novelist => 'nɒvәlist
novelistic => .nɒvә'listik
novelists => 'nɒvəlɪsts
novelization => ,nɔvəlai'zeiʃən
novelize => 'nɒvәlaiz
Novell => nəu'vel
novella => nɒ:'velә
novelly => 'nɔvәli
novels => 'nɔvәlz
novelties => ˈnɔvəltiz
novelty => 'nɒvәlti
November => nәu'vembә
novena => nәu'vi:nә
novennial => nәu'veniәl
Novgorod => 'nɔv^әrɔd
novice => 'nɒvis
novices => ˈnɔvɪsiz
novitiate => nɒ'viʃiit
Novokuznetsk => ,nɔvɔkjz'njetsk
Novosibirsk => ,nәuvәsi'biәsk
now => nau
now now => nau nau
now or never => nau ɔ: ˈnevə
nowadays => 'nauәdeiz
noway => 'nәuwei
nowed => nau
nowhere => 'nәuhwєә
nowise => 'nәuwaiz
nowness => 'naʊnəs
nowt => naut
NOx => nɔks
noxious => 'nɒkʃәs
noyade => nwɑ:'jɑ:d
noyau => 'nwaiәu, 'nɔiәu
nozzle => 'nɒzl
nozzles => 'nɒzlz
nth => enθ
nu => nju:
nu- => nuː
nuance => nju:'ɑ:ns
nuanced => 'nju:ɔnst, 'nu:-';nju:'ɔnst
nub => nʌb
Nuba => 'nu:bә
nubbin => 'nʌbin
nubby => 'nʌbi
Nubia => 'nju:biә
Nubian => 'nju:biәn
nubile => 'nju:bail
nubility => nju:'biliti
nubuck => 'nju:bʌk
nucella => n'ju:slə
nucellar => -ә(r)
nucellus => nju:'selәs
nuchal => 'nju:kәl
nuciferous => nju'sifәrәs
nuclear => 'nju:kliә
nuclear club => ˈnju:kliə klʌb
nuclear reactor => ˈnju:kliə ri:ˈæktə
nuclear waste => ˈnju:kliə weist
nuclear weapon => ˈnju:kliə ˈwepən
nuclear winter => ˈnju:kliə ˈwintə
nuclear-free => ˈnju:kliə fri:
nuclear-powered => 'nju:kliә'pajәd
nuclearization => ,nju:kliәrai'zeiʃәn; -ri'z-
nuclease => 'nju:kli,eis
nucleate => 'nju:klieit
nucleated => etɪd
nucleates => ˈnjuklieits
nucleating => ˈnjuklieitɪŋ
nucleation => ,nju:kli'eiʃәn
nuclei => 'nju:kliai
nucleic => nju:'kli:ik
nucleic acid => nju:'kli:ik; (?@) nu:-
nucleocapsid => nju:kliә'kæpsid
nucleolar => nju:k'liәlә
nucleolus => nju:'kli:әlәs
nucleon => 'nju:kliɒn
nucleonic => ,nju:kli'ɔnik
nucleonics => .nju:kli'ɒniks
nucleons => 'njuːklɪɒn
nucleophile => 'nju:kliәfail
nucleophilic => ,nju:kliəu'filik
nucleoplasm => 'nju:kliәplæzm
nucleoprotein => ,nju:kliәu'prәuti:n; -'prәuti:in
nucleoside => 'nju:kliәsaid
nucleosome => 'nju:kliәsәum
nucleosynthesis => ,nju:kliәu'sinθisis
nucleosynthetic => ,nju:kliəu'sin'θetik
nucleotide => 'nju:kliәtaid
nucleotides => n'ju:kli:əʊtaɪdz
nucleus => 'nju:kliәs
nuclide => 'nju:klaid
nude => nju:d
nudes => n'ju:dz
nudge => nʌdʒ
nudged => nʌdʒd
nudges => nʌdʒz
nudging => 'nʌdʒɪŋ
nudibranch => 'nju:dibræŋk
nudie => 'nju:di
nudism => 'nju:dizm
nudist => 'nju:dist
nudists => 'nju:dist
nudity => 'nju:diti
nudnik => 'nudnik
Nuer => nu:ә
nuff => nʌf
nuffin => 'nʌfin
nugacity => nju:'ɡæsiti
nugatory => 'nju:gәtәri
nugget => 'nʌgit
nuggets => ˈnʌgɪts
nuisance => 'nju:sns
nuisances => ˈnju:sənsiz
nuit blanche => 'njwi:'blɔŋʃ
nuke => nju:k
nuked => nju:kt
nukes => nju:ks
nuking => nju:kɪŋ
null => nʌl
nullah => 'nʌlә
nulled => nʌl
nullification => .nʌlifi'keiʃәn
nullifidian => ,nʌli'fidiәn
nullified => ˈnʌləˌfaɪd
nullifier => 'nʌlifaiә
nullifies => ˈnʌləˌfaɪz
nullify => 'nʌlifai
nullifying => ˈnʌləˌfaɪŋ
nullipara => nʌ'lipәrә
nulliparous => nʌ'lipәrәs, nә-
nullity => 'nʌliti
numb => nʌm
numbat => 'nʌmbæt
numbed => nʌmd
number => 'nʌmbә
number plate => ˈnʌmbə pleit
number two => ˈnʌmbə tu:
numbered => 'nʌmbәd
numbering => 'nʌmbәriŋ
numberless => 'nʌmbәlis
numbers => 'nʌmbәz
numbfish => 'nʌmfiʃ
numbing => 'nʌmiŋ
numbles => 'nʌmblz
numbly => 'nʌmli
numbness => 'nʌmnis
numbs => nʌmz
numbskull => 'nʌmskʌl
numdah => 'nʌmdɑ:
numen => 'nju:mәn
numerable => 'nju:mәrәbl
numeracy => 'njumәrәsi
numeral => 'nju:mәrәl
numerate => 'nju:mәreit
numerated => ˈnu:məˌreɪtid
numerates => ˈnu:məˌreɪts
numerating => ˈnu:məˌreɪtɪŋ
numeration => .nju:mә'reiʃәn
numerator => 'nju:mәreitә
numeric => nju:'merik
numerical => nju:'merikl
numero uno => ˈnju:mərəuˈu:nəu
numerologist => ,nju:mə'ɔlədʒist
numerology => .nju:mә'rɔlәdʒi
numerous => 'nju:mәrәs
numerously => ˊnjuːmәrәsli
numerousness => ˊnjuːmәrәsnis
Numidia => nju:'midiә
Numidian => nju:'midiәn
numina => 'nju:minә
numinous => 'nju:minәs
numismatic => .nju:miz'mætik
numismatics => .nju:miz'mætiks
numismatist => nju:'mizmәtist
numismatology => nju:,mizmә'tɔlәdʒi
nummular => 'nʌmjulә
nummulite => 'nʌmjulait
nummulites => nʌm'jʊlɪts
numnah => 'nʌmnә
numpty => 'nʌmpti
numskull => 'nʌmskʌl
nun => nʌn
nun buoy => nʌn ˈbu:i:
nunatak => 'nʌnәtæk
nunc => 'nʌŋk
Nunc Dimittis => 'nʌŋk di'mitis
nunchaku => 'njntʃәkә
nunciature => 'nʌnʃiәtʃә
nuncio => 'nʌnʃiәu
nuncle => 'nʌŋkl
nuncupative => 'nʌŋkjupeitiv
nunneries => 'nʌn(ə)rɪ
nunnery => 'nʌnәri
nuns => nʌnz
nunu => 'nu:nu:
nuoc mam => 'nwɔk'mɑ:m
NUPE => 'nu:pei
nuptial => 'nʌpʃәl
nuptiality => ,nʌpʃә'æliti
nuptials => ˈnʌpʃlz
Nuremberg => 'njurәmbә:g
nurse => nә:s
nurse practitioner => nə:s prækˈtiʃənə
nurse shark => nə:s ʃɑ:k
nursed => nə:st
nurseling => 'nә:sliŋ
nursemaid => 'nә:smeid
nursemaids => 'nɜːsmeɪd
nurseries => ˈnə:səriz
nursery => 'nә:sәri
nursery nurse => ˈnə:səri nə:s
nursery slope => ˈnə:səri sləup
nurseryman => 'n\\\\:sәrimәn
nursing => 'nә:siŋ
nursling => 'nә:sliŋ
nurturance => 'nә:tʃәrәns
nurturant => 'nətʃərənt
nurture => 'nә:tʃә
nurtured => ˈnə:tʃəd
nurturer => 'nɜ:tʃərə
nurtures => ˈnə:tʃəz
nurturing => ˈnə:tʃərɪŋ
nut => nʌt
nut tree => nʌt tri:
nut-brown => 'nʌt'brajn
nutation => nju:'teiʃәn
nutcases => 'nʌtkeis
nutcracker => 'nʌt.krækә
nutgall => 'nʌtgɒ:l
nuthatch => 'nʌthætʃ
nuthin => 'nʌθin
nuthouse => 'nʌthaʊs
nutlet => 'nʌtlit
nutmeg => 'nʌtmeg
nutraceutical => ˌnju:trəˈsu:tɪkl
nutria => 'nju:triә
nutrient => 'nju:triәnt
nutrients => 'nju:trɪənts
nutriment => 'nju:trimәnt
nutrimental => .nju:tri'mentl
nutrition => nju:'triʃәn
nutritional => nju: 'triʃәnәl
nutritionist => nju:'triʃәnist
nutritious => nju:'triʃәs
nutritiousness => nju(ː)ˊtriʃәsnis
nutritive => 'nju:tritiv
nuts => nʌts
nutshell => 'nʌtʃel
nutso => 'nʌtsәj
nutsy => 'nʌtsi
nutted => 'nʌtid
nutter => 'nʌtә
nutters => ˈnʌtəz
nuttiness => 'nʌtɪnəs
Nutting => 'nʌtiŋ
nutty => 'nʌti
Nuyorican => ,nu:jɔ'ri:kәn
nuzzle => 'nʌzl
nuzzled => ˈnʌzəld
nuzzles => ˈnʌzəlz
nuzzling => ˈnʌzəlɪŋ
nvq => ˌen vi: ˈkju:
nyala => 'njɑ:lә
Nyasa => ni'æsә,nai-
Nyasaland => ni'æsәlænd,nai-
nyctalopia => .niktә'lәupiә
nyctinasty => ,nikti'næsti
nyctophobia => .niktә'fәubiә
Nye => nai
nylon => 'nailɒn
nymph => nimf
nymphaea => nim'fi:ə
nymphaeum => nim'fi:әm
nymphal => 'nimfәl
nymphalid => 'nimfәlid
nymphean => naɪm'fi:ən
nymphet => 'nimfit. nim'fet
nympho => 'nimfәu
nympholepsy => 'nimfәlepsi
nympholept => 'nimfәlept
nympholeptic => nimfə'leptik
nymphomania => .nimfәu'meiniә
nymphomaniac => -'meiniæk
nymphomaniacal => ,nimfәjmә'naiәkәl
nymphomaniacs => ,nimfəu'meiniæk
nymphos => ˈnimfəuz
Nynorsk => 'nju:nɔ:sk
Nysa => 'naisә
nystagmic => ni'stægmik
nystagmus => ni'stægmәs
nystatin => 'nistәtin
Nyx => niks