naas => NAA
namibians => Namibian
nanas => NANA
nanning => nan
napoli => Napoli
nawabs => Nawab
naxalites => Naxalite
nazareth => Nazareth
Nazifies => Nazify
neanderthals => Neanderthal
neapolitans => Neapolitan
neaves => Neave
neds => NED
nellies => Nelly
nestorians => Nestorian
netherlanders => Netherlander
newlands => Newland
newsomes => Newsome
newtonians => Newtonian
nfs => nf
ni => Ni
nicaraguans => Nicaraguan
nicholls => Nicholl
nicols => Nicol
nicos => Nico
niels => Niel
nikes => Nike
nikos => niko
nogai => Nogai
nordics => Nordic
normans => norman
norways => Norway
norwegians => Norwegian
nsaid => NSAID
nubians => Nubian
nuer => nu
nuits => nuit
nutting => nut