L => el
La => lɔ:, lɑ:
La Paz => lɑ: 'pæz
La Plata => lә'plɑ:tә
la-di-da => .lɑ:di'lɑ:
laager => 'lɑ:gә
lab => læb
laban => 'leibәn
labarum => 'læbәrәm
labdanum => 'læbdәnәm
labefaction => .læbi'fækʃәn
label => 'leibl
labellum => lә'belәm
labelmate => læ'belmeɪt
labia => 'leibiә
labia majora => məˈdʒɔ:rə, -ˈdʒəʊrə
labia minora => məˈnɔ:rə, -ˈnəʊrə
labial => 'leibiәl
labialize => 'leibiәlaiz
labialized => 'leibiәlaizd
labiate => 'leibieit
labile => 'leibail
lability => lә'bilәti
labio- => 'leibiәj
labiodental => .leibiәu'dentl
labiovelar => ,leibiәu'vi:lә
labium => 'leibiәm
lablab => 'læblæb
labor => 'leibә
labor-intensive => 'læbərɪnt'ensɪv
laboratories => ləˈbɔrətəriz
laboratory => 'læbrәtәri
labored => 'leibәd
laborer => 'leibәrә
laborers => 'læbɔ:ərz
laboring => 'leibәriŋ
laborious => lә'bɒ:riәs
laboriousness => lәˊbɒːriәsnis
Laborite => 'leibәrait
labors => ˈleibəz
labour => 'leibә
labour-intensive => ˈleibə inˈtensiv
labour-saving => ˈleibə ˈseiviŋ
laboured => 'leibәd
labourer => 'leibәrә
labourers => ˈleɪbrəz
labouring => 'leibәriŋ
labourism => 'leibərizəm
labourist => 'leibərist
labours => ˈleibəz
labra => 'leibrә, 'læbrә
labrador => 'læbrәdɔ:
labradorescence => ,læbrә,dɔ'resәns
labradorite => 'læbrә,dɔ:rait
labret => 'leibret
labrum => 'leibrәm
labs => læbs
Labuan => lә'bu:әn, ,lɑ:bu:'ɑ:n
laburnum => lә'bә:nәm
laburnums => ləˈbə:nəmz
labyrinth => 'læbәrinθ
labyrinthian => 'læbәrinθiәn
labyrinthine => ,læbә'rinθain, -θin
labyrinthitis => ,læbәrin'θaitis
labyrinthodont => ,læbә'rinθәdɔnt
labyrinths => ˈlæbəˌrɪnθs
lac => læk
laccase => 'lækeis
laccolith => 'lækәliθ
lace => leis
lace into => leis ˈɪntuː
lace-up => leis ʌp
lace-ups => 'leɪs'ʌps
lacebark => 'leis,bɑ:k
laced => leist
Lacedaemonian => .læsidi'mәuniәn
lacemaking => 'leis,meikiŋ
lacerate => 'læsәreit
lacerated => 'læsәreitid
lacerates => ˈlæsəˌreɪts
lacerating => ˈlæsəˌreɪtɪŋ
laceration => .læsә'reiʃәn
lacerations => læsə'reɪʃnz
Lacerta => lә'sә:tә
lacertid => lә'sә:tid
lacertilian => ,læsә'tiljәn
lacewing => 'leis,wiŋ
lacewood => 'leis,wud
lacework => 'leisw\\\\:k
lacey => 'leisi
lach => 'lək
laches => 'lætʃiz
Lachesis => 'lækәsis
Lachlan => 'læklən
lachrymal => 'lækriml
lachrymation => .lækri'meiʃәn
lachrymator => 'lækrimeitә
lachrymatory => 'lækrimәtәri
lachrymose => 'lækrimәus
lachrymosely => ˊlækrimousli
lacier => ˈleisiə
lacily => 'leisili
laciness => 'leisinis
lacing => 'leisiŋ
laciniate => lә'sinieit
lack => læk
lackadaisical => .lækә'deizikәl
lackadaisically => lækə'deɪzɪklɪ
lackaday => 'lækәdei
lacked => lækt
lackey => 'læki
lackeyed => 'lækɪ
lackeys => ˈlæki:z
lacking => 'lækiŋ
lacklustre => 'læklʌstә
lacks => læks
Laconia => lә'kәjniә
Laconian => lә'kәjniәn
laconic => lә'kɒnik
laconically => lә'kɒnikli
laconicism => 'lә'kɔnisizәm
laconicum => lә'kɔnikәm
laconism => 'lækәnizәm
lacquer => 'lækә
lacquer tree => ˈlækə tri:
lacquered => ˈlækəd
lacquerer => 'lækәrә
lacquering => 'lækәriŋ
lacquers => ˈlækəz
lacquerware => 'lækәweә
lacquerwork => 'lækәw\\\\:k
lacquey => 'læki
lacrimal => 'lækrimәl
lacrimation => ,lækri'meiʃәn
lacrimator => 'lækrimeitә
lacrimatory => 'lækrimәtәri
lacrosse => lә'krɒs
lacrymal => 'lækrimәl
lactalbumin => læk'tælbjjmin, ,læktæl'bju:min
lactam => 'læktæm
lactase => 'lækteis
lactate => 'lækteit
lactated => ˈlækˌteɪtid
lactating => ˈlækˌteɪtɪŋ
lactation => læk'teiʃәn
lacteal => 'læktiәl
lactescent => læk'tesәnt
lactic => 'læktik
lactiferous => læk'tifәrәs
lacto- => 'læktәj
lacto-ovo-vegetarian => ˌlæktəʊ ˈəʊvəʊ vedʒəteəriən
lactobacillus => .læktәubә'silәs
lactoferrin => ,læktә'ferin
lactoflavin => ,læktәu'fleivin
lactogenic => ,læktә'dʒenik
lactoglobulin => ,læktәu'^lɔbjulin
lactometer => læk'tɒmitә
lactone => 'læktәun
lactoprotein => ,læktәu'prәuti:n, -'prәuti:in
lactoscope => 'læktәuskәup
lactose => 'læktәus
lacuna => lә'kju:nә
lacunae => lә'kju:ni:
lacunal => lә'kju:nәl
lacunar => lә'kju:nә
lacunary => læ'kju:nәri
lacunate => lә'kju:nit
lacunose => lә'kju:nәus
lacustrine => lә'kʌstriәn
lacy => 'leisi
lad => læd
ladanum => 'lædәnәm
ladder => 'lædә
ladder tournament => ˈlædə ˈtuənəmənt
ladder-back => 'lædərb'æk
laddered => 'lædәd
laddering => 'lædərɪŋ
ladders => ˈlædəz
laddertron => 'lædәtrɔn
laddie => 'lædi
laddish => 'lædiʃ
lade => leid
laden => 'leidn
lades => leidz
ladette => lædˈet
ladies' man => ˈleidiz mæn
ladified => 'leidifaid
ladify => 'leidifai
Ladin => lә'di:n
lading => 'leidiŋ
Ladino => lә'di:nәu
ladinos => lə'diːnəʊ
ladle => 'leidl
ladled => ˈleɪdld
ladleful => 'leidlful
ladles => ˈleɪdlz
Ladoga => 'lɑ:dә^ә
lady => 'leidi
ladybird => 'leidibә:d
ladybirds => 'leɪdɪbɜ:dz
ladybug => 'leidibʌg
ladyfied => 'leidifaid
ladyfinger => 'leidifiŋgә
ladyfish => 'leɪdi:fɪʃ
ladyfy => 'leidifai
ladyhood => 'leidihud
ladylike => 'leidilaik
ladyship => 'leidiʃip
Laetrile => 'leiәtril
laevo- => 'li:vәj
laevorotation => ,li:vәurәu'teiʃәn
laevorotatory => ,li:vәj'rәjtәtәri; -,tɔ:ri
laevulose => 'li:vәlәuz
lafayette => .lɑ:fei'et
lag => læg
lagan => 'læ^әn
lagena => lә'dʒi:nә
lager => 'lɑ:gә
lager lout => ˈlɑ:ɡə laʊt
laggard => 'lægәd
laggardly => 'læɡədlɪ
laggards => 'læɡədz
lagged => læɡd
lagger => 'læ^ә(r)
lagging => 'lægiŋ
lagniappe => læn'jæp
lagomorph => 'lægәmɒ:f
lagoon => lә'^u:n
lagoonal => lə'ɡu:nl
lagoons => lə'ɡu:nz
Lagos => 'lɑ:gәs
laguna => lә'ɡu:nә
lah => lɑ:
lahar => 'lɑ:hɑ:(r)
Lahnda => 'lɑ:ndә
lahore => lә'hɔ:
Lahu => 'lɑ:hu:
lai => lai
Laibach => 'laibɑ:h
laic => lei'ik
laical => 'leiikәl
laicism => 'leiisizm
laicize => 'leiisaiz
laid => leid
laid-back => ˌleidˈbæk
lain => lein
lair => lєә
lairage => 'leәridʒ
laird => lєәd
lairds => lɛədz
lairs => leəz
lairy => 'leәri
laissez-aller => 'leiseizælei
laissez-faire => lei'sei'fєәr
laissez-passer => 'leisei'pæsei
laity => 'leiәti
Laius => 'laijәs
lake => leik
lake dwelling => leik ˈdwelɪŋ
lake trout => leik traʊt
lakefront => 'leikfrʌnt
Lakeland => 'leiklәnd
lakelet => 'leiklit
Laker => 'leikә(r)
lakeshore => 'leikʃɔ:(r)
lakeside => 'leiksaid
lakh => læk
lakhs => læk; lɑːk
laksa => 'læksɑ:
lalapalooza => ,lɔlәpә'lu:zә
Lalique => lә'li:k
Lallans => 'lælən
lallation => læ'leiʃәn
Lally => 'lɑ:li
lallygag => 'lɔli:^æ^
lam => læm
lam into => læm ˈɪntuː
lama => 'lɑ:mә
Lamaism => 'lɑ:mәizm
Lamaist => 'lɑ:mәist
Lamarck => lә'mɑ:k
Lamarckian => lә'mɑ:kiәn
lamarckism => lә'mɑ:kizәm
lamas => ˈlɑ:məz
lamasery => 'lɑ:mәsәri
lamb => læm
lambada => læmˈbɑ:də
lambaste => læm'beist
lambasted => læmˈbeɪstid
lambasting => læmˈbeɪstɪŋ
lambasts => læmˈbeists
lambda => 'læmdә
lambdoid => 'læmdɔid
lambdoidal => læm'dɔɪdl
lambed => læm
lambency => 'læmbәnsi
lambent => 'læmbәnt
lamber => 'læmər
lambert => 'læmbә(:)t
Lambeth => 'læmbәθ
lambing => 'læmɪŋ
lambkin => 'læmkin
lamblike => 'læmlaik
lambrequin => 'læmbrikin
lambs => læmz
lambskin => 'læmskin
lambskins => 'læmskɪn
lame => leim
lame duck => leim dʌk
lamebrain => 'leimbrein
lamed => 'lɑ:med
lamella => lә'melә
lamellar => lә'melә
lamellate => 'læmәleit
lamellibranch => lә'melibræŋk
lamellicorn => lә'melikɔ:n
lamelliform => lә'melifɒ:m
lamellose => lә'melәus, 'læmәlәus
lamely => 'leimli
lameness => 'leimnis
lament => lә'ment
lamentable => 'læmәntәbl
lamentably => 'læməntəblɪ
lamentation => .læmәn'teiʃәn
lamentations => ,læmen'teiʃәnz
lamented => lә'mentid
lamenting => lә'mentiŋ
laments => ləˈments
lamer => leimə
lames => leimz
lamia => 'leimiә
lamina => 'læminә
laminable => 'læminәbl
laminal => 'læminәl
laminar => 'læminә(r)
laminas => ˈlæminəz
laminate => 'læmineit
laminated => 'læmineitid
laminates => ˈlæməˌneɪts
laminating => 'læmineitiŋ
lamination => .læmi'neiʃәn
laminator => 'læmineitә
laminectomy => ,læmi'nektәmi
lamington => 'læmiŋtәn
laminin => 'leɪmɪnɪn
laminitis => læmi'naitis
laminose => 'læminәus
Lammas => 'læmәs
lammed => læmd
lammergeier => 'læmә^aiә(r)
lamming => læmɪŋ
lamp => læmp
lamp chimney => læmp ˈtʃimni
lamp post => læmp pəust
lampas => 'læmpәs
lampblack => 'læmpblæk
Lampedusa => ,lɑ:mpə'du:zɑ:
lampern => 'læmpәn
lampless => 'læmplis
lamplight => 'læmplait
lamplighter => 'læmplaitә
lamplit => 'læmplit
lampoon => læm'pu:n
lampooned => læmˈpu:nd
lampooner => læm'pu:nә(r)
lampooning => læmˈpu:nɪŋ
lampoonist => læm'pu:nist
lampoons => læmˈpu:nz
lamppost => 'læmpәust
lamprey => 'læmpri
lampreys => 'læmprɪz
lamprophyre => 'læmprәfaiә
lampshade => 'læmpʃeid
lampshades => ˈlæmpˌʃeɪdz
lams => læmz
lanai => lɑ:'nɑ:
Lanark => 'lænək
Lanarkshire => 'lænәkʃә(r)
Lancashire => 'læŋkәʃiә
lancaster => 'læŋkәstә
Lancastrian => læŋ'kæstriәn
lance => lɑ:ns
lance corporal => læns ˈkɔ:pərəl
lanced => lænst
lancelet => 'lɑ:nslit
Lancelot => 'lɑ:nsәlәt
lanceolate => 'lɑ:nsiәlәt
lancer => 'lɑ:nsә
lancers => 'lɑ:nsəz
lances => lænsiz
lancet => 'lɑ:nsit
lancet arch => ˈlɑ:nsit ɑ:tʃ
lancet window => ˈlɑ:nsit ˈwindəu
lanceted => 'lɑ:nsitid; 'læn-
lancets => 'lɑːnsɪt
lancewood => 'lɑ:nswud
Lanchow => 'lɑ:n'dʒәj
Lancing => 'lɑ:nsiŋ
land => lænd
land grant => lænd ɡrɑ:nt
land up => lænd ʌp
land yacht => lænd jɔt
landau => 'lændɒ:
landaulet => ,lændɔ:'let
landaus => 'lændɔː; -aʊ
lande => lɑ:ŋd
landed => 'lændid
lander => 'lændә
landfall => 'lændfɒ:l
landfalls => ˈlændfɔ:lz
landfill => 'lændfil
landfills => ˈlændˌfɪlz
landform => 'lændfɒ:m
landgrave => 'lændgreiv
landholder => 'lændhәuldә
landholding => 'lændhәuldiŋ
landing => 'lændiŋ
landing field => ˈlændɪŋ fi:ld
landing gear => ˈlændɪŋ ɡiə
landing net => ˈlændɪŋ net
landing strip => ˈlændɪŋ strip
landladies => ˈlændˌleɪdi:z
landlady => 'lændleidi
landless => 'lændlis
landline => 'lændlain
landlock => 'lændlɔk
landlocked => 'lændlɔkt
landlord => 'lændlɒ:d
landlordism => 'lændlɔ:dizәm
landlords => 'lændlɔ:dz
landlubber => 'lændlʌbә
landmark => 'lændmɑ:k
landmarks => 'lændmɑ:ks
landmass => 'lændmæs
landmine => ˈlændmaɪn
landmines => 'lændmaɪnz
Landon => 'lændәn
Landor => 'lændɔ:
landowner => 'lændәunә
landowners => ˈlændˌəʊnəz
landownership => 'lænd,әjnәʃip
landowning => 'lænd,әjniŋ
landplane => 'lændplein
landrail => 'lændreil
landrover => 'lændrәuvә
landsat => 'lændsæt
landscape => 'lændskeip
landscape gardener => ˈlændskeip ˈɡɑ:dnə
landscape gardening => ˈlændskeip ˈgɑ:dnɪŋ
landscaper => 'lænd.skeipә
landscapes => ˈlændskeips
landscaping => 'lænd.skeipiŋ
landscapist => 'lændskeipist
landside => 'lændsaid
landsknecht => 'læntskә,nekt
landslide => 'lændslaid
landslides => 'lændslaɪdz
landslip => 'lændslip
landslips => ˈlændslips
landsman => 'lændzmәn
Landsteiner => 'lænd,stainә
landward => 'lændwәd
lane => lein
lanes => leinz
Lanfranc => 'lænfræŋk
lang => læŋ
lang syne => læŋ sain
lange => 'læŋә
Langland => 'læŋlәnd
langlauf => 'lɑ:ŋ'lauf
langley => 'læŋli
langouste => lɒŋ'gu:st
langoustine => lɑ:ŋ'^ustin
Langton => 'læŋtәn
language => 'læŋgwidʒ
language area => ˈlæŋɡwidʒ ˈɛəriə
language laboratory => ˈlæŋɡwidʒ ləˈbɔrətəri
langue => lɑ:ŋɡ
langued => lɑːŋɡ
Languedoc => lɔŋ^ә'dɔk
languid => 'læŋgwid
languidly => 'læŋɡwɪdlɪ
languidness => 'læŋɡwɪdnes
languish => 'læŋgwiʃ
languished => ˈlæŋgwɪʃt
languisher => 'læŋɡwɪʃər
languishes => ˈlæŋgwɪʃiz
languishing => 'læŋ^wiʃiŋ
languishingly => 'læŋɡwɪʃɪŋlɪ
languishment => 'læŋ^wiʃmәnt
languor => 'læŋgә
languorous => 'læŋgәrәs
languorously => 'læŋgərəsli
langur => lʌŋ'guә
laniard => 'lænjәd
lank => læŋk
lankier => ˈlæŋki:ə
lankily => 'læŋkili
lankiness => 'læŋkinis
lankly => 'læŋklɪ
lanky => 'læŋki
lanner => 'lænә
lanneret => 'lænәrit
lanolin => 'lænәlin
Lansdowne => 'lænzdajn
lansquenet => 'lænskәnet
lantana => læn'tɑ:nә
lantern => 'læntәn
lantern fly => ˈlæntən flai
lanternfish => 'læntənfɪʃ
lanterns => 'læntənz
lanthanide => 'lænθәnaid
lanthanides => lanθənɪdz
lanthanum => 'lænθәnәm
lanthorn => 'læntәn
lanugo => lә'nju:^әu, -'nu:-
lanyard => 'lænjәd
lanyards => 'lænjəd
Lanzhou => 'lɑ:n'dʒәj
lao => lau, 'lɑ:әu
Lao-tzu => 'lau'dzu
Laodicean => .leiәudi'siәn
Laos => lauz
Laotian => lei'әuʃiәn
lap => læp
lap belt => læp belt
lap dancing => læp ˈdænsɪŋ
lap of honour => læp ɔv ˈɔnə
lap robe => læp rəub
lapa => 'lɑ:pə
laparoscope => 'læpәrәjskәjp
laparoscopically => ləpærəs'kɒpɪklɪ
laparoscopy => ,læpә'rɔskәpi
laparotomy => .læpә'rɒtәmi
lapdog => 'læpdɒg
lapel => lә'pel
lapels => lə'pelz
lapful => 'læpful
lapidaries => ˈlæpɪˌderi:z
lapidary => 'læpidәri
lapilli => lә'pilai
lapillus => lә'pilәs
lapin => 'læpin
lapis => 'læpis
lapis lazuli => læpis 'læzju:li; (?@) 'læzәli
laplace => lɑ:'plɑ:s
Lapland => 'læplænd
Laplander => 'læplændә
Lapp => læp
lappa => 'læpә
lapped => læpt
lappet => 'læpit
lapping => 'læpiŋ
Lappish => 'læpiʃ
lapse => læps
lapse rate => læps reit
lapsed => læpst
lapses => læpsiz
lapsing => læpsɪŋ
lapstone => 'læpstәjn
lapstrake => 'læpstreɪk
lapsus calami => 'læpsәs'kælәmai,'lɑ:psjs'kɑ:lɑ:mi:
laptops => 'læptɒps
lapwing => 'læpwiŋ
lapwings => ˈlæpwiŋz
lar => lɑ:
lara => 'lærә,'lɑ:rә
larboard => 'lɑ:bәd
larcener => 'lɑ:sәnә
larcenies => ˈlɑ:səni:z
larcenous => 'lɑ:sәnәs
larceny => 'lɑ:sәni
larch => lɑ:tʃ
larches => 'lɑ:tʃɪz
lard => lɑ:d
lardass => ˈlɑ:dɑ:s
larded => lɑ:did
larder => 'lɑ:dә
larders => ˈlɑ:dəz
larding => 'lɑ:diŋ
lardon => 'lɑ:dәn
lards => lɑ:dz
lardy => 'lɑ:di
lares => 'leәri:z,'lɑ:reiz
large => lɑ:dʒ
large-hearted => 'lɑ:dʒh'ɑ:tɪd
large-minded => 'lɑ:dʒ'maindid
largely => 'lɑ:dʒli
largemouth => 'lɑ:dʒmajθ
largeness => 'lɑ:dʒnis
largess => 'lɑ:dʒes, 'lɑ:dʒis
largesse => lɑ:'dʒes
larghetto => lɑ:'getәu
largish => 'lɑ:dʒiʃ
largo => 'lɑ:gәu
lariat => 'læriәt
Larisa => lə'risə
lark => lɑ:k
larked => lɑ:kt
Larkin => 'lɑ:kin
larkiness => 'lɑ:kinis
larking => lɑ:kɪŋ
larks => lɑ:ks
larkspur => 'lɑ:kspә:
larky => 'lɑ:ki
larn => lɑ:n
larning => lɑ:n
larns => lɑ:n
larrikin => 'lærikin
larrup => 'lærәp
larruping => 'lærәpiŋ
Larry => 'læri
larva => 'lɑ:vә
larval => 'lɑ:vәl
larvicide => 'lɑ:visaid
laryngeal => lә'rindʒiәl
laryngectomy => ,lærin'dʒektәmi
laryngitis => .lærin'dʒaitis
laryngology => ,læriŋ'^ɔlәdʒi
laryngoscope => lә'riŋgәskәup
laryngoscopy => ,læriŋ'^ɔskәpi
laryngotomy => .læriŋ'gɒtәmi
larynx => 'læriŋks
Las Palmas => lɑ:s'pɑ:lmәs
lasagna => lә'zɑ:njә
lasagne => ləˈzænjə
lascivious => lә'siviәs
lase => leiz
laser => 'leizә
laser gun => ˈleizə ɡʌn
lash => læʃ
lash-up => 'læʃʌp
lashed => læʃt
lasher => 'læʃә
lashes => læʃiz
lashing => 'læʃiŋ
lashings => 'læʃiŋz. -inz
lashless => 'læʃlis
lasing => 'leisiŋ
Laski => 'læski
lasque => læsk
lass => læs
lasses => læsiz
lassi => ˈlæsi
lassie => 'læsi
lassies => ˈlæsiz
lassitude => 'læsitju:d
lasso => 'læsәu
lassoed => ˈlæsəʊd
lassoer => 'læsu:ər
lassoing => ˈlæsəʊɪŋ
last => lɑ:st
last minute => lɑ:st ˈminit
last orders => lɑ:st ˈɔ:dəz
last post => lɑ:st pəust
last thing => lɑ:st θiŋ
last-minute => 'lɑ:st'minit;'læst-
lasting => 'lɑ:stiŋ
lastly => 'lɑ:stli
lat => læt
Latakia => .lætә'ki:ә
latch => lætʃ
latched => lætʃt
latchet => 'lætʃit
latching => 'lætʃiŋ
latchkey => 'lætʃki:
latchkey child => ˈlætʃki: tʃaild
late => leit
late-breaking => 'leɪtbr'eɪkɪŋ
late-model => 'leit'mɔdәl
late-night => 'leitnait
latecomer => 'leitkʌmә
latecomers => ˈleitˌkʌməz
lateen => lә'ti:n
lately => 'leitli
latency => 'leitnsi
lateness => 'leitnis
latent => 'leitnt
later => 'leitә
lateral => 'lætәrәl
lateral line => ˈlætərəl lain
lateral ventricle => ˈlætərəl ˈventrikl
laterality => lætә'ræliti
lateralization => ,lætәrәlai'zeiʃәn;-li'z-
lateralize => 'lætәrә,laiz
lateran => 'lætәrәn
laterite => 'lætәrait
lateritic => ,lætә'ritik
latest => 'leitist
latex => 'leiteks
lath => læθ. lɑ:θ
lathe => leið
lather => 'læðә. 'lɑ:ðә
lathered => ˈlæðəd
lathering => 'lɑ:ðәriŋ;'læð-
lathers => ˈlæðəz
lathery => 'læðәri
lathes => leɪðz
lathi => 'lɑ:ti
laths => lɑ:θs
lathyrism => 'læθirizәm
latices => 'lætisi:z
laticifer => 'lætisifә
laticiferous => læti'sifәrәs
latifundium => ,læti'fʌndiәm
Latin => 'lætin
Latinate => 'lætineit
Latinism => 'lætinizm
Latinist => 'lætinist
Latinity => lә'tiniti
Latinization => .lætinai'zeiʃәn
Latinize => 'lætinaiz
Latino => læ'ti:nәu, lә-
latitude => 'lætitju:d
latitudinal => .læti'tju:dinәl
latitudinally => ,læti'tju:dinəl
latitudinarian => ,læti,tju:di'neәriәn
latitudinarianism => ,lætitju:di'neәriәnizәm
Latium => 'leiʃiəm
latke => 'lɑ:tki
Latona => lә'tәjnә
latria => lә'traiә
latrine => lә'tri:n
latrines => ləˈtri:nz
lats => læts
latte => ˈlɑ:teɪ
latten => 'lætn
latter => 'lætә
latterly => 'lætәli
lattice => 'lætis
lattice window => ˈlætɪs ˈwindəu
latticed => 'lætist
lattices => ˈlætɪsiz
latticework => 'lætiswә:k
latticinio => ,læti'tʃi:njәu
Latvia => 'lætviә
Latvian => 'lætviәn
laud => lɒ:d
laudability => .lɒ:dә'biliti
laudable => 'lɒ:dәbl
laudably => 'lɒ:dәbli
laudanum => 'lɒ:dәnәm
laudation => lɒ:'deiʃәn
laudatory => 'lɒ:dәtәri
lauded => lɔ:did
lauding => lɔ:dɪŋ
lauds => lɔ:dz
laugh => lɑ:f
laughable => 'lɑ:fәbl
laughably => 'lɑ:fәbli
laughed => 'lɑ:ft
laugher => 'lɑ:fә(r);'læf-
laughing => 'lɑ:fiŋ
laughing jackass => ˈlæfɪŋ ˈdʒækæs
laughing stock => ˈlæfɪŋ stɔk
laughingly => ˈlɑ:fɪŋli
laughingstock => 'lɑ:fiŋstɒk
laughs => lɑ:fs
laughter => 'lɑ:ftә
Laughton => 'lɔ:tn
launce => lɔ:ns, lәns, lɑ:ns
launch => lɒ:ntʃ
launched => lɔ:ntʃt
launcher => 'lɒ:ntʃә
launchers => 'lɔːn(t)ʃə
launching => 'lɔ:ntʃiŋ, 'lɑ:ntʃiŋ
launder => 'lɒ:ndә
laundered => ˈlɔ:ndəd
launderette => .lɒ:ndә'ret
launderettes => ,lɔ:ndə'ret, ,lɑ:n-
laundering => 'lɔ:ndәriŋ. 'lɑ:n-
launders => ˈlɔ:ndəz
laundress => 'lɒ:ndris
laundrette => 'lɔ:ndret
laundries => ˈlɔ:ndriz
laundromat => 'lɑ:ndrә,mæt, lɔ:n-
laundry => 'lɒ:ndri
laundry basket => ˈlɔ:ndri ˈbɑ:skit
laundry list => ˈlɔ:ndri list
laundryman => 'lɔ:ndrimәn,'lɑ:n-
laura => 'lɔ:rә
Laurasia => lɔ:'reiʒә, -ʃә
laureate => 'lɒ:riәt
laureateship => 'lɔ:riәt-ʃip
laurel => 'lɒ:rәl
laurence => 'lɔrәns
laurent => 'lɔrәnt
laurie => 'lɔ(:)ri
laurustinus => ,lɔrәs'tainәs
Lausanne => lәu'zæn
Lautrec => lәj'trek
lav => læv
lava => 'lɑ:vә
lava lamp => ˈlɑ:və læmp
lavabo => lә'veibәu
lavage => lә'vɑ:ʒ, 'lævidʒ
Laval => lә'vɑ:l
lavation => lә'veiʃәn
lavatorial => lævә'tɔ:riәl
lavatories => ˈlævətəriz
lavatory => 'lævәtәri
lave => leiv
laved => leɪvd
lavender => 'lævindә
laver => 'leivә
Laverne => lә'v\\\\:n
laving => leɪvɪŋ
LAVINIA => lə'viniə
lavish => 'læviʃ
lavished => ˈlæviʃt
lavishes => ˈlæviʃiz
lavishing => ˈlæviʃɪŋ
lavishly => 'læviʃli
lavishness => 'lævɪʃnəs
Lavoisier => ,lɑ:vwә'zjei
law => lɒ:
law agent => lɔ: ˈeidʒənt
law lord => lɔ: lɔ:d
lawbreaker => 'lɒ:breikә
lawbreaking => 'lɒ:breikiŋ
lawcourt => 'lɒ:kɒ:t
lawful => 'lɒ:ful
lawfulness => 'lɔ:flnəs
lawgiver => 'lɒ:givә
lawks => lɔ:ks
lawless => 'lɒ:lis
lawlessly => 'lɔ:ləslɪ
lawlessness => 'lɔ:ləsnəs
lawmaker => lɒ:'meikә
lawmakers => ˈlɔ:meikəz
lawmaking => lɒ:'meikiŋ
lawman => 'lɔ:mәn
lawmen => 'lɔːmən
lawn => lɒ:n
lawn bowling => lɔ:n ˈbəuliŋ
lawn mower => lɔ:n ˈməʊə
lawn party => lɔ:n ˈpɑ:ti
lawn tennis => lɔ:n ˈtenis
lawns => 'lɔ:nz
lawny => 'lɒ:ni
lawrence => 'lɔrәns
lawrencium => lɒ'rensiәm
Lawson => 'lɔ:sn
lawsuit => 'lɒ:sju:t
Lawton => 'lɔ:tn
lawyer => 'lɒ:jә
lawyering => 'lɔ:jәriŋ
lawyerly => 'lɔ:jәli
lax => læks
laxative => 'læksәtiv
laxatives => 'læksətɪvz
laxity => 'læksәti
laxly => 'læksli
lay => lei
lay into => lei ˈɪntuː
lay reader => lei ˈri:də
lay-by => 'leibai
layabout => 'leiәbajt
layabouts => ˈleɪəˌbaʊts
Layamon => 'laiәmәn
Layard => leәd
layaway => ˈleɪəweɪ
layback => 'leɪbæk
layby => 'leɪbɑɪ
layer => 'leiә
layered => 'leiәd
layering => 'leiәriŋ
layette => lei'et
laying => 'leiiŋ
layman => 'leimәn
laymen => 'leimәn
layoff => 'leiɒf
layoffs => ˈleɪɔ:fs
layout => 'leiaut
layover => 'leiәuvә
laypeople => 'leɪpi:pl
layperson => 'leip\\\\:sәn
layshaft => 'leiʃæft
layup => 'leiʌp
laywoman => 'leiwumәn
lazar => 'læzә
lazarette => ,læzә'ret
lazaretto => ,læzә'retәu
Lazarist => 'læzәrist
lazarus => 'læzәrәs
laze => leiz
lazed => leɪzd
lazes => leɪziz
lazier => ˈleiziə
laziest => 'leɪzɪɪst
lazily => 'leizili
laziness => 'leizinis
lazing => leɪzɪŋ
Lazio => 'lɑ:tsiәj
lazuli => 'læzjulai
lazurite => 'læzju,rait
lazy => 'leizi
lazy eye => ˈleizi ai
lazy tongs => ˈleizi tɔ:ŋz
lbw => ˌel bi: ˈdʌblju:
Le Havre => lә'hɑ:vrә
lea => li:
leach => li:tʃ
leachate => 'li:tʃeit
leached => 'li:tʃt
leaches => li:tʃiz
leaching => 'li:tʃiŋ
Leacock => 'li:kɔk
lead => li:d. led
lead pencil => li:d ˈpensəl
lead shot => ˌled ˈʃɒt
lead-footed => 'led,futid
lead-in => 'li:d'in
lead-off => li:d ɔf
lead-up => 'li:dʌp
leaded => 'ledid
leaded light => ˈledid lait
leaden => 'ledn
Leadenhall => 'lednhɔ:l
leader => 'li:dә
leaderboard => 'li:dərbɔ:d
leadership => 'li:dәʃip
leaderships => ˈli:dəʃips
leading => 'li:diŋ
leading aircraftman => ˈli:diŋ ˈɛəˈkrɑ:ftmən
leading lady => ˈli:diŋ ˈleidi
leading man => ˈli:diŋ mæn
leading note => ˈli:diŋ nəut
leading rein => ˈli:diŋ rein
leading tone => 'li:diŋ
leading-edge => ˈli:dɪŋ
leadoff => 'li:dɒf
leadwort => 'led,wә:t
leaf => li:f
leaf beetle => li:f ˈbi:tl
leaf curl => li:f kə:l
leaf insect => li:f ˈinsekt
leaf miner => li:f ˈmaɪnə
leaf mould => li:f məuld
leaf roll => li:f rəul
leaf roller => li:f ˈrəulə
leaf spot => li:f spɔt
leaf trace => li:f treis
leaf-like => 'li:fl'aɪk
leafage => 'li:fidʒ
leafed => lift
leafhopper => 'li:f,hɔpә(r)
leafiness => 'li:finis
leafing => 'li:fiŋ
leafless => 'li:flis
leaflet => 'li:flit
leaflets => ˈli:flits
leafs => liːf
leafy => 'li:fi
league => li:g
league table => li:ɡ ˈteibl
leagued => 'li:ɡd
leaguer => 'li:gә
leagues => 'li:ɡz
leaguing => 'li:ɡɪŋ
Leah => liә
leak => li:k
leakage => 'li:kidʒ
leakages => 'li:kɪdʒɪz
Leakey => 'li:ki:
leakier => ˈli:ki:ə
leakiness => 'li:kinis
leaking => 'li:kiŋ
leakproof => 'li:kpru:f
leaky => 'li:ki
leal => li:l
lean => li:n
lean-burn => 'li:nb'ɜ:n
lean-to => 'li:ntu:
leander => li: 'ændә( r)
leaning => 'li:niŋ
leanness => 'li:nnis
leant => lent
leap => li:p
leap out => li:p aut
leap second => li:p ˈsekənd
leapfrog => 'li:pfrɒg
leapfrogged => ˈli:pˌfrɔɡd
leapfrogs => ˈli:pˌfrɔɡz
leaping => 'li:piŋ
leaps => li:ps
leapt => lept
Lear => liә
learn => lә:n
learnable => 'l\\\\:nәbl
learned => 'lә:nid
learner => 'lә:nә
learners => 'lɜ:nəz
learning => 'lә:niŋ
learning disability => ˈlə:niŋ ˌdisəˈbiliti
learns => lə:nz
leary => 'liәri
lease => li:s
leaseback => 'li:sbæk
leasehold => 'li:shәuld
leaseholder => 'li:shәuldә
leaseholders => ˈli:sˌhəʊldəz
leash => li:ʃ
leashed => liːʃ
leashes => li:ʃiz
leashing => liːʃ
leasing => 'li:siŋ
least => li:st
leastways => 'li:stweiz
leastwise => 'li:stwaiz
leat => li:t
leather => 'leðә
leather carp => ˈleðə kɑ:p
leather-bound => 'leðərb'aʊnd
leatherback => 'leðәbæk
leatherbound => leðər'baʊnd
leathered => 'leðə
leatherette => ,leðә'ret
leatherhead => 'leðәhed
leatheriness => ˊleðәrinis
leathering => 'leðәriŋ
leatherjacket => 'leðә,dʒækit
leatherleaf => 'leðәli:f
leathern => 'leðәn
leatherneck => 'leðәnek
leathers => ˈleðəz
leatherwood => 'leðәwjd
leathery => 'leðәri
leave => li:v
leaved => li:vd
leaven => 'levn
leavened => ˈlevənd
leavening => 'levniŋ
leavens => ˈlevənz
leaver => 'li:vә
leaves => li:vz
leaving => 'li:viŋ
leavings => 'li:viŋz
lebanese => ,lebә'ni:z
Lebanon => 'lebәnәn
lebensraum => 'leibәns,raum
lech => letʃ
lecher => 'letʃә
lecherous => 'letʃәrәs
lechers => ˈletʃəz
lechery => 'letʃәri
leching => 'letʃiŋ
lechwe => 'li:tʃwi
lecithin => 'lesiθin
lecithinase => 'lesiθi,neis
lectern => 'lektә:n
lecterns => ˈlektənz
lectin => 'lektin
lection => 'lekʃәn
lectionary => 'lekʃәnәri
lector => 'lektә
lectrice => lekˈtri:s
lecture => 'lektʃә
lectured => ˈlektʃəd
lecturer => 'lektʃәrә
lecturers => ˈlektʃəəz
lectures => ˈlektʃəz
lectureship => 'letʃәʃip
lecturing => ˈlektʃərɪŋ
lecythus => 'lesiθәs
led => led
lederhosen => 'leidә,hәuzәn
ledge => ledʒ
ledger => 'ledʒә
ledger line => ˈledʒə lain
ledgers => ˈledʒəz
ledges => ledʒz
ledgy => 'ledʒi
lee => li:
lee shore => li: ʃɔ:
lee side => li: said
leeboard => 'li:bɒ:d
leech => li:tʃ
leechcraft => 'li:tʃkrɑ:ft;-kræft
leeds => li:dz
leek => li:k
leeks => li:ks
leer => liә
leeriness => ˊliәrinis
leering => lɪərɪŋ
leeringly => 'liәriŋli
leery => 'liәri
lees => li:z
leet => li:t
leeward => 'li:wә:d
leeway => 'li:wei
left => left
left field => left fi:ld
left fielder => left ˈfi:ldə
left luggage => left ˈlʌɡidʒ
left-footed => 'left,fjtid
left-handed => 'left'hændid
left-handedness => left 'hændɪdnɪs
left-handers => 'lefth'ændəz
left-leaning => 'left,li:niŋ
left-of-centre => left ɔv ˈsentə
left-wing => 'leftwiŋ
left-winger => 'left'wiŋә(r)
leftfield => 'left,fiːld
leftie => 'leftai
lefties => ˈleftiz
leftish => 'leftɪʃ
leftism => 'leftizәm
leftist => 'leftist
leftists => 'leftɪsts
leftmost => 'leftmәust
leftover => 'leftәuvә
leftward => 'leftwәd
leftwards => 'leftwәdz
lefty => 'lefti
leg => leg
leg bye => leɡ baɪ
leg it => leɡ it
leg warmer => leɡ ˈwɔ:mə
leg-pull => 'le^pjl
leg-pulling => 'leɡp'ʊlɪŋ
leg-up => 'le^ʌp
legacies => ˈleɡəsiz
legacy => 'legәsi
legal => 'li:gәl
legal aid => ˈli:ɡəl eid
legal pad => ˈli:ɡəl pæd
legal-size => 'li:^әlsaiz
legalese => ,li:^ә'li:z
legalisation => ˌli:gəlaɪ'zeɪʃən
legalise => 'li:^әlaiz
legalised => 'li:ɡəlaiz
legalism => 'li:^әlizәm
legalist => 'li:^әlist
legalistic => .li:gә'listik
legality => li:'gæliti
legalization => .li:gәlai'zeiʃәn
legalize => 'li:gәlaiz
legalized => 'li:ɡәlaizd
legalizes => ˈli:gəˌlaɪziz
legalizing => ˈli:gəˌlaɪzɪŋ
legally => 'li:gәli
legate => li'geit
legatee => .legә'ti:
legates => liˈɡeits
legatine => 'legәtain
legation => li'geiʃәn
legations => lɪˈgeɪʃənz
legato => lә'ɡɑ:tәu
legator => li'geitә
legend => 'ledʒәnd
legendarily => ledʒənd'rɪlɪ
legendary => 'ledʒәndәri
legends => 'ledʒəndz
leger => 'ledʒә(r)
leger line => ˈledʒə laɪn
legerdemain => .ledʒәdә'mein
legged => 'le^id, le^d
legger => 'le^ә
legginess => 'leginis
legging => 'legiŋ
leggy => 'legi
leghorn => 'leghɒ:n
legibility => .ledʒi'biliti
legible => 'ledʒәbl
legibly => 'ledʒәbli
legion => 'li:dʒәn
legionaries => 'liːdʒ(ə)n(ə)rɪ
legionary => 'li:dʒәnәri
legioned => 'li:dʒənd
legionella => 'li:dʒənelə
legionnaire => li:dʒi'neә(r)
legionnaires => ,liːdʒə'neə
legions => ˈli:dʒənz
legislate => 'ledʒisleit
legislated => ˈledʒɪˌsleɪtid
legislates => ˈledʒɪˌsleɪts
legislating => ˈledʒɪˌsleɪtɪŋ
legislation => .ledʒis'leiʃәn
legislative => 'ledʒislәtiv
legislatively => 'ledʒɪslətɪvlɪ
legislator => 'ledʒisleitә
legislators => 'ledʒɪsleɪtəz
legislature => 'ledʒisleitʃә
legislatures => ˈledʒɪˌsleɪtʃəz
legit => l ә'dʒit
legitimacy => li'dʒitimәsi
legitimate => li'dʒitimәt
legitimated => liˈdʒitimitid
legitimates => liˈdʒitimits
legitimating => liˈdʒitimitɪŋ
legitimation => li.dʒiti'meiʃәn
legitimatize => li'dʒitimәtaiz
legitimise => li'dʒitimaiz
legitimism => li'dʒitimizm
legitimist => li'dʒitimist
legitimization => lɪdʒɪtɪmaɪ'zeɪʃn
legitimize => li'dʒitimaiz
legitimized => liˈdʒitimaizd
legitimizes => liˈdʒitimaiziz
legitimizing => liˈdʒitimaizɪŋ
legless => ˈlegləs
legless lizard => ˈleɡləs ˈlɪzəd
legman => 'legmæn
legroom => 'le^ru:m
legs => leɡz
legume => 'legju:m
legumes => 'leɡju:mz
leguminous => le'gju:minәs
legwork => 'le^w\\\\:k
Lehmann => 'leimәn
lehr => liә
lehua => l ei'hu:ɑ:
lei => 'leii:
leibnitz => 'laibnits
Leicester => 'lestә
Leicestershire => 'lestәʃә(r)
leiden => 'laidən
leigh => l i:
leila => 'li:lә,'lailә
Leinster => 'lenstә(r)
leipzig => 'laipzi^
leishmaniasis => ,liʃmә'naiәsis
leister => 'li:stә
leisure => 'li:ʒә
leisure centre => ˈleʒə ˈsentə
leisure suit => ˈleʒə sju:t
leisured => 'leʒәd; 'li:ʒәd
leisureliness => 'li:ʒәlinis
leisurely => 'li:ʒәli
leisurewear => ˈleʒəweə(r)
Leith => l i:θ
leitmotif => 'laitmәjti:f
leitmotiv => laɪt'məʊtɪv
lek => lek
lekker => 'lekә(r)
leland => 'li:lәnd
Leman => 'lemәn
Lemberg => 'lemberk
lemma => 'lemә
lemmatize => 'lemәtaiz
lemme => 'lemi
lemming => 'lemiŋ
lemmings => ˈlemiŋz
lemon => 'lemәn
lemon curd => ˈlemən kɜ:d
lemon drop => ˈlemən drɔp
lemon geranium => ˈlemən dʒiˈreinjəm
lemon grass => ˈlemən ɡrɑ:s
lemon sole => ˈlemən səul
lemon thyme => ˈlemən taim
lemon verbena => ˈlemən və:ˈbi:nə
lemon-squeezer => 'lemәn,skwi:zә(r)
lemonade => .lemә'neid
lemongrass => 'lemәn^rɑ:s;-^ræs
lemonwood => 'lemənwʊd
lemony => 'lemәni
lempira => lem'piәrә
lemur => 'li:mә
lemurs => ˈli:məz
lena => 'li:nә
lend => lend
lender => 'lendә
lenders => ˈlendəz
lending => 'lendiŋ
lending library => ˈlendiŋ ˈlaibrəri
lending rate => ˈlendiŋ reit
lends => lendz
length => leŋθ
lengthen => 'leŋθәn
lengthened => ˈleŋkθənd
lengthens => ˈleŋkθənz
lengthier => ˈleŋkθi:ə
lengthily => 'leŋθili
lengthiness => 'leŋθinis
lengthman => 'leŋkθmәn
lengths => leŋθs
lengthways => 'leŋθweiz
lengthwise => 'leŋθwaiz
lengthy => 'leŋθi
lenience => 'li:njәns.-si
leniency => 'li:njәnsi
lenient => 'li:njәnt
lenin => 'lenin
Leninakan => ,leninɑ:'kɑ:n
Leningrad => 'lenin^ræd, -^rɑ:d
Leninism => 'leninizm
Leninist => 'leninist
lenis => 'li:nis, 'lei-
lenition => l i'niʃәn
lenitive => 'lenitiv
lenity => 'leniti
Lennon => 'lennən
leno => 'li:nәu
lens => lenz
lens hood => lenz hud
lenses => 'lensiz
lensing => 'lenzɪŋ
lensman => 'lenzmәn
lent => lent
lenten => 'lentәn
lentic => 'lentik
lenticel => 'lentisәl
lenticular => len'tikjulә
lentiform nucleus => ˈlentiˌfɔ:m ˈnju:kliəs
lentigo => len'taigәu
lentil => 'lentil
lentils => ˈlentəlz
lentisk => 'lentisk
lentivirus => 'lentɪˌvaɪərəs
lento => 'lentәu
lentoid => 'lentɒid
Leo => 'li:ou
leon => 'li(:)әn
leonard => 'lenәd
Leonardo da Vinci => liәu'nɑ:dәudә'vintʃi
Leone => li:'әun
Leonid => 'li:әunid
leonine => 'li:әnain
Leonora => ,li(:)ә'nɔ:rә
Leonore => 'li:әnɔ:(r)
leopard => 'lepәd
leopard cat => ˈlepəd kæt
leopardess => 'lepәdis
leopards => ˈlepədz
leopold => 'li:әpәjld
leotard => 'li:әutɑ:d
leotards => 'li:ətɑ:d
Lepcha => 'leptʃә
leper => 'lepә
lepers => ˈlepəz
lepidocrocite => ,lepidәu'krәusait
lepidolite => li'pidә,lait, 'lepidә,lait
lepidoptera => ,lepi'dɔptәrә
lepidopteran => .lepi'dɒptәrәn
lepidopterist => .lepi'dɒptәrist
lepidopterous => .lepi'dɒptәrәs
leporine => 'lepәrain
leprechaun => 'leprәkɒ:n
lepromatous => lә'prɔmәtәs
leprosarium => .leprәu'sєәriәm
leprosy => 'leprәsi
leprous => 'leprәs
leptin => 'lepˌtɪn
lepto- => 'leptәj
leptocephalic => ,leptәusi'fælik
leptokurtic => ,leptәu'kә:tik
leptomeninges => 'leptɒmenɪŋz
lepton => 'leptɒn
leptonic => lep'tɔnik
leptospirosis => ,leptәuspai'rәusis
leptotene => 'leptәjti:n
Lepus => 'li:pәs
Leroy => 'lerɔi
les => lei
lesbian => 'lezbiәn
lesbianism => 'lezbiәnizəm
lesbo => 'lesbәj
lesbos => 'lezbɔs
lesion => 'li:ʒәn
lesions => 'li:ʒnz
leslie => 'lezli, 'lisli
Lesotho => li'su:tu:
less => les
less than => les ðæn
lessee => le'si:
lessen => 'lesn
lessened => 'lesnd
lessening => 'lesәniŋ
lessens => ˈlesənz
Lesseps => le'seps
lesser => 'lesә
lesser celandine => ˈlesə ˈseləndain
lesser panda => ˈlesə ˈpændə
lesser-known => 'lesərn'əʊn
LESSING => 'lesiŋ
lesson => 'lesn
lessons => ˈlesənz
lessor => le'sɒ:
lessors => leˈsɔ:z
lest => lest
lester => 'lestә
let => let
let drive => let draiv
let on => let ɔn
let rip => let rip
let the cat out of the bag => let ðə kæt aut ɔv ðə bæɡ
let's => lets
let-down => let daun
let-off => 'letɔf
let-up => let ʌp
letch => letʃ
letdown => 'letdaun
lethal => 'li:θәl
lethality => li'θæliti
lethally => 'li:θəli
lethargic => le'θɑ:dʒik
lethargy => 'leθәdʒi
Lethe => 'li:θi
Lett => let
letter => 'letә
letter box => ˈletə bɔks
letter of marque => ˈletə ɔv mɑ:k
letter-perfect => ,letә'p\\\\:fikt
letterboxes => ˈletəˌbɔksiz
lettered => 'letәd
letterform => 'letәfɔ:m
letterhead => 'letәhed
letterheads => ˈletəhedz
lettering => 'letәriŋ
letterman => 'letәmæn
letterpress => 'letәpres
letterset => 'letәset
letting => 'letiŋ
Lettish => 'letiʃ
lettuce => 'letis
lettuces => 'letɪsɪz
letup => 'letʌp
leu => 'leiu:
leucine => 'lu:si:n
leucite => 'lu:sait
leuco- => 'lu:kәj
leucocyte => 'lu:kәsait
leucocytosis => ,lju:kәsai'tәusis
leucoderma => ,lju:kәu'dә:mә
leucoma => lu:'kәumә
leucopenia => ,lju:kә'pi:niә
leucoplast => 'lju:kәjplæst
leucorrhoea => ,lju:kә'ri:ә
leucosis => lju:'kәjsis
leucotomy => lju:'kɔtәmi
leukaemia => lu:'ki:miә
leukemia => lju:'ki:miә
leuko- => 'lju:kәj
leukocyte => 'lju:kәsait
leukocytosis => ,lju:kәsai'tәusis
lev => lef
Levallois => lә'vælwɑ:
levamisole => lә'væmisәjl
levant => li'vænt
levanted => lɪ'vænt
levanter => li'væntә
Levantine => 'levәntain
levanting => lɪ'vænt
levator => li'veitә
levee => 'levi
level => 'levl
leveler => 'levәlә
leveling => 'levәliŋ
leveller => 'levәlә
levelling => 'levәliŋ
levelly => ˈlevəli
levelness => levl'nes
lever => 'levә
leverage => 'levәridʒ
leveraged => ˈli:vəridʒd
leveraged buyout => ˈlevərɪdʒd, ˈli:vərɪdʒd
leverages => ˈli:vəridʒz
leveraging => ˈli:vəridʒɪŋ
levered => 'liːvə
leveret => 'levәrit
levi => 'li:vai
leviable => 'leviәbl
leviathan => li'vaiәθәn
leviathans => ləˈvaɪəθənz
levied => ˈli:vid
levies => ˈli:viz
levigate => 'levigeit
levigation => .levi'geiʃәn
levin => 'levin
levirate => 'levirit
levitate => 'leviteit
levitated => ˈlevɪˌteɪtid
levitates => ˈlevɪˌteɪts
levitating => 'levɪteɪtɪŋ
levitation => ,levi'teiʃәn
Levite => 'li:vait
Levitical => li'vitikәl
Leviticus => li'vitikәs
levity => 'levәti
levo- => 'li:vәj
levodopa => ,levәu'dәupә
levonorgestrel => 'levənɔ:dʒstrəl
levulose => 'levjulәus
levy => 'levi
levying => ˈli:viŋ
lew => lu:
lewd => lu:d
Lewes => 'lu(:)is
lewis => 'lu:is
Lewisham => 'lu（:）iʃəm
lewisite => 'lu:isait
lex => leks
Lexan => 'leksæn
lexeme => 'leksi:m
lexical => 'leksikl
lexically => 'leksikəli
lexicographer => .leksi'kɒgrәfә
lexicographic => ,leksikә'^ræfik
lexicographical => .leksikәu'græfikl
lexicography => .leksi'kɒgrәfi
lexicological => ,leksikəu'lɔdʒikəl
lexicology => .leksi'kɒlәdʒi
lexicon => 'leksikәn
lexicons => ˈleksɪˌkɔnz
lexigram => 'leksi^ræm
lexington => 'leksiŋtәn
lexis => 'leksәs
ley => lei
Leyden => 'laidn
Leys => lei; li:
Leyton => 'leitən
lez => lez
lhasa => 'lɑ:sә
Lhasa apso => 'æpsəu
Li => li:
Li Po => 'li:'pəu
liability => laiә'biliti
liable => 'laiәbl
liaise => li'eiz
liaised => li:ˈeɪzd
liaises => li:ˈeɪziz
liaising => li:ˈeɪzɪŋ
liaison => li:'eizɒn
liaison officer => ˈli:eɪˌzɔn ˈɔfisə
Liam => liæm
liana => li'ɑ:nә
Liaoning => 'ljaj'niŋ
liar => 'laiә
liard => 'li:ɑ:d
liars => ˈlaɪəz
liatris => lai'ætris
lib => lib
Lib Dem => ,lib'dem
libation => lai'beiʃәn
libations => laɪˈbeɪʃənz
libber => 'libә
libby => 'libi
libeccio => li'betʃiәj
libel => 'laibәl
libelled => ˈlaɪbəld
libeller => 'laibәlә
libelling => ˈlaɪbəlɪŋ
libellous => 'laibәlәs
libelous => 'laibәlәs
libels => ˈlaɪbəlz
liber => 'laibә, 'li:beә
Liberace => 'li:bəreis
liberal => 'libәrәl
liberalisation => ,libərəlai'zeiʃən, -li'z-
liberalise => 'lɪbərəlaɪz
liberalism => 'libәrәlizm
liberalist => 'libәrәlist
liberalistic => .libәrә'listik
liberality => ,libә'ræliti
liberalization => .libәrәlai'zeiʃәn
liberalize => 'libәrәlaiz
liberalized => ˈlibərəlaizd
liberalizer => 'li'z-
liberalizes => ˈlibərəlaiziz
liberally => 'libәrәli
liberals => ˈlibərəlz
liberate => 'libәreit
liberates => ˈlibəreits
liberating => ˈlibəreitɪŋ
liberation => .libә'reiʃәn
liberation theology => ˌlɪbəˈreɪʃən θi:ˈɔlədʒi:
liberationist => ,libә'reiʃәnist
liberator => 'libәreitә
liberators => ˈlɪbəreɪtəz
liberatory => 'lɪbərətərɪ
Liberia => lai'biәriә
Liberian => lai'biәriәn
libero => lɪ'bɪərəʊ
libertarian => .libә'tєәriәn
libertarianism => ˌlɪbə'teərɪənɪzəm
libertarians => ˌlibəˈtɛəriənz
liberties => ˈlibətiz
libertinage => 'libәtinidʒ
libertine => 'libәti:n
libertines => ˈlɪbəˌti:nz
libertinism => 'libәtinizm
liberty => 'libәli
liberty cap => ˈlibəti kæp
libidinal => li'bidinәl
libidinous => li'bidinәs
libido => li'bi:dәu
libidos => lɪˈbi:dəʊz
libra => 'laibrә
Libran => 'laibrәn,'li:-
librarian => lai'brєәriәn
librarians => laɪb'reərɪənz
librarianship => lɪ'brɛərɪənʃɪp
library => 'laibrәri
library science => ˈlaibrəri ˈsaiəns
librate => lai'breit
librated => 'laɪbreɪt
librates => 'laɪbreɪt
librating => 'laɪbreɪt
libration => lai'breiʃәn
librettist => li'bretist
libretto => li'bretәu
librettos => lɪˈbretəʊz
Libreville => ,li:brә'vi:l
Libya => 'libiә
Libyan => 'libiәn
lice => lais
licence => 'laisns
licencee => ,laisәn'si:
licences => ˈlaisənsiz
licencing => 'laɪsnsɪŋ
license => 'laisns
license number => ˈlaisəns ˈnʌmbə
licensed => 'laisnst
licensed victualler => ˈlaɪsnst ˈvitlə
licensee => .laisn'si:
licensees => ˌlaisənˈsi:z
licenser => 'laisәnsә(r)
licensure => 'laisnʃuә
licentiate => lai'senʃiәt
licentious => lai'senʃәs
licentiously => laɪ'senʃəslɪ
licentiousness => laɪ'sɛnʃəsnɪs
lichee => 'li:,tʃi:
lichen => 'laikәn
lichened => 'laɪkend
lichenology => ,laikә'nɔlәdʒi
lichenous => 'laikinәs
LICHFIELD => 'litʃ,fi:ld
licht => likt
licit => 'lisit
lick => lik
licked => likt
lickerish => 'likәriʃ
lickety-split => 'likәti'split
licking => 'likiŋ
lickspittle => 'likspitl
licorice => 'likәris
lictor => 'liktә
lid => lid
lidar => 'laidɑ:
lidded => 'lidid
lidless => 'lidlis
lido => 'li:dәu
lidocaine => 'lidәjkein
lidos => ˈli:dəʊz
lie => lai
lie-down => 'laidajn
Liebfraumilch => 'li:bfrau,milk
Liebig => 'li:bi^
Liechtenstein => 'liktәn,stain
lied => li:t
lieder => 'li:dә(r)
lief => li:f
liege => li:dʒ
liegeman => 'li:dʒmæn
lien => 'li:әn
liens => li:nz
lierne => li:'ә:n
lieu => lu:
lieutenancy => lef'tenәnsi
lieutenant => lef'tenәnt
lieutenant colonel => lefˈtenənt ˈkə:nl
lieutenant commander => luˈtɛnənt kəˈmændɚ
lieutenant general => luˈtɛnənt ˈdʒɛnərəl
lieutenant governor => lefˈtenənt ˈɡʌvənə
lieutenants => lefˈtenənts
life => laif
life assurance => laif əˈʃuərəns
life coach => laif kəutʃ
life force => laif fɔ:s
life form => laif fɔ:m
life imprisonment => laif ɪmˈprɪznmənt
life peer => laif piə
life ring => laif riŋ
life scientist => laif ˈsaiəntist
life sentence => laif ˈsentəns
life story => laif ˈstɔ:ri
life support => laif səˈpɔ:t
life-and-death => 'laifәn'deθ
life-giving => 'laif,^iviŋ
life-size => 'laifsaiz
life-threatening => laɪf 'θretnɪŋ
lifebelt => ˈlaɪfbelt
lifeblood => 'laifblʌd
lifeboat => 'laifbәjt
lifeboatman => 'laif,bәjtmәn
lifeboats => ˈlaɪfbəʊts
lifebuoy => ˈlaɪfbɔɪ
lifebuoys => 'laifbɔi
lifeguard => 'laifgɑ:d
lifeguards => ˈlaɪfˌgɑ:dz
lifeless => 'laiflis
lifelessly => 'laiflisli
lifelessness => 'laiflisnis
lifelike => 'laiflaik
lifelikeness => 'laɪflaɪknəs
lifeline => 'laiflain
lifelines => ˈlaɪfˌlaɪnz
lifelong => 'laiflɒŋ
lifer => 'laifә
lifers => ˈlaifəz
lifesaver => 'laifseivә
lifesaving => 'laifseiviŋ
lifespan => 'laifspæn
lifespans => ˈlaɪfˌspænz
lifestyle => 'laifstail
lifetime => 'laiftaim
lifetimes => ˈlaifˌtaimz
lifework => 'laif'w\\\\:k
lift => lift
liftable => 'liftəbl
lifter => 'liftә
lifting => 'liftiŋ
liftoff => 'lɪftˌɒf
lig => li^
ligament => 'ligәmәnt
ligamental => ,li^ә'mentәl
ligamentary => ,li^ә'mentәri
ligamentous => ,li^ә'mentәs
ligaments => 'lɪɡəmənts
ligand => 'li^әnd, 'lai^әnd
ligase => li'^eis
ligate => lai'geit
ligated => ˈlaiɡeitid
ligates => ˈlaiɡeits
ligating => ˈlaiɡeitɪŋ
ligation => lai'geiʃәn
ligature => 'ligәtʃuә
liger => 'laigә
ligger => ˈlɪgə(r)
light => lait
light aircraft => lait ˈɛəkrɑ:ft
light ale => lait eɪl
light bulb => lait bʌlb
light curve => lait kə:v
light flyweight => lait ˈflaiweit
light heavyweight => lait ˈhevi:ˌweɪt
light middleweight => lait ˈmid(ə)lweit
light opera => lait ˈɔpərə
light pollution => lait pəˈluʃən
light reaction => lait riˈækʃən
light show => lait ʃəu
light table => lait ˈteibl
light welterweight => lait ˈweltəweit
light year => lait jə:
light-headedness => 'laɪth'edɪdnəs
light-heartedly => 'lait'ha:tidli
lighten => 'laitn
lightened => ˈlaɪtnd
lightening => 'laitniŋ
lightens => ˈlaɪtnz
lighter => 'laitә
lighterage => 'laitәridʒ
lighterman => 'laitәmәn
lightfast => 'laitfɑ:st
lightfastness => 'laɪtfɑ:stnəs
lighthearted => 'lait'hɑ:tid
lightheartedly => 'laɪthɑ:tɪdlɪ
lightheartedness => 'laɪt'hɑ:tɪdnɪs
lighthouse => 'laithaus
lighthouses => ˈlaɪtˌhaʊsiz
lighting => 'laitiŋ
lightish => 'laitiʃ
lightless => 'laitlis
lightly => 'laitli
lightness => 'laitnis
lightning => 'laitniŋ
lightning bug => ˈlaitniŋ bʌɡ
lightproof => 'laitpru:f
lights => laits
lightship => 'laitʃip
lightsome => 'laitsәm
lightsomeness => 'laɪtsəmnəs
lightweight => 'laitweit
lightweights => ˈlaɪtˌweɪts
lightwood => 'laitwud
ligneous => 'ligniәs
ligni- => 'li^ni
lignification => .lignifi'keiʃәn
lignified => 'lɪgnəˌfɑɪd
lignify => 'li^ni,fai
lignin => 'lignin
lignite => 'lignait
lignites => 'lɪgnaɪt
lignitic => li^'nitik
lignocaine => 'li^nә,kein
lignocellulose => ,li^nәu'selju,lәus
ligroin => 'li^rәuin
ligula => 'li^julә
ligular => 'li^julә
ligule => 'ligju:l
Liguria => li'^jjәriә
Ligurian => l'i^jjәriәn
likability => .laikә'biliti
likable => 'laikәbl
like => laik
like water => laik ˈwɔ:tə
likeable => 'laikәbl
likelihood => 'laiklihud
likeliness => 'laɪklaɪnəs
likely => 'laikli
liken => 'laikәn
likened => ˈlaɪkənd
likeness => 'laiknis
likening => ˈlaɪkənɪŋ
likens => ˈlaɪkənz
likewise => 'laikwaiz
liking => 'laikiŋ
Likud => li:'ku:d
likuta => li'ku:tɑ:
lil => lil
lilac => 'lailәk
lilacs => ˈlaɪləks
lilangeni => 'laɪlənɡəni:
liliaceous => .lili'eiʃәs
lilian => 'liliәn
lilied => 'lilid
lilies => ˈliliz
Lille => li:l
lillian => 'liliәn
lilliput => 'lilipʌt
Lilliputian => .lili'pju:ʃjәn
Lilongwe => 'lilɔ:ŋkwi
lilt => lilt
lilted => liltid
lilting => liltɪŋ
lilts => lilts
lily => 'lili
lily pad => ˈlili pæd
lily-trotter => 'lili,trɔtә(r)
lima => 'li:mә
limb => lim
Limba => 'limbә
limbed => limd
limber => 'limbә
limber pine => ˈlɪmbə pain
limbered => ˈlɪmbəd
limbering => ˈlɪmbərɪŋ
limberneck => 'limbәnek
limbers => 'limbәz
limbic => 'limbik
limbic system => ˈlɪmbɪk sɪstəm
limbless => 'limlis
limbo => 'limbәu
Limburg => 'limb\\\\:^
Limburger => 'limbә:gә
limbus => 'limbәs
lime => laim
lime green => laɪm ɡri:n
limeade => 'laimeid
limed => 'laɪmd
Limehouse => 'laimhajs
limekiln => 'laimkiln
limelight => 'laimlait
limen => 'laimen
limerick => 'limәrik
limericks => ˈlɪmərɪks
limes => 'laimi:z
limescale => ˈlaɪmskeɪl
limestone => 'laimstәun
limestones => ˈlaɪmˌstəʊnz
limewash => 'laimwɔʃ
limey => 'laimi
limeys => ˈlaimiz
liminal => 'liminl
liming => 'laimiŋ
limit => 'limit
limitary => 'limitәri
limitation => .limi'teiʃәn
limitative => 'limiteitiv
limited => 'limitid
limited edition => ˈlimitid iˈdiʃən
limiter => 'limitә
limiting => 'limitiŋ
limitless => 'limitlis
limitlessly => ˊlimitlisli
limitlessness => 'lɪmɪtləsnəs
limn => lim
limned => lɪmd
limner => 'limnә
limning => 'lɪmɪŋ
limnological => ,limnәj'lɔdʒikәl
limnologist => lim'nɔlәdʒist
limnology => lim'nɒlәdʒi
limns => lɪmz
limo => 'limәu
Limoges => li'mәuʒ
limonene => 'limә,ni:n
limonite => 'laimәnait
limonitic => ,laimә'nitik
limousine => 'limәzi:n
limousine liberal => ˈlimuzi:n ˈlibərəl
limousines => ˈlimuzi:nz
limp => limp
limped => limpt
limpet => 'limpit
limpets => ˈlimpits
limpid => 'limpid
limpidity => lim'piditi
limpidly => 'lɪmpɪdlɪ
limpkin => 'limpkin
limply => 'limpli
limpness => 'lɪmpnɪs
Limpopo => lim'pәjpәj
limps => limps
limulus => 'limjulәs
limy => 'laimi
linac => 'lainæk
linage => 'lainidʒ
linchpin => 'lintʃpin
linchpins => ˈlintʃpinz
Lincoln => 'liŋkәn
Lincolnshire => 'liŋkәnʃiә
linctus => 'liŋktәs
lindane => 'lindein
Lindbergh => 'lindbә:^
linden => 'lindәn
lindens => ˈlindənz
linds => lind
lindy => 'lindi
line => lain
line dancing => lain ˈdænsɪŋ
line drive => lain draiv
line manager => lain ˈmænidʒə
line of battle => lain ɔv ˈbætl
line of fire => lain ɔv ˈfaiə
line of flight => lain ɔv flait
line of march => lain ɔv mɑ:tʃ
line of scrimmage => lain ɔv ˈskrimidʒ
line of vision => lain ɔv ˈviʒən
line squall => lain skwɔ:l
line-out => ˈlaɪnˌaʊt
line-up => lain ʌp
line-ups => 'laɪn'ʌps
lineage => 'liniidʒ
lineages => ˈliniidʒz
lineal => 'liniәl
lineally => 'lɪnɪəlɪ
lineament => 'liniәmәnt
lineaments => ˈlɪniəmənts
linear => 'liniә
linear motor => ˈliniə ˈməutə
linear perspective => ˈliniə pəˈspektiv
linearity => .lini'ærәti
linearization => ,liniәrai'zeiʃәn;-ri'z-
linearize => 'liniәraiz
linearizing => 'liniәraiziŋ
linearly => 'liniәli
lineation => .lini'eiʃәn
linebacker => 'lainbækә
linebackers => ˈlainˌbækəz
linebacking => 'lain,bækiŋ
lined => laind
linefeed => 'lain,fi:d
lineman => 'lainmәn
linemen => 'laɪnmən
linen => 'linin
linenfold => 'lininfәjld
linens => ˈlininz
lineout => laɪ'nɪət
liner => 'lainә
liner note => ˈlainə nəut
lineside => 'lainsaid
linesman => 'lainzmәn
linesmen => 'lainzmən
lineup => 'lainʌp
ling => liŋ
Lingala => liŋ'^ɑ:lә
lingam => 'liŋ^әm
lingcod => 'liŋkɒd
linger => 'liŋgә
linger over => ˈliŋɡə ˈəuvə
lingered => ˈliŋɡəd
lingerie => ,lænʒә'ri:, 'læn-
lingering => 'liŋɡәriŋ
lingeringly => 'lɪŋɡərɪŋlɪ
lingers => ˈliŋɡəz
lingo => 'liŋgәu
lingonberry => 'liŋ^әn,bәri
lingua => 'liŋgwә
lingua franca => 'liŋ^wә 'fræŋkә
lingual => 'liŋgwәl
lingually => 'liŋ^wәli
linguine => 'liŋ^wi:ni:
linguini => 'lɪngwɪnɪ
linguist => liŋ'gwist
linguistic => liŋ'^wistik
linguistic competence => liŋˈɡwistik ˈkɔmpitəns
linguistic performance => liŋˈɡwistik pəˈfɔ:məns
linguistically => liŋ'gwistikəli
linguistician => ,liŋ^wis'tiʃәn
linguistics => liŋ'gwistiks
linguists => ˈlɪŋgwɪsts
lingulate => 'liŋgjuleit
linhay => 'lini
liniment => 'linimәnt
liniments => 'lɪnɪmənts
lining => 'lainiŋ
linish => 'lɪnɪʃ
link => liŋk
link-up => liŋk ʌp
linkage => 'liŋkidʒ
linkages => 'lɪŋkɪdʒɪz
linked => liŋkt
linker => 'liŋkә
linking => 'liŋkiŋ
linkman => 'liŋkmәn
links => liŋks
linksland => 'liŋkslænd
linkup => 'liŋkʌp
linkwork => 'liŋkwә:k
Linlithgow => 'lin'liθɡəu
linn => lin
Linnaean => li'ni:ən
Linnaeus => li'ni(:)әs
linnean => 'lɪni:n
linnet => 'linit
lino => 'lainәu
linocut => 'lainә,kʌt
linoleate => li'nәuli,eit
linolenate => ,linә'li:neit
linoleum => li'nәuliәm
linotype => 'lainәutaip
linsang => 'linsæŋ
linseed => 'linsi:d
linsey-woolsey => linzi'wjlzi
linstock => 'linstɒk
lint => lint
lintel => 'lintәl
lintels => 'lɪntlz
linter => 'lintә
linty => 'linti
liny => 'laini
Linz => lints
lion => 'laiәn
lion dance => ˈlaiən dɑ:ns
lion-hearted => 'laɪənh'ɑ:tɪd
lionel => 'laiәnl
lioness => 'laiәnis
lionesses => ˈlaiənisiz
lionfish => 'laiәn,fiʃ
lionhearted => 'laiәn'hɑ:tid
lionization => ,laiənai'zeiʃən; -ni'z-
lionize => 'laiәnaiz
lionized => ˈlaɪəˌnaɪzd
lionizer => 'laɪənaɪzər
lionizes => ˈlaɪəˌnaɪziz
lionizing => ˈlaɪəˌnaɪzɪŋ
lip => lip
lip balm => lip bɑ:m
lip gloss => lip glɔ:s
lip synch => 'lɪp .sɪŋk
lip-sync => ˈlɪp sɪŋk
lip-syncer => 'lipsiŋk
lip-synch => 'lɪps'ɪntʃ
lipase => 'laipeis
lipectomy => li'pektәmi
Lipetsk => 'li:pjetsk
lipid => 'lipid, 'laipid
lipidosis => ,lipi'dәusis
Lipizzaner => ,lipi'tsɑ:nә(r)
lipless => 'liplis
lipogenesis => ,lipәj'dʒenisis,,lai-
lipogram => 'lipә^ræm,'lai-
lipogrammatic => ,lipәj^rә'mætik,,lai-
lipoidosis => lipɔi'dәusis
lipolysis => li'pɔlisis
lipolytic => ,lipә'litik
lipoma => li'pәumә
lipophilic => .lipәu'filik
lipopolysaccharide => 'lipәj,pɔli'sækәraid,'lai-
lipoprotein => .lipә'prәuti:n
liposome => 'lipәjsәjm,'lai-
liposomes => lɪ'pʊsəʊmz
liposuction => ˈlɪpəʊsʌkʃn
lipotropin => ,lipәj'trәjpin,,lai-
lipped => lipt
Lippes loop => 'lipəs
Lippizaner => ,lipit'sɑ:nә(r)
lippy => 'lipi
lips => lips
lipsalve => 'lipsælv
lipstick => 'lipstik
lipsticked => 'lɪpstɪk
lipsticks => 'lɪpstɪks
lipton => 'liptәn
liquate => 'laikweit
liquefaction => .likwi'fækʃәn
liquefactive => ,likwi'fæktiv
liquefiable => 'likwifaiәbl
liquefied => 'lɪkwɪfaɪd
liquefier => 'likwi,faiә
liquefies => ˈlɪkwəˌfaɪz
liquefy => 'likwifai
liquescent => 'likwesnt
liqueur => li'kjuә
liqueurs => lɪˈkɜ:z
liquid => 'likwid
liquidambar => 'likwid,æmbә
liquidate => 'likwideit
liquidated => 'lɪkwɪdeɪtɪd
liquidates => ˈlɪkwɪˌdeɪts
liquidating => ˈlɪkwɪˌdeɪtɪŋ
liquidation => .likwi'deiʃәn
liquidations => lɪkwɪ'deɪʃ(ə)n
liquidator => 'likwideitә
liquidators => ˈlɪkwɪdeɪtəz
liquidise => 'likwidaiz
liquidity => li'kwiditi
liquidize => 'likwidaiz
liquidized => 'lɪkwɪdaɪzd
liquidizes => ˈlɪkwɪˌdaɪziz
liquidizing => ˈlɪkwɪˌdaɪzɪŋ
liquidly => 'likwidli
liquids => 'lɪkwɪdz
liquified => 'likwifai
liquifies => 'likwifai
liquify => 'likwifai
liquifying => 'likwifai
liquor => 'likә
liquorice => 'likәris
liquorish => 'likәriʃ
liquors => ˈlikəz
lira => 'liәrә
liras => 'lɪərəz
lire => ˈlɪərə
liriodendron => ,liriәj'dendrәn
liripipe => 'liripaip
lisa => 'li:zә, 'laizә
Lisbon => 'lizbәn
lisle => lail
lisp => lisp
lisped => lɪspt
lisping => 'lispiŋ
lisps => lɪsps
lissom => 'lisәm
lissome => 'lisәm
list => list
list system => list ˈsistəm
listed => 'listid
listel => 'listel
listen => 'lisn
listenable => 'lisәnәbl
listened => ˈlisnd
listener => 'lisnә
listenership => 'lisәnәʃip
listening => 'lisniŋ
listens => ˈlisnz
lister => 'listә
listing => 'listiŋ
listless => 'listlis
listlessly => 'lɪstləslɪ
lists => lists
Liszt => list
Lisztian => 'listiәn
lit => lit
lit up => lɪt ʌp
litanies => ˈlitəniz
litany => 'litәni
litchi => 'li:tʃi:
lite => lait
liter => 'li:tә
literacy => 'litәrәsi
literae humaniores => 'litәri:hju:,mæni'ɔ:ri:z
literal => 'litәrәl
literalism => 'litәrәlizm
literalist => 'litәrәlist
literalistic => 'litərə'listik
literality => lɪtə'rælɪtɪ
literalization => ,lɪtərəlɪ'zeʃən
literalize => 'litәrәlaiz
literally => 'litәrәli
literalness => 'litәrәlnis
literarily => 'litәrәrili
literariness => 'litәrәrinis
literary => 'litәrәri
literary critic => ˈlitərəri ˈkritik
literary criticism => ˈlitərəri ˈkritisizəm
literate => 'litәrit
literati => .litә'rɑ:ti:. 'rɑ:ti:. -'reitai
literatim => ,litә'reitim
literature => 'litәrәtʃә
lith => liθ
litharge => 'liθɑ:dʒ, li'θɑ:dʒ
lithe => laið
lithely => laɪðlɪ
lithesome => 'laiðsәm
lithia => 'liθiә
lithiasis => li'θaiәsis
lithic => 'liθik
lithification => ,liθifi'keiʃәn
lithify => 'liθifai
lithium => 'liθiәm
litho => 'laiθәj
litho- => 'liθәj
lithograph => 'liθәugræf
lithographed => 'lɪθəgrɑːf; 'laɪ-
lithographer => li'θɒgrәfә
lithographic => .liθә'græfik
lithographing => 'lɪθəgrɑːf; 'laɪ-
lithographs => ˈliθəɡrɑ:fs
lithography => li'θɒgrәfi
lithologic => laɪ'θəʊlɒdʒɪk
lithological => laɪθəʊ'lɒdʒɪkl
lithologies => lɪ'θɒlədʒɪ
lithology => li'θɒlәdʒi
lithophane => 'liθәfein
lithophyte => 'liθәfait
lithopone => 'liθәupәun
lithosol => 'liθәjsɔl
lithosphere => 'liθәu.sfiә
lithotomist => li'θɔtәmist
lithotomy => li'θɒtәmi
lithotripter => 'laɪθəʊtrɪptɜ:
lithotrite => 'liθәjtrait
lithotrity => li'θɔtriti
lithuania => ,liθju(:)'einjә, -niә
Lithuanian => .liθju:'einiәn
lithuanians => ˌliθju(:)ˈeiniənz
litigant => 'litigәnt
litigants => 'lɪtɪɡənts
litigate => 'litigeit
litigated => ˈlitiɡeitid
litigates => ˈlitiɡeits
litigating => 'lɪtɪɡeɪtɪŋ
litigation => .liti'geiʃәn
litigator => 'lɪtɪgeɪtə
litigious => li'tidʒәs
litigiousness => lɪ'tɪdʒəsnəs
litmus => 'litmәs
litotes => 'laitәuti:z
litre => li:tә(r)
litres => ˈli:təz
litter => 'litә
litterateur => lɪtəræt'jʊər
litterbug => 'litәbʌg
litterbugs => 'lɪtəbʌg
littered => ˈlitəd
littermate => 'litәmeit
litters => ˈlitəz
little => 'litl
little finger => ˈlitl ˈfiŋɡə
little man => ˈlitl mæn
little people => ˈlitl ˈpi:pl
little theatre => ˈlitl ˈθiətə
little toe => ˈlitl təu
littleness => 'litlnis
Littler => 'lɪt(ə)l
littleton => 'litltәn
littoral => 'litәrәl
liturgical => li'tә:dʒikl
liturgics => li't\\\\:dʒiks
liturgies => ˈlɪtədʒi:z
liturgiologist => li,t\\\\:dʒi'ɔlәdʒist
liturgiology => li,t\\\\:dʒi'ɔlәdʒi
liturgist => 'litәdʒist
liturgy => 'litәdʒi
livability => ,livә'biliti
livable => 'livәbl
live => liv.laiv
live action => ˌlaɪv ˈækʃn
live bait => liv beit
live for => liv fɔ:
live oak => liv əuk
live rough => liv rʌf
live together => liv təˈɡeðə
live with => liv wið
live-in => ˈlɪv ɪn
liveability => ,livә'bilәti
liveable => 'livәb(ә)l
livebearer => 'laiv,beәrә(r)
lived => livd. 'laivd
liveliest => 'laɪvlɪɪst
livelihood => 'laivlihud
livelihoods => 'laɪvlɪhʊdz
livelily => 'laivlili
liveliness => 'laivlinis
livelong => 'livlɒŋ
lively => 'laivli
liven => 'laivәn
livened => ˈlaɪvənd
livening => ˈlaɪvənɪŋ
livens => ˈlaɪvənz
liver => 'livә
liver fluke => ˈlivə flu:k
liver sausage => ˈlivə ˈsɔsidʒ
liver spot => ˈlivə spɔt
liveried => 'livәrid
liverish => 'livәriʃ
Livermore => 'livə,mɔ:
Liverpool => 'livәpu:l
Liverpudlian => .livә'pʌdliәn
liverwort => 'livәwә:t
liverwurst => 'livәwә:st
livery => 'livәri
livery company => ˈlivəri ˈkʌmpəni
livery stable => ˈlivəri ˈsteibl
liveryman => 'livәrimәn
lives => laivz
livestock => 'laivstɒk
liveware => 'laivweә(r)
livid => 'livid
lividity => 'lividiti
living => 'liviŋ
living death => ˈliviŋ deθ
living fossil => ˈliviŋ ˈfɔsl
living rock => ˈliviŋ rɔk
living standard => ˈliviŋ ˈstændəd
living will => ˈliviŋ wil
livingston => 'liviŋstən
Livingstone => 'liviŋstәn
Livonia => li'vəuniə
livre => 'li:vә
lixiviate => lik'sivieit
lixiviation => lik,sivi'eiʃәn
LIZA => 'laizә
lizard => 'lizәd
lizards => ˈlɪzədz
lizzie => 'lizi
Ljubljana => 'lju:bljɑ:nɑ:
llama => 'lɑ:mә
llamas => ˈlɑ:məz
llanero => ljɑ:'neәrәj
llano => 'lɑ:nәu
llanos => ˈlɑ:nəuz
Llewellyn => lu(:)'welin
lloyd => lɔid
lo => lәu
lo-fi => 'lәufai
lo-res => ˌləʊ ˈrez
loach => lәutʃ
load => lәud
load-shedding => 'lәjd,ʃediŋ
loaded => 'lәudid
loader => 'lәudә
loading => 'lәudiŋ
loading dock => ˈləʊdɪŋ dɔk
loadmaster => 'lәjd,mɑ:stә(r);-mæstә(r)
loadstar => 'lәudstɑ:
loadstone => 'lәudstәun
loaf => lәuf
loaf sugar => ləuf ˈʃuɡə
loafer => 'lәufә
loafers => 'ləʊfəz
loam => lәum
loamy => 'lәumi
loan => lәun
loan collection => ləun kəˈlekʃən
loan shark => ləun ʃɑ:k
loanable => 'lәunәbl
loaned => ləund
loanee => lәu'ni:
loaner => 'lәunә
loaning => 'lәuniŋ
loanword => 'lәjnw\\\\:d
loath => lәuθ
loathe => lәuð
loathed => ləʊðd
loathes => ləʊðz
loathing => 'lәuðiŋ
loathsome => 'lәuðsәm
loathsomely => 'ləʊðsəmlɪ
loaves => lәjvz
lob => lɒb
lobar => 'lәubә
lobate => lәu'beit
lobation => lәu'beiʃәn
lobbed => lɔbd
lobbies => ˈlɔbiz
lobby => 'lɒbi
lobbyist => 'lɔbiist
lobbyists => ˈlɔbɪɪsts
lobe => lәub
lobectomy => lәu'bektәmi
lobed => lәubd
lobelia => lәu'bi:liә
lobes => ləʊbz
Lobito => lәu'bi:tәu
loblolly => 'lɒblɒli
lobo => 'lәubәu
lobola => 'lәubәlә
lobotomies => ləuˈbɔtəmiz
lobotomize => lәu'bɔtәmaiz
lobotomy => lәu'bɒtәmi
lobs => lɔbz
lobscouse => 'lɒbskaus
lobster => 'lɒbstә
lobster pot => ˈlɔbstə pɔt
lobster thermidor => ˌlɒbstə ˈθɜ:mɪdɔ:(r)
lobsterman => 'lɔbstәmәn
lobsters => ˈlɔbstəz
lobular => 'lɒbjulә
lobulate => 'lɔbjuleit
lobule => 'lɒbju:l
lobworm => 'lɔb,wә:m
local => 'lәukәl
local authority => ˈləukəl ɔ:ˈθɔriti
local colour => ˈləukəl ˈkʌlə
local time => ˈləukəl taim
locale => lәu'kɑ:l
localisation => ,ləukəlai'zeiʃən, -li'z-
localise => 'lәjkәlaiz
localised => 'ləʊkəlaɪzd
localism => 'lәukәlizm
localist => 'ləʊkəlɪst
localities => ləuˈkælitiz
locality => lәu'kæliti
localizable => 'lәukәlaizәbl
localization => .lәukәlai'zeiʃәn
localize => 'lәjkәlaiz
localizes => ˈləʊkəˌlaɪziz
localizing => ˈləʊkəˌlaɪzɪŋ
locally => 'lәukәli
Locarno => lәu'kɑ:nәu
locate => 'lәukeit
locater => lәu'keitә
locates => ləuˈkeits
locating => lәu'keitiŋ
location => lәu'keiʃәn
locational => lәu'keiʃәnәl
locative => 'lɒkәtiv
locator => lәu'keitә
loch => lɒk
lochan => 'lɔkәn
lochia => 'lәukiә, lɔ'kiә
lochs => lɔ’
loci => 'lәusai
lock => lɒk
lock-in => 'lɔkin
lock-keeper => lɔk ˈki:pə
lockage => 'lɔkidʒ
lockbox => 'lɔkbɔks
lockdown => 'lɔkdajn
locke => lɔk
Lockean => 'lɔkiәn
locked => lɔkt
locker => 'lɒkә
lockers => ˈlɔkəz
locket => 'lɔkit
lockets => ˈlɔkits
lockfast => 'lɔkfɑ:st;-fæst
lockhart => 'lɔkәt, 'lɔkhɑ:t
locking => 'lɔkiŋ
lockjaw => 'lɒkdʒɒ:
lockless => 'lɔklis
locknut => 'lɒknʌt
lockout => 'lɔkajt
locksmith => 'lɒksmiθ
lockstep => 'lɒkstep
lockup => 'lɒkʌp
locky => 'lɔki
Lockyer => 'lɔki
loco => 'lәukәu
locomotion => .lәukә'mәuʃәn
locomotive => .lәukә'mәutiv
locomotives => ləʊkə'məʊtɪvz
locomotor => .lәukә'mәutә
locomotory => ,lәjkә'mәjtəri
locoweed => 'lәukәuwi:d
locular => 'lɔkjulә
locule => 'lɔkju:l
loculus => 'lɒkjulәs
locum => 'lәukәm
locum tenency => 'ti:nәnsi
locum tenens => 'lәjkәm 'ti:nenz
locums => ˈləukəmz
locus => 'lәukәs
locus classicus => 'lәukәs'klæsikәs
locus standi => 'lәukәs 'stændai
locust => 'lәukәst
locusts => ˈləʊkəsts
locution => lәu'kju:ʃәn
locutionary => lәj'kju:ʃәnәri
locutions => lə'kjuːʃ(ə)n
lode => lәud
loden => 'lәudn
lodestar => 'lәudstɑ:
lodestone => 'lәudstәun
lodge => lɒdʒ
lodged => lɔdʒd
lodgement => 'lɔdʒmәnt
lodgepole => 'lɔdʒpəul
lodgepole pine => ˈlɔdʒˌpəʊl
lodger => 'lɔdʒә(r)
lodgers => ˈlɔdʒəz
lodging => 'lɒdʒiŋ
lodicule => 'lɔdi,kju:l
Lodz => lu:ʒ
Loe => lu:
loeb => lә:b
loess => 'lәuis
loessial => lәj'esiәl
loft => lɒft
lofted => lɔ:ftid
lofter => 'lɒftә
loftier => ˈlɔftiə
loftily => 'lɒftili
loftiness => 'lɒftinis
lofting => 'lɔftiŋ
lofts => lɔ:fts
loftsman => 'lɒftsmәn
lofty => 'lɒfti
log => lɒg
log line => lɔɡ lain
logan => 'lәu^әn
loganberries => ˈləuɡənbəriz
loganberry => 'lәugәnbәri
logarithm => 'lɒ:gәriðәm
logarithmic => .lɒ:gә'riðmik
logarithms => 'lɒgərɪθmz
logbook => 'lɒgbuk
loge => lәuʒ
logged => lɒgd
logger => 'lɒgә
loggerhead => 'lɔ^әhed
loggerheads => ˈlɒgəhedz
loggia => 'lɔdʒә, 'lɔdʒiә
loggias => ˈlɔdʒəz
logging => 'lɒgiŋ
logia => 'lɔ^iә
logic => 'lɒdʒik
logic bomb => ˈlɔdʒik bɔm
logical => 'lɒdʒikәl
logical empiricism => ˈlɔdʒikəl emˈpɪərɪˌsɪzəm
logical positivism => ˈlɔdʒikəl ˈpɔzitivizəm
logicality => .lɒdʒi'kæliti
logically => 'lɔdʒikәli
logician => lәu'dʒiʃәn
logicians => ləʊˈdʒɪʃənz
logicism => 'lɒdʒɪsɪzəm
logics => 'lɒdʒɪks
logie => 'lәuɡi
logion => 'lɒgiɒn
logistic => lәu'dʒistik
logistical => lə'dʒɪstɪkl
logistically => lɔ'dʒistikəli
logistics => lәu'dʒistiks
logjam => 'lɒgdʒæm
logo => 'lәugәu
logocentric => ,lɔ^әj'sentrik;,lɔ:^-
logogram => 'lɒgәgræm
logograph => 'lɔ^әu^rɑ:f
logographic => ,lɔ^әj'^ræfik;,lɔ:^-
logomachy => lә'gɒmәki
logon => 'lәugәn
Logos => 'lɒgɒs
logotype => 'lɔ^әutaip
logout => 'lɔ^aut
logroll => 'lɒ:grәul
logroller => lɒɡ'rəʊlə
logrolling => 'lɒg.rәuliŋ
logwood => 'lɒgwud
logy => 'lәugi
Lohengrin => 'lәjin^rin
loiasis => lәu'aiәsis
loin => lɒin
loincloth => 'lɒinklɒθ
loincloths => ˈlɔinklɔθs
LOIRE => lwɑ:
lois => 'lәuis
loiter => 'lɒitә
loitered => ˈlɔɪtəd
loiters => ˈlɔɪtəz
lola => 'lәjlә
loll => lɒl
Lolland => 'lɔlәnd
lollapalooza => ,lɔlәpә'lu:zә
Lollard => 'lɔlәd
Lollardism => 'lɔlәdizәm
lolled => lɔld
lollies => ˈlɔli:z
lolling => lɔlɪŋ
lollipop => 'lɒlipɒp
lollipop lady => ˈlɔli:ˌpɔp ˈleidi
lollipop man => ˈlɔli:ˌpɔp mæn
lollipops => 'lɒlɪpɒps
lollop => 'lɒlәp
lolls => lɔlz
lolly => 'lɔli
lollygag => 'lɔli^æ^
lollypop => 'lɔlipɔp
Lomas => 'lәumɑ:s
lombard => 'lɔmbәd, 'lʌmbәd
Lombardic => lɒm'bɑ:dik
Lombardy => 'lɒmbәdi
Lombok => 'lɔmbɔk
loment => 'lәumәnt
London => 'lʌndәn
Londonderry => ,lʌndәn'deri
Londoner => 'lʌndәnә
lone => lәun
lone hand => ləʊn hænd
loneliness => 'lәunlinis
lonely => 'lәunli
lonely hearts => ˈləʊnli:ˌhɑ:ts
loner => 'lәunә
loners => 'ləʊnərz
lonesome => 'lәunsәm
long => lɒŋ
long division => lɔŋ diˈviʒən
long jump => lɔŋ dʒʌmp
long jumper => lɔŋ ˈdʒʌmpə
long sight => lɔŋ sait
long-dated => 'lɔŋ,deitid;'lɔ:ŋ-
long-day => 'lɒŋd'eɪ
long-faced => lɒŋ feɪst
long-headed => 'lɒŋh'edɪd
long-horned grasshopper => lɔŋ hɔrnd ˈɡræsˌhɑpɚ
long-life => lɔŋ laif
long-lost => lɔŋ lɔ:st
long-player => 'lɔŋ'pler
long-running => lɔŋ ˈrʌnɪŋ
long-sighted => 'lɔŋ'saitid;'lɔ:ŋ-
long-standing => 'lɔŋstædiŋ
long-suffering => 'lɔŋ'sʌfəriŋ;'lɔ:ŋ-
long-time => lɒŋ taɪm
long-waisted => 'lɔŋ'weistid
long-winded => 'lɔŋ'windid;'lɔ:ŋ-
longan => 'lɒngәn
longbeard => lɒŋ'bɪəd
longbill => 'lɒŋbil
longboat => 'lɒŋbәut
longbow => 'lɒŋbәu
longbows => 'lɒŋbəʊ
longe => 'lʌndʒ
longed => lɔŋd
longer => 'lɔŋɡә. 'lɔ:ŋ-
longeron => 'lɒndʒәrәn
longest => 'lɔŋɡist. 'lɔ:ŋ-
longevity => lɒn'dʒeviti
Longfellow => 'lɔŋfelәu
Longford => 'lɔ:ŋfəd
longhair => 'lɔŋheә(r);'lɔ:ŋ-
longhand => 'lɒŋhænd
longhorn => 'lɒŋhɒ:n
longhorns => 'lɒŋhɔːn
longicorn => 'lɔndʒikɔ:n
longing => 'lɒŋiŋ
longingly => 'lɒŋɪŋlɪ
longish => 'lɒŋiʃ
longitude => 'lɒndʒitju:d
longitudes => ˈlɔndʒitju:dz
longitudinal => .lɒndʒi'tju:dinәl
longitudinally => ˌlɒndʒɪ'tju:dɪnəlɪ
longleaf pine => ˈlɔ:ŋˌli:f, ˈlɔŋ-
longline => 'lɒŋlain
Longman => 'lɔŋmәn
longship => ˈlɒŋʃɪp
longshore => 'lɒŋʃɒ:
longshore drift => ˌlɒŋʃɔ: ˈdrɪft
longshoreman => 'lɒŋʃɒ:mәn
longspur => 'lɔŋsp\\\\:(r);'lɔ:ŋ-
longstanding => 'lɔŋ'stændiŋ;'lɔ:ŋ-
longstop => 'lɔŋstɔp;'lɔ:ŋ-
longsuffering => 'lɒŋsʌfərɪŋ
longtime => 'lɔŋtaim;'lɔ:ŋ-
longueur => lɔŋ'ɡә:r
longwall => 'lɔŋwɔ:l;'lɔ:ŋ-
longways => 'lɔŋweiz
longwise => 'lɔŋwaiz;'lɔ:ŋ-
lonicera => lәu'nisәrә
Lonsdale => 'lɔnzdeil
loo => lu:
looey => 'lu:i
loofah => 'lu:fә
loofahs => ˈlu:fəz
looing => luː
look => luk
look forward to => luk ˈfɔ:wəd tu:
look like => luk laik
look up to => luk ʌp tu:
look-in => 'luk,in
look-see => 'ljksi:
lookalike => ˈlʊkəlaɪk
looked => lʊkt
looker => 'lukә
looker-on => 'lukәr'ɔn
looking => 'lukiŋ
lookism => 'lʊkɪzəm
lookit => 'ljkit
lookout => 'lukaut
lookouts => ˈlʊkˌaʊts
lookup => 'ljkʌp
looky => 'ljki
loom => lu:m
loomed => lu:md
looming => 'lu:miŋ
looms => lu:mz
loon => lu:n
looney => 'lu:ni
loonie => ˈlu:ni
loonier => ˈlu:niə
loonies => ˈlu:niz
loony => 'lu:ni
loop => lu:p
looped => lu:pt
looper => 'lu:pә
loophole => 'lu:phәul
loopholed => 'luːphəʊl
loopholes => 'lu:phəʊlz
loopy => 'lu:pi
loose => lu:s
loose box => lu:s bɔks
loose cannon => lu:s ˈkænən
loose cover => lu:s ˈkʌvə
loose end => lu:s end
loose head => lu:s hed
loosed => lu:st
looseleaf => 'lu:sli:f
loosely => 'lu:sli
loosen => lu:sn
loosener => 'lu:snər
looseness => 'lu:snis
loosening => 'lu:snɪŋ
loosens => ˈlu:sənz
looses => lu:siz
loosestrife => 'lu:s,straif
loosey-goosey => 'lu:sɪɡ'u:sɪ
loosing => 'lu:siŋ
loot => lu:t
looted => lu:tid
looters => 'lu:təz
looting => lu:tɪŋ
loots => lu:ts
lop => lɒp
lope => lәup
loped => ləʊpt
lopes => ləʊps
lophodont => 'lәjfәdɔnt,'lɔ-
lophophorate => ,lәjfә'fɔ:rit,,lɔ-
lophophore => 'lәufә,fɔ:, lɔfә-
loping => 'lәupiŋ
lopolith => 'lɔpәliθ
lopped => lɔpt
lopper => 'lɒpə
lopping => 'lɒpɪŋ
loppy => 'lɒpi
lops => lɔps
lopsided => lɒp'saidid
lopsidedness => ˊlɒpˊsaididnis
loquacious => lәu'kweiʃәs
loquacity => lәu'kwæsiti
loquat => 'lәukwɒt
loquitur => 'lɔkwitә
lor => lɔ:
lorca => 'lɔ:kɑ:
lord => lɒ:d
lord it over => lɔ:d it ˈəuvə
lorded => 'lɔ:dɪd
lording => 'lɔ:dɪŋ
lordliness => 'lɒ:dlinis
lordling => 'lɒ:dliŋ
lordly => 'lɒ:dli
lordosis => lɒ:'dәusis
lordotic => lɔ:'dɔtik
lordship => 'lɒ:dʃip
lore => lɒ:
Lorelei => 'lɒ:rәlai
Lorenzo => lɔ'renzәu
loretta => lә'retә
lorgnette => lɔ:'njet
lorica => lә'raikә
loricate => 'lɔri,keit
Lorient => lɔ:r'jɑ:ŋ
lories => ˈlɔ:riz
lorikeet => 'lɔ:ri,ki:t
Lorimer => 'lɔ:rimә
loris => 'lәuris
lorn => lɒ:n
Lorna => 'lɔ:nә
lorraine => lɔ'rein
lorries => 'lɒrɪz
lorry => 'lɒri
lorryload => 'lɔrilәjd;'lɔ:-
lory => 'lɒ:ri
los => lɔ:s
Los Angeleno => lɔs,ændʒə'li:nəu
Los Angeles => lɔs'ændʒәlәs
lose => lu:z
losel => 'lәuzl, 'lu:-
loser => 'lu:zә
losers => ˈlu:zəz
loses => lu:ziz
losing => 'lu:ziŋ
loss => lɒs
loss adjuster => lɔs əˈdʒʌstə
loss-leader => lɔs ˈli:də
lossless => ˈlɒsləs
lossy => 'lɔsi;'lɔ:si
lost => lɒst
lost-and-found => 'lɒst'ændf'aʊnd
lot => lɒt
lota => 'lәutә
loth => lәuθ
Lothario => lәu'θɑ:riәu
Lothian => 'lәjðiәn
loti => 'ləʊtaɪ
lotic => 'lәutik
lotion => 'lәuʃәn
lotions => ˈləuʃənz
lots => lɔts
lotsa => 'lɔtsә
Lotta => 'lɔtә
lotteries => ˈlɔtəriz
lottery => 'lɒtәri
lottie => 'lɔti
lotto => 'lɒtәu
lotus => 'lәjtәs
lotus position => ˈləutəs pəˈziʃən
lotus-eaters => 'ləutəsi,i:tə
lou => lu:
Louangphrabang => 'lwɑ:ŋɡrɑ:'bɑ:ŋ
louche => lu:ʃ
loud => laud
louden => 'lajdәn
loudhailer => 'laud'heilә
loudhailers => 'laʊd'helɚ
loudly => 'laudli
loudmouth => 'lajdmajθ
loudmouths => 'laʊdmaʊθ
loudness => 'laudnis
loudspeaker => 'laud'spi:kә
loudspeakers => 'laʊdspi:kərz
lough => lɒk
louie => 'lu(:)i
louis => 'lu(:)i, 'lu(:)is
louisa => lu(:)'i:zә
louise => lu(:)'i:z
Louisiana => lu:.i:zi'ænә
louisville => 'lu(:)ivil
lounge => laundʒ
lounge bar => laundʒ bɑ:
lounge lizard => laundʒ ˈlɪzəd
lounge suit => laundʒ sju:t
lounger => 'laundʒә
lounges => laundʒz
loungewear => 'lajndʒweә(r)
loup => lu:, lu
loupe => lu:p
lour => lauә
Lourdes => luəd
loured => 'laʊə
louring => 'laʊə
loury => 'lauәri
louse => laus
lousewort => 'lajsw\\\\:t
lousily => 'laʊzɪlɪ
lousy => 'lauzi
lout => laut
loutish => 'lautiʃ
Louvain => 'lu:iε:ŋ
louvar => 'lu:vɑ:
louver => 'lu:vә(r)
louvered => 'lu:vәd
louvre => lu:vr, 'lu:vә
louvred => 'lu:vәd
louvres => 'lu:vəz
lovable => 'lʌvәbl
lovableness => 'lʌvəblnəs
lovage => 'lʌvidʒ
lovastatin => lʌ'vɑ:steɪtɪn
lovat => 'lʌvәt
love => lʌv
love apple => lʌv ˈæpl
love bite => lʌv bait
love match => lʌv mætʃ
love nest => lʌv nest
love-in => 'lʌvin
love-in-a-mist => 'lʌvinә'mist
love-in-idleness => 'lʌvin'aidlnis
love-lies-bleeding => 'lʌvlaiz'bli:diŋ
loveable => 'lʌvəbl
lovebird => 'lʌvbә:d
lovebirds => 'lʌvbɜ:dz
loved => lʌvd
lovelace => 'lʌvleis
loveless => 'lʌvlis
loveliness => 'lʌvlinis
lovell => 'lʌvәl
Lovelock => 'lʌvlɔk
lovelorn => 'lʌvlɒ:n
lovely => 'lʌvli
lovemaking => 'lʌvmeikiŋ
lover => 'lʌvә
loves => lʌvz
loveseat => 'lʌvsi:t
lovesick => 'lʌvsik
lovesickness => 'lʌvsiknis
lovesome => 'lʌvsәm
loveworthy => 'lʌv,w\\\\:ði
lovey => 'lʌvi
lovey-dovey => 'lʌvi'dʌvi
loving => 'lʌviŋ
loving cup => ˈlʌvɪŋ kʌp
lovingly => 'lʌviŋli
lovingness => 'lʌviŋnis
low => lәu
low beam => ləu bi:m
low life => ləu laif
low profile => ləu ˈprəufail
low relief => ləu riˈli:f
low-cal => ˈləʊˈkæl
low-class => ˈləʊˈklæs
low-cost => 'lәjkɔst
low-cut => ləu kʌt
low-density lipoprotein => lo ˈdɛnsɪti ˌlɪpoˈproˌtin
low-down => 'lәu,daun
low-end => 'lәjend
low-fat => ləu fæt
low-flying => 'ləʊfl'aɪɪŋ
low-impact => ləu ˈimpækt
low-loader => 'ləʊl'əʊdər
low-minded => 'lәj'maindid
low-paid => 'ləu'peid
low-rent => ləu rent
low-risk => ləu risk
low-slung => 'ləʊsl'ʌŋ
low-spirited => 'lәj'spiritid
low-tech => ləu tek
low-yield => 'ləu'ji:ld
lowan => 'lәjәn
lowball => 'lәjbɔ:l
lowborn => 'lәu'bɒ:n
lowboy => 'lәubɒi
lowbrow => 'lәubrau
lowdown => 'lәjdajn
lowell => 'lәuәl
lower => 'lәuә
lower chamber => ˈləuə ˈtʃeimbə
lower class => ˈləuə klɑ:s
lower court => ˈləuə kɔ:t
lower deck => ˈləuə dek
lower oneself => ˈləuə wʌnˈself
lower orders => ˈləuə ˈɔ:dəz
lowercase => 'lәuәkeis
lowering => 'lәuәriŋ
lowermost => 'lәuәmәust
lowest => 'lәuist
Lowestoft => 'lәjstɔft
lowing => 'lәuiŋ
lowish => 'lәuiʃ
lowland => 'lәulәnd
lowlander => 'lәulәndә
lowliest => 'ləʊlɪɪst
lowlife => 'lәulaif
lowlight => 'ləʊlaɪt
lowlily => 'ləʊlɪlɪ
lowliness => 'lәulinis
lowly => 'lәuli
Lowndes => laundz
lowness => 'ləʊnɪs
lowrider => 'ləʊraɪdə
lox => lɒks
loxodrome => 'lɔksәdrәum
loxodromic => ,lɔksә'drɔmik
loyal => 'lɒiәl
loyalism => 'lɒiәlizm
loyalist => 'lɒiәlist
loyally => 'lɒiәli
loyalties => ˈlɔiəltiz
loyalty => 'lɒiәlti
loyalty card => ˈlɔiəlti kɑ:d
lozenge => 'lɒzindʒ
LP => 'єәl'pi:
Ltd => 'limitid
Lualaba => ,lu:ɑ:'lɑ:bɑ:
Luanda => lu:'ɑ:ndә
Luang Prabang => 'luɑ:ŋ prɑ:'bɑ:ŋ
luau => lu:'au, 'lu:au
Luba => 'lu:bɑ:
lubber => 'lʌbә
lubber line => ˈlʌbə lain
lubberly => 'lʌbәli
lube => lu:b
lubra => 'lu:brә
lubricant => 'lu:brikәnt
lubricants => 'lu:brɪkənts
lubricate => 'lu:brikeit
lubricates => ˈlu:brikeits
lubricating => 'lu:brikeitiŋ
lubrication => ,lu:bri'keiʃәn
lubricator => 'lju:brikeitә
lubricious => lu:'briʃәs
lubricity => lu:'brisiti
Lubumbashi => ,lu:bu:m'bɑ:ʃi:
Lucan => 'lu'kən
lucas => 'lu:kәs
Lucca => 'lu:kkɑ:
luce => lu:s
lucency => 'lu:sәnsi
lucent => 'lju:sәnt
lucerne => lu:'sә:n
luces => 'lu:si:z
lucia => 'lu:sjә
lucian => 'lu:sjәn
lucid => 'lu:sid
lucidity => lu:'siditi
lucidly => 'lu:sɪdlɪ
lucifer => 'lu:sifә
luciferase => lu:'sifәreis
lucifugous => lu:'sifju^әs
lucille => lu:'si:l
Lucinda => lu:'sindә
lucite => 'lu:sait
lucius => 'lu:sjәs
luck => lʌk
luck out => lʌk aut
luckily => 'lʌkili
luckiness => 'lʌkinis
luckless => 'lʌklis
Lucknow => 'lʌknaj
lucky => 'lʌki
lucky dip => ˈlʌki dip
lucrative => 'lu:krәtiv
lucre => 'lu:kә
Lucretia => lu:'kri:ʃiә
Lucretius => lu:'kri:ʃiәs
lucubrate => 'lu:kju:breit
lucubrated => ˈlu:kjʊˌbreɪtid
lucubrating => ˈlu:kjʊˌbreɪtɪŋ
lucubration => ,lju:kju(:)'breiʃәn
lucubrator => 'lju:kju(:),breitә
luculent => 'lu:kjulәnt
lucy => 'lu:si
lud => lʌd
Luddism => 'lʌdizm
Luddite => 'lʌdait
Ludditism => 'lʌdә,tizәm
luderick => 'lu:dәrik
Ludhiana => ,ludi'ɑ:nɑ:
ludic => 'lu:dik
ludicrous => 'lu:dikrәs
ludicrously => 'lu:dɪkrəslɪ
ludicrousness => ˊljuːdikrәsnis
ludlow => 'lʌdlәj
ludo => 'lu:dәu
ludwig => 'lʌdwi^
Ludwigshafen => 'lu:tviʃs,hɑ:fәn
lues => 'lu:i:z
luetic => lu:'etik
luff => lʌf
luffed => lʌft
luffing => 'lʌfiŋ
luffs => lʌfs
Lufthansa => 'ljft,hænsә
Luftwaffe => 'luftvɑfә
lug => lʌg
Luganda => lu:'^ændә
Lugansk => lu:'^ɑ:nsk
luge => lu:ʒ
luger => 'lu:^ә
luggable => 'lʌɡəbl
luggage => 'lʌgidʒ
luggage rack => ˈlʌɡidʒ ræk
luggage van => ˈlʌɡidʒ væn
lugger => 'lʌgә
lugging => 'lʌɡɪŋ
lugs => lʌg
lugsail => 'lʌgseil
lugubrious => lu:'gju:briәs
lugubriously => lu:'gju:briəsli
lugworm => 'lʌ^,wә:m
Luik => lɔik,lu:k
luke => lu:k
lukewarm => 'lu:kwɒ:m
lull => lʌl
lullaby => 'lʌlәbai
Lully => 'lʌli
lulu => 'lu:lu:
lum => lʌm
lumbago => lʌm'beigәu
lumbar => 'lʌmbә
lumber => 'lʌmbә
lumberer => 'lʌmbәrә
lumbering => 'lʌmbәriŋ
lumberjack => 'lʌmbәdʒæk
lumberman => 'lʌmbәmәn
lumbermen => 'lʌmbəmən
lumbermill => 'lʌmbəmɪl
lumbersome => 'lʌmbәsәm
lumberyard => 'lʌmbәjɑ:d
lumen => 'lu:min
luminaire => ,lju:mi'neә
luminal => 'ljuminæl
luminance => 'lju:minәns
luminaria => ,lju:mi'neәriә
luminary => 'lu:minәri
luminesce => ,lju:mi'nes
luminesced => ˌlju:miˈnest
luminescence => .lu:mi'nesns
luminescent => .lu:mi'nesnt
luminescing => ˌlju:miˈnesɪŋ
luminiferous => .lu:mi'nifәrәs
luminist => 'lu:minist
luminol => 'lu:minɔl
luminosities => ˌluːmɪˈnɒsətiz
luminosity => .lu:mi'nɒsiti
luminous => 'lu:minәs
lumme => 'lʌmi
lummox => 'lʌmәks
lump => lʌmp
lumpectomy => ˌlʌmˈpektəmi
lumpen => 'lʌmpәn
lumpenproletariat => 'lʌmpәn,prәjli'teәriәt
lumper => 'lʌmpә
lumpfish => 'lʌmpfiʃ
lumpily => ˊlʌmpili
lumpiness => 'lʌmpɪnəs
lumping => 'lʌmpiŋ
lumpish => 'lʌmpiʃ
lumps => lʌmps
lumpsucker => 'lʌmp,sʌkә
lumpy => 'lʌmpi
luna => 'lu:nә
luna moth => ˈlju:nə mɔθ
lunacies => ˈlu:nəsi:z
lunacy => 'lu:nәsi
lunar => 'lu:nә
lunar cycle => ˈlju:nə ˈsaikl
lunar day => ˈlju:nə dei
lunar month => ˈlju:nə mʌnθ
lunar year => ˈlju:nə jə:
lunate => 'lu:neit
lunatic => 'lu:nәtik
lunation => lu:'neiʃәn
lunch => lʌntʃ
lunch box => lʌntʃ bɔks
lunch hour => lʌntʃ ˈauə
lunchbox => 'lʌntʃ,bɔks
luncheon => 'lʌntʃәn
luncheon meat => ˈlʌntʃən mi:t
luncheon voucher => ˈlʌntʃən ˈvaʊtʃə
luncheonette => .lʌntʃә'net
luncheons => ˈlʌntʃənz
lunches => lʌntʃiz
lunchroom => 'lʌntʃrum
lunchtime => 'lʌntʃtaim
lune => lu:n
lunette => lu:'net
lung => lʌŋ
lunge => lʌndʒ
lunged => lʌŋd
lunges => lʌn(d)ʒ
lungfish => 'lʌŋfiʃ
lungful => 'lʌŋfjl
lungi => 'luŋ^i
lungs => 'lʌŋz
lungworm => 'lʌŋwɜ:m
lunisolar => .lu:ni'sәulә
lunitidal => .lu:ni'taidәl
lunk => lʌŋk
lunker => 'lʌŋkә
lunkhead => 'lʌŋkhed
lunula => 'lju:njulә
lunular => - lә(r)
lunulate => 'lu:njuleit
lunule => 'lu:nju:l
Luoyang => 'ljә'jɑ:ŋ
Lupercalia => lju:pә'keiliә, -'kæljә
Lupercalian => lju:pə'keiliən
lupin => 'lu:pin
lupine => 'lu:pain
lupous => 'lu:pәs
lupulin => 'lju:pjulin
lupus => 'lu:pәs
lurch => lә:tʃ
lurched => lɜːtʃ
lurcher => 'lә:tʃә
lurches => lɜːtʃ
lurching => 'lә:tʃiŋ
lurdan => 'lɜ:dæn
lure => luә
lurex => 'luәreks
lurgy => ˈlɜ:gi
lurid => 'luәrid
luridly => 'ljuəridli
lurk => lә:k
lurker => 'lә:kә
lurking => 'l\\\\:kiŋ
lurve => lɜ:v
lusaka => lu:'sɑ:kә
Lusatian => lu:'seiʃiәn
luscious => 'lʌʃәs
lush => lʌʃ
lushly => lʌʃli
Lusitania => lu:si'teiniә
lust => lʌst
luster => 'lʌstә
lusterless => 'lʌstəlɪs
lusterware => 'lʌstәwєә
lustful => 'lʌstful
lustily => 'lʌstili
lustiness => 'lʌstinis
lustra => 'lʌstrә
lustral => 'lʌstrәl
lustrate => 'lʌstreit
lustrated => ˈlʌstreitid
lustrating => ˈlʌstreitɪŋ
lustration => lʌs'treiʃәn
lustre => 'lʌstә(r)
lustred => 'lʌstə
lustreless => 'lʌstәlis
lustreware => 'lʌstәweә(r)
lustring => 'lʌstriŋ
lustrous => 'lʌstrәs
lustrously => ˊlʌstrәsli
lustrum => 'lʌstrәm
lusty => 'lʌsti
lusus naturae => 'lju:sәsnә'tjuәri:
lutanist => 'lu:tәnist
lutchet => 'lu:tʃit
lute => lu:t
luteal => 'lu:tiәl
lutein => 'lu:tiin
lutenist => 'lu:tnist
luteo- => 'lu:ti:əʊ
luteofulvous => ,lju:tiә'fʌlvәs
luteotrophic hormone => ˌlju:tiəuˈtrɔfik ˈhɔ:ˌməʊn
luteous => 'lu:tiәs
lutestring => 'lu:tistriŋ
lutetium => lu:'ti:ʃiәm
luther => 'lu:θә
Lutheran => 'lu:θәrәn
luthern => 'lu:θәn
luthier => 'lu:tiә
Luthuli => lu:'tu:li:
luting => 'lu:tiŋ
lutist => 'lu:tist
Luton => 'lu:tәn
Lutz => ljts
luv => lʌv
luvvy => ˈlʌvi
Luwian => 'lu:iәn
lux => lʌks
luxate => 'lʌkseit
luxated => ˈlʌkseitid
luxates => ˈlʌkseits
luxating => ˈlʌkseitɪŋ
luxation => lʌk'seiʃәn
luxe => luks. lʌks
luxembourg => 'luksәm,bә:^
Luxemburg => 'lʌksәmbә:g
luxuriance => lʌg'zjuәriәns
luxuriant => lʌg'zjuәriәnt
luxuriantly => lʌgˈʒʊəriəntli
luxuriate => lʌg'zjuәrieit
luxuriated => lʌg'ʒʊərɪeɪt; lʌg'zjʊə-; lʌk'sjʊə-
luxuriates => lʌg'ʒʊərɪeɪt; lʌg'zjʊə-; lʌk'sjʊə-
luxuriating => lʌg'ʒʊərɪeɪt; lʌg'zjʊə-; lʌk'sjʊə-
luxuries => ˈlʌkʃəriz
luxurious => lʌg'zjuәriәs
luxuriousness => lʌgˊzjuәriәsnis
luxury => 'lʌkʃәri
Luzern => lu:'z\\\\:n,-'tseәrn
Luzon => lu:'zɒn
Lvov => lvɔ:f
lwei => lwei
Lyallpur => 'li:әpur
lyase => 'laiәs
lycanthrope => 'laikәnθrәup, lai'kænθrәup
lycanthropy => lai'kænθrәpi
lycee => 'li:seɪ
lyceum => lai'siәm
lychee => 'li:tʃi:
lychgate => ˈlɪtʃgeɪt
lychnis => 'liknis
Lycia => 'lisiә,'liʃiә
Lycian => 'lisiәn,'liʃiәn
lycopene => 'laikә,pi:n
lycopod => 'laikәpɔd
lycopodium => ,laikә'pәudiәm
Lycra => 'laikrә
Lycurgus => lai'k\\\\:^әs
lyddite => 'lidait
Lydgate => 'lid^eit
Lydia => 'lidiә
Lydian => 'lidiәn
lye => lai
Lyell => 'laiәl
lying => 'laiiŋ
lying-in => 'laiiŋ'in
lyingly => 'laɪɪŋlɪ
lyle => lail
Lyly => 'lili
Lyme => laim
lymph => limf
lymph gland => lɪmf ɡlænd
lymph node => lɪmf nəud
lymph- => limf
lymphadenitis => lim,fædi'naitis
lymphadenopathy => 'lim,fædәn'ɔpәθi
lymphangiogram => lim'fændʒiә^ræm
lymphangiographic => lim,fændʒiə'ɡræfik
lymphangiography => lim,fændʒi'ɔ^rәfi
lymphangitis => ,limfәn'dʒaitis
lymphatic => lim'fætik
lymphedema => ,limfi'di:mә
lympho- => 'limfәj
lymphoblast => 'limfәblɑ:st
lymphoblastic => ,limfәj'blæstik
lymphocyte => 'limfәsait
lymphocytes => 'lɪmfəsaɪts
lymphocytic => ,limfәj'sitik
lymphoid => 'limfɒid
lymphokine => 'limfәjkain
lymphoma => lim'fәumә
lymphoreticular => lɪmphə'retɪkjʊlə
lymphous => 'limfәs
lynch => lintʃ
lynch mob => lɪntʃ mɔb
lynched => lɪn(t)ʃ
lyncher => 'lintʃә
lynchet => 'lintʃit
lynchets => 'lintʃits
lynching => 'lintʃiŋ
lynchpin => 'lintʃpin
Lynd => lind
lynn => lin
lynx => liŋks
lynxes => lɪŋks
Lyon => 'laiәn
Lyonnais => liɔ:'ne
lyonnaise => .laiә'neiz
Lyons => 'laiәnz
lyophilic => ,laiә'filik
lyophilization => lai,ɔfilai'zeiʃәn;-li'z-
lyophilize => lai'ɔfilaiz
lyophilized => laiˈɔfilaizd
lyophilizes => laiˈɔfilaiziz
lyophilizing => l'jɒfɪlaɪzɪŋ
lyophobic => ,laiә'fɔbik
Lyra => 'laiәrә
lyrate => 'laiәreit
lyre => 'laiә
lyrebird => 'laiәbә:d
lyres => laɪə
lyric => 'lirik
lyrical => 'lirikәl
lyricism => 'lirisizm
lyricist => 'lirisist
lyricists => 'lɪrɪsɪst
lyrist => 'laiәrist
lysate => 'laiseit
lyse => lais
lysergic acid => lai's\\\\:dʒik 'æsid
lysimeter => lai'simitә
lysin => 'laisin
lysine => 'laisi:n
Lysippus => lai'sipәs
lysis => 'laisis
lysosome => 'laisәsәum
lysozyme => 'laisәzaim
lytic => 'litik
Lytton => 'litn