a => ei
a cappella => ˌæ kəˈpelə
a chip off the old block => ə tʃip ɔf ðə əuld blɔk
a fortiori => ei fɔ:ti'ɔ:rai
a priori => .eiprai'ɒ:rai
a tempo => ɑ: ˈtempəʊ
a touch => ə tʌtʃ
A-bomb => 'eibɔm
A-side => 'ei'said
AA => ɔ:
Aachen => 'ɑ:kәn
aah => ɑ:
Aalborg => 'ɔ:lbɔ:^
aardvark => 'ɑ:dvɑ:k
aardwolf => 'ɑ:dwulf
aargh => ɑ:
Aarhus => 'ɔ:hu:s
aaron => 'eәrәn
ab => æb
ab initio => .æbi'niʃiәu
ab ovo => .æb'әuvәu
aba => 'ɑ:bә
abaca => .æbә'kɑ:
aback => ә'bæk
abacus => 'æbәkәs
Abadan => æbә'dɑ:n
abaft => ә'bɑ:ft
Abakan => 'ɑ:,bɑ:'kɑ:n
abalone => æbә'lәuni
abandon => ә'bændәn
abandoned => ә'bændәnd
abandonment => ә'bændәmәnt
abandons => əˈbændənz
abas => 'ɑ:bәs
abase => ә'beis
abased => 'a:bəs
abasement => ә'beismәnt
abases => əˈbeɪsiz
abash => ә'bæʃ
abashed => ә'bæʃd
abashes => əˈbæʃiz
abashing => ə'bæʃ
abashment => ә'bæʃmәnt
abasing => 'a:bəs
abate => ә'beit
abated => ə'beɪt
abatement => ә'beitmәnt
abates => əˈbeɪts
abatis => 'æbәtis
abattoir => 'æbәtwɑ:
abattoirs => 'æbətwɑː
abaxial => æb'æksiәl
abaya => ә'beijә
abb => æb
Abba => 'æbә
abbacies => 'æbəsɪ
abbacy => 'æbәsi
Abbasid => ә'bæsid; 'æbәsid
abbatial => ә'beiʃәl
abbess => 'æbes
abbesses => ˈæbɪsiz
Abbeville => 'æbivil
Abbevillian => ,æbi'viliәn
abbey => 'æbi
abbeys => 'æbɪ
abbot => 'æbәt
abbots => ˈæbəts
abbotship => ˊæbәtʃip
Abbott => 'æbət
abbreviate => ә'bri:vieit
abbreviates => əˈbri:vi:ˌeɪts
abbreviating => ə'briːvɪeɪt
abbreviation => ә.bri:vi'eiʃәn
abbreviations => əbri:v'ɪeɪʃnz
abby => 'æbi
ABC => 'eibi:'si:
abdicate => 'æbdikeit
abdicated => 'æbdɪkeɪt
abdicates => ˈæbdɪˌkeɪts
abdicating => 'æbdɪkeɪt
abdication => .æbdi'keiʃәn
abdicator => 'æbdikeitә
abdomen => 'æbdәmen
abdomens => ˈæbdəmənz
abdominal => æb'dɒminәl
abdominals => æb'dɔminəlz
abdominoplasty => æb'dɔminə,plæsti
abducens nerve => æbˈdju:sənz nə:v
abduct => æb'dʌkt
abductee => ,æbdʌk'ti:
abducting => əb'dʌkt
abduction => æb'dʌkʃәn
abductions => əb'dʌkʃn
abductor => æb'dʌktә
abducts => æbˈdʌkts
Abdullah => ,æb'dʌlə
abe => eib
abeam => ә'bi:m
abecedarian => .eibi:si:'dєәriәn
abed => ә'bed
abel => 'eibәl
Abelard => 'æbə,la:d
abele => ә'bi:l
Abenaki => ,æbə'næki
Abeokuta => ,æbi:'әjkәtә
Abercrombie => 'æbəkrʌmbi
Aberdare => ,æbə'dεə
aberdeen => ,æbә'di:n
Aberdeenshire => ,æbә'di:nʃә(r)
Aberdonian => æbә'dәjniәn
Abernethy => 'æbәneθi
aberrance => æ'berәns
aberrant => æ'berәnt
aberration => æbә'reiʃәn
aberrations => æbə'reɪʃnz
Aberystwyth => ,æbə'ristwiθ
abet => ә'bet
abetment => ә'betmәnt
abetted => ə'bet
abetter => ә'betә
abetting => ə'bet
abeyance => ә'beiәns
abeyant => ә'beiәnt
abhor => әb'hɒ:
abhorred => əb'hɔː
abhorrence => әb'hɒrәns
abhorrent => әb'hɒrәnt
abhors => æbˈhɔ:z
abidance => ә'baidәns
abide => ә'baid
abide by => əˈbaid bai
abides => əˈbaidz
abiding => ә'baidiŋ
abidingly => ə'baidiŋli
abidjan => ,æbi'dʒɑ:n
abigail => 'æbigeil
ability => ә'biliti
Abingdon => 'æbiŋdən
abiogenesis => .eibaiәu'dʒenisis
abiogenic => eɪbaɪəʊd'ʒenɪk
abiotic => .eibai'ɒtik
abject => 'æbdʒekt
abjection => æb'dʒekʃәn
abjuration => .æbdʒuә'reiʃәn
abjure => әb'dʒuә
abjured => əb'dʒʊə; əb'dʒɔː
abjures => æbˈdʒʊəz
abjuring => əb'dʒʊə; əb'dʒɔː
Abkhazia => æb'keiʒə, -zi:ə, -'ka:-, a:b-
ablate => æb'leit
ablated => æbˈleitid
ablates => æbˈleits
ablation => æb'leiʃәn
ablative => 'æblәtiv
ablative absolute => ˈæblətiv ˈæbsəlju:t
ablaut => 'æblaut
ablaze => ә'bleiz
able => 'eibl
able seaman => ˈeibl ˈsi:mən
abled => 'eibld
ableism => ˈeɪblɪzəm
ablest => ˈeɪblɪst
abloom => ә'blu:m
ablution => ә'blu:ʃәn
ablutionary => əb'lu:ʃnəri
ably => 'eibli
ABM => ei bi:'em
Abnaki => әb'nɑ:ki
abnegate => 'æbnigeit
abnegated => 'æbnɪgeɪt
abnegates => ˈæbniɡeits
abnegating => 'æbnɪgeɪt
abnegation => .æbni'geiʃәn
abnormal => æb'nɒ:mәl
abnormalities => ,æbnɔ:'mælitiz
abnormality => .æbnɒ:'mæliti
ABO => 'æbәu
aboard => ә'bɒ:d
abode => ә'bәud
abodes => əˈbəʊdz
abolish => ә'bɒliʃ
abolishable => ә'bɒliʃәbl
abolisher => ә'bɒliʃә
abolishes => əˈbɔliʃiz
abolishing => ə'bɒlɪʃ
abolishment => ә'bɒliʃmәnt
abolition => .æbәu'liʃәn
abolitionism => .æbәu'liʃәnizәm
abolitionist => .æbәu'liʃәnist
abolitionists => ˌæbəˈlɪʃɵnɪsts
abomasum => ,æbә'meisәm
Abomey => ,æbə'mei; ə'bɔmi
abominable => ә'bɒminәbl
abominably => ә'bɒminәbli
abominate => ә'bɒmineit
abominated => ə'bɒmɪneɪt
abominates => əˈbɔməˌneɪts
abominating => ə'bɒmɪneɪt
abomination => ә.bɒmi'neiʃәn
abominations => əˌbɔməˈneɪʃənz
aboral => æ'bɔ:rәl
aborally => ə'bɔ:rəlɪ
aboriginal => .æbә'ridʒәnәl
aborigines => .æbә'ridʒini:z
aborning => ә'bɒ:niŋ
abort => ә'bɒ:t
aborted => ә'bɒ:tid
abortifacient => ә.bɒ:ti'feiʃәnt
abortion => ә'bɒ:ʃәn
abortionist => ә'bɒ:ʃәnist
abortions => ə'bɔ:ʃnz
abortive => ә'bɒ:tiv
abortively => ə'bɔ:tivli
aborts => əˈbɔ:ts
aboulia => ә'bu:liә
abound => ә'baund
abounded => ə'baʊnd
abounds => əˈbaundz
about => ә'baut
about time => əˈbaut taim
about to => əˈbaut tu:
about-face => әbajt'feis
about-faces => ə'baut,feis,ə,baut'feis
about-turn => әbajt't\\\\:n
above => ә'bʌv
above-mentioned => ә,bʌv'menʃәnd
abracadabra => .æbrәkә'dæbrә
abrade => ә'breid
abrades => əˈbreɪdz
abraham => 'eibrәhæm, -hәm
abram => 'eibrәm
abrasion => ә'breiʒәn
abrasions => əb'reɪʒnz
abrasive => ә'breisiv
abrasives => əb'reɪsɪvz
abrazo => ɑ:'brɑ:ðәu
abreact => .æbri'ækt
abreacted => æbriˈæktid
abreacting => æbriˈæktɪŋ
abreaction => .æbri'ækʃәn
abreacts => æbriˈækts
abreast => ә'brest
abridge => ә'bridʒ
abridgement => ә'bridʒmәnt
abridges => əˈbrɪdʒz
abridging => ə'brɪdʒ
abridgment => ә'bridʒmәnt
abroad => ә'brɒ:d
abrogate => 'æbrәgeit
abrogated => 'æbrəgeɪt
abrogates => ˈæbrəˌgeɪts
abrogating => 'æbrəgeɪt
abrogation => .æbrәu'geiʃәn
abrupt => ә'brʌpt
abruption => ә'brʌpʃәn
abruptly => ә'brʌptli
abruptness => ә'brʌptnis
Abruzzi => ə'bru:tsi
Absalom => 'æbsәlәm
abscess => 'æbsis
abscessed => 'æbsist
abscise => æb'sais
abscised => æbˈsaizd
abscises => æbˈsaiziz
abscising => æbˈsaizɪŋ
abscissa => æb'sisә
abscission => æb'siʒәn
abscond => әb'skɒnd
absconded => əb'skɒnd; æb-
absconding => əb'skɔndiŋ
absconds => æbˈskɔndz
abseil => 'ɑ:bzail
abseiled => ˈɑ:bzaild
abseiling => æb'si:lɪŋ
abseils => ˈɑ:bzailz
absence => 'æbsәns
absences => ˈæbsənsiz
absent => 'æbsәnt
absent-minded => 'æbsәnt'maindid
absented => 'æbs(ə)nt
absentee => .æbsәn'ti:
absenteeism => æbsәn'ti:iz(ә)m
absentees => ˌæbsənˈti:z
absenting => ˈæbsəntɪŋ
absently => 'æbsәntli
absents => ˈæbsənts
absinth => 'æbsinθ
absinthe => 'æbsinθ
absolute => 'æbsәlu:t
absolute pitch => ˈæbsəlju:t pitʃ
absolutely => 'æbsәlu:tli
absoluteness => 'æbsәlu:tnis
absolutes => ˈæbsəlju:ts
absolution => æbsә'lu:ʃәn
absolutism => 'æbsәlu:tizm
absolutist => 'æbsәlu:tist
absolutize => 'æbsәlu:taiz
absolve => әb'zɒlv
absolved => əb'zɒlv
absolves => əbˈzɔlvz
absolving => əb'zɒlv
absonant => 'æbsәnәnt
absorb => әb'sɒ:b
absorbability => әb.sɒ:bә'biliti
absorbable => әb'sɒ:bәbl
absorbance => әb'sɒ:bәns
absorbed => әb'sɒ:bd
absorbedly => әb'sɒ:bidli
absorbency => әb'sɒ:bәnsi
absorbent => әb'sɒ:bәnt
absorber => әb'sɔ:bә
absorbing => әb'sɒ:biŋ
absorbs => əbˈsɔ:bz
absorptiometer => әb,sɔ:pʃi'ɔmitә
absorptiometry => әb,sɔ:pʃi'ɔmitri
absorption => әb'sɒ:pʃәn
absorptive => әb'sɒ:ptiv
absquatulate => æb'skwɒtjuleit
absquatulation => æb,skwɔtjj'leiʃәn
abstain => әb'stein
abstained => əb'steɪn
abstainer => әb'steinә
abstains => əbˈsteinz
abstemious => æb'sti:mjәs
abstemiously => 'əbsti:mɪəslɪ
abstention => әb'stenʃәn
abstentionism => əb'stenʃənizəm
abstentions => æbˈstenʃənz
abstinence => 'æbstinәns
abstinent => 'æbstinәnt
abstract => 'æbstrækt
abstract art => ˈæbstrækt ɑ:t
abstract expressionism => ˈæbstrækt kˈspreʃəniz(ə)m
abstracted => æb'stræktid
abstraction => æb'strækʃәn
abstractionism => æb'strækʃәnizm
abstractionist => æb'strækʃәnist
abstractions => æbˈstrækʃənz
abstractly => æb'stræktli
abstracts => ˈæbstrækts
abstruse => æb'stru:s
abstruseness => æb'stru:siti
absurd => әb'sә:d
absurdism => әb'sә:dizәm
absurdist => әb'sә:dist
absurdities => əb'sɜːdɪtɪ
absurdity => әb'sә:diti
absurdly => әb'sә:dli
Abu Dhabi => 'æbu: 'ðæbi:
abubble => ə'bʌbl
Abuja => a:'bu:dʒa:
abulia => ә'bju:liә
abundance => ә'bʌndәns
abundant => ә'bʌndәnt
abundantly => ә'bʌndәntli
abuse => ә'bju:s.ә'bju:z
abusive => ә'bju:siv
abustle => ә'bʌsl
abut => ә'bʌt
abutilon => ә'bju:tilәn
abutment => ә'bʌtmәnt
abuts => əˈbʌts
abutted => ə'bʌt
abutter => ә'bʌtә
abutting => ә'bʌtiŋ
abuzz => ә'bʌz
abysm => ә'bizm
abysmal => ә'bizmәl
abysmally => ə'bɪzməlɪ
abyss => ә'bis
abyssal => ә'bisәl
abysses => əˈbɪsiz
Abyssinia => .æbi'sinjә
Abyssinian => .æbi'sinjәn
ac- => 'æk
acacia => ә'keiʃә
academe => ,ækә'di:m
academia => .ækә'di:miә
academic => .ækә'demik
academical => ,ækә'demikәl
academically => .ækә'demikәli
academicals => .ækә'demiklz
academician => ә.kædә'miʃәn
academicism => .ækә'demisizәm
academics => ækə'demɪks
academy => ә'kædәmi
Acadian => ә'keidiәn
acajou => 'ækәʒu:
acalculia => ,eikæl'kju:liә
acanthocephalan => ә,kanθә'sefәlәn
acanthus => ә'kænθәs
acapulco => ,ækә'pjlkәj
acaricide => ә'kæri,said
acarid => 'ækәrid
acarine => 'ækәrain
acaroid => 'ækәrɔid
acarology => ,ækә'rɔlәdʒi
Acas => 'eikæs
acatalectic => ә,kætә'lektik
accede => æk'si:d
acceded => ək'siːd
accedes => ækˈsi:dz
acceding => ək'siːd
accelerando => æk,selә'rændәu
accelerant => әk'selәrәnt
accelerate => әk'selәreit
accelerated => әk'selәreitid
accelerates => ækˈseləreits
accelerating => æk'selәreitiŋ
acceleration => әk.selә'reiʃәn
accelerations => ækˌseləˈreɪʃənz
accelerative => әk'selәrәtiv
accelerator => әk'selәreitә
accelerators => ək'seləreɪtəz
accelerometer => әk.selә'rɒmitә
accent => 'æksәnt
accented => ˈæksentɪd
accentor => æk'sentә
accents => ˈæksənts
accentual => æk'sentjuәl
accentuate => æk'sentjueit
accentuates => ækˈsentʃu:ˌeɪts
accentuation => æk.sentju'eiʃәn
accept => әk'sept
acceptability => әk.septә'biliti
acceptable => әk'septәbl
acceptably => әk'septәbli
acceptance => әk'septәns
acceptances => əkˈseptənsiz
acceptant => әk'septәnt
acceptation => .æksep'teiʃәn
accepted => әk'septid
accepter => әk'septә(r)
accepting => әk'septiŋ
acceptor => әk'septә
acceptors => ək'septə
access => 'ækses
access course => ˈækses kɔː(r)s
accessary => әk'sesәri
accesses => ˈæksesiz
accessibility => әk.sesә'biliti
accessible => әk'sesәbl
accessibly => әk'sesәbli
accession => æk'seʃәn
accessioned => ək'seʃ(ə)n
accessioning => ək'seʃ(ə)n
accessions => ækˈseʃənz
accessorial => .æksә'sɒ:riәl
accessorize => әk'sesәraiz
accessory => әk'sesәri
accessory nerve => ækˈsesəri nə:v
acciaccatura => ɑ:,tʃɑ:kɑ:'tjәrә
accidence => 'æksidәns
accident => 'æksidәnt
accident-prone => 'æksidәntprәjn
accidental => .æksi'dentl
accidentally => .æksi'dentli
accidently => .æksi'dentli
accidie => 'æksidi
accipiter => æk'sipitә
accipitrine => æk'sipitrain; -trin
acclaim => ә'kleim
acclaimed => ə'kleɪmd
acclaiming => əˈkleimɪŋ
acclaims => əˈkleimz
acclamation => .æklә'meiʃәn
acclimate => ә'klaimit
acclimated => 'æklɪmeɪt; ə'klaɪmət
acclimates => əˈklaimits
acclimating => 'æklɪmeɪt; ə'klaɪmət
acclimation => .æklai'meiʃәn
acclimatisation => ə,klaimətai'zeiʃən, -ti'z-
acclimatise => ә'klaimәtaiz
acclimatization => ә,klaimәtai'zeiʃәn
acclimatize => ә'klaimәtaiz
acclimatized => ə'klaimətaiz
acclimatizing => ə'klaimətaiz
acclivitous => ә'klivitәs
acclivity => ә'kliviti
accolade => .ækәu'leid
accolades => ˈækəˌleɪdz
accommodate => ә'kɒmәdeit
accommodates => əˈkɔmədeits
accommodating => ә'kɒmәdeitiŋ
accommodation => ә.kɒmә'deiʃәn
accommodationist => әkɒmә'deiʃәnist
accommodative => ә'kɒmәdeitiv
accompanies => əˈkʌmpəniz
accompaniment => ә'kʌmpәnimәnt
accompaniments => ə'kʌmpənɪmənts
accompanist => ә'kʌmpәnist
accompanists => əˈkʌmpənists
accompany => ә'kʌmpәni
accomplice => ә'kʌmplis
accomplices => əˈkɔmplisiz
accomplish => ә'kʌmpliʃ
accomplished => ә'kʌmpliʃt
accomplishes => əˈkɔmpliʃiz
accomplishment => ә'kʌmpliʃmәnt
accomplishments => ә'kʌmpliʃmәntz
accord => ә'kɒ:d
accordance => ә'kɒ:dәns
accordant => ә'kɒ:dәnt
accorded => ə'kɔːd
according => ә'kɒ:diŋ
according as => ә'kɔ:diŋ
accordingly => ә'kɒ:diŋli
accordion => ә'kɒ:djәn
accordionist => ә'kɒ:djәnist
accordions => əˈkɔ:di:ənz
accords => əˈkɔ:dz
accost => ә'kɒst
accosted => ə'kɒst
accosting => ə'kɒst
accosts => əˈkɔ:sts
accouchement => ɑ:'ku:ʃmɒŋ
accoucheur => ɑ:ku:'ʃә:
account => ә'kaunt
accountability => ә.kauntә'biliti
accountable => ә'kauntәbl
accountably => ә'kauntәbli
accountancy => ә'kauntәnsi
accountant => ә'kauntәnt
accounting => ә'kauntiŋ
accouterments => ә'ku:tәmәnts
accoutre => ә'ku:tә
accoutred => ə'kuːtə
accoutrement => ә'ku:tәmәnt
accoutrements => ә'ku:tәmәnts
accoutring => ə'kuːtə
Accra => ә'krɑ:
accredit => ә'kredit
accreditation => ә.kredi'teiʃәn
accredited => ә'kreditid
accredits => əˈkredɪts
accrete => æ'kri:t
accreted => æˈkri:tid
accretes => æˈkri:ts
accreting => æˈkri:tɪŋ
accretion => æ'kri:ʃәn
accretions => ək'ri:ʃnz
Accrington => 'ækriŋtən
accrual => ә'kru:әl
accruals => ə'kru:əlz
accrue => ә'kru:
accrued => ә'krud
accrues => əˈkru:z
acculturate => ә'kʌltʃәreit
acculturated => əˈkʌltʃəˌreitid
acculturates => əˈkʌltʃəˌreits
acculturating => əˈkʌltʃəˌreitɪŋ
acculturation => ә.kʌltʃә'reiʃәn
accumulate => ә'kju:mjuleit
accumulates => əˈkju:mjuleits
accumulation => ә.kju:mju'leiʃәn
accumulations => əˌkju:mjəˈleɪʃənz
accumulative => ә'kju:mjulәtiv
accumulator => ә'kju:mjuleitә
accuracies => ˈækjurəsiz
accuracy => 'ækjurәsi
accurate => 'ækjurәt
accurately => 'ækjurәtli
accursed => ә'kә:sid
accurst => ә'kә:st
accusal => ә'kju:zәl
accusation => ækju:'zeiʃәn
accusations => ˌækju:ˈzeɪʃənz
accusative => ә'kju:zәtiv
accusatorial => әkju:zә'tɒ:riәl
accusatory => ә'kju:zәtәri
accuse => ә'kju:z
accused => ә'kju:zd
accuser => ә'kju:zә
accusers => əˈkju:zəz
accuses => əˈkju:ziz
accusing => ә'kju:ziŋ
accusingly => ә'kju:ziŋli
accustom => ә'kʌstәm
accustomed => ә'kʌstәmd
accustoming => ə'kʌstəm
accustoms => əˈkʌstəmz
ace => eis
acedia => ә'si:diә
acellular => ei'seljulә
acentric => ә'sentric
acephalous => ә'sefәlәs
acequia => ә'seikjә
acerb => ә'sә:b
acerbic => ә'sә:bik
acerbity => ә'sә:biti
acet => ә'set
acetabulum => æsә'tæbjulәm
acetal => 'æsitæl
acetaldehyde => ,æsi'tældәhaid
acetamide => æsi'tæmaid
acetaminophen => ,æsi'tæminәfәn
acetanilide => æsi'tænilaid
acetate => 'æsiteit
acetic => ә'si:tik
acetic acid => ә'si:tik
acetonaemia => ,æsitәu'ni:miә
acetone => 'æsitәun
acetonitrile => ə,siːtə(ʊ)'naɪtraɪl; ,æsɪtəʊ-
acetous => 'æsitәs
acetyl => 'æsitil
acetylate => ,æsiti'leit
acetylates => ˌæsitiˈleits
acetylating => ˌæsitiˈleitɪŋ
acetylation => ә,seti'leiʃәn
acetylcholine => ә.si:til'kәuli:n
acetylcholinesterase => ,æsitilkәuli'nestәreis
acetylene => ә'setili:n
acetylide => ,æsiti'laid
Achaea => ә'ki:ә
Achaean => ә'ki:әn
Achaemenid => ə'ki:mənid; ə'kem-
achalasia => ,ækә'leiziә
acharnement => ɑ:ʃɑ:nә'mɑ:ŋ
Achates => ә'keiti:z
ache => eik
ached => eɪkt
achene => ә'ki:n
Acheron => 'ækәrɒn
aches => eikiz
Acheson => 'ætʃisn
Acheulian => ə'ʃju:liən
achievable => ә'tʃi:vәbl
achieve => ә'tʃi:v
achieved => ә'tʃi:vd
achievement => ә'tʃi:vmәnt
achiever => ә'tʃi:vә
achieves => əˈtʃi:vz
Achilles => ә'kili:z
Achilles' heel => ә'kili:z
aching => 'eikiŋ
achingly => 'ekɪŋli
achiote => ,ɑ:tʃi'әuti
achlorhydria => ,eiklɔ:'haidriә
achondrite => ei'kɔndrait
achondritic => ,eikɔn'dritik
achondroplasia => ei,kɔndrә'pleiʒiә
achromat => 'ækrәmæt
achromatic => ækrәu'mætik
achromaticity => ә,krәjmә'tisәti
achromatism => ә'krәjmәtizəm
achy => 'eiki
acicular => ә'sikjulә
acid => 'æsid
acid drop => ˈæsid drɔp
acid house => ˈæsid haus
acidic => ә'sidik
acidification => ә.sidifi'keiʃәn
acidifies => əˈsidifaiz
acidify => ә'sidifai
acidimetry => ,æsi'dimitri
acidity => ә'siditi
acidly => 'æsidli
acidophil => 'æsidәfil
acidophilic => ,æsidәj'filik,,æsi'dɔfilik
acidophilus => ˌæsɪ'dɒfələs
acidosis => .æsi'dәusis
acidulate => ә'sidjuleit
acidulated => ә'sidjuleitid
acidulous => ә'sidjulәs
acidy => 'æsɪdɪ
acinar => 'æsinә
acinus => 'æsinәs
ack emma => æk'emә
ack-ack => .æk'æk
ackee => 'æki:
Acker => 'eikә
acknowledge => әk'nɒlidʒ
acknowledged => әk'nɒlidʒid
acknowledgement => әk'nɒlidʒmәnt
acknowledgements => əkˈnɔlidʒmənts
acknowledges => əkˈnɔlidʒz
acknowledgment => әk'nɔlidʒmәnt
acme => 'ækmi
Acmeist => 'ækmiist
acne => 'ækni
acolyte => 'ækәulait
acolytes => ˈækəˌlaɪts
aconite => 'ækәnait
aconitine => ә'kɒniti:n
acorn => 'eikɒ:n
acorn barnacle => ˈeɪˌkɔ:n ˈbɑ:nəkl
acorn worm => ˈeɪˌkɔ:n wə:m
acorns => 'eɪkɔ:nz
acouchi => ә'ku:ʃi
acoustic => ә'ku:stik
acoustical => ә'ku:stikәl
acoustically => ə'kuːstɪkəlɪ
acoustician => .æku:'stiʃәn
acoustics => ә'ku:stiks
acquaint => ә'kweint
acquaintance => ә'kweintәns
acquaintances => ək'weɪntənsɪz
acquaintanceship => ә'kweintәnsʃip
acquainted => ә'kweintid
acquaints => əˈkweints
acquiesce => .ækwi'es
acquiesced => ,ækwɪ'es
acquiescence => .ækwi'esәns
acquiescent => .ækwi'eәsnt
acquiesces => ˌækwi:ˈesiz
acquiescing => ,ækwɪ'es
acquirable => ә'kwaiәrәbl
acquire => ә'kwaiә
acquired => ә'kwaiәd
acquirement => ә'kwaiәmәnt
acquires => əˈkwaiəz
acquisition => .ækwi'ziʃәn
acquisitions => ˌækwiˈziʃənz
acquisitive => ә'kwizitiv
acquisitively => ə'kwizitivli
acquisitiveness => ə,kwi'zitivnis
acquit => ә'kwit
acquits => əˈkwits
acquittal => ә'kwitәl
acquittals => əˈkwɪtlz
acquittance => ә'kwitәns
acrasia => ә'kreiziә
acre => 'eikә
acre-foot => 'eɪkərf'ʊt
acreage => 'eikәridʒ
acred => 'eikәd
acres => 'eɪkəs
acrid => 'ækrid
acridine => 'ækridi:n
acridity => æ'kriditi
acriflavine => ,ækri'fleivi:n
Acrilan => 'ækrilәn
acrimonious => ækri'mәunjәs
acrimoniously => ,ækri'məuniəsli
acrimony => 'ækrimәni
acrobat => 'ækrәbæt
acrobatic => .ækrәu'bætik
acrobatically => ,ækrəu'bætik
acrobatics => .ækrәu'bætiks
acrobats => ˈækrəˌbæts
acrocyanosis => ,ækrәu,saiә'nәusis
acrolect => 'ækrәulekt
acromegalic => .ækrәumә'gælik
acromegaly => .ækrә'megәli
acronym => 'ækrәunim
acronyms => ˈækrəˌnɪmz
acropetal => ә'krɔpitəl
acrophobia => .ækrәu'fәubiә
acropolis => ә'krɒpәlis
across => ә'krɒs
across-the-board => ә'krɔsðә'bɔ:d
acrostic => ә'krɒstik
acrostics => ə'krɒstɪk
Acrux => 'ækrʌks
acrylamide => ə'krɪləmaɪd
acrylate => 'ækrileit
acrylic => ә'krilik
acrylics => ә'kriliks
acrylonitrile => ,ækrәlәu'naitril
act => ækt
act as => ækt æz
actability => ,æktə'biliti
actable => 'æktәbl
Actaeon => æk'ti:әn
actin => 'æktin
acting => 'æktiŋ
actinian => æk'tiniәn
actinic => æk'tinik
actinide => 'æktinaid
actinides => 'æktinaidz
actinism => 'æktinizm
actinium => æk'tiniәm
actinolite => æk'tinәu,lait
actinometer => .ækti'nɒmitә
actinomorphic => ,æktinәu'mɔ:fik
actinomorphy => æktɪnəʊ'mɔ:fɪ
actinomycete => ,æktinәjmai'si:t
actinomycin => ,æktinәu'maisin
action => 'ækʃәn
action point => ˈækʃən pɔint
action replay => ˈækʃən ri:ˈpleɪ
action research => ˈækʃən riˈsə:tʃ
action-packed => ˈækʃən pækt
actionable => 'ækʃәnәbl
actioner => ˈækʃənə(r)
activate => 'æktiveit
activated => 'æktiveitid
activates => ˈæktiveits
activation => ækti'veiʃәn
activator => 'æktiveitә
active => 'æktiv
active birth => ˈæktiv bə:θ
active citizen => ˈæktiv ˈsitizən
actively => 'æktivli
activewear => 'æktiv,wεə
activism => 'æktivizm
activist => 'æktivist
activists => 'æktɪvɪsts
activity => æk'tiviti
actomyosin => ,æktәu'maiәsin
acton => 'æktәn
actor => 'æktә
actress => 'æktris
actresses => 'æktrɪsɪz
actressy => 'æktrɪsɪ
actual => 'æktʃuәl
actualise => 'æktjʊəlaɪz
actualised => 'æktʃuəlaiz
actualities => æktjʊ'ælɪtɪ; -tʃʊ-
actuality => .æktʃu'æliti
actualization => .æktʃuәlai'zeiʃәn
actualize => 'æktʃuәlaiz
actualized => ˈæktjuəlaizd
actualizes => ˈæktjuəlaiziz
actualizing => ˈæktjuəlaizɪŋ
actually => 'æktʃuәli
actuarial => .æktju'єәriәl
actuary => 'æktjuәri
actuate => 'æktʃueit
actuates => ˈæktʃu:ˌeɪts
actuation => .æktʃu'eiʃәn
actuator => 'æktʃueitә
acuity => ә'kju:әti
aculeate => ә'kju:liәt
acumen => ә'kju:men
acuminate => ә'kju:minәt
acuminated => əˈkju:minitid
acuminating => əˈkju:minitɪŋ
acupressure => 'ækjj,preʃә(r)
acupuncture => 'ækju.pʌŋktʃә
acupuncturist => .ækju'pʌŋktʃәrist
acushla => ә'kuʃlә
acutance => ә'kju:tәns
acute => ә'kju:t
acute accent => əˈkju:t ˈæksənt
acutely => ә'kju:tli
acuteness => ә'kju:tnis
acyclic => ei'saiklik
acyl => 'æsil
acylate => 'æsә,leit
ad => æd
ad hoc => 'æd'hɔk
ad hominem => ,æd'hɔminem
ad infinitum => æd infi'naitәm
ad interim => æd'intәrim
ad libitum => æd'libitәm
ad litem => æd'laitәm
ad nauseam => æd 'nɔ:ziæm
ad rem => æd'rem
ad valorem => ,ædvә'lɔ:rem
ad- => æd,әd,id
ADA => 'eidә
adage => 'ædidʒ
adagio => ә'dɑ:dʒiәu
Adam => 'ædәm
adamance => eɪdə'mæns
adamancy => 'ædәmәnsi
adamant => 'ædәmәnt
adamantine => .ædә'mæntain
ADAMS => 'ædәmz
Adana => 'ædәnә
adapt => ә'dæpt
adaptability => ә.dæptә'biliti
adaptable => ә'dæptәbl
adaptation => .ædæp'teiʃәn
adaptationist => ,ædæp'teɪʃənɪst
adaptations => ædæp'teɪʃnz
adapter => ә'dæptә
adapting => ә'dæptiŋ
adaption => ә'dæpʃәn
adaptive => ә'dæptiv
adaptive radiation => əˈdæptiv ˌreidiˈeiʃən
adaptor => ә'dæptә(r)
adaptors => əˈdæptəz
adat => 'ɑːdɑːt
adaxial => æd'æksiәl
Adcock => 'ædkɔk
add => æd
add-in => æd in
Addams => 'ædәmz
addax => 'ædæks
added => 'ædid
addenda => ә'dendә
addendum => ә'dendәm
adder => 'ædә
adders => 'ædəz
addict => ә'dikt
addicted => ә'diktid
addicting => 'ædɪkt (for n.); əˈdɪkt (for v.)
addiction => ә'dikʃәn
addictions => əˈdɪkʃənz
addictive => ә'diktiv
addicts => ˈædikts
adding => 'ædiŋ
addis => 'ædis
Addis Ababa => 'ædis'æbәbә
addison => 'ædisn
Addisonian => ædi'sәuniәn
addition => ә'diʃәn
additional => ә'diʃәnәl
additive => 'æditiv
addle => 'ædl
addled => 'ædld
addles => ˈædlz
addling => 'æd(ə)l
address => ә'dres
addressable => ә'dresәbl
addressee => .ædre'si:
addressees => ˌædreˈsi:z
addresser => ә'dresә
addresses => əˈdresiz
addressing => ә'dresiŋ
adduce => ә'dju:s
adduced => ə'djuːs
adduces => əˈdu:siz
adducible => ә'dju:sibl
adducing => ə'djuːs
adduct => ә'dʌkt
adducted => ə'dʌkt
adducting => ə'dʌkt
adduction => ә'dʌkʃәn
adductor => ә'dʌktә
adducts => 'ædʌkts
ADE => eid
adelaide => 'ædәleid
adele => ә'del
adelgid => 'ædildʒid
Aden => 'eidn
adenine => 'ædәni:n
adenocarcinoma => 'ædinәu,kɑ:si'nәumә
adenoid => 'ædinɒid
adenoidal => ,ædi'nɔidәl
adenoidectomy => ,ædinɔi'dektәmi
adenoids => 'ædinɒidz
adenoma => ,ædi'nәumә
adenomatous => ,ædi'nɔmәtәs
adenosine => ә'denәsi:n
adenovirus => .ædәnәu'vaiәrәs
adenylate => ә'denileit
adept => ә'dept
adeptness => ə'deptnis
adepts => əˈdepts
adequacy => 'ædikwәsi
adequate => 'ædikwәt
adequately => 'ædikwәtli
adhere => әd'hiә
adherence => әd'hiәrәns
adherent => әd'hiәrәnt
adherents => əd'hɪərənts
adheres => ədˈhiəz
adhesion => әd'hi:ʒәn
adhesive => әd'hi:siv
adhesively => əd'hi:sivli
adhesiveness => əd'hi:sɪvnɪs'
adhibit => әd'hibit
adhibition => ,ædhi'biʃәn
adhocracy => æd'hɔkrəsi
adiabatic => .ædiә'bætik
Adie => 'eidi:
adieu => ә'dju:
adipate => 'ædә,peit
adipocere => .ædipәu'siә
adipocyte => ˈædipəuˌsait
adipose => 'ædipәus
adiposity => .ædi'pɒsәti
adit => 'ædit
adjacency => ә'dʒeisәnsi
adjacent => ә'dʒeisәnt
adjectival => .ædʒek'taivәl
adjectivally => ,ædʒik'taivəli
adjective => 'ædʒiktiv
adjectives => 'ædʒɪktɪvz
adjoin => ә'dʒɒin
adjoined => ə'dʒɒɪn
adjoining => ә'dʒɒiniŋ
adjoins => əˈdʒɔinz
adjoint => ә'dʒɔint
adjourn => ә'dʒә:n
adjournment => ә'dʒә:nmәnt
adjournments => əˈdʒə:nmənts
adjourns => əˈdʒə:nz
adjudge => ә'dʒʌdʒ
adjudgement => ә'dʒʌdʒmәnt
adjudges => əˈdʒʌdʒz
adjudging => ə'dʒʌdʒ
adjudicate => ә'dʒu:dikeit
adjudicated => ə'dʒuːdɪkeɪt
adjudicates => əˈdʒu:dɪˌkeɪts
adjudicating => ə'dʒuːdɪkeɪt
adjudication => ә.dʒu:di'keiʃәn
adjudicative => ә'dʒu:dikeitiv
adjudicators => ə'dʒu:dikeitə
adjunct => 'ædʒʌŋkt
adjunction => ә'dʒʌŋkʃәn
adjunctive => ә'dʒʌŋktiv
adjuncts => 'ædʒʌŋkts
adjuration => .ædʒuә'reiʃәn
adjuratory => ә'dʒjәrәtәri
adjure => ә'dʒuә
adjured => ə'dʒʊə; ə'dʒɔː
adjuring => ə'dʒʊə; ə'dʒɔː
adjust => ә'dʒʌst
adjustability => ә,dʒʌstә'biliti
adjustable => ә'dʒʌstәbl
adjusted => ә'dʒʌstid
adjuster => ә'dʒʌstә
adjusters => əˈdʒʌstəz
adjusting => ә'dʒʌstiŋ
adjustment => ә'dʒʌstmәnt
adjustments => əˈdʒʌstmənts
adjustor => ә'dʒʌstә
adjusts => əˈdʒʌsts
adjutancy => 'ædʒutәnsi
adjutant => 'ædʒutәnt
adjutants => 'ædʒʊtənts
adjuvant => 'ædʒuvәnt
adland => 'ædlænd
adler => 'ædlә
Adlerian => æd'leriәn
adman => 'ædmæn
admass => 'ædmæs
admeasurement => æd'meʒәmәnt
adminicle => æd'minikl
adminicular => ædmi'nikjulә
administer => әd'ministә
administered => ədˈministəd
administers => ədˈministəz
administrable => әd'ministrәbl
administrate => әd'ministreit
administrated => ədˈministreitid
administrates => ədˈministreits
administrating => ədˈministreitɪŋ
administration => әd.mini'streiʃәn
administrations => ədmɪnɪst'reɪʃnz
administrative => әd'ministrәtiv
administrator => әd'ministreitә
administratrix => әd'ministreitriks
admirable => 'ædmәrәbl
admirably => 'ædmәrәbli
admiral => 'ædmәrәl
admirals => ˈædmərəlz
admiralship => 'ædmәrәlʃip
admiralties => 'ædmərəltɪ
Admiralty => 'ædmәrәlti
admiration => .ædmә'reiʃәn
admire => әd'maiә
admired => əd'maɪəd
admirer => әd'maiәrә
admirers => ədˈmaɪərəz
admires => ədˈmaiəz
admiring => әd'maiәriŋ
admiringly => әd'maiәriŋli
admissibility => әd.misә'biliti
admissible => әd'misәbl
admission => әd'miʃәn
admissions => əd'mɪʃnz
admit => әd'mit
admits => ədˈmits
admittance => әd'mitәns
admitted => әd'mitid
admittedly => әd'mitidli
admix => æd'miks
admixed => ədˈmikst
admixing => æd'mɪksɪŋ
admixture => æd'mikstʃә
admonish => әd'mɒniʃ
admonished => əd'mɒnɪʃ
admonishes => ædˈmɔnɪʃiz
admonishment => әd'mɔniʃmәnt
admonition => .ædmәu'niʃәn
admonitions => ˌædməˈnɪʃənz
admonitor => әd'mɔnitә
admonitory => әd'mɒnitәri
adnate => 'ædneit
adnexa => æd'neksә
adnexal => æd'neksәl
adnominal => æd'nɔminәl
ado => ә'du:
adobe => ә'doubi
adobo => ә'dәjbәj
adolescence => .ædәu'lesәns
adolescent => .ædәu'lesәnt
adolescents => ædə'lesnts
Adolf => 'ædɔif
Adolphus => ә'dɔlfәs
Adonis => ә'dәunis
adopt => ә'dɒpt
adoptable => ә'dɒptәbl
adopted => ә'dɒptid
adopting => ə'dɒpt
adoption => ә'dɒpʃәn
adoptive => ә'dɒptiv
adopts => əˈdɔpts
adorability => ə,dɔ:rə'biləti
adorable => ә'dɒ:rәbl
adorably => ә'dɒ:rәbli
adoral => ә'dɔ:rәl
adoration => .ædә'reiʃәn
adore => ә'dɒ:
adorer => ә'dɒ:rә
adores => əˈdɔ:z
adoring => ә'dɒ:riŋ
adoringly => ə'dɔriŋli
adorn => ә'dɒ:n
adornment => ә'dɒ:nmәnt
adornments => əˈdɔ:nmənts
Adorno => ə'dɔ:nəu
adorns => əˈdɔ:nz
adpressed => 'ædprest
adrenal => ә'dri:nәl
adrenalin => ә'drenәlin
adrenalized => ə'drenəlaiz
adrenergic => ,ædri'nә:dʒik
adrenocorticotrophin => ә'dri:nәj,kɔ:tikәj'trɔfin
adret => æ'drei
adrian => 'eidriәn
Adriatic => .eidri'ætik
Adrienne => 'eidrien
adrift => ә'drift
adroit => ә'drɒit
adroitly => ә'drɒitli
adroitness => ə'drɔitnis
adscititious => .ædsi'tiʃәs
adsorb => æd'sɒ:b
adsorbate => æd'sɒ:beit
adsorbent => æd'sɒ:bәnt
adsorbs => ədˈsɔ:bz
adsorption => æd'sɒ:pʃәn
adsorptive => æd'sɒ:ptiv
adulate => 'ædjuleit
adulated => ˈædʒəˌleɪtid
adulates => ˈædʒəˌleɪts
adulating => ˈædʒəˌleɪtɪŋ
adulation => .ædju'leiʃәn
adulator => 'ædjuleitә
adulatory => 'ædjuleitәri
Adullamite => ә'dʌlәmait
adult => 'ædʌlt
adulterant => ә'dʌltәrәnt
adulterate => ә'dʌltәreit
adulterated => ә'dʌltәreitid
adulterates => əˈdʌltəˌreɪts
adulterating => ə'dʌltəreitiŋ
adulteration => ә.dʌltә'reiʃәn
adulterator => ә'dʌltәreitә(r)
adulterer => ә'dʌltәrә
adulterers => əˈdʌltərəz
adulteress => ә'dʌltәris
adulteries => ə'dʌlt(ə)rɪ
adulterine => ә'dʌltәrain
adulterous => ә'dʌltәrәs
adultery => ә'dʌltәri
adulthood => ә'dʌlthud
adultly => æ'dʌltlɪ
adumbrate => 'ædʌmbreit
adumbrated => ˈædəmˌbreɪtid
adumbrates => ˈædəmˌbreɪts
adumbrating => ˈædəmˌbreɪtɪŋ
adumbration => .ædʌm'breiʃәn
adumbrative => 'ædʌmbreitiv
adust => ә'dʌst
advance => әd'vɑ:ns
advanced => әd'vɑ:nst
advancement => әd'vɑ:nsmәnt
advancements => ædˈvænsmənts
advancer => әd'vɑ:nsә
advancing => æd'vɑ:nsiŋ
advantage => әd'vɑ:ntidʒ
advantageous => .ædvәn'teidʒәs
advantageously => ,ædvən'teidʒəsli
advantaging => əd'vɑːntɪdʒ
advect => æd'vekt
advection => æd'vekʃәn
advent => 'ædvәnt
Adventism => 'ædvәntizәm
Adventist => 'ædvәntist
adventitia => ,ædven'tiʃjә,-ʃiә,-ʃә
adventitious => .ædven'tiʃәs
adventitiously => ædvenˊtiʃәsli
adventure => әd'ventʃә
adventure playground => ədˈventʃə ˈpleiɡraund
adventured => əd'ventʃə
adventurer => әd'ventʃәrә
adventurers => ædˈventʃəəz
adventures => ədˈventʃəz
adventuresome => әd'ventʃәsәm
adventuress => әd'ventʃәris
adventuring => əd'ventʃə
adventurism => әd'ventʃәrizm
adventurist => әd'ventʃәrist
adventurous => әd'ventʃәrәs
adventurously => əd'ventʃərəslɪ
adverb => 'ædvә:b
adverbial => әd'vә:bjәl
adverbially => æd'və:biəli
adverbs => 'ædvɜ:bz
adversarial => ,ædvә'seәriәl
adversary => 'ædvәsәri
adversative => әd'vә:sәtiv
adverse => 'ædvә:s
adversity => әd'vә:sәti
advert => әd'vә:t
adverted => 'ædvɜːt
adverting => 'ædvɜːt
advertise => 'ædvәtaiz
advertisement => .ædvә'taizmәnt
advertiser => 'ædvәtaizә
advertisers => ˈædvətaɪzəz
advertises => ˈædvətaiziz
advertising => 'ædvәtaiziŋ
advertorial => ,ædvә'tɔ:riәl
adverts => ədˈvə:ts
advice => әd'vais
advice column => ədˈvais ˈkɔləm
advisability => әd.vaizә'biliti
advisable => әd'vaizәbl
advisably => әd'vaizәbli
advise => әd'vaiz
advised => әd'vaizd
advisedly => әd'vaizidli
advisee => әd'vaizi:. .ædvai'zi:
advisement => әd'vaizmәnt
adviser => әd'vaizә
advisers => əd'vaɪzəz
advises => ədˈvaiziz
advisor => әd'vaizә
advisory => әd'vaizәri
advocaat => ,ædvәu'kɑ:t
advocacy => 'ædvәkәsi
advocate => 'ædvәkeit
advocated => 'ædvəkeɪt；-ət
advocates => ˈædvəkeits
advocation => .ædvә'keiʃәn
advowson => әd'vajzәn
advt => 'ədvt
Adyghe => 'ɑ:di,ɡei; ,ɑ:di'ɡei; ,ɑ:di'ɡe
adytum => 'æditәm
adzuki => æd'zu:ki
aedile => 'i:dail
Aegean => i:'dʒi:әn
aegis => 'i:dʒis
Aegisthus => i:'dʒisθәs
aegrotat => i:'^rәjtæt
Aeneas => i'ni:әs
Aeneid => 'i:niid
aeolian => i:'әjliәn
aeolian harp => i:ˈəuljən hɑ:p
Aeolus => 'i:әulәs
aeon => 'i:әn
aeons => 'iːən
aepyornis => ,i:pi:'ɔ:nis
aer => eә
aerate => 'eiәreit
aerated => 'eiәreitid
aerates => ˈeiəreits
aerating => 'eiәreitiŋ
aeration => eiә'reiʃәn
aerator => 'eiәreitә(r)
aerenchyma => eә'reŋkimә
aerial => 'єәriәl
aerialist => 'єәriәlist
aeriality => ,eərɪ'ælɪtɪ
aerially => 'єәriәli
aerials => 'eərɪəlz
aerie => 'єәri
aero => 'єәrәu
aero- => 'eәrәj
aerobatic => ,eәrәu'bætik
aerobatics => .єәrәu'bætiks
aerobe => 'єәrәub
aerobic => єә'rәubik
aerobically => ,eiə'rəubik
aerobics => .eiә'rәubiks
aerobiology => .єәrәubai'ɒlәdʒi
aerodrome => 'єәrәdrәum
aerodromes => ˈeərəˌdrəʊmz
aerodynamic => ,eәrәudai'næmik
aerodynamically => ,eәrәudai'næmikәli
aerodynamicist => ,eәrәudai'næmisist
aerodynamics => .єәrәudai'næmiks
aeroelastic => ,eәrәui'læstik
aeroelasticity => -'tisiti
aeroflot => 'eәrәuflɔt
aerofoil => 'eәrәfɔil
aerogel => 'eәrәdʒәl
aerogramme => 'єәrәugræm
aerolite => 'єәrәulait
aerological => ,εərəu'lɔdʒikəl
aerology => єә'rɒlәdʒi
aeromagnetic => ,eәrәmæ^'netik
aeromedical => 'eәrәu'medikәl
aeromodeller => eәrәu'mɔdlә
aeronaut => 'єәrәnɒ:t
aeronautic => .єәrә'nɒ:tik
aeronautical => ,eәrә'nɔ:tikәl
aeronautics => .єәrә'nɒ:tiks
aeronomy => єә'rɒnәmi
aerophagy => ,eәrәu'feidʒi
aerophone => 'єәrәfәun
aeroplane => 'єәrәplein
aeroplanes => ˈɛərəpleinz
aeroshell => ,eәrәj'ʃel
aerosol => 'єәrәusɒl
aerosolize => eә'rɔsɔlaiz
aerosols => 'eərəsɒlz
aerospace => 'єәrәuspeis
aerostat => 'єәrәustæt
aerotow => 'eәrәtәu
Aertex => 'εəteks
Aeschines => 'i:skini:z
Aeschylus => 'i:skiləs
Aesculapian => ,i:skju'leipjәn
Aesop => 'i:sɒp
aesthete => 'i:sθi:t
aesthetes => i:s'θi:ts
aesthetic => i:s'θetik
aesthetically => i:s'θetikәli
aesthetician => ,i:sθi'tiʃәn
aestheticism => i:s'θetizm
aestheticize => esˈθetəˌsaɪz
aesthetics => i:s'θetiks
aestival => i:s'taivәl
aestivate => 'i:stiveit
aestivated => ˈi:stiveitid
aestivates => ˈi:stiveits
aestivating => ˈi:stiveitɪŋ
aestivation => ,i:sti'veiʃәn
aetatis => i:'teitis
aether => 'i:θә
aetiological => ,i:tiә'lɔdʒikәl
aetiology => .i:ti'ɒlәdʒɑ
afar => ә'fɑ:
afear => ə'fiə
afeared => ə'fɪəd
afebrile => ә'fi:brәl
affability => .æfә'biliti
affable => 'æfәbl
affably => 'æfәbli
affair => ә'fєә
affaire => əˈfeə(r)
affect => ә'fekt
affectation => .æfek'teiʃәn
affectations => ˌæfekˈteɪʃənz
affected => ә'fektid
affectedly => ə'fektidli
affecting => ә'fektiŋ
affectingly => ə'fektiŋli
affection => ә'fekʃәn
affectional => ә'fekʃәnәl
affectionate => ә'fekʃәnәt
affectionately => ә'fekʃәnitli
affections => əˈfekʃənz
affective => ә'fektiv
affectivity => ,æfek'tiviti
affectless => ә'fektlis
affectlessness => ə'fektləsnəs
affenpinscher => 'æfәn,pinʃә
afferent => 'æfәrәnt
affiance => ә'faiәns
affianced => ə'faiənst
affiances => əˈfaiənsiz
affiancing => ə'faɪəns
affiant => ә'faiәnt
affidavit => .æfi'deivit
affidavits => ˌæfɪˈdeɪvɪts
affiliate => ә'filieit
affiliated => ә'filieitid
affiliates => əˈfilieits
affiliating => ə'fɪlɪeɪt
affiliation => ә.fili'eiʃәn
affiliations => əfɪl'ɪeɪʃnz
affinal => ә'fainәl
affine => ә'fain
affined => ә'faind
affinity => ә'finiti
affinity card => əˈfɪnɪti: kɑ:d
affirm => ә'fә:m
affirmation => .æfә'meiʃәn
affirmations => æfə'meɪʃ(ə)n
affirmative => ә'fә:mәtiv
affirmatively => ə'fə:mə'tivli
affirmatives => əˈfɜ:mətɪvz
affirmatory => ə'fə:mətəri
affirming => ə'fɜːm
affirms => əˈfə:mz
affix => ә'fiks
affixation => ,æfik'seiʃәn
afflatus => ә'fleitәs
afflict => ә'flikt
afflicting => ə'fliktiŋ
affliction => ә'flikʃәn
afflictions => əˈflɪkʃənz
afflictive => ә'fliktiv
afflicts => əˈflikts
affluence => 'æfluәns
affluent => 'æfluәnt
affluently => 'æfluəntli
affluenza => ,æflu'enzə
afflux => 'æflʌks
afforce => ә'fɔ:s
afford => ә'fɒ:d
affordability => əˌfɔdɚ'bɪlətɪ
afforded => ə'fɔːd
affording => ə'fɔːd
affords => əˈfɔ:dz
afforest => ә'fɒrist
afforestation => æ.fɒri'steiʃәn
afforested => æˈfɔristid
afforesting => 'əfɒrɪstɪŋ
afforests => æˈfɔrists
affranchise => ә'fræntʃaiz
affranchised => ə'fræn(t)ʃaɪz
affranchises => ə'fræn(t)ʃaɪz
affranchising => ə'fræn(t)ʃaɪz
affray => ә'frei
affrays => ə'freɪ
affricate => 'æfrikәt
affright => ә'frait
affrighted => ə'fraɪt
affrighting => ə'fraɪt
affront => ә'frʌnt
affronting => ə'frʌnt
affronts => əˈfrʌnts
Afghan => 'æfgæn
Afghanistan => æf'gænistæn
afghans => ˈæfɡænz
aficionado => ә.fisjә'nɑ:dәu
afield => ә'fi:ld
afire => ә'faiә
AFL-CIO => ,ei ef el si: ai 'əu
aflame => ә'fleim
aflatoxin => ,æflә'tɔksin
afloat => ә'flәut
aflutter => ә'flʌtә
afoot => ә'fut
afore => ә'fɒ:
aforementioned => ә'fɒ:.menʃәnd
aforesaid => ә'fɒ:sed
aforethought => ә'fɒ:θɒ:t
afoul => ә'faul
afraid => ә'freid
afreet => 'æfri:t
afresh => ә'freʃ
Africa => 'æfrikә
African => 'æfrikәn
Africander => ,æfri'kændә
Africanism => 'æfrikәnizəm
Africanist => 'æfrikәnist
Africanization => ,æfrikәnai'zeiʃən;-ni'z-
Afrikaans => .æfri'kɑ:ns
Afrikander => ,æfri'kændә
Afrikaner => .æfri'kɑ:nә
Afrikanerdom => ,æfri'kɑ:nәdәm
afrit => 'æfri:t
afro => 'æfrәu
Afro- => 'æfrәj
Afro-American => 'æfrәuә'merikәn
Afrocentric => ,æfrəu'sentrik
afrormosia => ,æfrɔ:'mәjziә
aft => ɑ:ft
after => 'ɑ:ftә
after-effects => ˈɑ:ftə ɪˈfekts
afterbirth => 'ɑ:ftәbә:θ
afterburner => 'ɑ:ftә.bә:nә
aftercare => 'ɑ:ftәkєә
afterdamp => 'ɑ:ftәdæmp
afterdeck => 'ɑ:ftәdek
aftereffect => 'ɑ:ftәri.fekt
afterglow => 'ɑ:ftәglou
afterimage => 'ɑ:ftәr.imidʒ
afterlife => 'ɑ:ftәlaif
aftermarket => 'ɑ:ftә.mɑ:kit. 'æf-
aftermath => 'ɑ:ftәmæθ
aftermost => 'ɑ:ftәmәust
afternoon => 'ɑ:ftә'nu:n
afternoons => ,ɑ:ftә'nu:nz
afterpains => 'ɑ:ftәpeinz
afters => 'ɑ:ftәz. 'æf-
aftershave => 'ɑːftəʃeɪv
aftershock => 'ɑ:ftәʃɒk
aftershocks => 'ɑ:ftəʃɒks
aftertaste => 'ɑ:ftәteist
afterthought => 'ɑ:ftәθɒ:t
afterthoughts => ˈæftəˌθɔ:ts
afterward => 'ɑ:ftәwәd
afterwards => 'ɑ:ftәwәdz
afterword => 'ɑ:ftәwә:d
afterworld => 'ɑ:ftәw\\\\:ld
ag => æg
aga => 'ɑ:gә
Agadir => ,ɑ:^ә'diә(r)
again => ә'gein
against => ә'geinst
agal => 'ɑ:^a:l
agama => 'æ^әmә
Agamemnon => .ægә'memnәn
agamic => ә'gæmik
agamid => 'æ^әmid
agammaglobulinaemia => ei'^æmә,^lɔbjjli'ni:miә
agamospermy => 'æ^әmәj,sp\\\\:mi
agapanthus => ,æ^ә'pænθәs
agape => ә'geip
agar => 'eigә
agaric => 'ægәrik
agarose => 'ɑ:^әrәjs
Agartala => 'ʌɡətə,lɑ:
Agassiz => 'æ^әsi(:)
agate => 'ægәt
agates => ˈægɪts
agatha => 'æ^әθә
agave => ә'geivi
age => eidʒ
age bracket => eidʒ ˈbrækit
age limit => eidʒ ˈlimit
age-old => 'eidʒәjld
aged => 'eidʒid
ageing => 'eidʒiŋ
ageism => 'eidʒizәm
ageless => 'eidʒlis
agelessness => eɪdʒ'ləsnəs
agency => 'eidʒәnsi
agenda => ә'dʒendә
agendas => əˈdʒendəz
agent => 'eidʒәnt
agent noun => ˈeidʒənt naun
agentive => 'eidʒintiv
agentry => 'eidʒәntri
ageratum => .ædʒә'reitәm
Aggadah => əɡə'dɑ:
aggie => 'æɡi
aggiornamento => ә.dʒɒ:nә'mentou
agglomerate => ә'glɒmәreit
agglomerates => əɡ'lɒməreɪts
agglomerating => ә'^lɔmәreitiŋ
agglomeration => ә.glɒmә'reiʃәn
agglomerations => əɡlɒmə'reɪʃnz
agglomerative => ә'glɒmәreitiv
agglutinate => ә'glu:tineit
agglutinated => ə'gluːtɪneɪt
agglutination => ә.glu:ti'neiʃәn
agglutinative => ә'glu:tinәtiv
agglutinin => ә'glu:tinin
aggradation => ,æ^rә'deiʃən
aggrandize => ә'grændaiz
aggrandized => ə'grændaɪz
aggrandizement => ә'grændizmәnt
aggrandizes => əˈgrænˌdaɪziz
aggrandizing => ə'grændaɪz
aggravate => 'ægrәveit
aggravated => 'æɡrә.veitid
aggravates => ˈæɡrəveits
aggravating => 'ægrәveitiŋ
aggravation => ægrә'veiʃәn
aggregate => 'ægrigәt
aggregate fruit => ˈæɡriɡit fru:t
aggregates => ˈæɡriɡits
aggregation => ægri'geiʃәn
aggregative => 'ægrigeitiv
aggregator => ˈægrɪgeɪtə(r)
aggress => ә'gres
aggressed => əˈɡrest
aggresses => əˈɡresiz
aggressing => əˈɡresɪŋ
aggression => ә'greʃәn
aggressive => ә'gresiv
aggressor => ә'gresә
aggressors => əˈgresəz
aggrieved => ә'gri:vd
aggro => 'æ^rәu
aghast => ә'gɑ:st
agile => 'ædʒail
agilely => 'ædʒəli
agility => ә'dʒiliti
agin => ә'^in
Agincourt => 'ædʒinkɔ:t
aging => 'eidʒiŋ
agism => 'eidʒizm
agist => ә'dʒist
agistment => ə'dʒɪstmənt
agitate => 'ædʒiteit
agitated => 'ædʒiteitid
agitatedly => 'ædʒiteitidli
agitates => ˈædʒiteits
agitation => .ædʒi'teiʃәn
agitato => ædʒi'tɑ:tәu
agitator => 'ædʒiteitә
agitators => ˈædʒɪˌteɪtəz
agitprop => 'ædʒitprɒp
agleam => ә'^li:m
aglet => 'æglit
agley => ә'gli:
aglow => ә'glәu
agnail => 'ægneil
agnate => 'ægneit
Agnatha => 'æɡnəθə
agnathan => 'æɡnəθən
agnatic => æg'nætik
agnation => æg'neiʃәn
agnes => 'æ^nis
Agni => 'ʌ^ni
agnolotti => ,ɑ:njә'lɔ:tti:
agnosia => æ^'nәjsiә
agnostic => æg'nɒstik
agnosticism => æg'nɒstisizәm
agnostics => ægˈnɔstɪks
ago => ә'gәu
agog => ә'gɒg
agogo => ә'^әu^әu
agonies => 'ægənɪ
agonise => 'æ^әnaiz
agonised => 'æɡənaiz
agonising => 'æɡə,naiziŋ
agonisingly => 'ægənaiziŋli
agonism => 'æɡənizəm
agonist => 'æ^әnist
Agonistes => ,æɡə'nis,ti:z
agonistic => .ægәu'nistik
agonize => 'ægәnaiz
agonizes => ˈægəˌnaɪziz
agonizing => 'ægәnaiziŋ
agonizingly => 'ægənaiziŋli
agony => 'ægәni
agony aunt => ˈæɡəni ɑ:nt
agony uncle => ˈæɡəni ˈʌŋkl
agora => 'ægәrә
agoraphobe => æ'ɡərəfəʊb
agoraphobia => .ægәrә'fәubiә
agoraphobic => ,æ^әrә'fәjbik
agoraphobics => ,æɡərə'fəʊbɪk
agouti => ә'gu:ti
agra => 'ɑ:^rә
agranulocytosis => æ,^rænjulәusai'tәusis
agraphia => æ'^ræfiә
agrarian => ә'grєәriәn
agrarianism => ә'^reәriәnizəm
agree => ә'gri:
agreeable => ә'griәbl
agreeableness => ə'griəblnəs
agreeably => ә'griәbli
agreed => ә'ɡri:d
agreement => ә'gri:mәnt
agreements => əɡ'ri:mənts
agrees => əˈɡri:z
agrestic => ә'grestik
agribusiness => 'ægri.bizinis
agribusinessman => 'æɡri'biznismən
agricola => ә'^rikәlә
agricultural => .ægri'kʌltʃәrәl
agriculturalist => ,æ^ri'kʌltʃərәlist
agriculturalists => ,æɡrɪ'kʌltʃərəlɪst
agriculture => 'ægrikʌltʃә
agriculturist => ,æ^ri'kʌltʃәrist
agrimony => 'ægrimәni
agritourism => ˈægrɪtʊərɪzəm
agro- => 'æ^rәj
agro-industrial => 'æɡrəuin'dʌstriəl
agrobiological => ,æɡrəubaiə'lɔdʒikəl
agrobiologist => ,æ^rәjbai'ɔlәdʒist
agrobiology => .ægrәu'baiɒlәdʒi
agrochemical => .ægrәu'kemikәl
agroecosystem => ,æ^rәu,i:kәu'sistәm
agroforestry => ,æɡrəu'fɔristri
agrologist => ә'^rɔlәdʒist
agrology => ә'grɒlәdʒi
agronomic => .ægrә'nɒmik
agronomically => ,æɡrə'nɔmikəli
agronomics => ,æ^rәu'nɔmiks
agronomist => ә'grɒnәmist
agronomy => ә'grɒnәmi
agrostology => ,æ^rәu'stɔlәdʒi
aground => ә'graund
aguardiente => ɑ:^wɑ:di'entei
Aguascalientes => ,ɑ:ɡwɑ:skɑ:'ljenteis
ague => 'eigju:
agued => 'ei^ju:d
aguish => 'eigju:iʃ
ah => ɑ:
aha => ɑ:'hɑ:
ahead => ә'hed
ahem => ә'hem
ahimsa => ә'himsɑ:
Ahmadabad => ,ɑ:mәdә'bɑ:d
ahold => ә'hәjld
aholehole => əhəule'həul
ahoy => ә'hɒi
Ahriman => 'ɑ:rimәn
Ahvaz => ɑ:'vɑ:z
Ahvenanmaa => 'ɑ:venɑ:nmɑ:
AI => ai
aid => eid
aid climbing => eid ˈklaimiŋ
Aida => ɑ:'i:dә
aide => eid
aide-de-camp => .eiddә'kɒŋ
aide-memoire => 'eidmem'wɑ:r
aided => 'eidid
aides => eidz
AIDS => eidz
aigrette => 'ei^ret
aiguille => 'eigwi:l
aiguillette => .eigwi'let
aiken => 'eikәn
aikido => ai'ki:dәu
ail => eil
ailanthus => ei'lænθәs
ailed => eɪl
aileen => 'eili:n
aileron => 'eilәrɒn
ailerons => 'eɪlərɒnz
ailing => 'eiliŋ
ailment => 'eilmәnt
ailments => ˈeilmənts
ailurophile => ai'ljjәrәfail
ailurophobe => ai'ljjәrәfәjb
ailurophobia => ai,ljjәrә'fәjbiә
aim => eim
aiming => 'eimiŋ
aimless => 'eimlis
aimlessly => 'eimlisli
aimlessness => 'eimlisnis
ain => ein
ain't => eint
Aintab => ain'tɑ:b
Aintree => 'eintri
Ainu => 'ainu:
aioli => ai'әjli
air => єә
air ball => eə(r) bɔ:l
air bridge => eə(r) bridʒ
air commodore => eə(r) ˈkɔməˌdɔ:
air corridor => eə(r) ˈkɔridɔ:
air cover => eə(r) ˈkʌvə
air freshener => eə(r) ˈfreʃənə
air lock => 'eәlɔk
air marshal => eə(r) ˈmɑ:ʃəl
air mattress => eə(r) ˈmætris
air mile => eə(r) mail
air pistol => eə(r) ˈpistl
air plant => eə(r) plɑ:nt
air power => 'εəpauə
air quality => eə(r) ˈkwɔliti
air rage => eə(r) reidʒ
air rifle => eə(r) ˈraifl
air sac => eə(r) sæk
air station => eə(r) ˈsteiʃən
air strike => eə(r) straik
air-dry => 'eәdrai
air-kiss => eə(r) kis
air-raid shelter => ˈeəˈreɪd ˈʃeltə
air-sea rescue => eə(r) si: ˈreskju:
air-to-air => 'eәtә'eә(r)
air-to-ground => 'eәtә'^rajnd
air-to-surface => 'eәtә's\\\\:fis
airbag => 'eәbæ^
airbed => 'eəbed
airboat => 'eәbәjt
airborne => 'єәbɒ:n
airbrick => eərb'rɪk
airbrush => 'єәbrʌʃ
airbrushed => 'eəbrʌʃ
airbrushes => ˈɛəbrʌʃiz
airbrushing => ˈɛəbrʌʃɪŋ
airburst => 'eәb\\\\:st
airbus => 'eәbʌs
aircraft => 'єәkræft
aircraftman => 'єәkræftmәn
aircrew => 'єәkru:
aircrews => 'eəkru:z
airdate => 'eәdeit
Airdrie => 'εədri
airdrop => 'єәdrɒp
Airedale => 'eәdeil
airer => 'εәrә
airfare => 'εә.fεә
airfield => 'єәfi:ld
airfields => ˈeəˌfi:ldz
airflow => 'єәflәu
airfoil => 'eәfɔil
airframe => 'єәfreim
airfreight => 'єәfreit
airglow => 'єәglәu
airgun => 'ɛrɡʌn
airguns => 'ɛrɡʌn
airhead => 'eәhed
airier => ˈeəri:ə
airily => 'єәrili
airiness => 'єәrinis
airing => 'єәriŋ
airing cupboard => ˈeərɪŋ ˈkʌbəd
airless => 'єәlis
airletter => eə'letər
airlift => 'єәlift
airlifted => ˈeəˌlɪftid
airlifting => ˈeəˌlɪftɪŋ
airlifts => ˈeəˌlɪfts
airline => 'єәlain
airliner => 'єәlainә
airliners => ˈeəˌlaɪnəz
airlocks => 'ɛrlɑk
airmail => 'єәmeil
airmailed => ˈeəˌmeɪld
airmailing => ˈeəˌmeɪlɪŋ
airman => 'єәmәn
airmanship => 'eәmænʃip
airmen => 'εәmәn
airmiss => ˈeəmɪs
airmobile => 'eәmәj,bi:l
airplane => 'єәplein
airplanes => ˈɛəpleinz
airplay => 'eәplei
airport => 'єәpɒ:t
airports => 'eəpɔ:ts
airpower => 'εəpauə
airscrew => 'єәskru:
airshaft => eə'ʃɑ:ft
airship => 'єәʃip
airshow => 'εəʃəu
airsick => 'єәsik
airsickness => 'єәsiknis
airspace => 'єәspeis
airspeed => 'єәspi:d
airspeeds => ˈɛəspi:dz
airstream => 'eәstri:m
airstrike => 'er,straik
airstrip => 'єәstrip
airstrips => ˈɛəstrips
airtight => 'єәtait
airtime => 'eәtaim
airwave => 'єәweiv
airwaves => 'eәweivz
airway => 'єәwei
airwoman => 'єәwumәn
airwomen => 'eə,wʊmən
airworthiness => 'єә.wә:ðinis
airworthy => 'єәwә:ði
airy => 'єәri
aisle => ail
aisled => aild
aisles => ailz
ait => eit
aitch => eitʃ
aitchbone => 'eitʃboun
aitches => eɪtʃ
aitken => 'eitkin
Ajaccio => ɑ:'jɑ:ttʃɔ:
ajar => ә'dʒɑ:
Ajmer => ʌdʒ'mi:ə
Akan => 'ɑ:kɑ:n
akasha => ɑ:'kɑ:ʃə
Akbar => 'ækbɑ:
akee => ә'ki:
Akihito => ,ɑ:ki'hi:təu; ɑ:'ki:ji:tɔ
akimbo => ә'kimbәu
akin => ә'kin
akinesia => ,æki'ni:ʒә
Akkad => 'ækæd
Akkadian => ә'keidiәn, -'kɑ:-
Aksum => 'ɑ:ksum
Akubra => ə'ku:brə
akvavit => 'ɑ:kvәvit, 'æk-
al dente => ˌæl ˈdenteɪ
al- => æl
ala => 'eilә
Alabama => .ælә'bæmә
alabaster => 'ælәbɑ:stә
alack => ә'læk
alacrity => ә'lækrәti
Aladdin => ә'lædin
Alagoas => ,ɑ:lə'ɡəuəs
alameda => .ælә'meidә
Alamein => ,ælә'mein
alamo => 'ælәmәu
alan => 'ælәn
alanine => 'ælә,ni:n
alar => 'eilә
Alaric => 'ælərik
alarm => ә'lɑ:m
alarming => ә'lɑ:miŋ
alarmingly => ə'lɑːmɪŋli
alarmism => ә'lɑ:mizәm
alarmist => ә'lɑ:mist
alarmists => əˈlɑ:mists
alarms => əˈlɑ:mz
alarum => ә'leәrәm
alas => ә'læs
Alaska => ә'læskә
alaskan => ә'læskәn
alaskans => ə'læskən
Alastair => 'ælәstә(r),-steә(r)
alate => 'eileit
alb => ælb
alba => 'ælbә
Albacete => ,ɑ:lvɑ:θete
albacore => 'ælbәkɔ:
Alban => 'ɔ:lbәn,'æl-
Albania => æl'beiniә
albanian => æl'beinjәn
Albany => 'ɒ:lbәni
albatross => 'ælbәtrɒs
albatrosses => ˈælbətrɔsiz
albedo => æl'bi:dәu
albeit => ɔ:l'bi:it
albert => 'ælbәt
Albertville => ælbər'vi:
albescent => æl'besәnt
Albi => æl'bi:
Albigenses => ,ælbi'^ensi:z
Albigensian => -siәn
albinism => 'ælbinizm
albino => æl'bi:nәu
Albion => 'ælbiәn
albite => 'ælbait
albizzia => æl'biziә
album => 'ælbәm
albumen => 'ælbjumin
albumin => 'ælbjumin
albuminoid => æl'bju:minɒid
albuminous => æl'bju:minәs
albuminuria => .ælbju:mi'njuәriә
albuquerque => 'ælbәk\\\\:ki
Alcaeus => æl'si:əs
alcahest => 'ælkәhest
alcalde => æl'kældi
Alcatel => 'ælkætəl
Alcatraz => 'ælkə,træz
alcazar => 'ælkә'zɑ:
Alcestis => æl'sestis
alchemic => æl'kemik
alchemist => 'ælkimist
alchemists => ˈælkimists
alchemize => 'ælkimaiz
alchemy => 'ælkimi
alcheringa => ,æltʃә'riŋgә
alcid => 'ælsɪd
alcohol => 'ælkәhɒl
alcoholic => .ælkә'hɒlik
alcoholics => ˌælkəˈhɔliks
alcoholism => 'ælkәhɒlizәm
alcoholometer => .ælkәhɒ'lɒmitә
alcoholometry => ,ælkәhɔ'lɔmitri
alcopop => ˈælkəʊpɒp
alcove => 'ælkәuv
alcoves => ˈælˌkəʊvz
Alcuin => 'ælkwin
Aldabra => æl'dæbrə
Aldebaran => æl'debәrәn
aldehyde => 'ældihaid
aldehydes => 'ældɪhaɪdz
alder => 'ɒ:ldә
alderfly => 'ɔ:ldərflaɪ
alderman => 'ɒ:ldәmәn
aldermanic => .ɒ:ldә'mænik
aldermanship => 'ɔ:ldəmənʃip
Aldermaston => 'ɔ:ldәmɑ:stәn
aldermen => 'ɔ:ldəmən
Alderney => 'ɔ:ldәni
alders => ˈɔ:ldəz
alderwoman => ˈɔ:ldəˌwʊəmən
Aldine => 'ɒ:ldain
ALDINGTON => 'ɔ:ldiŋtәn
aldo => 'ɑ:ldәj,'ɔ:l-,'æl-
aldol => 'ældәul
aldosterone => æl'dɔstәrәun
aldosteronism => 'ældɔstә'rәunizm
Aldous => 'ɔ:ldәs, 'ældәs
Aldridge => 'ɔ:ldridʒ
aldrin => 'ɔ:ldrin
ale => eil
aleatoric => .eiliә'tɒrik
aleatory => 'eiliәtәri
alec => 'ælik
alecost => 'eilkɔst
Alecto => ә'lektәj
alee => ә'li:
alehouse => 'eil,haus, 'el,haus
Aleksandropol => ,æliksæn'drɔ:pәl
Aleksandrovsk => ,ælik'sændrәfsk
alembic => ә'lembik
aleph => 'ɑ:lif
Aleppo => ә'lepәu
alerce => ә'leәsә
alert => ә'lә:t
alerted => ə'lɜːt
alerting => ә'lә:tiŋ
alertly => ә'lә:tli
alertness => ә'lә:tnis
alerts => əˈlə:ts
Alessandra => ,ælə'sændrə
aleurone => ә'ljjәrәjn
Aleut => 'æliu:t
Aleutian => ә'lu:ʃjәn
alevin => 'ælivin
alewife => 'eilwaif
alexander => ,æli^'zɑ:ndә
alexanders => ,ælig'za:ndə
alexandra => ,æli^'zɑ:ndrә
Alexandretta => ,æli^zɑ:n'dretә
alexandria => ,æli^'zɑ:ndriә
Alexandrian => ,æli^'zɑ:ndriәn
alexandrite => ælig'zændrait
alexia => ei'leksiә
alexis => ә'leksis
ALF => ælf
alfa => 'ælfә
alfalfa => æl'fælfә
Alfie => 'ælfi
alfonso => æl'fɔnsәu
alfred => 'ælfrid
alfresco => æl'freskәu
alga => 'ælgә
algae => 'ælgi:
algal => 'æl^әl
algebra => 'ældʒibrә
algebraic => .ældʒi'breiik
algebraical => ,ældʒi'breiikәl
algebraist => .ældʒi'breiist
Algeria => æl'dʒiәriә
Algerian => æl'dʒiәriәn
algerians => ælˈdʒiəriənz
ALGERNON => 'ældʒәnәn
algicide => 'ældʒisaid
Algiers => æl'dʒiәrz
alginate => 'ældʒineit
algolagnia => .ælgәu'lægniә
algological => ,ælɡə'lɔdʒikəl
algologist => æl'gɒlәdʒist
algology => æl'gɒlәdʒi
Algonquian => æl'^ɔŋkwiәn
algonquin => æl'^ɔŋkwin
algorithm => 'ælgәriðm
algorithmically => æl'ɡɒrɪθmɪklɪ
alguacil => ,æl^wә'si:l
Alhambra => ,æl'hæmbrә
alias => 'eiliæs
aliasing => 'eiliәsiŋ
alibi => 'ælibai
alibis => ˈæləˌbaɪz
Alicante => æli'kænti
ALICE => 'ælis
alicia => ә'liʃiә
alicyclic => æli'siklik
alidade => 'ælideid
alien => 'eiljәn
alienability => .eiljәnә'biliti
alienable => 'eiljәnәbl
alienage => 'eiliәnidʒ
alienate => 'eiljәneit
alienates => ˈeiljəneits
alienation => .eiljә'neiʃәn
alienator => 'eiljәneitә
alienee => .eiljә'ni:
alienist => 'eiljәnist
alienor => 'eiljәnә
aliens => ˈeiljənz
aliform => 'ælifɒ:m
Aligarh => ,ɑ:li'ɡə:; ,æli-
alight => ә'lait
alighted => ə'laɪt
alights => əˈlaɪts
align => ә'lain
aligning => ә'lainiŋ
alignment => ә'lainmәnt
alignments => əˈlaɪnmənts
aligns => ə'laɪnz
alike => ә'laik
aliment => 'ælimәnt
alimentary => .æli'mentәri
alimentation => .ælimen'teiʃәn
alimented => ˈæliməntid
alimenting => ˈæliməntɪŋ
aliments => ˈælimənts
alimony => 'ælimәni
Alina => ailina
aline => ә'lain
alined => ə'laɪn
alining => ə'laɪn
aliphatic => .æli'fætik
aliphatics => ,æli'fætiks
aliquot => 'ælikwɒt
alison => 'ælisn
alit => ә'lit
aliteracy => 'ælaɪtərəsɪ
aliterate => 'ælaɪtəreɪt
alive => ә'laiv
aliyah => ,ɑ:li:'jɑ:
alizarin => ә'lizәrin
alkahest => 'ælkәhest
alkali => 'ælkәlai
alkalic => æl'kælik
alkaline => 'ælkәlain
alkalinity => .ælkә'liniti
alkalis => 'ælkәlis
alkalization => .ælkәlai'zeiʃәn
alkalize => 'ælkәlaiz
alkalized => 'ælkəlaɪz
alkaloid => 'ælkәlɒid
alkalosis => ,ælkә'lәusis
alkane => 'ælkein
alkanet => 'ælkәnet
alkene => 'ælki:n
alky => 'ælki
alkyd => 'ælkid
alkyl => 'ælkil
alkylate => 'ælkileit
alkylation => .ælki'leiʃәn
alkyne => 'ælkain
all => ɒ:l
all fours => ɔ:l fɔ:z
all-American => ,ɔ:lә'merikәn
all-around => 'ɔ:lә,rajnd
all-clear => ɔ:l kliə
all-day => 'ɔ:l'dei
all-embracing => 'ɔ:lem'breisiŋ
all-fired => 'ɔ:l'faiәd
all-important => 'ɔ:lim'pɔ:tәnt
all-in wrestling => ɔ:l in ˈreslɪŋ
all-in-one => ɔ:l in wʌn
all-inclusive => 'ɔ:lin'klu:siv
all-or-none => 'ɔ:lә'nʌn
all-or-nothing => 'ɔ:lә'nʌθiŋ
all-over => ɔ:l ˈəuvə
all-party => ɔ:l ˈpɑ:ti
all-points bulletin => 'ɔ:l,pɔints
all-seater => 'ɔ:ls'i:tər
all-star => 'ɔ:lstɑ:(r)
all-terrain vehicle => ˈɔ:ltəˈreɪn
all-weather => 'ɔ:l'weðә(r)
all-wheel drive => ɔ:l hwi:l draiv
alla breve => ˈæləˈbreivi
Allah => 'ælә
Allahabad => 'ælәhә,bæd
allamanda => ,ælә'mændә
allan => 'ælәn
allanite => ә'lælәnait
allantoic => ,ælәn'tәuik
allantoid => ә'læntɔid
allantoin => æ'læntɔin
allantois => ә'læntәuis
allargando => .ɑ:lɑ:'gɑ:ndәu
allay => ә'lei
allayed => ə'leɪ
allaying => ə'leɪ
allays => əˈleɪz
allegation => .æli'geiʃәn
allegations => ælɪ'ɡeɪʃnz
allege => ә'ledʒ
alleged => ә'ledʒd
allegedly => ә'ledʒidli
alleges => əˈledʒz
allegiance => ә'li:dʒәns
allegiances => əˈli:dʒənsiz
alleging => ə'ledʒ
allegoric => ,æli'ɔrik
allegorical => .æli'gɒrikl
allegorically => .æli'gɒrikli
allegories => 'ælɪg(ə)rɪ
allegorist => 'æligәrist
allegorization => ,æli^әrai'zeiʃәn;-ri'z-
allegorize => 'æli^әraiz
allegorized => 'ælɪg(ə)raɪz
allegorizing => 'ælɪg(ə)raɪz
allegory => 'æligәri
allegretto => .æli'gretәu
allegro => ә'leigrәu
allele => ә'li:l
allelic => ә'li:lik
allelomorph => ә'li:lәmɔ:f
allelopathic => ælilə'pæθik
allelopathy => ә,li:'lɔpәθi
alleluia => ,æli'lu:jә
allemande => ,æli'mɑ:nd
allen => 'ælin, 'ælәn
Allenby => 'ælәnbi
allergen => 'ælәdʒәn
allergenic => .ælә'dʒenik
allergic => ә'lә:dʒik
allergies => ˈælədʒi:z
allergist => 'ælәdʒist
allergy => 'ælәdʒi
alleviate => ә'li:vieit
alleviates => əˈli:vieits
alleviation => ә.li:vi'eiʃәn
alleviative => ә'li:vieitiv
alleviator => ә'li:vieitә
alley => 'æli
alley cat => ˈæli kæt
alley-oop => ˌælɪ'u:p
alleyway => 'æliwei
alleyways => ˈæliweiz
allheal => 'ɔ:lhi:l
alliaceous => ,æli'eiʃәs
alliance => ә'laiәns
alliances => əˈlaiənsiz
allicin => 'ælәsin
allied => ә'laid
alligator => 'æligeitә
alligator pear => ˈælɪˌgeɪtə pɛə
alligator snapper => ˈælɪˌgeɪtə ˈsnæpə
alligators => ˈælɪˌgeɪtəz
Allison => 'ælisən
alliterate => ә'litәreit
alliterated => əˈlitəreitid
alliterates => əˈlitəreits
alliterating => əˈlitəreitɪŋ
alliteration => ә.litә'reiʃәn
alliterative => ә'litәrәtiv
allo => 'ælәu
allo- => 'ælәj
allocable => 'ælәjkәbl
allocate => 'ælәukeit
allocates => ˈæləkeits
allocation => .ælәu'keiʃәn
allocations => ˌæləˈkeiʃənz
allocator => 'ælәkeitә
allochthonous => ә'lɔkθәnәs
allocution => .ælәu'kju:ʃәn
allod => 'ælɔd
allodial => ә'lәudiәl
allogamous => ә'lɔ^әmәs
allogamy => ә'lɒgәmi
allogeneic => ,ælә'dʒenik
allograft => 'ælә^rɑ:ft
allograph => 'ælәugrɑ:f
allometric => ,ælә'metrik
allometry => ә'lɔmitri
allomorph => 'ælәmɔ:f
allomorphic => ,æləu'mɔ:fik
allopath => 'ælәupæθ
allopathic => .ælәu'pæθik
allopathist => ә'lɒpәθist
allopathy => ә'lɒpәθi
allopatric => ,ælә'pætrik
allopatry => 'æləʊpətrɪ
allophone => 'ælәufәun
allophonic => .ælәu'fɔnik
allopurinol => ,ælә'pju:rinɔl
allosaurus => 'ælә'sɔ:rәs
allosteric => ,ælә'sterik
allot => ә'lɒt
allotment => ә'lɒtmәnt
allotments => əˈlɔtmənts
allotrope => 'ælәutrәup
allotropic => .ælәu'trɒpik
allotropy => ә'lɔtrәpi
allots => əˈlɔts
allottee => ә.lɒt'i:
allow => ә'lau
allowable => ә'lauәbl
allowably => ə'lauəbli
allowance => ә'lauәns
allowances => əˈlauənsiz
allowancing => ə'laʊəns
allowedly => ә'lauidli
alloxan => ә'lɔksәn
alloy => 'ælɒi. ә'lɒi
alloying => 'ælɔiiŋ
allseed => 'ɒ:lsi:d
allspice => 'ɒ:lspais
allude => ә'lu:d
alluded => ə'l(j)uːd
alludes => əˈlu:dz
alluding => ə'l(j)uːd
allure => ә'luә
allured => əˈljuəd
allurement => ә'luәmәnt
allures => əˈljuəz
alluring => ә'luәriŋ
alluringly => ə'ljuəriŋli
allus => 'æləs
allusion => ә'lu:ʒәn
allusions => ə'lu:ʒnz
allusive => ә'lu:siv
alluvial => ә'lu:viәl
alluvion => ә'lu:viәn
alluvium => ә'lu:viәm
ally => 'ælai. ә'lai
allyl => 'ælil
allylic => 'ælә,lik
alm => ɑ:m
alma => 'ælmә
Almagest => 'ælmәdʒest
almanac => 'ɒ:lmәnæk
almanacs => ˈɔ:lməˌnæks
almandine => 'ælmәndi:n
almighty => ɒ:l'maiti
almirah => æl'maiәrә
almond => 'ɑ:mәnd
almonds => ˈɑ:məndz
almoner => 'ɑ:mәnә
almonry => 'ɑ:mәnri
almost => 'ɒ:lmәust
alms => ɑ:mz
almshouse => 'ɑ:mzhaus
almshouses => ˈɑ:mzˌhaʊsiz
almucantar => ,ælmju:'kæntә
aloe => 'ælәu
aloft => ә'lɒft
alogical => ә'lɔdʒikәl
aloha => ә'lәuhә
aloha shirt => əˈləuə ʃə:t
alone => ә'lәun
aloneness => ə'ləunis
along => ә'lɒŋ
alongshore => ә'lɒŋʃɒ:
alongside => ә'lɒŋ'said
aloof => ә'lu:f
aloofness => ə'lu:fnis
alopecia => .ælә'pi:ʃiә
alors => æ'lɔ:
aloud => ә'laud
alow => ә'lәu
Aloysius => ,ælәj'iʃәs
alp => ælp
alpaca => æl'pækә
alpargata => ,ælpɑ:'^ɑ:tә
alpenglow => 'ælpәnglәu
alpenhorn => 'ælpәnhɒ:n
alpenstock => 'ælpinstɒk
alpha => 'ælfә
alphabet => 'ælfәbit
alphabet soup => ˈælfəbit su:p
alphabetic => .ælfә'betik
alphabetical => .ælfә'betikәl
alphabetically => .ælfә'betikәli
alphabetization => ,ælfәbeti'zeiʃәn
alphabetize => 'ælfәbәtaiz
alphabetized => ˈælfəbitaizd
alphabetizing => ˈælfəbitaizɪŋ
alphabets => ˈælfəbits
alphafetoprotein => 'ælfә,fi:tә'prәjti:n
alphanumeric => .ælfәnju:'merik
alphas => ˈælfəz
Alphonse => 'ælfɔns
alphorn => 'ælphɔ:n
alpine => 'ælpain
alpine salamander => ˈælˌpaɪn ˈsæləmændə
alpines => æl'paɪnz
alpinist => 'ælpinist
Alps => ælps
already => ɒ:l'redi
alright => ɔ:l'rait
Alsace => æl'sæs
Alsatian => æl'seiʃ(ә)n
alsike => 'ɔ:lsaik
also => 'ɒ:lsәu
also-ran => 'ɔ:lsәj ræn
Alston => 'ɔ:lstən
alstroemeria => ælstrəʊe'mərɪə
alt => ælt
alta => 'æltә
Altai => æl'teiai
Altaic => æl'teiik
Altair => æl'tєә
altar => 'ɒ:ltә
altar boy => ˈɔ:ltə bɔi
altarpiece => 'ɔ:ltәpi:s
altars => ˈɔ:ltəz
Altay => 'æltai
altazimuth => æl'tæzimәθ
Altdorf => 'ɑ:ltdɔ:f
alter => 'ɒ:ltә
alter ego => æltәr 'ә^әj; (?@) æltә'i:gәj
alterable => 'ɒ:ltәrәbl
alteration => .ɒ:ltә'reiʃәn
altercate => 'ɒ:ltәkeit
altercated => 'ɔːltəkeɪt; 'ɒl-
altercating => 'ɔːltəkeɪt; 'ɒl-
altercation => .ɒ:ltә'keiʃәn
altercations => ˌɔ:ltəˈkeɪʃənz
altered => ˈɔ:ltəd
alternant => ɒ:l'tә:nәnt
alternate => 'ɒ:ltәnәt
alternately => 'ɒ:ltәnәtli
alternates => ˈɔːltə(r)neɪts
alternation => .ɒ:ltә'neiʃәn
alternative => ɒ:l'tә:nәtiv
alternative energy => ɔ:lˈtə:nətiv ˈenədʒi
alternative fuel => ɔ:lˈtə:nətiv fjuəl
alternative medicine => ɔ:lˈtə:nətiv ˈmedisin
alternatively => ɒ:l'tә:nәtivli
alternatives => ɔ:l'tɜ:nətɪvz
alternator => 'ɒ:ltәneitә
alternators => ˈɔ:ltə(:)neitəz
alters => ˈɔ:ltəz
althorn => 'ælthɒ:n
although => ɒ:l'ðou
altimeter => æl'timitә
altimeters => ˈæltimi:təz
altimetry => æl'timitri
altiplano => ,ælti'plɑ:nәj
altissimo => æl'tisimәj
altitude => 'æltitju:d
altitudes => 'æltɪtju:dz
altitudinal => ,æltә'tju:dinl
Altman => [ˈɔ:ltmən
alto => 'æltәu
alto clef => ˈæltəʊ klef
alto-relievo => ,æltәjri'li:vәj
altocumulus => .æltәu'kju:mjulәs
altogether => .ɒ:ltә'geðә
Alton => 'ɔ:ltәn
altostratus => .æltәu'streitәs
altricial => æl'triʃәl
altruism => 'æltruizm
altruist => 'æltruist
altruistic => .æltru'istik
altruistically => ,æltru'stikəli
aludel => 'æljudel
alula => 'æljulә
alum => 'ælәm
alumina => ә'lu:minә
aluminium => .ælju'miniәm
aluminize => ә'lu:minaiz
aluminized => æl'jʊmɪnaɪzd
aluminosilicate => ә,lju:mәnәu'silikeit
aluminous => ә'lu:minәs
aluminum => ә'lu:minәm
alumna => ә'lʌmnә
alumni => ә'lʌmni
alumnus => ә'lʌmnәs
alva => 'ælvә
alveolar => æl'viәlә
alveolate => æl'viәlit
alveolitis => æl,viә'laitis
alveolus => æl'viәlәs
alvin => 'ælvin
alway => 'ɔ:lwei
always => 'ɒ:lweiz
Alwyn => 'ælwin
ALYSON => 'ælisən
alyssum => ә'lisәm
Alzheimer => 'ælz'ɛmɚ
AM => æm
AMA => 'ɑ:mɑ:
amadavat => ,æmәdә'væt
Amadeus => a'madiəs
amadou => 'æmәdu:
amah => 'ɑ:mә
amalgam => ә'mælgәm
amalgamate => ә'mælgәmeit
amalgamates => əˈmælgəˌmeɪts
amalgamation => ә.mælgә'meiʃәn
amalgams => əˈmælgəmz
Amalthea => ,æmәl'θi:ә
amanda => ә'mændә
amanuensis => ә.mænju'ensis
amaranth => 'æmәrænθ
amaranthine => .æmә'rænθain
amaretto => ,æmә'retәj
amaryllis => .æmә'rilis
amass => ә'mæs
amassed => ə'mæs
amasses => əˈmæsiz
amateur => 'æmәtә
amateurish => .æmә'tә:riʃ
amateurishly => ˈæmətərɪʃlɪ
amateurism => 'æmәtә:rizm
Amati => ə'mɑ:ti
amatol => 'æmәtɒl
amatory => 'æmәtәri
amaurosis => .æmɒ:'rәusis
amaze => ә'meiz
amazed => ә'meizd
amazement => ә'meizmәnt
amazes => əˈmeiziz
amazing => ә'meiziŋ
amazon => 'æmәzɒn
Amazonas => ,æmә'zәunәs
Amazonian => ,æmә'zәunjәn
ambassador => æm'bæsәdә
ambassador-at-large => æm'bæsәdәrәt'lɑ:dʒ
ambassadorial => æm.bæsә'dɒ:riәl
ambassadors => æmˈbæsədəz
ambassadorship => æm'bæsәdәʃip
ambassadress => æm'bæsәdris
ambatch => 'æmbætʃ
amber => 'æmbә
ambergris => 'æmbәgri:s
amberjack => 'æmbәdʒæk
ambi- => 'æmbi
ambiance => 'æmbiәns
ambidexterity => .æmbidek'steriti
ambidextrous => .æmbi'dekstrәs
ambience => 'æmbiәns
ambient => 'æmbiәnt
ambiguity => .æmbi'gju:iti
ambiguous => æm'bigjuәs
ambiguousness => æm'bigjuəsnis
ambisexual => ,æmbi'seksjuәl
ambit => 'æmbit
ambition => æm'biʃәn
ambitions => æm'bɪʃənz
ambitious => æm'biʃәs
ambitiousness => æm'biʃəs
ambivalence => æm'bivәlәns
ambivalent => æm'bivәlәnt
ambiversion => .æmbi'vә:ʒәn
ambivert => 'æmbivә:t
amble => 'æmbl
ambled => 'æmb(ə)l
ambler => 'æmblә
ambles => ˈæmbəlz
ambling => 'æmb(ə)l
amblyopia => .æmbli'әupiә
amblyopic => ,æmbli'ɔpik
ambo => 'æmbәu
Ambonese => ,æmbɔi'ni:z; ,æmbə'ni:z
amboyna => æm'bɔinә
Ambrose => 'æmbrәuz
ambrosia => æm'brәuʒiә
ambrosia beetle => æmˈbrəʊzɪə ˈbi:tl
ambrosial => æm'brәuzjәl
ambry => 'æmbri
ambulacral => -krәl
ambulacrum => ,æmbju'leikrәm
ambulance => 'æmbjulәns
ambulanceman => 'æmbjʊlənsmæn
ambulances => ˈæmbjulənsiz
ambulant => 'æmbjulәnt
ambulate => 'æmbjuleit
ambulated => ˈæmbjuleitid
ambulating => ˈæmbjuleitɪŋ
ambulation => æmbju'leiʃәn
ambulatories => 'æmbjʊlət(ə)rɪ
ambulatory => 'æmbjulәtәri
ambuscade => .æmbәs'keid
ambuscaded => ˌæmbəsˈkeidid
ambuscading => ˌæmbəsˈkeidɪŋ
ambush => 'æmbuʃ
ambush marketing => ˈæmbʊʃ ˈmɑ:kɪtɪŋ
ambushes => ˈæmbʊʃiz
ambushing => 'æmbʊʃ
ameba => ә'mi:bә
amebiasis => ,æmi'baiәsis
amebic => ә'mi:bik
ameboid => ә'mi:bɔid
amelia => ә'mi:ljә
ameliorate => ә'mi:ljәreit
ameliorated => ə'miːlɪəreɪt
ameliorates => əˈmi:ljəˌreɪts
ameliorating => əˈmi:ljəˌreɪtɪŋ
amelioration => ә.mi:ljә'reiʃәn
ameliorative => ә'mi:ljәrәtiv
ameliorator => ə'mi:ljəreitə
amen => .ɑ:'men
amenability => ә.mi:nә'biliti
amenable => ә'mi:nәbl
amenably => ә'mi:nәbli
amend => ә'mend
amendable => ә'mendәbl
amender => ə'mendər
amendment => ә'mendmәnt
amendments => ə'mendmənts
amends => ә'mendz
Amenhotep => ,ɑ:mәn'hәutep
amenity => ә'mi:niti
amenorrhea => ei,menә'ri:ә
ament => 'eimәnt
amentia => ә'menʃә
Amerasian => æmә'reiʃәn
amerce => ә'mә:s
amerced => ə'mɜːs
amercement => 'әm\\\\:smәnt
amercing => ə'mɜːs
America => ә'merikә
American => ә'merikәn
americana => ә,meri'kɑ:nә
Americanism => ә'merikәnizәm
Americanization => ә,merikәnai'zeiʃən;-ni'z-
Americanize => ә'merikәnaiz
Americanizes => ə'merikənaiz
AMERICAS => ə'merikəz
americium => .æmә'riʃiәm
Amerindian => ,æmә'rindjәn
AMES => eimz
Ameslan => 'æmәslæn
amethyst => 'æmiθist
amethystine => ,æmi'θistain
amethysts => ˈæməθɪsts
Amex => 'æmeks
Amhara => ɑ:m'hɑ:rɑ:
Amharic => æm'hærik
Amherst => 'æmhә:st
ami => ɑ:'mi:
amiability => eimjә'biliti
amiable => 'eimjәbl
amiably => 'eimjәbli
amianthus => ,æmi'ænθәs
amicability => .æmikә'biliti
amicable => 'æmikәbl
amicably => 'æmikәbli
amice => 'æmis
amicus => æ'mɪkəs
amid => ә'mid
amide => 'æmaid
amides => æ'maɪdz
amidships => ә'midʃips
amidst => ә'midst
Amiens => 'æmiәnz
amigo => ә'mi:gәu
amigos => ә'mi:ɡәuz
Amindivi Islands => ,ʌmin'di:vi
amine => ә'mi:n
amino => 'æminәu
amino acid => ə,mi:nəu 'æsid
aminoglycoside => ,æminə'ɡlikəsaid
aminotransferase => ә,mi:nәu'trænsfә,reis
amir => ә'miә
AMIS => 'eimis
amish => 'ɑ:miʃ
amiss => ә'mis
amitosis => .æmi'tәusi:s
amitotically => ,æmi'tɔtikəli
amitriptyline => ,æmi'triptli:n
amity => 'æmiti
amma => 'ʌmɑ:
Amman => æ'mɑ:n
ammeter => 'æmitә
ammo => 'æmәu
Ammon => 'æmәn
ammonia => ә'mәunjә
ammoniacal => ә'mәuniækәl
ammoniate => ә'mәunieit
ammoniated => ә'mәunieitid
ammonite => 'æmәnait
ammonium => ә'mәunjәm
ammonoid => 'æmә,nɔid
ammunition => .æmju'niʃәn
amnesia => æm'ni:zjә
amnesiac => æm'ni:zi,æk
amnesic => æm'ni:zik
amnestied => 'æmnɪstɪ
amnesties => ˈæmnɪsti:z
amnesty => 'æmnisti
amnestying => 'æmnɪstɪ
amnio => 'æmniəu
amniocentesis => .æmniәusen'ti:sis
amnion => 'æmniәn
amoeba => ә'mi:bә
amoebae => ә'mi:bi:
amoebiasis => ,æmi'baiәsis
amoebic => ә'mi:bik
amoeboid => ә'mi:bɒid
amok => ә'mɔk
amon => 'ɑ:mәn
among => ә'mʌŋ
amongst => ә'mʌŋst
amontillado => ә.mɒnti'lɑ:dou
amor => 'eimɔ
amoral => ei'mɒrәl
amoralism => eɪ'mɒrəlɪzəm
amorality => .eimɔ'rælәti
amoretto => 'ɑ:mә'retәu
amorist => 'æmәrist
amoroso => ,æmә'rәjsәj
amorous => 'æmәrәs
amorously => 'æmərəsli
amorphous => ә'mɒ:fәs
amortise => ә'mɔ:taiz,'æmә-
amortization => ә,mɔ:ti'zeiʃәn
amortize => ә'mɒ:taiz
amortized => 'əmɔ:taɪzd
amortizes => ˈæməˌtaɪziz
amortizing => ˈæməˌtaɪzɪŋ
Amory => 'eiməri
Amos => 'eimәs
amount => ә'maunt
amounted => ə'maʊnt
amounting => ə'maʊnt
amour => ә'muә
amour propre => əˌmʊə(r) ˈprɒprə
amours => əˈmuəz
amoxycillin => ә,mɔksә'silin
amp => æmp
ampelopsis => .æmpi'lɒpsis
amperage => 'æmpәridʒ
ampere => 'æmpєә
amperes => ˈæmˌpɪəz
ampersand => 'æmpәsænd
amphetamine => æm'fetәmi:n
amphetamines => æm'fetəmi:nz
amphi- => 'æmfi
amphibian => æm'fibiәn
amphibians => æm'fɪbɪənz
amphibious => æm'fibiәs
amphibole => 'æmfibәul
amphibolite => æm'fibәlait
amphibology => .æmfi'bɒlәdʒi
amphiboly => æm'fibәli
amphibrach => 'æmfibræk
amphimictic => ,æmfi'miktik
amphimixis => .æmfi'miksis
amphioxus => .æmfi'ɒksәs
amphipathic => ,æmfi'pæθik
amphiphilic => ,æmfi'filik
amphipod => 'æmfipɔd
amphiprostyle => æm'fiprәustail
amphisbaena => .æmfis'bi:nә
amphisbaenian => ,æmfis'bi:niәn
amphitheater => 'æmfi.θiәtә
amphitheatres => ˈæmfθətəz
Amphitrite => 'æmfitraiti
amphora => 'æmfәrә
amphoteric => .æmfә'terik
amphotericin => ,æmfә'terәsin
ampicillin => ,æmpi'silin
ample => 'æmpl
amplexus => æm'pleksәs
amplification => .æmplifi'keiʃәn
amplifications => ,æmplɪfɪ'keɪʃən
amplifier => 'æmplifaiә
amplifiers => 'æmplɪfaɪəz
amplifies => ˈæmplifaiz
amplify => 'æmplifai
amplitude => 'æmplitju:d
amply => 'æmpli
ampoule => 'æmpu:l
ampoules => ˈæmpu:lz
ampule => 'æmpul
ampulla => æm'pulә
amputate => 'æmpjuteit
amputates => ˈæmpjʊˌteɪts
amputation => .æmpju'teiʃәn
amputator => 'æmpjuteitә
amputee => .æmpju'ti:
Amritsar => ,ʌm'ritsә(r)
Amsterdam => .æmstә'dæm
amtrac => 'æmtræk
amtrak => 'æmtræk
amuck => ә'mʌk
amulet => 'æmjulit
amulets => ˈæmjəlɪts
Amundsen => 'ɑ:mjndsən
Amur => ә'muә
amuse => ә'mju:z
amuse-bouche => əm'ju:zb'aʊʃ
amuse-gueule => ɑ:ˈmju:zɡə:l
amused => ә'mju:zd
amusedly => ә'mju:zidli
amusement => ә'mju:zmәnt
amusement arcade => ˌəˈmju:zmənt ɑ:ˈkeɪd
amusements => ˌəˈmju:zmənts
amuses => əˈmju:ziz
amusing => ә'mju:ziŋ
amusingly => ə'mju:zɪŋlɪ
amy => 'eimi
amygdala => ә'migdәlә
amygdale => ә'mi^deil
amygdalin => ә'mi^dәlin
amygdaloid => ә'mi^dәlɔid
amygdaloidal => ә,mi^dә'lɔidəl
amyl => 'æmil
amylase => 'æmileis
amyloid => 'æmilɒid
amyloidosis => ,æmilɔi'dәjsis
amylopectin => ,æmilәu'pektin
amylose => 'æmilous
Amytal => 'æmitæl
an => æn
an- => 'æn
ana => 'ɑ:nә
ana- => 'ænә
anabaptist => .ænә'bæptist
anabatic => .ænә'bætik
anabiosis => .ænәbai'әusis
anabolic => .ænә'bɒlik
anabolic steroid => ˌænəbɒlɪk ˈsterɔɪd
anabolism => ә'næbәulizәm
anabranch => 'ænәbrɑ:ntʃ
anachronic => ,ænә'krɔnik
anachronism => ә'nækrәnizәm
anachronisms => ə'nækrənɪzəmz
anachronistic => ә.nækrә'nistik
anaclitic => ,ænә'klitik
anacoluthic => ,ænəkə'lu:θik
anacoluthon => .ænәkәu'lu:θɒn
anaconda => ,ænә'kɔndә
Anacreon => ә'nækriәn
anacrusis => ,ænә'kru:sis
anadromous => ә'nædrәmәs
anaemia => ә'ni:mjә
anaemic => ә'ni:mik
anaerobe => æ'nєәroub
anaerobic => .ænєә'rәubik
anaesthesia => .ænis'θi:zjә
anaesthesiology => 'ænis,θi:zi'ɔlәdʒi
anaesthetic => .ænis'θetik
anaesthetics => .ænis'θetiks
anaesthetise => æ'ni:sθәtaiz,ә'nes-
anaesthetised => æ'ni:sθətaiz, ə'nes-
anaesthetist => æ'ni:sθәtist
anaesthetists => əˈnesθɪtɪsts
anaesthetization => æ,ni:sθiti'zeiʃәn
anaesthetize => ә'ni:sθәtaiz
anaesthetized => ˈənesθɪˌtaɪzd
anaesthetizes => ˈənesθɪˌtaɪziz
anaesthetizing => 'əni:sθətaɪzɪŋ
anagenesis => ,ænә'dʒenisis
anagenetic => ,ænәdʒi'netik
anaglyph => 'ænәglif
anaglyphic => ,ænә'^lifik
anagnorisis => ,ænә^'nɔrisis
anagogic => ,ænә'^әudʒik
anagram => 'ænәgræm
anagrammatic => ,ænəɡrə'mætik
anagrammatical => ,ænəɡrə'mætikəl
anagrammatize => .ænә'græmәtaiz
anagrams => 'ænəɡræmz
anal => 'einәl
anal-retentive => ˌeɪnəlrɪˈtentɪv
analects => 'ænәlekts
analeptic => .ænә'leptik
analgesia => .ænæl'dʒi:zjә
analgesic => .ænæl'dʒi:zik
analgesics => ˌænəl'dʒi:zɪks
anally => -nəli
analog => 'ænәlɔ^
analogical => ,ænә'lɔdʒikәl
analogically => ,ænə'lɔdʒikəli
analogize => ә'nælәdʒaiz
analogized => əˈnælədʒaizd
analogizes => əˈnælədʒaiziz
analogizing => əˈnælədʒaizɪŋ
analogous => ә'nælәgәs
analogously => ə'næləgəsli
analogue => 'ænәlɒg
analogues => 'ænəlɒɡz
analogy => ә'nælәdʒi
analphabetic => .ænælfә'betik
analysable => 'ænәlaizәbl
analysand => ә'nælisænd
analyse => 'ænәlaiz
analyser => 'ænәlaizә
analysing => æ'nəlaɪzɪŋ
analysis => ә'nælәsis
analyst => 'ænәlist
analyte => 'ænәlait
analytic => .ænә'litik
analytical => .ænә'litikl
analytics => .ænә'litiks
analyze => 'ænәlaiz
analyzer => 'ænәlaizә
analyzes => ˈænəlaiziz
anamnesis => .ænæm'ni:sis
anamnestic => .ænæm'ni:stik
anamorphic => ,ænә'mɔ:fik
anamorphosis => .ænә'mɒ:fәsis
ananda => 'ɑ:nəndə
Ananias => ,ænә'naiәs
anapaest => 'ænәpi:st
anapaestic => ,ænə'pi:stik
anaphase => 'ænә,feiz
anaphor => ə'næfə
anaphora => ә'næfәrә
anaphoric => .ænә'fɒ:rik
anaphrodisiac => æn,æfrә'diziæk
anaphylactic => ,ænәfi'læktik
anaphylaxis => .ænәfi'læksis
anapsid => æ'næpsɪd
anaptyctic => ,ænæp'tiktik
anaptyxis => ,ænәp'tiksis
anarch => 'ænɑ:k
anarchic => æ'nɑ:kik
anarchical => æ'nɑ:kikәl
anarchism => 'ænәkizәm
anarchist => 'ænәkist
anarchistic => .ænә'kistik
anarchists => ˈænəkists
anarchy => 'ænәki
Anasazi => ,a:nə'sa:zi:
anastigmat => ә'næstigmæt
anastigmatic => ә.næstig'mætik
anastomose => ,æ'næstәmәuz
anastomosed => ə'næstəməʊz
anastomosis => .ænәstә'mәusis
anastrophe => ә'næstrәfi
anathema => ә'næθәmә
anathemas => ə'næθəmə
anathematize => ә'næθәmәtaiz
Anatole => 'ænәtәjl
Anatolia => .ænә'tәuljә
Anatolian => ,ænә'tәjljәn
anatomic => ,ænә'tɔmik
anatomical => .ænә'tɒmikl
anatomies => ə'nætəmɪ
anatomist => ә'nætәmist
anatomists => əˈnætəmists
anatomize => ә'nætәmaiz
anatomized => ə'nætəmaɪz
anatomizes => əˈnætəmaiziz
anatomizing => ə'nætəmaɪz
anatomy => ә'nætәmi
anatto => ә'nɑ:tәu
ancestor => 'ænsestә
ancestors => 'ænsestəz
ancestral => æn'sestrәl
ancestress => 'ænsestris
ancestries => ˈænsistriz
ancestry => 'ænsestri
Anchises => æŋ'kaisi:z
ancho => 'ænkəʊ
anchor => 'æŋkә
anchorage => 'æŋkәridʒ
anchorages => ˈæŋkərɪdʒz
anchoress => 'æŋkәris
anchorite => 'æŋkәrait
anchoritic => ,æŋkə'ritik
anchorman => 'æŋkәmæn
anchorperson => 'æŋkә,p\\\\:sən
anchors => ˈæŋkəz
anchorwoman => 'æŋkə,wumən
anchoveta => ,æntʃәj'vetә
anchovies => ˈæntʃəviz
anchovy => 'æntʃәvi
anchusa => æn'kju:zә
ancient => 'einʃәnt
ancient history => ˈeinʃənt ˈhistəri
ancient monument => ˈeinʃənt ˈmɔnjumənt
anciently => 'einʃәntli
ancients => 'eɪnʃənts
ancillary => æn'silәri
ancon => 'æŋkɒn
Ancona => æŋ'kәjnә
ancylostomiasis => ,ænsi,lɔstә'maiәsis
and => ænd
and everything => ænd ˈevriθiŋ
Andalusia => .ændә'lu:zjә
Andalusian => ,ændә'lu:ziәn
andalusite => ,ændә'lu:sait
andante => æn'dænti
andantes => ænˈdæntiz
andantino => ,ændæn'ti:nәu
andean => 'ændiәn, æn'di:әn
Andersen => 'ændәsәn
anderson => 'ændәsn
Andes => 'ændi:z
andesite => 'ændizait
andiron => 'ændairәn
andorra => æn'dɔrә
Andorran => æn'dɔ:rәn
Andover => 'æn,dəuvə
andradite => 'ændrәdait
andre => 'ændri, 'ɑ:ndrei
andrea => 'ændriә,ɑ:n'dreiә
andrew => 'ændru:
andrews => 'ændru:z
andro- => 'ændrәj
androcentric => ,ændrә'sentrik
Androcles => 'ændrәkli:z
androcracy => æn'drɔkrәsi
androcratic => ,ændrə'krætik
androecium => æn'dri:ʃiәm
androgen => 'ændrәdʒәn
androgenize => æn'drɔdʒәnaiz
androgyne => 'ændrɔdʒain
androgynous => æn'drɒdʒinәs
androgyny => æn'drɔdʒini
android => 'ændrɒid
androids => ˈændrɔidz
andrology => æn'drɒlәdʒi
Andromache => æn'drɔmәki
Andromeda => æn'drɒmidә
andropause => 'ændrəupɔ:z
androstenedione => 'ændrә,sti:n'daiәjn
androsterone => æn'drɒstәrәun
andy => 'ændi
anecdotage => 'ænik.dәutidʒ
anecdotal => ,ænek'dәutl
anecdotalist => ,ænik'dәjtәlist
anecdote => 'ænikdәut
anechoic => .æni'kәuik
anele => ә'ni:l
aneled => ə'niːl
aneles => ə'niːl
aneling => ə'niːl
anemia => ә'ni:miә
anemic => ә'ni:mik
anemograph => ә'nemәgrɑ:f
anemometer => .ænә'mɒmitә
anemometric => .ænәmәu'metri:k
anemometry => .æni'mɒmitri
anemone => ә'nemәni
anemones => əˈneməniz
anemophilous => .æni'mɒfilәs
anemophily => ,æni'mɔfili
anencephalic => -'fælik
anent => ә'nent
anergy => 'ænәdʒi
aneroid => 'ænәrɒid
anesthesia => .ænis'θi:ziә
anesthesiologist => ,ænis,θizi'ɔlәdʒist
anesthesiology => ,ænisθizi'ɔlәdʒi
anesthetic => .ænis'θetik
anesthetist => æ'ni:sθәtist
anesthetize => æ'ni:sθәtaiz
anesthetized => æ'niːsθətaɪz
anesthetizes => ˈənesθɪˌtaɪziz
anesthetizing => 'əni:sθətaɪzɪŋ
aneuploid => 'ænjjplɔid
aneurin => ә'naiәrin
aneurism => 'ænjuәrizm
aneurysm => 'ænjuәrizm
anew => ә'nju:
anfractuosity => .ænfræktʃu'ɒsiti
anfractuous => æn'fræktʃuәs
angel => 'eindʒәl
angel dust => ˈeindʒəl dʌst
angel shark => ˈeindʒəl ʃɑ:k
angela => 'ændʒilә
Angeleno => ,ændʒi'li:nәu
angelic => æn'dʒelik
angelica => æn'dʒelikә
angelical => æn'dʒelikәl
angelically => æn'dʒelikli
angelina => ,ændʒi'li:nә
Angelino => ,ændʒә'li:nәj
Angell => 'eindʒәl
angelo => 'ændʒilәu
angelology => eindʒә'lɒlәdʒi
angels => 'eindʒәls
angelus => 'ændʒilәs
anger => 'æŋgә
angering => 'æŋgə
angers => 'ændʒәz
Angevin => 'ændʒivin
angina => æn'dʒainә
angio- => 'ændʒiәj
angiogram => 'ændʒiәj^ræm
angiographic => ˌændʒiəuˈɡræfik
angiography => ,ændʒi'ɔ^rәfi
angioma => ,ændʒi'әumә
angiosarcoma => ,ændʒiәjsɑ:'kәjmә
angiosperm => 'ændʒiәspә:m
angiospermous => ,ændʒiə'spə:məs
angiotensin => ,ændʒiәj'tensin
Angkor => 'æŋkɔ:
anglaise => ɑ:ŋ'ɡleiz
angle => 'æŋgl
angle grinder => ˈæŋɡl ˈgraɪndə
angled => 'æŋ^ld
anglepoise => 'æŋɡl,pɔiz
angler => 'æŋ^lә
anglerfish => 'ængləfɪʃ
anglers => ˈæŋɡləz
angles => 'æŋɡlz
Anglesey => 'æŋgəlsi:
Anglia => 'æŋgliә
anglian => 'æŋ^ljәn
Anglican => 'æŋglikәn
anglicanism => 'æŋ^likәnizəm
Anglicise => 'æŋglisaiz
Anglicism => 'æŋglisizm
Anglicize => 'æŋglisaiz
anglicizes => ˈæŋglɪˌsaɪziz
anglicizing => 'æŋɡlisaiz
angling => 'æŋgliŋ
anglo => 'æŋ^lәj
Anglo- => 'æŋ^lәj
Anglo-American => 'æn^lәuә'merikәn
Anglo-Catholic => 'æŋ^lәu'kæθәlik
Anglo-Saxon => 'æŋ^lәu'sæksәn
Anglocentric => ,æŋ^lәj'sentrik
Anglomania => .æŋglәu'meinjә
Anglomaniac => .æŋglәu'meiniæk
Anglophile => 'æŋglәufail
Anglophilia => 'æŋ^lәj'filiә
Anglophobe => 'æŋglfәub
Anglophobia => æŋglәu'fәubiә
anglophone => 'æŋ^lәufәun
Angola => æŋ'^әulә
Angolan => æŋ'^әjlәn
Angora => æŋ'gәurә
angostura => .æŋgәs'tjuәrә
angrily => 'æŋgrili
angry => 'æŋgri
angst => æŋst
angstrom => 'æŋstrәm
Anguilla => æŋ'^wilә
anguilliform => æŋ'ɡwilə,fɔ:m
anguish => 'æŋgwiʃ
anguished => 'æŋgwiʃt
anguishes => ˈæŋɡwiʃiz
anguishing => 'æŋgwɪʃ
angular => 'æŋgjulә
angularity => æŋgju'læriti
angulate => 'æŋgjuleit
angulated => 'æŋ^jjleitid
angulation => ,æŋ^ju'leiʃәn
angus => 'æŋ^әs
angwantibo => æŋ'^wɑ:ntibәu
anharmonic => ænhɑː'mɒnɪk
anharmonicity => ænhɑ:mɒ'nɪsɪtɪ
anhedonia => ,ænhi:'dәjniә
anhedonic => ,ænhi:'dəunik
anhinga => æŋ'hiŋ^ә
Anhui => 'ɑ:n'hwei
anhydride => æn'haidraid
anhydrite => æn'haidrait
anhydrous => æn'haidrәs
anil => 'ænil
aniline => 'ænili:n
anilingus => ,eini'liŋ^әs
anima => 'ænimә
animadversion => .ænimæd'vә:ʃәn
animadvert => .ænimæd'vә:t
animadverted => ˌænəmædˈvɜ:tid
animadverting => ,ænɪməd'vɜːt
animadverts => ˌænəmædˈvɜ:ts
animal => 'ænimәl
animal husbandry => ˈæniməl ˈhʌzbəndri:
animalcular => ,æni'mælkjulə
animalcule => æni'mælkjul
animalism => 'æni,mәlizәm
animalist => 'ænimәlist
animalistic => ,ænimә'listik
animality => ,æni'mæliti
animalization => ,ænimәlai'zeiʃәn
animalize => 'ænimәlaiz
animalized => 'ænɪm(ə)laɪz
animate => 'ænimeit
animated => 'ænimeitid
animates => ˈænəˌmeɪts
animateur => ,ɑ:nimɑ:'t\\\\:r
animatic => .æni'mætik
animation => .æni'meiʃәn
animations => ˌænəˈmeɪʃənz
animato => ,æni'mɑ:tәj
animator => 'ænimeitә
animators => 'ænɪmeɪtəz
animatronics => ,ænimə'trɔniks
anime => 'ænimei
animism => 'ænimizәm
animist => 'ænimist
animistic => æni'mistik
animists => 'ænimist
animosities => ,ænɪ'mɒsɪtɪ
animosity => .æni'mɒsiti
animus => 'ænimәs
anion => 'ænaiәn
anionic => ',ænai'ɔnik
anise => 'ænis
aniseed => 'ænisi:d
anisette => æni'zet
anisogamy => ,ænai'sɔ^әmi
anisotropic => ә,naisәu'trɔpik
anisotropies => ,ænaɪ'sɒtrəpɪ
anisotropy => ,ænai'sɔtrәpi
anita => ә'ni:tә
Anjou => ændʒu:
Ankara => 'æŋkәrә
ankh => æŋk
ankle => 'æŋkl
ankles => ˈæŋklz
anklet => 'æŋklit
anklets => 'æŋklit
ankus => 'æŋkәs
ankylosaur => 'æŋkәlәu,sɔ:
ankylose => 'æŋkilәus
ankylosing => æŋkɪ'ləʊzɪŋ
ankylosis => æŋki'lәusis
ankylostomiasis => ,æŋkai,lɔstә'maiәsis
anlage => 'ɑ:nlɑ:^ә
ann => æn
anna => 'ænә
Annaba => æn'nɑ:bә
Annabel => 'ænəbel
ANNABELLE => ænə'bel
annal => 'ænәl
annalist => 'ænәlist
annalistic => ,ænә'listik
annals => 'ænәlz
Annamese => .ænә'mi:z
Annan => ˈænən]
Annandale => 'ænən,deil
Annapurna => ,ænə'puənə
annates => 'æneits
annatto => ә'nɑ:tәu
anne => æn
anneal => ә'ni:l
annealing => æ'ni:liŋ
anneals => əˈni:lz
annelid => 'ænәlid
Annelida => ә'nelidә
annelidan => ә'nelidәn
annette => ә'net
annex => ә'neks
annexation => ænek'seiʃәn
annexe => 'æneks
annexes => əˈneksiz
annexing => æˈnɛks; (for n.)ˈænɛks
annie => 'æni
annihilate => ә'naiәleit
annihilated => ə'naiəleitid
annihilates => əˈnaɪəˌleɪts
annihilation => ә.naiә'leiʃәn
annihilator => ә'naiәleitә
anniversary => æni'vә:sәri
Anno Domini => 'ænәu'dɔminai
annotate => 'ænәuteit
annotated => 'ænә.teitid
annotates => ˈænəʊˌteɪts
annotation => ænәu'teiʃәn
annotator => 'ænәuteitә
announce => ә'nauns
announcement => ә'naunsmәnt
announcer => ә'naunsә
announcers => ə'naʊnsəz
announces => əˈnaunsiz
annoy => ә'nɒi
annoyance => ә'nɒiәns
annoyances => əˈnɔɪənsiz
annoying => ә'nɒiiŋ
annoyingly => ә'nɒiiŋli
annoys => əˈnɔiz
annual => 'ænjuәl
annualised => 'ænjuəlaizd
annualized => 'ænjuə,laizd
annually => 'ænjuәli
annuitant => ә'nju:itәnt
annuitants => əˈnju:ɪtənts
annuity => ә'nju:iti
annul => ә'nʌl
annular => 'ænjulә
annularly => ˊænjulәli
annulate => 'ænjuleit
annulation => ,ænjj'leiʃən
annulet => 'ænjulet
annulled => ə'nʌld
annulment => ә'nʌlmәnt
annuls => əˈnʌlz
annulus => 'ænjulәs
annunciate => ә'nʌnʃieit
annunciated => ə'nʌnsɪeɪt
annunciates => əˈnʌnʃieits
annunciating => ə'nʌnsɪeɪt
annunciation => ә.nʌnsi'eiʃәn
annunciator => ә'nʌnʃieitә
annus mirabilis => ˈænəsmɪˈræbəlɪs
anoa => ә'nәuә
anodal => 'ænәudәl
anode => 'ænәud
anodes => ˈænˌəʊdz
anodic => ә'nɔdik
anodize => 'ænәjdaiz
anodizes => ˈænəudaiziz
anodyne => 'ænәudain
anoint => ә'nɒint
anoints => əˈnɔɪnts
anole => ə'nəuli
anomalistic => ә.nɒmә'listik
anomalistic month => əˌnɔməˈlistik mʌnθ
anomalistic year => əˌnɔməˈlistik jə:
anomalous => ә'nɒmәlәs
anomalously => ə'namələsli
anomaly => ә'nɒmәli
anomic => ә'nɔmik
anomie => 'ænәmi
anon => ә'nɒn
anonym => 'ænәnim
anonymity => .ænә'nimiti
anonymize => əˈnɒnɪmaɪz
anonymous => ә'nɒnimәs
anopheles => ә'nɔfili:z
anorak => 'ɑ:nәrɑ:k
anoraks => ˈænəræks
anorectic => ,ænә'rektik
anorexia => .ænә'reksiә
anorexic => ˌænəˈreksɪk
anorthite => ә'nɔ:θait
anorthosite => æ'nɔ:θәsait
anosmia => æ'nɒzmiә
another => ә'nʌðә
another place => əˈnʌðər pleis
anovulant => æ'nɔvjjlәnt
anovulatory => æ'nɔvjjlәtəri
anoxia => æ'nɒksiә
anoxic => æ'nɔksik
anschluss => 'ɑ:nʃlus
anselm => 'ænselm
anserine => 'ænsәrain
Anshan => 'ɑ:n'ʃæn
answer => 'ɑ:nsә
answer for => ˈɑ:nsə fɔ:
answerable => 'ɑ:nsәrәbl
answering machine => 'ɑ:nsəriŋ
answering service => ˈɑ:nsərɪŋ ˈsɜːvɪs
answerphone => 'ænsɚ'fon
ant => ænt
ant- => ænt
Antabuse => 'æntәbju:s
antacid => .ænt'æsid
Antaeus => æn'tiәs
antagonise => æn'tæ^әnaiz
antagonism => æn'tægәnizm
antagonist => æn'tægәnist
antagonistic => æn.tægә'nistik
antagonistically => ænˌtæɡə'nɪstɪklɪ
antagonists => æn'tæɡənɪsts
antagonize => æn'tægәnaiz
antagonized => æn'tæɡənaiz
antagonizes => ænˈtægəˌnaɪziz
antagonizing => ænˈtægəˌnaɪzɪŋ
Antakya => ,ɑ:ntɑ:'kjɑ:
Antananarivo => ,ɑ:ntənɑ:nə'ri:vəu
antarctic => ænt'ɑ:ktik
Antarctica => ænt'ɑ:ktikә
ante => 'ænti
ante up => ˈænti: ʌp
ante- => 'ænti
ante-post => 'ænti:p'əʊst
ante-room => 'ænti:r'u:m
anteater => 'ænt.i:tә
antebellum => .ænti'belәm
antecedence => ænti'si:dәns
antecedent => .ænti'si:dnt
antecedently => ,ænti'si:dəntli
antechamber => 'ænti.tʃeimbә
antechambers => ˈæntitʃeimbəz
antechapel => 'ænti.tʃæpl
antedate => 'ænti,deit
antedates => ˈæntɪˌdeɪts
antediluvian => .æntidi'lu:viәn
anteed => 'æntɪ
anteing => ˈænti:ɪŋ
antelope => 'æntilәup
antelopes => ˈæntlˌəʊps
antenatal => .ænti'neitl
antenna => æn'tenә
antennae => æn'teni:
antennal => -nәl
antennary => æn'tenərɪ
antennas => æn'tenəz
antennule => æn'tenju:l
antenuptial => ænti'nʌpʃәl
antepartum => ,ænti'pɑ:tәm
antepenultimate => æntipi'nʌltimәt
anterior => æn'tiәriә
anteriority => -'ɔriti
anteriorly => æn'tiri:əli
anteroom => 'æntirum
anterooms => ˈæntirumz
antes => ˈænti:z
Anthea => æn'θi:ә
anthelion => æn'θi:ljәn
anthelmintic => .ænθel'mintik
anthem => 'ænθәm
anthemion => æn'θi:miәn
anthems => ˈænθəmz
anther => 'ænθә
antheridial => ,ænθə'ridiəl
antheridium => .ænθә'ridiәm
antherozoid => ,ænθәrә'zәuid
anthesis => æn'θi:sis
anthill => 'ænthil
antho- => 'ænθәj
anthocyanin => ,ænθә'saiәnin
anthologies => ænˈθɔlədʒi:z
anthologist => æn'θɒlәdʒist
anthologize => æn'θɒlәdʒiz
anthologized => ænˈθɔlədʒaizd
anthologizing => ænˈθɔlədʒaizɪŋ
anthology => æn'θɒlәdʒi
anthony => 'æntәni
anthophilous => æn'θɔfilәs
Anthozoa => ,ænθә'zәjә
anthozoan => .ænθә'zәuәn
anthracene => 'ænθrәsi:n
anthracite => 'ænθrәsait
anthracitic => .ænθrә'sitik
anthracnose => æn'θræknәus
anthranilate => æn'θrænileit
anthraquinone => ,ænθrәkwi'nәun
anthrax => 'ænθræks
anthropic => æn'θrɔpik
anthropic principle => ænˈθrɔpik ˈprinsəpl
anthropo- => 'ænθrәjpәj
anthropocentric => ,ænθrәpәu'sentrik
anthropocentrism => ,ænθrәjpәj'sentrizəm
anthropoid => 'ænθrәupɒid
anthropological => .ænθrәpә'lɒdʒikl
anthropologically => ˌænθrəpə'lɒdʒɪklɪ
anthropologist => .ænθrә'pɒlәdʒist
anthropology => .ænθrә'pɒlәdʒi
anthropometric => .ænθrәpә'metrik
anthropometry => .ænθrә'pɒmitri
anthropomorphic => .ænθrәpә'mɒ:fik
anthropomorphism => .ænθrәpә'mɒ:fizәm
anthropomorphize => .ænθrәpә'mɒ:faiz
anthropomorphized => ˌænθrəupəuˈmɔ:faizd
anthropomorphizes => ˌænθrəupəuˈmɔ:faiziz
anthropomorphizing => ˌænθrəupəuˈmɔ:faizɪŋ
anthropomorphous => .ænθrәpә'mɒ:fәs
anthropopathy => ,ænθrәu'pɔpәθi
anthropophagi => ,ænθrə'pɒfə,ɡaɪ
anthropophagous => ,ænθrәu'pɔfә^әs
anthropophagy => .ænθrәu'pɒfәdʒi
anthroposophical => - pә'sɔfikəl
anthroposophy => ,ænθrәj'pɔsәfi
anthurium => æn'θjjәriәm
anti => 'ænti
anti- => 'ænti
anti-abortion => ,ænti:ə'bɔ:ʃən
anti-abortionist => 'ænti:əb'ɔ:ʃənɪst
anti-aircraft => ˈænti ˈɛəkrɑ:ft
anti-American => ,æntiә'merikәn
anti-apartheid => ,æntiə'pɑ:theit
anti-capitalist => ,æntɪ'kæpɪtəlɪst
anti-choice => ˌæntiˈtʃɔis
anti-christian => ,ænti'kristjən
anti-communist => 'ænti'kɔmjunist
anti-emetic => 'ænti:ɪm'etɪk
anti-establishment => ,æntii'stæbliʃmənt
anti-hero => ˈænti ˈhiərəu
anti-life => ,ænti'laif
anti-lock => ˈænti:ˌlɔk, ˈæntaɪ-
anti-national => ,æntɪ'næʃənl
anti-personnel => ˌæntipə:səˈnel
anti-racist => ,æntɪ'reɪsɪst
anti-roll bar => ˈænti rəul bɑːr
anti-Semite => ænti'si:mait; (?@) ænti'semit
anti-Semitic => ænti'semitik
anti-Semitism => ænti'semitiz(ә)m
anti-social => ,ænti'səuʃəl
anti-tank => ˈænti tæŋk
anti-war => 'ænti'wɔ:
antiaircraft => .ænti'єәkrɑ:ft
antibacterial => .æntibæk'tiәriәl
antibiosis => .æntibai'әusis
antibiotic => .æntibai'ɒtik
antibody => 'æntibɒdi
antic => 'æntik
anticathode => .ænti'kæθәud
anticholinergic => 'ænti,kәjli'n\\\\:dʒik
antichrist => 'æntikraist
anticipate => æn'tisipeit
anticipates => ænˈtisipeits
anticipating => æn'tɪsɪpeɪtɪŋ
anticipation => æn.tisi'peiʃәn
anticipative => æn'tisipeitiv
anticipator => æn'tisipeitә
anticipatory => æn'tisipeitәri
anticking => ˈæntɪkɪŋ
anticlerical => 'ænti'klerikl
anticlimactic => 'æntiklai'mæktik
anticlimax => .ænti'klaimæks
anticlimaxes => ˌænti:ˈklaɪˌmæksiz
anticlinal => .ænti'klainl
anticline => 'æntiklain
anticlockwise => .ænti'klɒkwaiz
anticoagulant => .æntikәu'ægjulәnt
anticoagulation => 'æntɪkəʊ,æɡjʊ'leɪʃən
anticodon => 'ænti'kәudɔn
anticompetitive => ,æntikəm'petətiv
anticonvulsant => ,æntikәn'vʌlsәnt
antics => 'æntiks
anticyclone => .ænti'saiklәun
anticyclones => ˌæntiˈsaikləunz
anticyclonic => .æntisai'klɒnik
antidepressant => ,æntidi'presәnt
antidepressants => ænti:dɪp'resænts
antidotal => 'æntidәutl
antidote => 'æntidәut
antidotes => 'æntɪdəʊts
antidromic => ,ænti'drɔmik
antifeedant => ,ænti'fi:dәnt
antifeminist => ,ænti'feminist
antiferromagnetic => ,æntɪ,ferəʊmæg'netɪk
antifouling => ,ænti'fajliŋ
antifreeze => 'æntifri:z
antifungal => 'æntifʌŋ^әl
antigen => 'æntidʒәn
antigens => ˈæntɪdʒənz
antigravity => .ænti'grævәti
Antigua => æn'ti:^ә
antihero => ,ænti'hiәrәu
antihistamine => .ænti'histәmi:n
antihistamines => ænti:hɪs'tæmɪnz
antihydrogen => ,ænti'hɑidrәdʒәn
antihypertensive => 'ænti,hɑipә'tensiv
Antilles => æn'tili:z
antilog => 'ænti,lɔ^
antilogarithm => .ænti'lɒgәriðm
antilogy => æn'tilәdʒi
antimacassar => .æntimә'kæsә
antimacassars => ,æntɪmə'kæsə
antimalarial => ,æntimә'leәriәl
antimatter => 'ænti.mætә
antimetabolite => 'æntime'tæbә,lait
antimicrobial => ,æntimai'krәubiәl
antimonial => .ænti'mәunjәl
antimonic => ,ænti'mәunik
antimony => 'æntimәni
antineutrino => 'æntinju:'tri:nәu
antinode => 'æntinәud
antinomian => ,ænti'nәumiәn
antinomianism => ,ænti'nәjmiәnizәm
antinomies => æn'tɪnəmɪ
antinomy => æn'tinәmi
Antioch => 'æntiɔk
Antiochus => æn'taiәkәs
antioxidant => .ænti'ɒksidәnt
antiparallel => ,ænti'pærәlel
antiparticle => 'ænti.pɑ:tikl
antipasto => ,æn:ti'pɑ:stәu
antipathetic => .æntipә'θetik
antipathies => æn'tɪpəθɪ
antipathy => æn'tipәθi
antiperspirant => 'ænti'pә:spirәnt
antiphon => 'æntif(ә)n
antiphonal => æn'tifәnәl
antiphonary => æn'tifәnәri
antiphony => æn'tifәni
antipodal => æn'tipәdәl
antipode => 'æntipәud
antipodean => æn,tipә'di(:)әn
antipodes => æn'tipәdi:z
antipope => 'æntipәup
antiproton => .ænti'prәutɒn
antiprotons => æntɪ'prəʊtɒn
antipruritic => 'æntipru:'ritik
antipsychotic => ,æntisai'kɔtik
antipyretic => .æntipai'retik
antiquarian => .ænti'kwєәriәn
antiquarianism => ,ænti'kweәriәnizәm
antiquarians => ˌæntiˈkwɛəriənz
antiquaries => 'æntɪkwərɪ
antiquark => 'ænti'kwɑ:k
antiquary => 'æntikwәri
antiquate => 'æntikweit
antiquated => 'æntikweitid
antique => æn'ti:k
antiqued => æn'tiːkt
antiques => ænˈti:ks
antiquing => æn'tɪkɪŋ
antiquity => æn'tikwәti
antiracism => .ænti'reisizәm
antiretroviral => ˌæntɪˌretrəʊ'vaɪrəl
antirrhinum => .ænti'rainәm
antiscorbutic => .æntiskɒ:'bju:tik
antisense => 'æntɪsens
antisepsis => .ænti'sepsis
antiseptic => .ænti'septik
antiseptically => ,ænti'septikəli
antiseptics => ˌæntɪ'septɪks
antiserum => .ænti'siәrәm
antiserums => 'æntɪ,sɪərəm
antislavery => .ænti'sleivәri
antisocial => .ænti'sәuʃәl
antispasmodic => 'ænti.spæz'mɒdik
antistrophe => æn'tistrәfi
antisymmetric => 'æntisi'metrik
antiterrorism => ,ænti'terәrizәm
antiterrorist => ,ænti'terәrist
antitheses => æn'tiθisi:z
antithesis => æn'tiθisis
antithetic => ,ænti'θetik
antithetical => .ænti'θetik.-kәl
antitoxic => .ænti'tɒksik
antitoxin => .ænti'tɒksin
antitoxins => ˈæntiˈtɔksinz
antitrades => ænti'treids
antitrust => .ænti'trʌst
antitussive => 'ænti'tʌsiv
antitype => 'æntitaip
antitypical => ,ænti'tipikəl
antivenin => ,ænti'venin
antivenom => ,ænti'venәm
antiviral => 'ænti'vaiәrәl
antivivisection => 'ænti,vivi'sekʃәn
antivivisectionism => 'ænti,vivi'sekʃәnizәm
antler => 'æntlә
antlers => 'æntləz
antoine => æn'twɑ:n
Antoinette => ,æntwɑ:'net
anton => 'æntәn
Antonia => æn'tәunjә
antonio => æn'tәuniәu
antonomasia => .æntәnәu'meiziә
antonym => 'æntәunim
antonymous => 'ænˌtɒnɪməs
antonyms => 'æntənɪmz
Antrim => 'æntrim
antrum => 'æntrәm
antsy => 'æntsi
Antwerp => 'æntwә:p
Anubis => ә'nju:bis
anuran => ә'njuәrәn
anuria => ә'njuәriә
anuric => -rik
anus => 'einәs
Anvers => ɔŋ'ver
anvil => 'ænvil
anvils => ˈænvɪlz
anxieties => æŋˈzaiətiz
anxiety => æŋ'zaiәti
anxiolytic => æŋ,zaiә'litik
anxious => 'æŋʃәs
anxiously => 'æŋʃәsli
anxiousness => 'æŋkʃəs,nis
any => 'eni
anybody => 'enibɒdi
anyhow => 'enihau
anymore => 'eni'mɔ:
anyone => 'eniwʌn
anyplace => 'enipleis
anything => 'eniθiŋ
anytime => 'enitaim
anyway => 'eniwei
anyways => 'eniweiz
anywhere => 'enihwєә
anywheres => 'enɪweərz
anywise => 'eniwaiz
Anzus => 'ænzәs
ao dai => ˈaʊdaɪ, ˈɔ:
AOB => ,ei əu 'bi:
aorist => 'eәrist
aoristic => ,eiə'ristik
aorta => ei'ɒ:tә
aortic => ei'ɒ:tik
aoudad => 'audæd
apace => ә'peis
Apache => ә'pætʃi
apanage => 'æpәnidʒ
apart => ә'pɑ:t
apartheid => ә'pɑ:theit
apartment => ә'pɑ:tmәnt
apartment building => əˈpɑ:tmənt ˈbildiŋ
apartment hotel => əˈpɑ:tmənt həuˈtel
apartness => ə'pa:tnis
apathetic => .æpә'θetik
apathetically => ,æpə'θetikli
apathy => 'æpәθi
apatite => 'æpәtait
apatosaurus => ə,pætə'sɔrəs
ape => eip
Apeldoorn => 'ɑ:pəldɔ:n
Apelles => ә'peli:z
apeman => eipmæn
Apennines => 'æpinainz
aperient => ә'piәriәnt
aperiodic => .eipiәri'ɒdik
aperiodicity => ,eipiәriә'disiti
aperitif => ɑ:peri'ti:f
aperitifs => əˌperˈti:fs
aperture => 'æpә.tjuә
apertures => æ'pətʃəz
apery => 'eipәri
apes => eips
apetalous => ei'petәlәs
apex => 'eipeks
aphasia => ә'feizjә
aphasic => ә'feizik
aphelion => æ'fi:ljәn
apheresis => æ'fiәrisis
aphesis => 'æfisis
aphetic => ә'fetik
aphicide => 'æfisaid
aphid => 'eifid
aphids => 'eɪfɪdz
aphis => 'eifis
aphonia => ei'founjә
aphorism => 'æfәrizm
aphorisms => ˈæfəˌrɪzəmz
aphorist => 'æfәrist
aphoristic => ,æfә'ristik
aphorize => 'æfәraiz
aphrodisiac => ,æfrәu'diziæk
aphrodisiacs => ˌæfrəuˈdiziæks
Aphrodite => .æfrәu'daiti
aphtha => 'æfθә
Apia => ɑ:'pi:ɑ:
apian => 'eipjәn
apiarian => .eipi'єәriәn
apiarist => 'eipjәrist
apiary => 'eipjәri
apical => 'æpikl
apices => 'eipisi:z
apicultural => ,eipi'kʌltʃərəl
apiculture => 'eipikʌltʃә
apiculturist => ,eipi'kʌltʃәrist
apiece => ә'pi:s
Apis => 'eipis
apish => 'eipiʃ
APL => ,eipi:'el
aplanat => 'æplәnæt
aplanatic => ,æplә'nætik
aplasia => ә'pleiziә
aplastic => ei'plæstik
aplenty => ә'plenti
aplomb => ә'plɒm
Aplysia => 'æplisiə
apnea => æp'ni:ә
apnoea => æp'ni:ә
apocalypse => ә'pɒkәlips
apocalyptic => ә.pɒkә'liptik
apocarpous => ,æpә'kɑ:pәs
apochromat => 'æpәkrәumæt
apochromatic => ,æpәkrәu'mætik
apocope => ә'pɒkәpi
apocrine => 'æpәkrin
apocrypha => ә'pɔkrifә
apocryphal => ә'pɔkrif(ә)l
apodictic => ,æpәj'diktik
apodosis => ә'pɒdәusis
apodous => 'æpәdәs
apogee => 'æpәudʒi:
apolar => ei'pәulә
apolitical => .eipә'litikl
Apollinaris => ә,pɔli'neәris
Apolline => ә'pɔlain
Apollo => ә'pɒlәu
Apollonian => ,æpә'lәjnjәn
Apollyon => ә'pɔljәn
apologetic => ә.pɒlә'dʒetik
apologetically => ә.pɒlә'dʒetikli
apologetics => æpɔlә'dʒetiks
apologia => .æpә'lәudʒiә
apologise => ә'pɔlәdʒaiz
apologist => ә'pɒlәdʒist
apologists => ə'pɒlədʒɪsts
apologize => ә'pɒlәdʒaiz
apologizes => əˈpɔlədʒaiziz
apologue => 'æpәlɒg
apology => ә'pɒlәdʒi
apolune => 'æpәlu:n
apomict => 'æpәumikt
apomictic => ,æpә'miktik
apomixis => ,æpә'miksis
apomorphine => ,æpәu'mɔ:fi:n
aponeurosis => ,æpәunjuә'rәusis
aponeurotic => -njj'rɔtik
apophatic => ,æpә'fætik
apophthegm => 'æpәuθem
apophthegmatic => ,æpəθeɡ'mætik
apophyllite => ә'pɔfilait
apophysis => ә'pɒfisis
apoplectic => .æpәu'plektik
apoplexy => 'æpәupleksi
apoprotein => ,æpә'prәuti:n
apoptosis => ,æpə(p)'təʊsɪs
apoptotic => æpɒp'tɒtɪk
aporia => ә'pɔ:riә
aposematic => .æpәsi'metik
aposiopesis => .æpәsaiәu'pi:sis
aposiopetic => ,æpəusaiəu'petik
apostasy => ә'pɒstәsi
apostate => ә'pɒsteit
apostates => əˈpɔsˌteɪts
apostatize => ә'pɒstәtaiz
apostatized => ə'pɒstətaɪz
apostatizing => ə'pɒstətaɪz
apostle => ә'pɒsl
apostles => əˈpɔsəlz
apostleship => ə'pɒslʃɪp
apostolate => ә'pɒstәulәt
apostolic => ,æpәs'tɔlik
apostrophe => ә'pɒstrәfi
apostrophes => əˈpɔstrəfi:z
apostrophize => ә'pɔstrәfaiz
apothecaries => ə'pɒθɪk(ə)rɪ
apothecary => ә'pɒθәkәri
apothegm => 'æpәθem
apothem => 'æpәθem
apotheosis => ә.pɒθi'әusis
apotheosize => ә'pɒθiәusaiz
apotropaic => ,æpәtrә'peiik
appal => ә'pɒ:l
Appalachian => ,æpə'leitʃjən
appall => ә'pɒ:l
appalled => ə'pɔ:ld
appalling => ә'pɒ:liŋ
appallingly => ә'pɔ:liŋli
appals => əˈpɔ:lz
appanage => 'æpәnidʒ
apparat => ,æpә'rɑ:t
apparatchik => ,æpə'rætʃɪk
apparatus => .æpә'reitәs
apparel => ә'pærәl
appareled => əˈpærəld
appareling => əˈpærəlɪŋ
apparels => əˈpærəlz
apparent => ә'pærәnt
apparent horizon => əˈpærənt həˈraizən
apparent magnitude => əˈpærənt ˈmæɡnitju:d
apparent time => əˈpærənt taim
apparently => ә'pærәntli
apparition => .æpә'riʃәn
apparitions => ˌæpəˈrɪʃənz
appeal => ә'pi:l
appealing => ә'pi:liŋ
appear => ә'piә
appearance => ә'piәrәns
appease => ә'pi:z
appeased => əˈpi:zd
appeasement => ә'pi:zmәnt
appeases => əˈpi:ziz
appeasing => ə'piːz
appellant => ә'pelәnt
appellants => əˈpelənts
appellate => ә'pelit
appellation => .æpә'leiʃәn
appellations => æpə'leɪʃnz
appellative => ә'pelәtiv
appellee => .æpә'li:
append => ә'pend
appendage => ә'pendidʒ
appendages => ə'pendɪdʒɪz
appendant => ә'pendәnt
appendectomy => .æpen'dektәmi
appendices => ә'pendisi:z
appendicitis => ә.pendi'saitis
appendicular => ,æpәn'dikjulә
appendix => ә'pendiks
appends => əˈpendz
apperception => .æpә'sepʃәn
appertain => .æpә'tein
appertained => ,æpə'teɪn
appertains => ˌæpəˈteinz
appetencies => 'æpɪt(ə)nsɪ
appetency => 'æpitәnsi
appetiser => 'æpitaizә(r)
appetising => 'æpitaiziŋ
appetite => 'æpitait
appetites => ˈæpitaits
appetitive => ә'petitiv
appetizer => 'æpitaizә
appetizers => ˈæpɪˌtaɪzəz
appetizing => 'æpitaiziŋ
applaud => ә'plɒ:d
applauded => əˈplɔ:did
applauding => ə'plɔːd
applauds => əˈplɔ:dz
applause => ә'plɒ:z
apple => 'æpl
apple-cheeked => 'æpltʃi:kt
apple-pie bed => ˈæpəlˌpaɪ bed
apple-pie order => ˈæpəlˌpaɪ ˈɔ:də
apple-polisher => 'æpl,pɔliʃә(r)
Appleby => 'æpəlbi
applecart => 'æplkɑ:t
applejack => 'æpldʒæk
apples => 'æplz
applesauce => .æpl'sɒ:s
applet => 'æplәt
Appleton => 'æpltәn
appliance => ә'plaiәns
applianced => ə'plaɪəns
applicability => .æplikә'biliti
applicable => 'æplikәbl
applicably => 'æplikәbli
applicant => 'æplikәnt
applicants => ˈæplikənts
application => .æpli'keiʃәn
applicative => 'æplikeitiv
applicator => 'æplikeitә
applied => ә'plaid
applier => 'æplaiә
applique => æ'pli:kei
apply => ә'plai
appoggiatura => ә,pɔdʒә'turә
appoint => ә'pɒint
appointed => ә'pɔintid
appointee => ә.pɒin'ti:
appointees => əˌpɔinˈti:z
appointing => ə'pɔɪnt
appointive => ә'pɒintiv
appointment => ә'pɒintmәnt
appointments => əˈpɔintmənts
appoints => əˈpɔints
apport => ә'pɒ:t
apportion => ә'pɒ:ʃәn
apportioned => ə'pɔːʃ(ə)n
apportioning => ə'pɔːʃ(ə)n
apportionment => ә'pɒ:ʃәnmәnt
apportions => əˈpɔ:ʃənz
appose => æ'pәuz
apposed => ə'pəʊz
apposing => əˈpəuzɪŋ
apposite => 'æpәuzit
appositely => ˊæpәzitli
appositeness => ˊæpәzitnis
apposition => æpәu'ziʃәn
appositional => æpәu'ziʃәnl
appositive => ә'pɒzitiv
appraisable => ә'preizәbl
appraisal => ә'preizәl
appraisals => əˈpreizəlz
appraise => ә'preiz
appraisee => ə,preizi:
appraisement => ә'preizmәnt
appraiser => ә'preizә
appraisers => əˈpreizəz
appraises => əˈpreɪziz
appraisive => ә'preisiv
appreciable => ә'pri:ʃiәbl
appreciably => ә'pri:ʃiәbli
appreciate => ә'pri:ʃieit
appreciated => əˈpri:ʃieitid
appreciates => əp'ri:ʃɪeɪts
appreciation => ә.pri:ʃi'eiʃәn
appreciations => əˌpri:ʃi:ˈeɪʃənz
appreciative => ә'pri:ʃiәtiv
appreciatively => ə'pri:ʃiətivli
appreciator => ә'pri:ʃieitә
appreciatory => ә'pri:ʃiәtәri
apprehend => .æpri'hend
apprehended => æprɪ'hend
apprehends => ˌæpriˈhendz
apprehensible => .æpri'hensәbl
apprehension => .æpri'henʃәn
apprehensive => .æpri'hensiv
apprehensiveness => ,æpri'hensivniz
apprentice => ә'prentis
apprenticed => ə'prentɪs
apprentices => əˈprentisiz
apprenticeship => ә'prentisʃip
apprenticeships => əˈprentɪʃɪps
apprenticing => ə'prentɪs
appressed => ә'prest
apprise => ә'prais
apprises => əˈpraɪziz
apprising => ə'praɪz
apprize => ә'praiz
apprized => əˈpraizd
apprizes => əˈpraiziz
apprizing => əˈpraizɪŋ
appro => 'æprәu
approach => ә'prәutʃ
approach shot => əˈproʊtʃ ʃɔt
approach to => əˈproʊtʃ tu:
approachability => ә.prәutʃә'biliti
approachable => ә'prәutʃәbl
approbate => 'æprәubeit
approbated => ˈæprəubeitid
approbating => ˈæprəubeitɪŋ
approbation => æprәu'beiʃәn
approbative => 'æprəʊbeɪtɪv
approbatory => ә'prәubәtәri
appropriate => ә'prәupriәt
appropriateness => ə'prəupriətnis
appropriates => əˈprəupriits
appropriating => ə'prəʊprɪət
appropriation => әprәupri'eiʃәn
appropriations => əprəʊpr'ɪeɪʃnz
approval => ә'pru:vl
approvals => əˈpru:vəlz
approve => ә'pru:v
approved => ә'pru:vd
approver => ә'pru:vә(r)
approves => əˈpru:vz
approving => әp'ru:viŋ
approvingly => әp'ru:viŋli
approx => ə'prɒks
approximate => ә'prɒksimәt
approximately => ә'prɒksimәtli
approximates => əˈprɔksimits
approximation => ә.prɒksi'meiʃәn
approximations => əprɒksɪ'meɪʃnz
approximative => ә'prɔksimәtiv
appurtenance => ә'pә:tinәns
appurtenances => ə'pɜ:tnənsɪz
appurtenant => ә'pә:tinәnt
apraxia => ә'præksiә
apraxic => ә'præksik
apricot => 'eiprikɒt
apricots => 'eɪprɪkɒts
April => 'eiprәl
apriorism => ,eiprai'ɔ:rizm
apron => 'eiprәn
aproned => 'eɪpr(ə)n
aprons => ˈeiprənz
apropos => .æprә'pәu
apse => æps
apsidal => 'æpsidl
apsis => 'æpsis
apt => æpt
apterous => 'æptәrәs
aptitude => 'æptitju:d
aptitudes => ˈæptitju:dz
aptly => 'æptli
aptness => 'æptnis
Apulia => ә'pju:ljә
Apulian => ә'pju:ljәn
Apus => 'eipәs
Aqaba => 'ɑ:kәbә
aqua => 'ækwә
aqua fortis => ækwә 'fɔ:tis
aqua regia => ækwe 'ri:dʒjә
aqua vitae => ækwә 'vi:tai
aquacade => 'ækwәkeid
aquaculture => 'ækwә.kʌltʃә
aqualung => 'ækwәlʌŋ
aqualungs => 'ækwəlʌŋ
aquamanile => ,ækwәmә'naili
aquamarine => .ækwәmә'ri:n
aquamarines => ˌækwəməˈri:nz
aquanaut => 'ækwәnɔ:t
aquaplane => 'ækwәplein
aquaplaned => 'ækwəpleɪn
aquaplanes => 'ækwəpleɪn
aquarelle => .ækwә'rel
aquaria => ә'kwєәriә
aquarian => ә'kweәriәn
aquarist => ә'kweәrist
aquarium => ә'kwєәriәm
aquarius => ә'kweәriәs
aquatic => ә'kwætik
aquatint => 'ækwәtint
aquatinted => 'ækwətɪnt
aquatinting => 'ækwətɪnt
aquatints => 'ækwətɪnt
aquavit => 'ækwәvit
aqueduct => 'ækwidʌkt
aqueducts => 'ækwɪdʌkts
aqueous => 'eikwiәs
aqueous humour => ˈeikwiəs ˈhju:mə
aquifer => 'ækwifә
aquifers => æk'waɪfəz
aquilegia => ,ækwi'lidʒjә
aquiline => 'ækwәlain
Aquitaine => ,ækwi'tein
aquiver => ә'kwivә(r)
Arab => 'ærәb
Arabella => ,ærә'belә
arabesque => .ærә'besk
arabesques => ˌærəˈbesks
Arabia => ә'reibiә
Arabian => ә'reibiәn
Arabic => 'ærәbik
arabica => ә'reibikә
arabinose => ә'ræbәnәus
arabis => 'ærәbis
Arabism => 'ærәbizm
Arabist => 'ærәbist
Arabization => ,ærәbi'zeiʃәn
Arabize => 'ærәbaiz
arable => 'ærәbl
aracari => ,ɑ:rə'sɑ:ri
Arachne => ә'rækni
arachnid => ә'ræknid
arachnoid => ә'ræknɒid
arachnophobia => ə,ræknə'fəubi:ə
Aragon => 'ærә^әn
aragonite => ә'ræ^әnait, 'ærә^әnait
arak => 'ærək
aralia => ә'reiliә
Aramaic => .ærә'meiik
aramid => 'ærəmid
Aran => 'ærən
araneid => ә'reiniid
Aranyaka => ɑ:'rʌnjəkə
arapaima => ,ærә'paimә
Ararat => 'ærәræt
Araucanian => ,ærɔ'keinjən
araucaria => .ærɒ:'kєәriә
Arawak => 'ɑ:rɑ:,wɑ:k, 'ærә,wɔ:k
Arawakan => ,ɑ:rɑ:'wɑ:kәn, ,ærә'wɑ:kәn
arbalest => 'ɑ:bәlist
arbiter => 'ɑ:bitә
arbiter elegantiarum => 'ɑ:bitәr'elә,^ænʃi'eәrәm
arbiters => ˈɑ:bɪtəz
arbitrage => .ɑ:bi'trɑ:ʒ
arbitrageur => 'ɑ:bitræ'ʒ\\\\:(r)
arbitrageurs => ɑ:bɪtrɑ:'ʒɜ:rz
arbitral => 'ɑ:bitrәl
arbitrament => ɑ:'bitrәmәnt
arbitrarily => 'ɑ:bitrәrili
arbitrariness => 'ɑ:bitrәrinis
arbitrary => 'ɑ:bitrәri
arbitrate => 'ɑ:bitreit
arbitrates => ˈɑ:bɪˌtreɪts
arbitrating => 'ɑːbɪtreɪt
arbitration => .ɑ:bi'treiʃәn
arbitrator => 'ɑ:bitreitә
arbitrators => 'ɑːbɪtreɪtə
arblast => 'ɑ:blɑ:st
arbor => 'ɑ:bә
arboreal => ɑ:'bәuriәl
arborescence => .ɑ:bә'resns
arborescent => .ɑ:bә'resnt
arboretum => .ɑ:bә'ri:tәm
arboricultural => 'ɑ:bәri.kʌltʃәrәl
arboriculture => 'ɑ:bәri.kʌltʃә
arboriculturist => .ɑ:bәri'kʌltʃrist
arborist => 'ɑ:bɔ:rist
arborization => .ɑ:bәrai'zeiʃәn
arborvitae => ɑ:bә'vaiti:
arbour => 'ɑ:bә
arbours => ˈɑ:bəz
arbovirus => 'ɑ:bә'vaiәrәs
Arbroath => ɑ:'brəuθ
Arbuthnot => ɑ:'bʌθnәt
arbutus => ɑ:'bju:tәs
arc => ɑ:k
arc cosine => ɑ:k ˈkəusain
arc sine => ɑ:k sain
arc tangent => ɑ:k ˈtændʒənt
arcade => ɑ:'keid
arcaded => ɑ:'keidid
arcades => ɑ:ˈkeɪdz
arcadia => ɑ:'keidiә
arcadian => ɑ:'keidiәn
arcading => ɑ:'keidiŋ
Arcady => 'ɑ:kәdi
arcana => ɑ:'keinə
arcane => ɑ:'kein
arced => ɑ:kt
arch => ɑ:tʃ
archaea => ɑː'kɪə
Archaean => ɑ:'ki(:)әn
archaebacteria => ,ɑ:kibæk'tiәriә
archaeo- => 'ɑ:kiәj
archaeoastronomy => ,ɑ:kiәuәs'trɔnәmi
archaeologic => ,ɑ:kiə'lɔdʒik
archaeological => .ɑ:kiә'lɒdʒikl
archaeologist => .ɑ:ki'ɒlәdʒist
archaeologists => ˌɑ:kɪˈɔlədʒɪsts
archaeologize => ,ɑ:ki'ɔlәdʒaiz
archaeology => .ɑ:ki'ɒlәdʒi
archaeomagnetism => ,ɑ:kiә'mæ^nәtizәm
archaeometry => ,ɑ:ki'ɔmitri
archaeopteryx => ,ɑ:ki'ɔptәriks
archaic => ɑ:'keiik
archaism => 'ɑ:keiizәm
archaistic => .ɑ:kei'istik
archaize => 'ɑ:keiaiz
archaizing => 'ɑːkeɪaɪz
archangel => 'ɑ:keindʒәl
archangelic => ,ɑ:kæn'dʒelik
archangels => ˈɑ:keindʒəlz
archbishop => 'ɑ:tʃ'biʃәp
archbishopric => .ɑ:tʃ'biʃәprik
archbishops => ɑ:tʃˈbɪʃəps
archdeacon => .ɑ:tʃ'di:kәn
archdeaconry => .ɑ:tʃ'di:kәnri
archdiocesan => ,ɑ:tʃdai'ɔsisən
archdiocese => .ɑ:tʃ'daiәsis
archdioceses => ˈɑ:tʃˈdaiəsisiz
archducal => 'ɑ:tʃ'dju:kl
archduchess => 'ɑ:tʃ'dʌtʃis
archduchy => 'ɑ:tʃ'dʌtʃi
archduke => 'ɑ:tʃ'dju:k
Archean => ɑ:'ki:әn
arched => ɑ:tʃt
archegonium => ,ɑ:ki'^әjniәm
archenemy => .ɑ:tʃ'enimi
archenteron => ɑ:'kentәrɔn
archeological => .ɑ:kiә'lɔdʒikәl
archeologist => ,ɑ:ki'ɔlәdʒist
archeology => ɑ:ki'ɔlәdʒi
archer => 'ɑ:tʃә
archery => 'ɑ:tʃәri
archetypal => 'ɑ:kitaipl
archetype => 'ɑ:tʃtaip
archetypes => 'ɑ:kɪtaɪps
archetypical => ,ɑ:ki'tipikəl
archibald => 'ɑ:tʃibɒ:ld
archidiaconal => ,ɑ:kidai'ækәnәl
Archie => 'ɑ:tʃi
archiepiscopacy => ,ɑ:kii'piskәpәsi
archiepiscopal => ,ɑ:kii'piskәpәl
archiepiscopate => ,ɑ:kii'piskәpit
archil => 'ɑ:tʃil
archimandrite => ɑ:kii'mændrait
Archimedean => .ɑ:ki'mi:diәn
Archimedes => .ɑ:ki'mi:di:z
arching => 'ɑ:tʃiŋ
archipelago => .ɑ:ki'pelәgәu
archipelagos => ˌɑ:kəˈpeləˌgəʊz
architect => 'ɑ:kitekt
architected => 'ɑːkɪtekt
architectonic => .ɑ:kitek'tɒnik
architectonics => ,ɑ:kitek'tɔniks
architects => ˈɑ:kitekts
architectural => .ɑ:ki'tektʃәrәl
architecture => 'ɑ:kitektʃә
architectures => 'ɑ:kɪtektʃərz
architrave => 'ɑ:kitreiv
archival => ɑ: 'kaivәl
archive => 'ɑ:kaiv
archived => 'ɑ:rkaɪvd
archives => 'ɑ:kaivz
archivist => 'ɑ:kivist
archivists => 'ɑ:kɪvɪsts
archivolt => 'ɑ:kivәult
archlute => 'ɑ:tʃ,lu:t
archly => 'ɑ:tʃli
archness => 'ɑ:tʃnis
archon => 'ɑ:kәn
archonship => 'ɑːkənʃɪp
archosaur => 'ɑ:kәsɔ:
archpriest => 'ɑ:tʃ'pri:st
archrival => 'ɑ:tʃ'rɑɪvəl
archway => 'ɑ:tʃwei
archways => ˈɑ:tʃweiz
arco => 'ɑ:kәu
arcology => ɑ:'kɔlәdʒi
arcs => ɑ:ks
arctic => 'ɑ:ktik
Arcturus => ɑ:k'tjuәrәs
arcuate => 'ɑ:kju:it
arden => 'ɑ:dәn
ardency => 'ɑ:dnsi
Ardennes => a:'denz
ardent => 'ɑ:dnt
ardently => 'ɑ:dntli
ardor => 'ɑ:dә
ardour => 'ɑ:dә
arduous => 'ɑ:djuәs
arduousness => 'a:djuəsnis
are => ɑ:
area => 'єәriә
areal => 'εәriәl
areaway => 'eәriәwei
areawide => 'eərɪə,waɪd
areca => 'ærikә
areca nut => æˈrikə nʌt
areg => 'ærә^
areligious => ,eɪrɪ'lɪdʒəs
aren't => ɑ:nt
arena => ә'ri:nә
arenaceous => .ærә'neiʃәs
arenavirus => ә,rinә'vaiәrәs
areola => æ'riәulә
areolate => æ'riәulit
areole => 'æriәjl
Areopagus => .æri'ɒpәgәs
Arequipa => ,æri'ki:pә
Ares => 'єәri:z
arf => ɑ:f
argali => 'ɑ:gәli
argent => 'ɑ:dʒәnt
argentiferous => .ɑ:dʒәn'tifәrәs
Argentina => .ɑ:dʒәn'ti:nә
argentine => 'ɑ:dʒәntain
argentines => ˈɑ:dʒəntainz
Argentinian => ,a:dʒən'tiniən
argillaceous => .ɑ:dʒi'leiʃәs
argillite => 'ɑ:dʒilait
arginine => 'ɑ:dʒini(:)n
Argive => 'ɑ:^aiv
argol => 'ɑ:gɒl
argon => 'ɑ:gɒn
argonaut => 'ɑ:^әnɔ:t
argos => 'ɑ:^әus
argosies => 'ɑːgəsɪ
argosy => 'ɑ:gәsi
argot => 'ɑ:gәu
arguable => 'ɑ:gjuәbl
arguably => 'ɑ:ɡjuәbli
argue => 'ɑ:gju
argues => ˈɑ:ɡju:z
argufy => 'ɑ:gjufai
argument => 'ɑ:gjumәnt
argumentation => .ɑ:gjumen'teiʃәn
argumentative => .ɑ:gju'mentәtiv
argumentatively => ,a:gju'mentətivli
Argus => 'ɑ:gәs
argute => ɑ:'gju:t
argy => 'ɑ:dʒi
argy-bargy => 'ɑ:^i'bɑ:^i
argyle => ɑ:'^ail,'ɑ:-
arhat => 'ɑ:hәt
arhythmic => ә'riðmik
aria => 'ɑ:riә
Ariadne => ,æri'ædni
arian => 'eәriәn
Ariane => ,æri'æn
arid => 'ærid
aridity => ә'riditi
ariel => 'єәriәl
Aries => 'єәri:z
aright => ә'rait
aril => 'æril
arillate => 'ærileit
arioso => .ɑ:ri'әuzәu
arise => ә'raiz
arisings => ә'raiziŋz
Aristarchus => ,æri'stɑ:kəs
Aristides => ,æri'staidi:z
aristo => ә'ristәj
aristocracies => ,ærɪ'stɒkrəsɪ
aristocracy => .æri'stɒkrәsi
aristocrat => 'æristәkræt
aristocratic => æristә'krætik
aristocrats => æ'rɪstəkræts
Aristophanes => ,æri'stɔfəni:z
Aristotelian => .æristɒ'ti:ljәn
aristotelians => ,æristɔ'tiljən
Aristotle => 'æristɒtl
arithmetic => ә'riθmәtik
arithmetical => .æriθ'metikl
arithmetically => ,æriθ'metikli
arithmetician => ә.riθmә'tiʃәn
Arizona => æri'zәunә
ark => ɑ:k
Arkansan => ɑ:'kænzәn
Arkansas => 'ɑ:kәnsɒ:
Arkhangelsk => ɑ:'kæn^elsk
arkose => 'ɑ:kәus
arkosic => ɑ:'kɔsik
Arkwright => 'ɑ:krait
arlene => ɑ:'li:n
arlington => 'ɑ:liŋtәn
arm => ɑ:m
arm-twist => 'ɑ:mtw'ɪst
arm-twisting => 'ɑ:m,twistin
arm-wrestle => 'ɑ:m,resl
arm-wrestling => ˈɑ:mˌresliŋ
armada => ɑ:'mɑ:dә
armadas => ɑ:ˈmɑ:dəz
armadillo => .ɑ:mә'dilәu
Armageddon => ,ɑ:mә'^edn
Armagh => a:'ma:
Armagnac => 'ɑ:mәnjæk
armament => 'ɑ:mәmәnt
armamentarium => ,ɑ:mәmәn'teәriәm
armaments => 'ɑ:məmənts
Armand => 'ɑ:mɔnd
ARMANI => armʌni
armature => 'ɑ:mә.tjuә
armband => 'ɑ:mbænd
armbands => ˈɑ:mˌbændz
armchair => .ɑ:m'tʃєә
armchairs => 'ɑ:mtʃeəz
Armco => 'ɑ:mkәj
armed => ɑ:md
Armenia => ɑ:'mi:njә
Armenian => ɑ:'mi:njәn
armful => 'ɑ:mful
armfuls => ˈɑ:mˌfʊlz
armhole => 'ɑ:mhәul
armholes => ˈɑ:mhəulz
armies => ˈɑ:miz
armiger => 'ɑ:midʒә
armigerous => ɑ:'midʒәrәs
armillary sphere => ɑ:ˈmiləri sfiə
arming => 'ɑ:miŋ
Arminian => ɑ:'miniәn
Arminianism => ɑ:'miniәnizәm
armistice => 'ɑ:mistis
armistices => ˈɑ:mɪstɪsiz
armless => 'ɑ:mlis
armlet => 'ɑ:mlit
armload => 'ɑ:m.lәud
armlock => 'ɑ:mlɔk
armoire => ɑ:'mwɑ:
armor => 'ɑ:mә
armored => 'ɑ:mәd
armorer => 'ɑ:mәrә
armorial => ɑ:'mәuriәl
Armorica => ɑ:'mɔrikә
Armorican => ɑ:'mɔrikәn
armoring => 'ɑ:mərɪŋ
armory => 'ɑ:mәri
armour => 'ɑ:mә
armoured => 'ɑ:mәd
armouries => ˈɑ:məriz
armouring => 'ɑ:mәriŋ
armours => 'ɑːmə
armoury => 'ɑ:mәri
armpit => 'ɑ:mpit
armr => 'ɑ:mr
armrest => 'ɑ:mrest
arms => ɑ:mz
Armstrong => 'ɑ:mstrɔŋ
army => 'ɑ:mi
army ant => ˈɑ:mi ænt
army worm => ˈɑ:mi wə:m
Arne => ɑ:n
Arnel => 'ɑ:nil
Arnhem => 'ɑ:nәm,'ɑ:nhem
arnica => 'ɑ:nikә
arnold => 'ɑ:nәld
aroid => 'ærɔid,'eәr-
aroma => ә'rәumә
aromas => əˈrəʊməz
aromatherapist => ə,rəumə'θerəpist
aromatherapy => ərəʊmə'θerəpɪ
aromatic => .ærәu'mætik
aromaticity => ,ærәmә'tisiti
aromatization => ә'rәumә,tai'zeiʃәn
aromatize => ә'rәumәtaiz
arose => ә'rәuz
around => ә'raund
arousal => ә'rauzl
arouse => ә'rauz
arouses => əˈrauziz
ARP => ɑ:p
arpeggiate => ɑ:ˈpedʒiˌeit
arpeggiation => ɑ:,pedʒi'eiʃәn
arpeggio => ɑ:'pedʒiәu
arpeggione => ɑ:,pedʒi'әjni:
arquebus => 'ɑ:kwibәs
arrack => 'ærәk
arrah => 'ærә
arraign => ә'rein
arraigning => ə'reɪn
arraignment => ә'reinmәnt
arraigns => əˈreɪnz
arrange => ә'reindʒ
arrangement => ә'reindʒmәnt
arranges => əˈreindʒz
arrant => 'ærәnt
arrantly => 'ærəntli
arras => 'ærәs
array => ә'rei
arrayed => ə'reid
arraying => ə'reɪ
arrearage => ә'riәridʒ
arrears => ә'riәz
arrest => ә'rest
arrestee => ә,res'ti:
arrester => ә'restә
arresters => ə'restəz
arresting => ә'restiŋ
arrestment => ә'restmәnt
arrests => əˈrests
Arrhenius => ә'ri:niәs, -'rei-
arrhythmia => ә'riðmiә
arrhythmic => ә'riðmik
arris => 'æris
arrival => ә'raivl
arrive => ә'raiv
arrived => a'raivd
arrivederci => əriːvə'deətʃɪ; ærɪve'dertʃɪ
arrives => əˈraivz
arrivisme => ɑ:ri:'vi:sm
arriviste => æri:'vist
arrogance => 'ærәgәns
arrogant => 'ærәɡәnt
arrogantly => 'ærəgəntli
arrogate => 'ærәugeit
arrogated => 'ærəgeɪt
arrogates => ˈærəˌgeɪts
arrogating => 'ærəgeɪt
arrogation => .ærәu'geiʃәn
arrondissement => ,ærɔn'di:s'mɑ:ŋ
arrow => 'ærәu
arrowhead => 'ærәuhed
arrowheads => ˈærəʊhedz
arrowroot => 'ærәuru:t
Arrowsmith => 'ærəu,smiθ
arrowy => 'ærәui
arroyo => ә'rɒiәu
ARS => ɑ:z
arse => ɑ:s
arse-licking => 'ɑ:s,likiŋ
arsed => ɑ:s
arsehole => 'ɑrshol
arseholes => ˈɑ:sˌhəulz
arsenal => 'ɑ:snәl
arsenals => ˈɑ:sənəlz
arsenate => 'ɑ:sinit
arsenic => 'ɑ:sәnik
arsenical => ɑ:'senikәl
arsenide => 'ɑ:sәnaid
arsenious => ɑ:'si:niәs
arsenopyrite => ,ɑ:sinәu'pairait
arses => ɑ:siz
arsine => 'ɑ:sin
arsing => ɑ:s
arsis => 'ɑ:sis
arson => 'ɑ:sәn
arsonist => 'ɑ:sәnist
arsonists => ˈɑ:sənɪsts
arsphenamine => ɑ:sfenә'mi:n
art => ɑ:t
art deco => ɑ:t 'dekәj
art paper => ɑ:t ˈpeipə
art therapy => ɑ:t ˈθerəpi
artefact => 'ɑ:tifækt
artefacts => 'ɑ:tɪfækts
artefactual => ,ɑ:ti'fæktʃəl
artel => ɑ:'tel
Artemis => 'ɑ:timis
artemisia => ,ɑ:ti'mi:ziә
arterial => ɑ:'tiәriәl
arterialize => ɑ:'tiәriәlaiz
arterialized => ɑː'tɪərɪəlaɪz
arterializes => ɑː'tɪərɪəlaɪz
arterializing => ɑː'tɪərɪəlaɪz
arteriography => ɑ:.tiәri'ɒgrәfi
arteriolar => ɑ:,tiәri'әulә
arteriole => ɑ:'tiәriәul
arteriosclerosis => ɑ:,tiәriәu,skliә'rәusis
arteriovenous => ɑ:,tiәriәu'vi:nәs
arteritis => .ɑ:tә'raitis
artery => 'ɑ:tәri
artesian => ɑ:'ti:zjәn
artful => 'ɑ:tful
arthralgia => ɑ:'θrældʒiә
arthritic => ɑ:'θritik
arthritics => ɑr'θrɪtɪk
arthritis => ɑ:'θraitis
arthrodesis => ɑ:'θrɔdәsis
arthroplasty => 'ɑ:θrә,plæsti
arthropod => 'ɑ:θrәpɒd
arthropods => 'ɑrθrəˌpɑdz
arthroscope => 'ɑ:θrәskәjp
arthroscopy => ɑ:'θrɔskәpi
arthur => 'ɑ:θә
Arthurian => ɑ:'θjuriәn
artic => 'ɑ:tik
artichoke => 'ɑ:titʃәuk
artichokes => 'ɑ:tɪtʃəʊks
article => 'ɑ:tikl
articled => 'ɑrtɪkld
articulable => ɑ:'tɪkjʊləbl
articulacy => ɑ:'tikjjlәsi
articular => ɑ:'tikjulә
articulate => ɑ:'tikjulit
articulated => ɑ:'tikju:leitid
articulates => ɑ:ˈtikjulits
articulating => ɑ:'tɪkjʊleɪt
articulation => ɑ:.tikju'leiʃәn
articulator => ɑ:'tikjuleitә
articulatory => ɑ:'ti:kjulәtәri
artifact => 'ɑ:tifækt
artifactual => ,ɑːtɪ'fæktʃʊəl
artifice => 'ɑ:tifis
artificer => ɑ:'tifisә
artifices => ˈɑ:təfɪsiz
artificial => .ɑ:ti'fiʃәl
artificial life => ˌɑ:tiˈfiʃəl laif
artificiality => .ɑ:tifiʃi'æliti
artificially => .ɑ:ti'fiʃәli
artillerist => ɑ:'tilәrist
artillery => ɑ:'tilәri
artilleryman => ɑ:'tilәrimәn
artiodactyl => ,ɑ:tiәu'dæktil
artisan => .ɑ:ti'zæn
artisans => 'ɑ:tɪzænz
artist => 'ɑ:tist
artiste => ɑ:'ti:st
artistes => ɑ:ˈti:sts
artistic => ɑ:'tistik
artistically => ɑ:'tistikli
artistry => 'ɑ:tistri
artless => 'ɑ:tlis
artlessly => 'ɑ:tlɪslɪ
Artois => 'ɑ:twɑ:
arts => ɑ:ts
artsy => 'ɑ:tsi
Artur => 'ɑ:tuə
artwork => 'ɑ:twә:k
artworks => 'ɑ:twɜ:ks
arty => 'ɑ:ti
arty-farty => ˌɑ:ti ˈfɑ:ti
arugula => ә'ru:^әlә
arum => 'єәrәm
arum lily => ˈeərəm lɪli
Arundel => 'ærəndəl
arvo => 'ɑ:vәj
Aryan => 'єәriәn
aryl => 'æril
arytenoid => ,æri'ti:nɔid
as => æz
as the crow flies => æz ðə krəu flaɪz
as- => æz; əz
ASA => 'eisә
asafoetida => ,æsә'fetidә
asana => 'asənə
Asansol => 'ɑ:sәnsәjl
Asante => ə'sænti; ə'sɑ:n-
asbestos => æs'bestɒs
asbestosis => .æsbes'tәusis
ascariasis => ,æskә'raiәsis
ascarid => 'æskәrid
ascend => ә'send
ascendance => ә'sendәns
ascendancy => ә'sendәnsi
ascendant => ә'sendәnt
ascendency => ә'sendәnsi
ascender => ә'sendә
ascending => ә'sendiŋ
ascending colon => əˈsendiŋ ˈkəulən
ascends => əˈsendz
ascension => ә'senʃәn
Ascensiontide => ә'senʃәntaid
ascent => ә'sent
ascents => əˈsents
ascertain => .æsә'tein
ascertained => æsə'teind
ascertaining => ,æsə'teɪn
ascertains => ˌæsəˈteinz
ascesis => ә'si:sis
ascetic => ә'setik
ascetically => ə'si:tɪklɪ
asceticism => ә'setisizm
ascetics => əˈsetɪks
aschelminth => 'æstʃelmɪnθ
ascidian => ә'sidiәn
ASCII => 'æski
ascites => ә'saiti:z
Asclepius => æ'skli:piәs
ascomycete => .æskәmai'si:t
ascomycetes => ,æskәumai'si:ti:z
ascorbate => 'æskɔ:beit
ascorbic acid => ә'skɔ:bik 'æsid
ascot => 'æskәt
ascribable => ә'skraibәbl
ascribe => ә'skraib
ascribed => əˈskraibd
ascribes => əsˈkraibz
ascribing => əsˈkraibɪŋ
ascription => ә'skripʃәn
ascriptive => ə'skriptiv
ascus => 'æskәs
Asea => ә'si:
asean => 'æsi:ɔn
aseismic => ei'saismik
asepsis => æ'sepsis
aseptic => æ'septik
asexual => ei'sekjuәl
asexuality => ei.seksju'æliti
Asgard => 'æsgɑ:d
ash => æʃ
ashamed => ә'ʃeimd
Ashanti => ә'ʃænti
Ashby => 'æʃbi
ashcan => 'æʃkæn
ashcans => 'æʃkæn
Ashdod => 'æʃdɔd
Ashe => æʃ
ashen => 'æʃәn
ashet => 'æʃit
Ashgabat => ,a:ʃga:'ba:t
ashine => æ'ʃi:n
Ashkenazi => 'æʃkə'næzi
Ashkenazic => 'æʃkə'næzik
Ashkhabad => ,ɑ:ʃka'bɑ:d
ashlar => 'æʃlә(r)
ashlaring => 'æʃlәriŋ
ashore => ә'ʃɒ:
ashplant => 'æʃplɑ:nt
ashram => 'æʃrәm
ashtray => 'æʃtrei
ashtrays => ˈæʃˌtreɪz
Ashur => 'ɑ:ʃjә(r)
Ashurbanipal => ,ɑ:ʃuə'bɑ:nipɑ:l
ashy => 'æʃi
Asia => 'eiʒә
asiago => ˌɑ:si:ˈɑ:gəʊ, ɑ:ˈsjɑ:-
Asian => 'eiʃәn
asiatic => ,eiʃi'ætik
aside => ә'said
asides => əˈsaidz
asinine => 'æsinain
asininity => .æsi'niniti
ask => ɑ:sk
askance => ә'skæns
askari => 'ɑ:skɑ:ri, ә'skɑ:ri
asker => 'ɑ:skә
askew => ә'skju:
asking => 'ɑ:skiŋ
aslant => ә'slænt
asleep => ә'sli:p
aslope => ә'slәup
Asmara => æz'mɑ:rә
asocial => ei'sәuʃәl
Asoka => ә'soukә
asp => æsp
asparagine => әs'pærәdʒi:n
asparagus => ә'spærәgәs
asparagus fern => əˈspærəgəs fɜ:n
asparagus pea => əˈspærəgəs pi:
aspartame => әs'pɑ:teim
aspartate => ә'spɑ:teit
aspect => 'æspekt
aspects => 'æspekts
aspectual => æ'spektjjәl
aspen => 'æspәn
aspens => ˈæspənz
asperge => əs'pɜːdʒ
asperges => æ'spә:dʒi:z
aspergillosis => ,æspәdʒi'lәusis
aspergillum => .æspә'dʒilәm
asperities => æs'perɪtɪz
asperity => æ'speriti
aspermia => ә'sp\\\\:miә
asperse => ә'spә:s
aspersed => əˈspə:st
aspersing => əˈspə:sɪŋ
aspersion => ә'spә:ʃәn
asphalt => 'æsfælt
asphalted => ˈæsˌfɔ:ltid
asphaltic => æs'fæltik
asphalting => 'æsfæltɪŋ
asphalts => ˈæsˌfɔ:lts
aspheric => eis'ferik
aspherical => æz'ferɪkl
asphodel => 'æsfәdel
asphyxia => æs'fiksiә
asphyxial => æs'fiksiәl
asphyxiant => æs'fiksiәnt
asphyxiate => æs'fiksieit
asphyxiated => ˈæspərəntid
asphyxiates => æsˈfɪksi:ˌeɪts
asphyxiating => ˈæspərəntɪŋ
asphyxiation => æs.fiksi'eiʃәn
asphyxiator => æs'fiksieitә
aspic => 'æspik
aspidistra => .æspi'distrә
aspirant => ә'spairәnt
aspirants => ˈæspərənts
aspirate => 'æspәreit
aspirated => 'æspәreitid
aspirates => ˈæspəreits
aspirating => 'æspәreitiŋ
aspiration => .æspә'reiʃәn
aspirational => ˌæspəˈreɪʃənl
aspirator => 'æspәreitә
aspire => ә'spaiә
aspired => əsˈpaiəd
aspires => əsˈpaiəz
aspirin => 'æspәrin
aspiring => ә'spaiәriŋ
asportation => ,æspә'teiʃәn
asprawl => ә'sprɔ:l
asquint => ә'skwint
ass => æs
ass-kicking => 'æs,kik
ass-kisser => 'æs'kisә(r)
ass-kissing => 'æs'kisiŋ
assagai => 'æsәgai
assai => ә'sai
assail => ә'seil
assailant => ә'seilәnt
assailants => əˈseɪlənts
assailed => əˈseɪld
assailing => əˈseɪlɪŋ
assails => əˈseɪlz
Assam => ә'sæm
Assamese => .æsә'mi:z
assart => æ'sɑ:t
assassin => ә'sæsin
assassinate => ә'sæsineit
assassinated => ə'sæsɪneɪt
assassinates => əˈsæsəˌneɪts
assassinating => əˈsæsəˌneɪtɪŋ
assassination => ә.sæsi'neiʃәn
assassinations => əsæsɪ'neɪʃnz
assassins => ə'sæsɪnz
assault => ә'sɒ:t
assault course => əˈsɔ:lt kɔː(r)s
assault rifle => əˈsɔ:lt ˈraifl
assaulting => əˈsɔ:ltɪŋ
assaultive => ә'sɔ:ltiv
assaults => əˈsɔ:lts
assay => ә'sei
assayed => ə'seɪ; 'æseɪ
assayer => ә'seiә
assays => ˈæsˌeɪz
assegai => 'æsi,^ai
assemblage => ә'semblidʒ
assemblages => əˈsemblɪdʒz
assemble => ә'sembl
assembled => ә'sembәld
assembler => ә'semblә
assemblers => əˈsembləz
assembles => əˈsemblz
assemblies => əˈsembliz
assembly => ә'sembli
assemblyman => ә'semblimәn
assemblymen => ə'semblɪmən; ə'semblɪwʊmən
assemblywoman => ә'sembli,wjmәn
assent => ә'sent
assented => əˈsentid
assentient => ә'senʃәnt
assenting => əˈsentɪŋ
assents => əˈsents
assert => ә'sә:t
asserted => ә'sә:tid
asserting => əˈsə:tɪŋ
assertion => ә'sә:ʃәn
assertions => ə'sɜ:ʃnz
assertive => ә'sә:tiv
assertively => ə'sə:tivli
assertiveness => ə'sə:tivnis
asserts => əˈsə:ts
asses => 'æsɪz
assess => ә'ses
assessment => ә'sesmәnt
assessments => əˈsesmənts
assessor => ә'sesә
assessors => ə'sesəz
asset => 'æset
assets => 'æsets
asseverate => ә'sevәreit
asseverated => əˈsevəˌreɪtid
asseverates => əˈsevəˌreɪts
asseverating => əˈsevəˌreɪtɪŋ
asseveration => әsevә'reiʃәn
asshole => 'æshәul
assholes => ˈæsˌhəʊlz
assibilate => ә'sibileit
assibilation => ә,sibi'leiʃәn
assiduities => ˌæsɪˈdu:ɪti:z
assiduity => .æsi'dju:әti
assiduous => ә'sidjuәs
assiduously => ə'sidʒuəsli
assign => ә'sain
assignable => ә'sainәbl
assignation => ,æsi^'neiʃәn
assignations => ˌæsiɡˈneiʃənz
assignee => ,æsi'ni:
assigner => ә'sainә
assigning => əˈsainɪŋ
assignment => ә'sainmәnt
assignor => ә'sainә
assigns => əˈsainz
assimilable => ә'similәbl
assimilate => ә'simileit
assimilates => əˈsimileits
assimilation => ә.simi'leiʃәn
assimilationist => -nist
assimilative => ә'similәtiv
assimilator => ə'sɪmɪleɪtə
assimilatory => ə'sɪməleɪtrɪ
Assisi => ə'si:zi
assist => ә'sist
assistance => ә'sistәns
assistant => ә'sistәnt
assistants => ə'sɪstənts
assistantship => ә'sistәnt-ʃip
assisted => əˈsistid
assistive => ə'sɪstɪv
assize => ә'saiz
associability => ә.sәuʃjә'biliti
associable => ә'sәuʃjәbl
associate => ә'sәuʃieit
association => ә.sәuʃә'eiʃәn
association area => əˌsəuʃiˈeiʃən ˈɛəriə
associationism => ә,sәjsi'eiʃәnizәm
associative => ә'sәuʃjәtiv
associator => ә'sәuʃieitә
assonance => 'æsәunәns
assonant => 'æsәunәnt
assonate => 'æsәjneit
assort => ә'sɒ:t
assortative => ә'sɔ:tәtiv
assorted => ә'sɒ:tid
assortment => ә'sɒ:tmәnt
assortments => əˈsɔ:tmənts
assorts => əˈsɔ:ts
assuage => ә'sweidʒ
assuaged => əˈsweɪdʒd
assuagement => ə'sweɪdʒmənt
assuages => əˈsweɪdʒz
assuaging => əˈsweɪdʒɪŋ
assumable => ә'sju:mәbl
assume => ә'sju:m
assumed => ә'sju:md
assumedly => ә'sju:midli
assumes => əˈsju:mz
assuming => ә'sju:miŋ
assumption => ә'sʌmpʃәn
assumptions => ə'sʌmpʃnz
assumptive => ә'sʌmptiv
Assur => 'æsә(r)
assurance => ә'ʃuәrәns
assurances => əˈʃuərənsiz
assure => ә'ʃuә
assured => ә'ʃuәd
assuredly => ә'ʃuәridli
assures => əˈʃuəz
assuring => ә'ʃuәriŋ
Assyria => ә'siriә
Assyrian => ә'siriәn
Assyriologist => ә.siri'ɒlәdʒist
Assyriology => ә.siri'ɒlәdʒi
astable => 'æstәbl
Astana => 'ɑ:stənə
Astarte => æ'stɑ:ti
astatic => ei'stætik
astatine => 'æstәti:n
Astbury => 'æstbəri
aster => 'æstә
asterisk => 'æstәrisk
asterisked => ˈæstəˌrɪskt
asterisking => ˈæstəˌrɪskɪŋ
asterisks => 'æstərɪsks
asterism => 'æstәrizm
astern => ә'stә:n
asteroid => 'æstәrɒid
asteroidal => .æstә'rɒidl
asters => 'æstə
asthenia => æs'θi:njә
asthenic => æs'θenik
asthenosphere => æs'θenәsfiә
asthma => 'æsmә
asthmatic => æs'mætik
asthmatics => æs'mætɪks
Asti => 'æsti
astigmatic => ,æsti^'mætik
astigmatism => ә'stigmәtizm
astilbe => ә'stilbi
astir => ә'stә:
aston => 'æstәn
astonish => ә'stɒniʃ
astonishes => əsˈtɔniʃiz
astonishing => ә'stɒniʃiŋ
astonishingly => ə'stɔniʃiŋli
astonishment => ә'stɒniʃmәnt
Astor => 'æstə
Astoria => æs'tɔ:riə
astound => ә'staund
astounded => ə'staundid
astounding => ә'staundiŋ
astounds => əˈstaʊndz
astraddle => ә'strædl
Astraea => æs'tri:ә
astragal => 'æstrә^әl
astragalus => æ'stægәlәs
astrakhan => æstrә'kæn
astral => 'æstrәl
astray => ә'strei
Astrid => 'æstrid
astride => ә'straid
astringency => ә'strindʒәnsi
astringent => ә'strindʒәnt
astringently => əst'rɪndʒəntlɪ
astringents => əst'rɪndʒənts
astro- => 'æstrәj
astrobiologist => ,æstrәbaiә'lɔdʒist
astrobiology => .æstrәubai'ɒlәdʒi
astrobleme => 'æstrәbli:m
astrochemist => ,æstrəʊ'kemɪst
astrochemistry => ,æstrәj'kemistri
astrocompass => 'æstrәu.kʌmpәs
astrocyte => 'æstrәsait
astrogation => ,æstrә'^eiʃәn
astroid => 'æstrɒid
astrolabe => 'æstrәleib
astrologer => ә'strɒlәdʒә
astrologers => əsˈtrɔlədʒəz
astrological => .æstrә'lɒdʒikl
astrology => ә'strɒlәdʒi
astrometric => ,æstrə'metrik, ,æstrə'metrikəl
astrometry => æ'strɒmitri
astronaut => 'æstrәnɒ:t
astronautical => æstrә'nɒ:tikl
astronautics => .æstrә'nɒ:tiks
astronomer => ә'strɒnәmә
astronomers => əˈstrɔnəməz
astronomic => ,æstrə'nɔmikəl,-ik
astronomical => .æstrә'nɒmikl
astronomical unit => ˌæstrəˈnɔmɪkəl ˈju:nit
astronomically => ,æstrə'nɔmikli
astronomy => ә'strɒnәmi
astrophotographer => 'æstrəfətəɡrəfə
astrophotographic => 'æstrəu,fəutə'ɡræfik
astrophotography => .æstrәfәu'tɒgrәfi
astrophysical => .æstrә'fizikl
astrophysicist => .æstrәu'fizisist
astrophysics => .æstrәu'fiziks
AstroTurf => 'æstrәjt\\\\:f
asturian => æ'stjjәriәn
Asturias => ә'stjjәriәs
astute => ә'stju:t
astutely => əs'tju:tli
astuteness => ә'stju:tnis
astylar => ei'stailә
asunder => ә'sʌndә
Asur => 'æsə
asura => 'a:surə
aswarm => ә'swɔ:m
aswirl => ә'sw\\\\:l
asylee => ə'saɪli:
asylum => ә'sailәm
asylums => əˈsailəmz
asymmetric => æsi'metrik
asymmetric bars => ˌæsɪˈmetrɪk bɑ:z
asymmetrically => əsi'metrikli
asymmetry => æ'simitri
asymptomatic => ,eisimptә'mætik
asymptote => 'æsimtәut
asymptotic => ,æsimp'tɔtik
asynchronous => ei'siŋkrәnәs
asynchrony => ei'siŋkrәni
asyndetic => ,æsin'detik
asyndeton => æ'sinditәn
at => æt
at bay => æt bei
at ease => æt i:z
at first blush => æt fə:st blʌʃ
at first glance => æt fə:st ɡlɑ:ns
at first hand => æt fə:st hænd
at knifepoint => æt ˈnaifpɔint
at loggerheads => æt ˈlɔgəhedz
at source => æt sɔ:s
at the ready => æt ðə ˈredi
at- => ət
at-home => әt'hәum
ata => 'ætә
atactic => ә'tæktik
Atalanta => .ætә'læntә
ataman => 'ætәmәn
atap => 'ætæp