atheistic => .eiθi'istik
atheistical => ,eiθi'istikәl
atheists => 'eɪθɪɪst
atheling => 'æθiliŋ
Athelstan => 'æθəlstæn
athematic => ,eiθi'mætik
Athena => ә'θi:nә
Athenaeum => ,æθi'ni:әm
Athene => ә'θi:ni:
Athenian => ә'θi:njәn
Athens => 'æθәns
atherogenesis => ,æθәrә'dʒenisis
atherogenic => ,æθәrәu'dʒenik
atheroma => .æθә'rәumә
atheromatous => ,æθә'rɔmәtәs
atherosclerosis => ,æθәrәuskliә'rәusis
Atherton => 'æθәtәn
athetoid => 'æθәtɔid
athetosis => ,æθi'tәusis
athetotic => æθi'tɔtik
Athey => 'æðe
athirst => ә'θә:st
athlete => 'æθli:t
athletes => 'æθli:ts
athletic => æθ'letik
athletically => æθ'letikli
athleticism => æθ'letisizm
athletics => æθ'letiks
athwart => ә'θwɒ:t
atishoo => ә'tiʃu:
atkins => 'ætkinz
atlanta => әt'læntә
Atlantean => ,ætlæn'tiәn; әt'læntiәn
atlantes => әt'lænti:z
Atlantic => әt'læntik
Atlanticism => ət'læntisizəm
Atlanticist => -sist
Atlantis => әt'læntis
atlas => 'ætlәs
atlatl => 'ɑ:tlɑ:tl
atman => 'ɑ:tmәn
atmosphere => 'ætmәsfiә
atmospheres => 'ætməsfɪəz
atmospheric => ætmәs'ferik
atmospherically => ætmәs'ferikli
atmospherics => ,ætmәs'feriks
atoll => 'ætɒl
atolls => ˈætɔlz
atom => 'ætәm
atomic => ә'tɒmik
atomicity => .ætә'misiti
atomics => ә'tɒmiks
atomised => 'ætəumaiz
atomism => 'ætәumizm
atomist => 'ætәumist
atomistic => .ætәu'mistik
atomization => .ætәumai'zeiʃәn
atomize => 'ætәumaiz
atomizer => 'ætәumaizә
atomizes => ˈætəmaiziz
atomizing => 'ætә,maiziŋ
atomy => 'ætәmi
aton => 'ɑ:tɔn
atonal => ei'tәunl
atonalism => 'eɪtəʊnælɪzəm
atonalist => eɪˈtəʊnəlɪst
atonality => .eitәu'næliti
atone => ә'tәun
atoned => əˈtəʊnd
atonement => ә'tәunmәnt
atones => əˈtəʊnz
atonic => æ'tɒnik
atoning => əˈtəʊnɪŋ
atony => 'ætәni
atop => ә'tɒp
atopic => ә'tɔpik
atopy => 'ætәpi
atorvastatin => ə,tɔ:və'stætn
atrabilious => .ætrә'biljәs
atraumatic => ,eitrɔ:'mætik
atrazine => 'ætrәzi:n
atremble => ә'trembl
atresia => ә'tri:siә
Atreus => 'eitriu:s
atrioventricular => ,eitriәjven'trikjjlә(r)
atrium => 'ɑ:triәm
atrocious => ә'trәuʃәs
atrociously => ə'trəuʃəsli
atrociousness => әˊtrouʃәsnis
atrocities => əˈtrɔsitiz
atrocity => ә'trɒsiti
atrophic => æ'trɒfik
atrophied => ә'trɔfid
atrophies => ˈætrəfi:z
atrophy => 'ætrәfi
atrophying => ˈætrəfi:ɪŋ
atropine => 'ætrәpi:n
attaboy => 'ætәbɔi
attacca => ə'tækə
attach => ә'tætʃ
attach to => əˈtætʃ tu:
attachable => ә'tætʃәbl
attache => ɑ:tɑ:'ʃei
attached => ә'tætʃt
attaches => əˈtætʃiz
attachment => ә'tʃætʃmәnt
attack => ә'tæk
attacker => ә'tækә
attackers => əˈtækəz
attagirl => 'ætә,^ә:l
attain => ә'tein
attainability => ә,teinә'bilәti
attainable => ә'teinәbl
attainder => ә'teindә
attaining => əˈteinɪŋ
attainment => ә'teinmәnt
attains => əˈteinz
attaint => ә'teint
attainted => əˈteintid
attainting => əˈteintɪŋ
attaints => əˈteints
attar => 'ætә
attempt => ә'tempt
attempting => əˈtemptɪŋ
attend => ә'tend
attendance => ә'tendәns
attendances => əˈtendənsiz
attendant => ә'tendәnt
attendants => əˈtendənts
attendee => æten'di:
attendees => ˌætenˈdi:z
attender => ə'tendə(r)
attending => ә'tendiŋ
attends => əˈtendz
attention => ә'tenʃәn
attention deficit disorder => əˈtenʃən ˈdefisit disˈɔ:də
attention span => əˈtenʃən spæn
attentions => ə'tenʃnz
attentive => ә'tentiv
attentively => ә'tentivli
attentiveness => ə'tentivnis
attenuate => ә'tenjueit
attenuated => ə'tɛnjuetɪd
attenuates => əˈtenju:ˌeɪts
attenuation => ә.tenju'eiʃәn
attenuator => ә'tenjjeitә(r)
attest => ә'test
attestation => .æte'steiʃәn
attestations => ,æte'steɪʃən
attested => ә'testid
attestor => ә'testә
attests => əˈtests
attic => 'ætik
attica => 'ætikә
attics => ˈætiks
Attila => 'ætilә
attire => ә'taiә
attired => ә'taiәd
attires => əˈtaɪəz
attiring => əˈtaɪərɪŋ
attitude => 'ætitju:d
attitudes => ˈætitju:dz
attitudinal => ,æti'tju:dinәl
attitudinize => .æti'tju:dinaiz
Attlee => 'ætli
atto- => ˈætəʊ
attorn => ә'tә:n
attorned => ə'tɜːn
attorney => ә'tә:ni
attorneys => əˈtə:niz
attorning => ə'tɜːn
attorns => ə'tɜːn
attract => ә'trækt
attractable => ә'træktәbl
attractant => ә'træktәnt
attracted => ə'træktɪd
attraction => ә'trækʃәn
attractions => ət'rækʃnz
attractive => ә'træktiv
attractively => ә'træktivli
attractor => ә'træktә
attracts => əˈtrækts
attributable => ә'tribju:tәbl
attribute => ә'tribju:t
attributed => ə'trɪbjuːtɪd
attributing => əˈtribju:tɪŋ
attribution => әtri'bju:ʃәn
attributive => ә'tribju:tiv
attrit => 'ætrit
attrition => ә'triʃәn
attune => ә'tju:n
attuned => əˈtju:nd
attunement => ə'tju:nmənt;
attunes => əˈtu:nz
attuning => əˈtu:nɪŋ
Atwood => ˈætˌwʊəd
atypical => .ei'tipikl
AU => әu
au courant => ˌəʊku:ˈrɑ:ŋ
au fait => әu'fe
au gratin => ˌəʊ ˈgrætæn
au naturel => әu natyrel
au pair => әu peә
au revoir => ,әurә'vwɑ:
aubade => әu'bɑ:d
auberge => әu'berʒ
aubergine => 'әubәʒi:n
Aubrey => 'ɔ:bri
auburn => 'ɒ:bәn
Aubusson => әubʌ'sәun
Auckland => ɒ:klәnd
auction => 'ɒ:kʃәn
auction bridge => ˈɔ:kʃən bridʒ
auctioned => ˈɔ:kʃənd
auctioneer => .ɒ:kʃә'niә
auctioneers => ˌɔ:kʃəˈnɪəz
auctioning => ˈɔ:kʃənɪŋ
aucuba => 'ɔ:kjubә
audacious => ɒ:'deiʃәs
audaciously => ɔ:'deiʃəsli
audacity => ɒ:'dæsiti
Auden => 'ɔ:dn
audial => 'ɔ:diәl
audibility => .ɒ:di'biliti
audible => 'ɒ:dәbl
audibly => 'ɒ:dәbli
audience => 'ɒ:diәns
audiences => 'ɔ:dɪənsɪz
audile => 'ɒ:dail
audio => 'ɒ:diou
audio typist => ˈɔ:djəu ˈtaipist
audio- => 'ɔ:diәj
audio-visual => ɔ:diәj 'viʒjәl
audiobook => 'ɔ:di:əubuk
audiogram => 'ɔ:diә,^ræm
audiology => .ɒ:di'ɒlәdʒi
audiometer => .ɒ:di'ɒmitә
audiometric => ,ɔ: diә'metrik
audiometry => ,ɔ:di'ɔmitri
audiophile => 'ɔ:diәfail
audiotape => 'ɔ:diәuteip
audiovisuals => ,ɔ:diәj'vizjjәlz
audit => 'ɒ:dit
audited => ˈɔ:ditid
auditing => 'ɔ:ditiŋ
audition => ɒ:'diʃәn
auditive => 'ɒ:ditiv
auditor => 'ɒ:ditә
auditorial => .ɒ:di'tɒ:riәl
auditorium => .ɒ:di'tɒ:riәm
auditoriums => ɔ:dɪ'tɔ:rɪəmz
auditors => 'ɔ:dɪtəz
auditory => 'ɒ:ditәri
audits => ˈɔ:dits
audrey => 'ɔ:dri:
Audubon => 'ɔ:dәbɔn
Augean => ɒ:'dʒi:әn
Augeas => ɔ:'dʒi:æs
auger => 'ɒ:gә
augering => 'ɔ:^әriŋ
aught => ɒ:t
augite => 'ɒ:dʒait
augment => ɒ:g'ment
augmentation => .ɒ:gmen'teiʃәn
augmentative => ɔ:^'mentәtiv
augmented => ɔ:ɡ'mentid
augments => ɔ:ɡˈments
augur => 'ɒ:gә
augural => 'ɒ:gjurәl
augured => ˈɔ:gəd
auguries => ˈɔ:gjəri:z
auguring => ˈɔ:gərɪŋ
augurs => ˈɔ:gəz
augury => 'ɒ:gjuri
august => ɒ:'gʌst. 'ɒ:gәst
augusta => ɔ:'^ʌstә
Augustan => ɒ:'gʌstәn
Auguste => aj'^u:st
Augustine => ɔ:'^ʌstin
Augustinian => ,ɔ:^әs'tiniәn
augustly => 'ɔ:gəstlɪ
augustness => ɔ:'ɡʌstnəs
augustus => ɔ:'^ʌstәs
auk => ɒ:k
auklet => 'ɒ:klit
auks => ɔ:ks
Auld => ɔ:ld
aumbry => 'æmbri
aunt => ɑ:nt
auntie => 'ɑ:nti
aunties => ˈænti:z
aunts => ɑ:nts
aunty => 'ɑ:nti
aura => 'ɒ:rә
aurae => 'ɒ:ri:
aural => 'ɒ:rәl
Aurangzeb => 'ɔ:rəŋzeb
aurar => 'aurɑ:
aureate => 'ɒ:riit
Aurelius => ɔ:'ri:ljәs
aureole => 'ɒ:riәul
aureus => 'ɔ:riәs
auric => 'ɒ:rik
auricle => 'ɒ:rikl
auricula => ә'rikjulә
auricular => ɒ:'rikjulә
auriculas => ɔː'rɪkjʊlə
auriculate => ɔ:'rikjulit
auriferous => ɒ:'rifәrәs
Auriga => ɒ:'raigә
Aurignacian => ,ɔ:ri^'neiʃәn
auriscope => 'ɒ:riskәup
aurochs => 'ɒ:rɒks
aurora => ɒ:'rɒ:rә
auroral => ɒ:'rɒ:rәl
auroras => 'ɔ:rɔ:rəz
Auschwitz => 'auʃ,vits
auscultate => 'ɒ:skәlteit
auscultated => ˈɔ:skəlteitid
auscultates => ˈɔ:skəlteits
auscultating => ˈɔ:skəlteitɪŋ
auscultation => .ɒ:skәl'teiʃәn
auscultatory => ɒ:'skʌltәtәri
Auspex => 'ɔ:speks
auspice => 'ɒ:spis
auspices => 'ɔ:spisiz
auspicious => ɒ:'spiʃәs
auspiciousness => ɒːsˊpiʃәsnis
Aussie => 'ɒ:zi
Austen => 'ɔ:stin
austenite => 'ɔ:stә,nait
austenitic => ˌɔ:stə'nɪtɪk
austere => ɒ'stiә
austerely => ɔ:s'tiəli
austerities => ɔ:ˈsterɪti:z
austerity => ɒ'sterәti
austin => 'ɔ:stin
austral => 'ɒ:strәl
Australasia => .ɒstrә'leiʒjә
Australasian => .ɒstrә'leiʒjәn
Australia => ɒ'streiljә
Australian => ɒ'streiljәn
Australianism => ɔ'streiljənizəm
australians => ɔ:ˈstreɪljənz
Australoid => 'ɔ:strәlɔid
australopithecine => ,ɔstrәlәj'piθәsi:n
Australorp => 'ɔstrәlɔ:p
Austria => 'ɒstriә
Austria-Hungary => 'ɔstriə'hʌŋɡəri
Austrian => 'ɒstriәn
austrians => ˈɔstrɪənz
Austronesian => ,ɔ:strәu'ni:ʒiәn
aut- => ɔ:t
autarch => 'ɔ:tɑ:tʃ
autarchic => ɔ:'tɑ:kik
autarchy => 'ɒ:tɑ:ki
autarkic => ɔ:'tɑ:kik
autarky => 'ɒ:tɑ:ki
autecological => ,ɔ:tәkә'lɔdʒikәl
autecology => ,ɔ:tә'kɔlәdʒi
auteur => әu'tә:
auteurist => ɔ:'tεərist
authentic => ɒ:'θentik
authentically => ɒ:'θentikli
authenticate => ɒ:'θentikeit
authenticates => ɔ:ˈθentɪˌkeɪts
authenticating => ɔ:ˈθentɪˌkeɪtɪŋ
authentication => ɒ:θenti'keiʃәn
authenticity => .ɒ:θen'tisiti
authentics => ɔː'θentɪk
authigenic => ,ɔ:θi'dʒenik
author => 'ɒ:θә
authored => ˈɔ:θəd
authoress => 'ɒ:θәris
authoresses => ˈɔ:θərisiz
authorial => ɒ:'θɒ:riәl
authorisation => ,ɔ:θəraɪ'zeɪʃən
authorise => 'ɔ:θәraiz
authorised => 'ɔ:θəraɪzd
authoritarian => ɒ:.θɒri'tєәriәn
authoritarianism => ə,θɔrə'tɛrɪənɪzəm
authoritarians => əˌθɔ:rɪˈteəri:ənz
authoritative => ɒ:'θɒritәtiv
authoritatively => ɒ:'θɒritәtivli
authoritativeness => ɒːˊθɒritәtivnis
authority => ɒ:'θɒriti
authority figure => ɔ:ˈθɔriti ˈfiɡə
authorization => .ɒ:θәrai'zeiʃәn
authorize => 'ɒ:θәraiz
authorized => 'ɒ:θәraizd
authorizes => ˈɔ:θəraiziz
authors => ˈɔ:θəz
authorship => 'ɔ:θәʃip
autism => 'ɒ:tizm
autistic => ɔ:'tistik
auto => 'ɒ:tәu
auto- => 'ɔ:tәj
auto-suggestion => ˈɔːtəʊ səˈdʒestʃən
autoantibody => ,ɔ:tә'ænti,bɔdi
autobahn => 'ɔ:tәubɑ:n
autobahns => 'ɔ:təubɑ:n
autobiographer => .ɒ:tәubai'ɒgrәfә
autobiographical => ɔ:tәjbaiә'^ræfik(ә)l
autobiographies => ˌɔ:təubaiˈɔɡrəfiz
autobiography => .ɒ:tәubai'ɒgrәfi
autocar => 'ɒ:tәukɑ:
autocatalysis => ,ɔ:tәkә'tælisis
autocatalyst => ,ɔ:tә'kætәlist
autocatalytic => 'ɔ:tәj,kætә'litik
autocephalous => .ɒ:tә'sefәlәs
autochanger => 'ɔ:tәu,tʃeindʒә
autochrome => 'ɔtәukrәum
autochthon => ɒ:'tɒkθәn
autochthonous => 'ɔ:'tɔkθәnәs
autoclave => 'ɔ:tәukleiv
autocorrelation => ,ɔ:tәukɔri'leiʃәn
autocracies => ɔ:ˈtɔkrəsi:z
autocracy => ɒ:'tɒkrәsi
autocrat => 'ɒ:tәkræt
autocratic => .ɒ:tә'krætik
autocratically => .ɒ:tә'krætikli
autocrats => ˈɔ:təˌkræts
autocross => 'ɔ:tәu,krɔs
autocue => 'ɔ:tә,kju:
autodial => 'ɔ:tәu,daiәl
autodidact => 'ɒ:tәu.daidækt
autodidactic => ˌɔ:təʊdɪ'dæktɪk
autoecology => ,ɔ:tәu,i:'kɔlәdʒi
autoerotic => ,ɔ:tәui'rɔtik
autofocus => 'ɔ:tәu'fәukәs
autogamous => ɒ:'tɒgәmәs
autogamy => ɒ:'tɒgәmi
autogenic => ,ɔ:tә'dʒenik
autogenic training => ˌɔ:təˈdʒenik ˈtreiniŋ
autogenics => ,ɔːtə(ʊ)'dʒenɪk
autogenous => ɒ:'tɒdʒinәs
autogiro => .ɒ:tәu'dʒaiәrәu
autograft => 'ɔ:tәu^rɑ:ft
autograph => 'ɒ:tәugrɑ:f
autographic => ,ɔ:tәj'^ræfik
autographing => ˈɔ:təˌgræfɪŋ
autographs => ˈɔ:təˌgræfs
autography => ɒ:'tɒgrәfi
autoharp => 'ɔ:tәu,hɑ:p
autohypnosis => .ɒ:tәuhip'nәusis
autoimmunity => ,ɔ:tәui'mju:niti
autointoxication => 'ɔ:tәuin,tɔksi'keiʃәn
autoloader => 'ɔ:tәu,lәudә
autologous => ɔ:'tɔlә^әs
autolysis => ɒ:'tɒlisis
automaker => 'ɔ:tәu,meikә
automat => 'ɒ:tәumæt
automata => ɒ:'tɒmәtә
automate => 'ɔ:tәmeit
automated teller machine => 'ɔ:təumeitid ˈtelə məˈʃi:n
automates => ˈɔ:təˌmeɪts
automatic => .ɒ:tә'mætik
automatic pilot => ˌɔ:təˈmætik ˈpailət
automatically => .ɒ:tә'mætikli
automaticity => ɒ:.tɒmә'tisiti
automatics => ,ɔ:tә'mætiks
automation => .ɒ:tә'meiʃәn
automatism => ɒ:'tɒmәtizm
automatization => ,ɔ:tәmæti'zeiʃәn
automatize => ɒ:'tɒmәtaiz
automaton => ɒ:'tɒmәtәn
automatons => ɔ:'tɒmətənz
automize => 'ɔ:təumaiz
automobile => 'ɒ:tәmәbi:l
automobiles => 'ɔ:təməbi:lz
automotive => .ɒ:tәu'mәutiv
autonomic => .ɒ:tәu'nɒmik
autonomist => ɒ:'tɒ:nәmist
autonomous => ɒ:'tɒnәmәs
autonomously => ɔ:'tɔnəməsli
autonomy => ɒ:'tɒnәmi
autopilot => 'ɔ:tәpailәt
autopista => ,ɔ:tәu'pistә
autopsies => ˈɔ:ˌtɔpsi:z
autopsy => 'ɒ:tәpsi
autoradiograph => ,ɔ:tәj'reidiәj^rɑ:f; -^ræf
autoradiography => 'ɔ:tәu,reidi'ɔ^rәfi
autorotate => 'ɔ:tәurәu'teit
autorotation => ,ɔ:tәjrәj'teiʃәn
autoroute => 'ɔ:tә,ru:t
autoshape => 'ɔ:tәjʃeip
autosomal => ,ɔ:tәj'sәjmәl
autosome => 'ɔ:tәsәum
autostrada => ,autәu'strɑ:dә
autosuggestion => .ɒ:tәusә'dʒestʃәn
autotelic => .ɒ:tәu'telik
autotomy => ɒ:'tɒtәmi
autotoxin => .ɒ:tәu'tɒksin
autotransformer => ,ɔ:tәutræns'fɔ:mә
autotransplant => ,ɔ:tәj'trænspla:nt
autotransplantation => ,ɔ:tәutrænsplɑ:n'teiʃәn
autotransplanted => ,ɔ:təu'trænsplɑ:nt; -plænt
autotroph => 'ɔ:tәutrɔf
autotrophic => ,ɔ:tәu'trɔfik
autotrophy => ,ɔ:tә'trɔfi
autotune => 'ɔ:tә,tju:n
autowinder => 'ɔ:təu,waində
autoworker => 'ɔ:tәu,wә:kә
autoxidation => ɒ:.tɒksi'deiʃәn
autumn => 'ɒ:tәm
autumn crocus => ˈɔ:təm ˈkrəukəs
autumnal => ɒ:'tʌmnәl
autunite => 'ɔ:tәnait
Auvergne => əu'vεən
auxiliary => ɒ:g'ziljәri
auxiliary verb => ɔ:ɡˈziljəri və:b
auxin => 'ɒ:ksin
auxotroph => 'ɔ:ksәtrɔf
auxotrophic => ,ɔ:ksә'trɔfik
avadavat => 'ævәdә,væt
avail => ә'veil
availabilities => ə,veɪlə'bɪlətɪ
availability => ә.veilә'biliti
available => ә'veilәbl
availed => əˈveild
availing => əˈveilɪŋ
avails => ә'veils
avalanche => 'ævәlɑ:ntʃ
avalanched => 'ævəlɑːnʃ
avalanches => ˈævəˌlæntʃiz
avalanching => 'ævəlɑːnʃ
Avalon => 'ævәlɔn
avant- => 'ævɔŋ
avant-garde => .ævɔŋ'ɡɑ:d
avant-gardism => ,ævɔŋ'ɡɑ:dizəm
avarice => 'ævәris
avaricious => .ævә'riʃәs
avariciously => ˌævə'rɪʃəslɪ
avariciousness => ævәˊriʃәsnis
avascular => ә'vɑ:skjulә
avast => ә'væst
avatar => .ævә'tɑ:
avaunt => ә'vɔ:nt
ave => 'ævi
Aveling => 'eivliŋ
aven => ә'ven
avenge => ә'vendʒ
avenged => əˈvendʒd
avenger => ә'vendʒә
avenges => əˈvendʒz
avenging => ә'vendʒiŋ
avens => 'ævinz
aventurine => ә'ventjurin
avenue => 'ævәnju:
avenues => 'ævə,njʊ
aver => ә'vә:
average => 'ævәridʒ
averagely => 'ævəridʒli
averages => ˈævəridʒz
averaging => 'ævәridʒiŋ
averment => ә'vә:mәnt
Avernus => ә'vә:nәs
averred => 'əvɜ:d
avers => əˈvɜ:z
averse => ә'vә:s
aversion => ә'vә:ʃәn
aversion therapy => əˈvɜ:ʒən ˈθerəpi
aversions => əˈvɜ:ʒənz
aversive => ə'və:siv
avert => ә'vә:t
averted => ə'və:tid
averting => əˈvə:tɪŋ
averts => əˈvə:ts
avery => 'eivәri
Avesta => ә'vestә
Avestan => ә'vestәn
avgas => 'ævgæs
avian => 'eiviәn
avian flu => ˈeiviən flu:
aviaries => ˈeɪvi:ˌeri:z
aviary => 'eivjәri
aviate => 'eivieit
aviated => ˈeivieitid
aviates => ˈeivieits
aviating => ˈeivieitɪŋ
aviation => .eivi'eiʃәn
aviator => 'eivieitә
aviators => ˈeɪvi:ˌeɪtəz
aviatrix => ,eivi'eitriks
aviculture => 'eivikʌltʃә
aviculturist => 'eɪvɪ'kʌltʃərɪst
avid => 'ævid
avidin => 'ævidin
avidity => ә'viditi
avifauna => .eivi'fɒ:nә
avignon => .ævi:n'jәuŋ
avionics => ,eivi'ɔniks
avirulent => æ'virjulәnt
avitaminosis => ei.vaitәmi'nәusis
Aviv => ɑ:'viv
avizandum => ,ævi'zændәm
avo => 'ævu:
avocado => .ævәu'kɑ:dou
avocados => ˌævəˈkɑ:dəʊz
avocation => .ævәu'keiʃәn
avocet => 'ævәset
avocets => 'ævəset
Avogadro => avɔ'gadrɔ
avoid => ә'vɒid
avoidable => ә'vɒidәbl
avoidance => ә'vɒidәns
avoidant => ә'vɔidәnt
avoids => əˈvɔidz
avoirdupois => .ævәdә'pɒiz
avon => 'eivɔn
avouch => ә'vautʃ
avouched => əˈvaʊtʃt
avouches => ə'vaʊtʃ
avouching => əˈvaʊtʃɪŋ
avow => ә'vau
avowal => ә'vauәl
avowals => ə'vaʊəl
avowed => ә'vaud
avowedly => ә'vaudli
avowing => əˈvaʊɪŋ
avows => əˈvaʊz
avulse => ә'vʌls
avulsed => æ'vʌlst
avulsing => əˈvʌlsɪŋ
avulsion => ә'vʌlʃәn
avuncular => ә'vʌŋkjulә
aw => ɔ:
aw-shucks => 'ɔ:'ʃʌks
awa => ә'wɑ:, -'wɔ:
await => ә'weit
awaited => əˈweitid
awaits => əˈweits
awake => ә'weik
awaken => ә'weikәn
awakened => əˈweɪkənd
awakening => ә'weikәniŋ
awakens => əˈweɪkənz
awakes => əˈweiks
award => ә'wɒ:d
aware => ә'wєә
awareness => ә'weәnis
awash => ә'wɒʃ
away => ә'wei
awe => ɒ:
awe-inspiring => 'ɔ:in,spaiәriŋ
aweary => ә'wiәri
awed => ɔ:d
aweigh => ә'wei
awesome => 'ɒ:sәm
awesomely => 'ɔ:səmli
awestruck => 'ɔ:strʌk
awful => 'ɒ:ful
awfully => 'ɒ:fuli
awfulness => 'ɒ:fulnis
awhile => ә'hwail
awhirl => ә'wә:l
awing => ә'wiŋ
awkward => 'ɒ:kwәd
awl => ɒ:l
awn => 'ɔ:n
awned => 'ɔ:nd
awning => 'ɒ:niŋ
awnings => 'ɔ:nɪŋz
awoke => ә'wәuk
awoken => ә'wәukәn
awol => 'eiwә:l
awry => ә'rai
ax => æks
Axa => 'æksə
axed => ækst
axel => 'æksәl
axeman => 'æksmәn
axenic => ei'zenik
axes => 'æksi:z
axial => 'æksiәl
axially => 'æksiәli
axil => 'æksil
axilla => æk'silә
axillaries => ækˈsiləriz
axillary => 'æksilәri
axiological => .æksiә'lɔdʒikәl
axiom => 'æksiәm
axiomatic => .æksiәu'mætik
axiomatically => .æksiәu'mætikli
axiomatize => ,æksi'ɔmәtaiz
axis => 'æksis
axisymmetric => ,æksisi'metrik
axle => 'æksl
axles => 'ækslz
axman => 'æksmәn
Axminster => 'æksminstә
axolemma => æksә'lemә
axolotl => .æksә'lɒtl
axon => 'æksɔn
axoneme => 'æksәni:m
axonometric => ,æksәnәu'metrik
axoplasm => 'æksә,plæzәm
axoplasmic => æk'sɒplæzmɪk
Axum => 'ɑ:ksum
ay => ai
Ayacucho => ,ɑ:jɑ:'ku:tʃɔ:
ayah => 'aiә
ayahuasca => ,aijә'hwɑ:skә
ayatollah => ,aɪə'tɒlə
aye => ai
aye-aye => 'aiai
Aylesbury => 'eilzbәri
Aymara => ,aimә'rɑ:
Ayodhya => əˈjəʊdjə
Ayr => εə
Ayrshire => 'єәʃә
ayurvedic => ,ɑ:jə'veidik
azalea => ә'zeiljә
azaleas => əˈzeiliəz
azan => ɑ:'zɑ:n
Azania => ә'zæniә
azarole => 'æzә,rәul
azeotrope => ә'zi:әtrәup
azeotropic => ә,zi:ә'trɔpik
Azerbaijan => ,ɑ:zәbai'dʒɑ:n
Azerbaijani => ,æzәbai'dʒɑ:ni
Azeri => 'æzəri
azide => 'æzaid, 'eizid
azidothymidine => eɪzɪdəθɪ'maɪdaɪn
Azilian => ә'ziliәn
azimuth => 'æzimәθ
azimuthal => æzi'mju:θl
azine => 'æzi:n
azo- => 'æzәj
azobenzene => ,æzәu'benzi:n
azoic => ә'zәuik
azonal => ei'zәunl
azoospermia => ei,zәuә'spә:miә
azoturia => ,æzәu'tjuәriә
Azov => 'æzɒv
Aztec => 'æztek
azulejo => ,ɑ:θu:'lehәj
azure => 'æʒә
azurite => 'æʒurait
azygos vein => ˈæziɡəs vein
azygous => 'æzigәs