Q => kju:
qanat => kɑ:'nɑ:t
qat => kɑ:t
Qatar => 'kɑ:tәr
Qatari => 'kɑ:təri
qawwali => kɔ:wə'lɪ
qigong => kɪ'ɡɒŋ
Qinghai => 'tʃiŋ'hai
qintar => kin'tɑ:
Qom => kәjm
qua => kwei
Quaalude => 'kweilu:d,'kwɑ:-
quack => kwæk
quack grass => kwæk ɡrɑ:s
quacked => kwækt
quackery => 'kwækәri
quacking => kwækɪŋ
quackish => 'kwækiʃ
quacks => kwæks
quad => kwɔd
quad bike => kwɔd baik
quad-speed => k'wɒdsp'i:d
quadplex => 'kwɔ:d,pleks
quadragenarian => ,kwɔdrәdʒi'neә riәn
Quadragesima => ,kwɔdrә'dʒesimә
quadragesimal => ,kwɒdrə'dʒesɪm(ə)l
quadraminium => ,kwɔdrә'miniәm
quadrangle => 'kwɒdræŋgl
quadrangles => kwɒd'ræŋɡlz
quadrangular => kwɒ'dræŋgjulә
quadrant => 'kwɒdrәnt
quadrantal => kwɒ'dræntәl
Quadrantids => 'kwɔdrәntidz
quadraphonic => ,kwɔdrә'fәunik
quadraphonics => ,kwɔdrә'fәuniks
quadraphony => kwɔ'dræfәni
quadrat => 'kwɒdræt
quadrate => 'kwɒdrәt
quadratic => kwә'drætik
quadratics => kwɔ'drætiks
quadrature => 'kwɒdrәtʃә
quadrennial => kwɔ'drenjәl
quadrennially => k'wɒdrnɪəlɪ
quadrennium => kwɔ'dreniәm
quadric => 'kwɒdrik
quadricep => 'kwɔdrisep
quadriceps => 'kwɒdriseps
quadrilateral => .kwɒdri'lætәrәl
quadrilaterals => ,kwɒdrɪ'læt(ə)r(ə)l
quadrille => kwә'dril
quadrilles => kwɔˈdrilz
quadrillion => kwɔ'driljәn
quadrillionth => kwɔ'drilijәnθ
quadripartite => .kwɒdri'pɑ:tait
quadriplegia => ,kwɔdrә'pli:dʒiә
quadriplegic => ,kwɔdri'pledʒik,-'pli:-
quadriplex => 'kwɔdri,pleks
quadrivalent => .kwɒdri'veilәnt
quadrivium => kwɒ'driviәm
quadrominium => ,kwɔdrә'miniәm
quadroon => kwɒ'dru:n
quadrophonic => ,kwɔdrә'fɔnik
quadrumanous => kwɒ'dru:mәnәs
quadruped => 'kwɒdruped
quadrupedal => kwɔ'dru:pidәl
quadrupeds => k'wɒdrʊpedz
quadruple => 'kwɒdrupl
quadrupled => kwɔˈdru:pəld
quadruples => kwɔˈdru:pəlz
quadruplet => 'kwɒdruplit
quadruplets => kwodrʊplɪt
quadruplicate => kwɔ'dru:plikit
quadruplicated => kwɒ'druːplɪkət
quadruplicates => kwɒ'druːplɪkət
quadruplicating => kwɒ'druːplɪkət
quadruplicity => ,kwɔdrj'plisәti
quadrupling => kwɔ'dru:pliŋ
quadruply => 'kwɒdrupli
quadrupole => 'kwɔdrә,pәul
quads => kwɒdz
quaestor => 'kwi:stә
quaestorship => ˊkwiːstәʃip
quaff => kwæf
quaffable => k'wɒfeɪbl
quaffed => kwɔft
quaffing => kwɔfɪŋ
quaffs => kwɔfs
quag => kwæg
quagga => 'kwægә
quaggy => 'kwægi
quagmire => 'kwæ^maiә
quagmires => ˈkwægˌmaɪəz
quahog => 'kwɑ:hɔ^, 'kwɔ:-
Quai => kei
quaich => kweik
quail => kweil
quailed => kweɪld
quailing => kweɪlɪŋ
quails => kweɪlz
quaint => kweint
quainter => kweintə
quaintness => kweɪntnəs
quake => kweik
quaked => kweɪkt
quaker => 'kweikә
Quakerish => 'kweikәriʃ
Quakerism => 'kweikәrizm
quakes => kweɪks
quaky => 'kweiki
quale => 'kweili:
qualifiable => 'kwɔlifɑiәbl
qualification => .kwɒlifi'keiʃәn
qualificatory => 'kwɒlifikәtәri
qualified => 'kwɒlifaid
qualifier => 'kwɒlifaiә
qualifiers => ˈkwɔlifaiəz
qualifies => ˈkwɔlifaiz
qualify => 'kwɒlifai
qualitative => 'kwɒlitәtiv
qualitatively => 'kwɒlɪtətɪvlɪ
qualities => ˈkwɔlitiz
quality => 'kwɒlәti
quality circle => ˈkwɔliti ˈsə:kl
quality time => ˈkwɔliti taim
qualm => kwɒ:m
qualmish => 'kwɒ:miʃ
quamash => 'kwɔmæʃ,kwә'mæʃ
quandaries => ˈkwɔndəri:z
quandary => 'kwɒndәri
quandong => 'kwɔndɔŋ
quango => ˈkwæŋgəʊ
quant => kwænt
quanta => 'kwɒntә
quantal => 'kwɑntl
quantic => 'kwɒntik
quantifiability => ,kwɔntәfaiә'biliti
quantifiable => 'kwɒntifaiәbl
quantification => ,kwɔntifi'keiʃ(ә)n
quantified => ˈkwɔntifaid
quantifier => 'kwɒntifaiә
quantify => 'kwɒntifai
quantile => 'kwɔntail
quantitate => 'kwɔntiteit
quantitation => ,kwɔnti'teiʃən
quantitative => 'kwɒntitәtiv
quantitive => 'kwɔntitiv
quantity => 'kwɒntәti
quantity theory => ˈkwɔntiti ˈθiəri
quantization => ,kwɔntai'zeiʃәn
quantize => 'kwɔntaiz
quantized => 'kwɔntaizd
quantizer => 'kwɔntaizә
quantizes => ˈkwɔntaiziz
quantizing => ˈkwɔntaiziŋ
quantum => 'kwɒntәm
quantum chromodynamics => ˈkwɔntəm ˌkrəumədaiˈnæmiks
quantum electrodynamics => ˈkwɔntəm ilektrəudaiˈnæmiks
quantum field theory => ˈkwɔntəm fi:ld ˈθiəri
quantum jump => ˈkwɔntəm dʒʌmp
quantum-mechanical => 'kwɔntәmmi'kænikәl
quarantine => 'kwɒrәnti:n
quarantined => ˈkwɔ:rənˌti:nd
quarantines => ˈkwɔ:rənˌti:nz
quarantining => ˈkwɔ:rənˌti:nɪŋ
quark => kwɑ:k
quarks => kwɑ:ks
quarrel => 'kwɒrәl
quarrels => ˈkwɔrəlz
quarrelsome => 'kwɒrәlsәm
quarrelsomeness => ˊkwɒnәlsәmnis
quarried => ˈkwɔ:ri:d
quarrion => 'kwɔriәn
quarry => 'kwɒri
quarrying => 'kwɔriiŋ
quarryman => 'kwɒrimәn
quart => kwɒ:t
quartan => 'kwɒ:tn
quarter => 'kwɒ:tә
quarter section => ˈkwɔ:tə ˈsekʃən
quarter-bound => 'kwɔ:tәbajnd
quarter-final => 'kwɔ:tәfain(ә)l
quarter-finalist => k'wɔ:tərf'aɪnəlɪst
quarter-hour => k'wɔ:tər'aʊər
quarter-light => k'wɔ:tərl'aɪt
quarterage => 'kwɔ:tә,ridʒ
quarterback => 'kwɒ:tәbæk
quarterbacks => ˈkwɔ:təˌbæks
quarterdeck => 'kwɔ:tәdek
quarterdecks => 'kwɔːtədek
quartered => 'kwɔ:tәd
quarterfinal => 'kwɒ:tәfainәl
quarterfinals => ,kwɔ:tə'fainəl
quartering => 'kwɔ:tәriŋ
quarterlies => ˈkwɔ:təliz
quarterly => 'kwɔ:tәli
quartermaster => 'kwɒ:tә.mɑ:stә
quartermasters => ˈkwɔ:rtəˌmɑ:stəz
quartern => 'kwɔ:tәn
quarterstaff => 'kwɔ:tәstɑ:f
quartet => kwɒ:'tet
quartets => kwɔ:ˈtets
quartic => 'kwɒ:tik
quartile => 'kwɒ:tail
quarto => 'kwɒ:tәu
quartos => ˈkwɔ:təuz
quarts => kwɔ:ts
quartz => kwɒ:ts
quartz-halogen => 'kwɔ:ts'hælədʒin
quartzite => 'kwɒ:tsait
quasar => 'kweisɑ:
quasars => k'weɪzɑ:z
quash => kwɒʃ
quashed => kwɔʃt
quashes => kwɔʃiz
quashing => kwɔʃɪŋ
quasi => 'kwɑ:zi:
quasi- => 'kweisai
quasiparticle => ,kweizai'pɑ:tikl
quassia => 'kwɒʃiә
quatercentenary => , kwætәsen'ti:nәri
quaternary => kwә'tә:nәri
quaternion => kwә'tә:njәn
quatorze => kә'tɔ:z
quatrain => 'kwɒtrein
quatrefoil => 'kætәfɒil
quatro => 'kwɑ:trәj
quattrocento => ,kwætrәu'tʃentәu
quaver => 'kweivә
quavered => ˈkweɪvəd
quaveringly => k'weɪvərɪŋlɪ
quavers => ˈkweɪvəz
quavery => 'kweivәri
quay => ki:
quayage => 'ki:idʒ
quays => ki:z
quayside => 'ki:said
quean => kwi:n
queasily => 'kwi:zili
queasiness => 'kwi:zinis
queasy => 'kwi:zi
quebec => kwi'bek
Quebecker => kwi'bekә
quebracho => kei'brɒtʃәu
Quechua => 'ketʃwɑ:, -wә
Quechuan => 'ketʃwәn,kә'tʃu:әn
queen => 'kwi:n
queen-sized => 'kwi:nsaiz
queendom => 'kwi:ndәm
Queenie => 'kwi:ni
queening => 'kwi:niŋ
queenliness => 'kwi:nlinis
queenly => 'kwi:nli
queensberry => 'kwi:nzb(ә)ri
queenship => 'kwi:nʃip
queenside => 'kwi:nsaid
Queensland => 'kwi:nzlәnd
queensware => 'kwi:nzweә(r)
queer => kwiә
queerer => kwiəə
queerly => 'kwiәli
queerness => 'kwiәnis
queers => kwiəz
quelea => 'kwi:liә
quell => kwel
quelled => kweld
quelling => kwelɪŋ
quells => kwelz
quench => kwentʃ
quenched => kwentʃt
quencher => 'kwentʃә
quenches => kwentʃiz
quenching => 'kwentʃiŋ
quenchless => 'kwentʃlis
quenelle => kә'nel
Quentin => 'kwentin
quercetin => 'kwә:sitin
queried => ˈkwiərid
querist => 'kwiәrist
quern => kwә:n
quernstone => 'kw\\\\:nstәjn
querulous => 'kwerulәs
querulously => 'kwɛrələsli
query => 'kwiәri
quesadilla => ,keisә'di:jә
quest => kwest
question => 'kwestʃәn
question master => ˈkwestʃən ˈmɑ:stə
question tag => ˈkwestʃən tæɡ
questionable => 'kwestʃәnәbl
questionably => 'kwestʃənəblɪ
questionary => 'kwestʃ(ә)nәri
questioned => ˈkwestʃənd
questioner => 'kwestʃәnә
questioners => ˈkwestʃənəz
questioning => 'kwestʃәniŋ
questioningly => 'kwestʃәniŋli
questionnaire => kwestʃә'nєә
questionnaires => ˌkwestiəˈnɛəz
questor => 'kwestә, 'kwi:s-
Quetta => 'kwetә
quetzal => ket'sɑ:l, 'ketsәl
queue => kju:
queued => kju:d
queues => kju:z
Quezon City => 'keizɔn 'siti
qui vive => ki:'vi:v
quibble => 'kwibl
quibbled => ˈkwɪbəld
quibbles => ˈkwɪbəlz
quibblingly => k'wɪblɪŋlɪ
quiche => ki:ʃ
quiches => ki:ʃiz
quick => kwik
quick fix => kwik fiks
quick march => kwik mɑ:tʃ
quick-freezing => kwik ˈfri:ziŋ
quick-froze => kwik frəuz
quick-frozen => kwik ˈfrəʊzən
quick-release => k'wɪkrɪl'i:s
quick-tempered => kwik 'tempәd
quick-witted => kwik 'witid
quicken => 'kwikәn
quickened => ˈkwɪkənd
quickening => 'kwikәniŋ
quickens => ˈkwɪkənz
quickie => 'kwiki
quicklime => 'kwiklaim
quickly => 'kwikli
quickness => 'kwiknis
quicksand => 'kwiksænd
quickset => 'kwikset
quicksilver => 'kwiksilvә
quickstep => 'kwikstep
quicksteps => 'kwɪkstep
quickthorn => 'kwikθɔ:n
quid => kwid
quid pro quo => 'kwidprәu'kwou
quiddities => ˈkwiditiz
quiddity => 'kwidәti
quidnunc => 'kwidnʌŋk
quids in => k'wɪdz in
quiescence => kwai'esns
quiescent => kwai'esnt
quiet => 'kwaiәt
quieted => ˈkwaiətid
quieten => 'kwaiәtn
quietened => ˈkwaɪɪtnd
quietening => ˈkwaɪɪtnɪŋ
quietens => ˈkwaɪɪtnz
quieter => 'kwaiәtә
quieting => 'kwaiәtiŋ
quietism => 'kwaiәtizm
quietist => 'kwaiәtist
quietistic => k'waɪətɪstɪk
quietly => 'kwaiәtli
quietness => 'kwaiәtnis
quiets => ˈkwaiəts
quietude => 'kwaiәtju:d
quietus => kwai'i:tәs
quiff => kwif
quill => kwil
quilled => kwild
quilling => 'kwiliŋ
quills => kwɪlz
quillwort => k'wɪlwɜ:t
quilt => kwilt
quilter => 'kwiltә
quilting => 'kwiltiŋ
quilts => kwilts
quim => kwim
quin => kwin
quinacridone => kwin'ækridәjn
quinacrine => 'kwinә,kri:n
quinary => 'kwainәri
quince => kwins
quincentenary => ,kwinsen'ti:nәri
quincentennial => kwɪnsen'tenɪəl
quinces => kwinsiz
quincuncial => kwin'kʌnʃәl
quincuncially => kwɪn'kʌnʃəlɪ
quincunx => 'kwinkʌŋks
Quincy => 'kwinsi
quinella => ki:'nelә,kwi-
quinidine => 'kwinidi:n
quinine => kwi'ni:n
quinoa => ki'nәuә
quinoline => 'kwinәli:n
quinone => kwi'nәun, 'kwinәun
quinquagenarian => ,kwiŋkwәdʒi'neәriәn
Quinquagesima => ,kwinkwә'dʒesimә
quinquennial => kwiŋ'kweniәl, -njәl
quinquennium => kwiŋ'kweniәm
quinquereme => 'kwiŋkwiri:m
quinquevalent => .kwiŋkwi'veilәnt
quins => kwinz
quinsy => 'kwinzi
quint => kwint
Quinta => 'ki:ntә
quintain => 'kwintin
quintal => 'kwint(ә)l
quinte => kæŋt
quintessence => kwin'tesns
quintessential => .kwinti'senʃәl
quintessentially => ,kwinti'senʃəli
quintet => kwin'tet
quintets => kwɪnˈtets
quintile => 'kwintil, -tail
quintillion => kwin'tiljәn
quintillionth => kwin'tiljәnθ
Quintin => 'kwintn
Quinton => 'kwintɔn
quintuple => 'kwintjupl
quintupled => ˈkwintju(:)pld
quintuples => ˈkwintju(:)plz
quintuplet => 'kwintjuplit
quintuplets => k'wɪntj'u:plets
quintuplicate => kwin'tju:plikit
quintupling => 'kwintjjpliŋ,kwin'tju:-
quip => kwip
quipped => kwɪpt
quipping => kwɪpɪŋ
quips => kwɪps
quipster => 'kwipstә(r)
quipu => 'kwi:pu; 'ki:pu
quire => 'kwaiә
quirk => kwә:k
quirked => kwɜːk
quirkier => ˈkwə:kiə
quirkily => kwɜ:'kɪlɪ
quirkish => 'kw\\\\:kiʃ
quirks => kwɜ:ks
quirky => 'kw\\\\:ki
quirt => kwә:t
quisle => 'kwizl
quisling => 'kwizliŋ
quislings => ˈkwɪzlɪŋz
quit => kwit
quitch => kwitʃ
quitclaim => 'kwitkleim
quite => kwait
quito => 'ki:tәu
quits => kwits
quittance => 'kwitns
quitter => 'kwitә
quitters => ˈkwɪtəz
quiver => 'kwivә
quivered => ˈkwivəd
quiverful => 'kwivәful
quivering => 'kwivәriŋ
quiveringly => k'wɪvərɪŋlɪ
quivers => ˈkwivəz
quivery => 'kwivәri
Quixote => 'kwiksәt
quixotic => kwik'sɔtik
quixotically => kwɪk'sɒtɪklɪ
quixotism => 'kwiksәtizәm
quixotry => k'wɪksətrɪ
quiz => kwiz
quizmaster => 'kwizmɑ:stә
quizzer => 'kwizә
quizzical => 'kwizikәl
quizzicality => ,kwizi'kæliti
quizzically => 'kwɪzɪklɪ
Qum => kum
Qumran => 'kjmrɑ:n
quo warranto => 'kwәu wɔ'ræntәu
quod => kwɒd
quod erat demonstrandum => 'kwɔd'eræt,demәn'strændjm
quodlibet => 'kwɒdlibet
quoin => kwɒin
quoit => kwɒit
quoits => 'kɔɪts
quokka => 'kwɔkә
quondam => 'kwɒndәm
Quonset => 'kwɔnsit
quorate => ˈkwɔ:rət
Quorn => kwɔ:n
quorum => 'kwɒ:rәm
quota => 'kwәutә
quotability => .kwәutә'biliti
quotable => 'kwәutәbl
quotas => k'wəʊtəz
quotation => kwәu'teiʃәn
quote => kwәut
quoth => kwәuθ
quotidian => kwɒ'tidiәn
quotient => 'kwәuʃәnt
quotients => ˈkwəʊʃənts
qursh => kjәʃ
qv => k'ju:v'i:
qwerty => 'kwә:ti