I => ai
I'd => aɪ'd
I'll => aɪl
I'm => aɪm
I've => aɪv
I-beam => 'aibi:m
Iago => i:'ɑ:^әu
iamb => 'aiæmb
iambic => ai'æmbik
iambus => ai'æmbәs
ian => iәn
Ianthe => ai'ænθi
iatro- => ai'ætrәj
iatrochemistry => ai,ætrә'kemistri
iatrogenesis => ai,ætrә'dʒenisis
iatrogenic => ai,ætrә'dʒenik
IBA => i'bɑ:
Ibadan => i'bædәn
iberia => ai'biәriә
Iberian => ai'biәriәn
iberis => ai'biәris
ibex => 'aibeks
Ibibio => ,ibi'bi:әu
ibis => 'aibis
Ibiza => i:'bi:zə
Ibizan => i'vi:θәn
Ibizan hound => i'vi:zən
Ibn => 'ibən
ibogaine => i:'bәu^ein
ibsen => 'ibsen
ibuprofen => ,aibjj'prәjfin
IC => ai'si:
Icarian => i'kєәriәn
icarus => 'aikәrәs
ice => ais
ice axe => ais æks
ice bucket => ais ˈbʌkit
ice cap => ais kæp
ice chest => ais tʃest
ice cube => ais kju:b
ice dancing => ais ˈdænsɪŋ
ice field => ais fi:ld
ice floe => ais fləu
ice fog => ais fɔɡ
ice hockey => ais ˈhɔki
ice house => ais haus
ice lolly => ais ˈlɔli:
ice milk => ais milk
ice pick => ais pik
ice plant => ais plɑ:nt
ice rink => ais rɪŋk
ice sheet => ais ʃi:t
ice shelf => ais ʃelf
ice skater => ais ˈskeɪtə
ice skating => ais ˈskeɪtɪŋ
ice storm => ais stɔ:m
ice tea => ais ti:
ice water => ais ˈwɔ:tə
ice yacht => ais jɔt
ice-bound => aɪs baʊnd
ice-breaker => 'aɪsbr'eɪkər
ice-cold => 'ais'kәjld
ice-cream soda => ˈaiskri:m ˈsəudə
iceberg => 'aisbә:g
iceberg lettuce => ˈaɪsˌbɜ:g ˈletis
icebergs => ˈaɪsˌbɜ:gz
iceblink => 'aisbliŋk
iceboat => 'aisbәut
icebound => 'aisbaund
icebox => 'aisbɒks
icebreaker => 'aisbreikә
icecap => 'aɪskæp
iced => aist
iced tea => aist ti:
icefall => 'aisfɒ:l
icehouse => 'aishaus
Iceland => 'aislәnd
Icelander => 'aislәndә
Icelandic => .ais'lændik
iceman => 'aismæn
Iceni => ai'si:nai
icepick => 'aɪspɪk
ices => aisiz
ichneumon => ik'nju:mәn
ichneumon fly => ikˈnju:mən flai
ichnography => ik'nɒgrәfi
ichor => 'aikɒ:
ichorous => 'aikɒ:rәs
ichthyic => 'ikθi:ik
ichthyo- => 'ikθiәj
ichthyolite => 'ikθiәlait
ichthyological => ,ikθiə'lɔdʒikəl
ichthyologist => .ikθi'ɒlәdʒist
ichthyology => ,ikθi'ɔlәdʒi
ichthyophagous => .ikθi'ɒfәgәs
ichthyophagy => ,ikθi'ɔfәdʒi
ichthyornis => .ikθi'ɒ:nis
ichthyosaur => 'ikθiәsɒ:
ichthyosis => ,ikθi'әusis
ichthyotic => -'ɔtik
icicle => 'aisikl
icicles => 'aɪsɪklz
icier => ˈaɪsi:ə
icily => 'aisili
iciness => 'aisinis
icing => 'aisiŋ
icing sugar => ˈaɪsɪŋ ˈʃuɡə
ick => 'ɪk
ickiness => 'ɪkɪnɪs
icky => 'iki
Ico => 'aikәu
icon => 'aikɒn
iconic => ai'kɔnik
iconically => ai'kɔnikәli
iconicity => ,aikә'nisәti
iconize => 'aikәnaiz
icono- => ai'kɔnәj
iconoclasm => ai'kɒnәklæzm
iconoclast => ai'kɒnәklæst
iconoclastic => ai.kɒnәu'klæstik
iconoclastically => ai,kɔnəu'klæstikəli
iconoclasts => aɪˈkɔnəˌklæsts
iconodule => ai'kɔnәdju:l
iconographer => aɪkɒ'nɒɡrəfə
iconographic => ai.kɔnә'ɡræfik
iconography => .aikә'nɒgrәfi
iconolatry => ,aikɔ'nɔlәtri
iconological => ai,kɔnә'lɔdʒikәl
iconology => ,aikә'nɔlәdʒi
iconostasis => ,aikә'nɔstәsis
icosahedral => ,aikәusә'hedrәl
icosahedron => .aikәsәu'hedrәn
ictal => 'iktәl
icteric => 'iktәrik
icterus => 'iktәrәs
Ictinus => ik'tainәs
ictus => 'iktәs
icy => 'aisi
id => id
IDA => 'aidә
Idaho => 'aidәhәu
Idahoan => 'aidәhәuәn
iddingsite => 'idiŋ,zait
IDE => aid
idea => ai'diә
ideal => ai'diәl
idealisation => aɪdɪəlaɪ'zeɪʃən
idealise => ai'diәlaiz
idealised => ai'diəlaiz
idealism => ai'diәlizm
idealist => ai'diәlist
idealistic => ai'diәlistik
idealistically => ˌaɪdɪə'lɪstɪklɪ
idealists => aɪ'dɪəlɪsts
ideality => .aidi'æliti
idealization => ai.diәlai'zeiʃәn
idealize => ai'diәlaiz
idealized => aɪ'diəl,aɪz
idealizes => aɪˈdi:əˌlaɪziz
idealizing => aɪˈdi:əˌlaɪzɪŋ
ideally => ai'diәli
ideate => ai'dieit
ideated => aiˈdi(:)eitid
ideating => aiˈdi(:)eitɪŋ
ideation => ,aidi'eiʃәn
ideational => ,aidi'eiʃәnәl
idem => 'aidem
idempotent => 'aidәm,pәutәnt
ident => ai'dent
identical => ai'dentikәl
identical twin => aiˈdentikəl twin
identifiable => ai'dentifaiәbl
identifiably => aɪ'dentɪfaɪəblɪ
identification => ai.dentifi'keiʃәn
identifications => aiˌdentifiˈkeiʃənz
identifier => ai'dentifaiә
identifies => aiˈdentifaiz
identify => ai'dentifai
identify with => aiˈdentifai wið
identikit => ai'dentikit
identities => aiˈdentitiz
identity => ai'dentiti
identity card => aiˈdentiti kɑ:d
identity crisis => aiˈdentiti ˈkraisis
identity parade => aiˈdentiti pəˈreid
identity theft => aiˈdentiti θeft
ideogram => 'idiә^ræm
ideograph => 'idiә^rɑ:f
ideographic => ,idiәu'^ræfik
ideography => .idi'ɒgrәfi
ideological => .aidiә'lɒdʒikәl
ideologies => ˌaidiˈɔlədʒiz
ideologist => .aidi'ɒlәdʒist
ideologue => 'aidi:әulɔ^
ideologues => ˈaidiəˌlɔɡz
ideology => .aidi'ɒlәdʒi
ides => aidz
idio- => 'idiәj
idiocies => ˈɪdi:əsi:z
idiocy => 'idiәsi
idiographic => ,idiә'^ræfik
idiolect => 'idiәulekt
idiom => 'idiәm
idiomatic => .idiә'mætik
idiomatically => .idiә'mætikәli
idioms => 'ɪdɪəmz
idiopathic => ,idiә'pæθik
idiopathy => .idi'ɒpәθi
idiophone => 'idiәufәun
idiosyncrasies => ˌɪdi:əʊˈsɪŋkrəsi:z
idiosyncrasy => .idiә'siŋkrәsi
idiosyncratic => .idiәsiŋ'krætik
idiot => 'idiәt
idiot board => ˈidiət bɔ:d
idiot box => ˈidiət bɔks
idiot savant => ˈidiət sæˈvɑ:nt
idiotic => .idi'ɒtik
idiotically => idi'ɔtikli
idiots => ˈidiəts
idiotype => 'idiәtaip
idle => 'aidl
idled => ˈaidld
idleness => 'aidlnis
idler => 'aidlә
idlers => 'aɪdləz
idles => ˈaidlz
idli => 'idli
idly => 'aidli
idocrase => 'aidәukreis, 'idәu-
idol => 'aidәl
idolater => ai'dɒlәtә
idolatress => ai'dɒlәtris
idolatrous => ai'dɒlәtrәs
idolatry => ai'dɒlәtri
idolization => .aidәlai'zeiʃәn
idolize => 'aidәlaiz
idolized => ˈaidəˌlaizd
idolizes => ˈaidəˌlaiziz
idolizing => ˈaidəˌlaizɪŋ
Idomeneus => ai'dɔminju:s
idyll => 'idil, 'aidil
idyllic => ai'dilik
idylls => ɪ'dɪlz
IE => 'i:ei
if => if
if not => if nɔt
iff => if
iffy => 'ifi
ifs => ifs
Igbo => 'i:^bәu
igg => i^
igloo => 'iglu:
igloos => ˈɪglu:z
Ignatius => i^'neiʃjәs
igneous => 'igniәs
ignimbrite => 'i^nimbrait
ignis fatuus => 'i^nis 'fætjuәs
ignitability => iɡ,naitə'biləti
ignitable => i^'naitәbl
ignite => ig'nait
ignited => iɡˈnaitid
ignites => iɡˈnaits
igniting => iɡˈnaitɪŋ
ignition => ig'niʃәn
ignitions => ɪgˈnɪʃənz
ignitron => 'i^nitrɔn
ignobility => ,ɪɡnəʊ'bɪlətɪ
ignoble => ig'nәubl
ignobly => ig'nәubli
ignominious => .ignәu'miniәs
ignominiously => ˌɪɡnə'mɪnɪəslɪ
ignominy => 'ignәmini
ignoramus => .ignә'reimәs
ignorance => 'ignәrәns
ignorant => 'ignәrәnt
ignorantly => 'ignərəntli
ignoratio elenchi => ,i^nә'reiʃiәu i'leŋkai
ignore => ig'nɒ:
ignores => iɡˈnɔ:z
ignoring => iɡˈnɔ:ɪŋ
ignotum per ignotius => i^'nәutәm pә: i^'nәuʃiәs
iguana => i'gwɑ:nә
iguanas => ɪ'gwa:ne
iguanodon => i'gwɑ:nәdɒn
iiwi => i'i:wi
IJssel => 'aisəl
ikat => 'ɪkæt
Ike => aik
ikebana => 'i:ke'bɑ:nɑ:
ikon => 'aikɔn
ilang-ilang => 'i:lɑ:ŋ'i:lɑ:ŋ
Ile => ail,il,əl
ileac => 'iliæk
ileal => 'iliәl
ileitis => ,ili'aitis
ileostomy => ,ili'ɔstәmi
ileum => 'iliәm
ileus => 'iliәs
ilex => 'aileks
ilia => 'iliә
iliac => 'iliæk
iliad => 'iliәd
ilium => 'iliәm
ilk => ilk
ill => il
ill feeling => il ˈfi:liŋ
ill health => il helθ
ill nature => il ˈneitʃə
ill temper => il ˈtempə
ill-affected => 'ilә'fektid
ill-assorted => il əˈsɔ:tid
ill-gotten => il'^ɔtn
ill-judged => 'il'dʒʌdʒd
ill-starred => 'il'stɑ:d
ill-used => il ju:zd
illation => i'leiʃәn
illative => i'leitiv
illatively => 'ɪleɪtɪvlɪ
Illawarra => ,ilә'wɔrә
illegal => i'li:gәl
illegalities => ˌɪli:ˈgælɪti:z
illegality => .ili:'gæliti
illegibility => i.ledʒi'bilәti
illegible => i'ledʒәbl
illegibly => i'ledʒәbli
illegitimacy => .ili'dʒitimәsi
illegitimate => .ili'dʒitimәt
illiberal => i'libәrәl
illiberality => i,libә'ræliti
illiberally => 'ɪlɪbərəlɪ
illicit => i'lisit
illicitly => ɪ'lɪsɪtlɪ
illimitability => i,limitə'biləti
illimitable => i'limitәbl
illimitably => iˊlinitәbli
Illinoian => ,ili'nɔiәn
Illinois => .ili'nɒis
Illinoisan => -ʒәn
illiquid => i'likwid
illiquidity => -diti
illite => 'ilait
illiteracy => i'litәrәsi
illiterate => i'litәrәt
illiterates => ɪˈlɪtərɪts
illness => 'ilnis
illnesses => 'ɪlnəsɪz
illocution => ,ilә'kju:ʃən
illocutionary => ,ilәj'kju:ʃənәri
illogic => i'lɔdʒik
illogical => i'lɒdʒikl
illogicality => .ilɒdʒi'kæliti
ills => 'ɪlz
illude => i'lu:d
illume => i'lju:m
illumed => iˈlju:md
illuminance => i'lju:minәns
illuminant => i'lju:minәnt
illuminate => i'lju:mineit
illuminates => iˈlju:mineits
illuminati => i.lu:mi'nɑ:ti:
illuminating => i'lju:mi,neitiŋ
illuminatingly => ɪ'lu:mɪneɪtɪŋlɪ
illumination => i.lju:mi'neiʃәn
illuminative => i'lju:minәtiv
illuminator => i'lju:mineitә
illumine => i'lju:min
illumined => iˈlju:mind
illumines => iˈlju:minz
illuming => ɪ'lu:mɪŋ
illumining => iˈlju:minɪŋ
illuminism => i'lu:minizm
illuminist => ɪlu:'mɪnɪst
illusion => i'lju:ʒәn
illusionary => i'lju:ʒənәri
illusionism => i'lju:ʒәnizәm
illusionist => i'lu:ʒ(ә)nist
illusionistic => i,lju:ʒə'nistik
illusions => ɪ'lu:ʒnz
illusive => i'lju:siv
illusory => i'lju:sәri
illustrate => 'ilәstreit
illustrated => 'ilәstreitid
illustrates => ˈiləstreits
illustrating => ˈiləstreitɪŋ
illustration => .ilә'streiʃәn
illustrational => ɪləst'ræʃnəl
illustrative => 'ilәstrәtiv
illustrator => 'ilәstreitә
illustrators => ˈiləstreitəz
illustrious => i'lʌstriәs
illustriously => ɪ'lʌstrɪəslɪ
illuvial => i'lu:viәl
illuviation => i,lu:vi'eiʃәn
Illyria => i'liəriə
Illyrian => i'liәriәn
ilmenite => 'ilminait
ILO => ,ai el 'əu
Ilocano => ,i:ləu'ka:nəu
Iloilo => ,i:ləu'i:ləu
image => 'imidʒ
image-maker => 'imidʒ,meikə
imager => 'imidʒә
imagery => 'imidʒәri
imaginable => i'mædʒinәbl
imaginably => im'ædʒinәbli
imaginal => i'mædʒinәl
imaginary => i'mædʒinәri
imagination => i.mædʒi'neiʃәn
imaginations => iˌmædʒiˈneiʃənz
imaginative => i'mædʒinәtiv
imagine => i'mædʒin
imagined => iˈmædʒind
imagineering => i,mædʒi'niәriŋ
imagines => i'meidʒini:z
imaging => i'mædʒiŋ
imagining => iˈmædʒinɪŋ
imagism => 'imidʒizm
imagist => 'imidʒist
imago => i'meigәu
imam => i'mɑ:m
imamate => i'mɑ:meit
imbalance => im'bælәns
imbalanced => ɪm'bælənst
imbalances => ɪmˈbælənsiz
imbecile => 'imbisi:l
imbeciles => ˈɪmbəsɪlz
imbecilic => ,imbi'silik
imbecilities => ˌɪmbɪˈsɪlətɪz
imbecility => .imbi'siliti
imbed => im'bed
imbedding => im'bediŋ
imbibe => im'baib
imbibed => ɪmˈbaɪbd
imbibes => ɪmˈbaɪbz
imbibing => ɪm'baɪbɪŋ
imbibition => .imbi'biʃәn
imbricate => 'imbrikeit
imbricates => 'ɪmbrɪkeɪt
imbricating => 'ɪmbrɪkeɪt
imbroglio => im'brәuljәu
imbrue => im'bru:
imbrued => imˈbru:d
imbruing => imˈbru:ɪŋ
imbue => im'bju:
imbued => ɪmˈbju:d
imbues => ɪmˈbju:z
imbuing => ɪmˈbju:ɪŋ
imidazole => ,imi'dæzәul,-dә'zәul
imide => 'imaid,-id
imine => 'imi:n,-in; i'mi:n
imipramine => i'miprәmi:n
imitable => 'imitәbl
imitate => 'imiteit
imitated => 'imiteitid
imitates => ˈimiteits
imitation => .imi'teiʃәn
imitations => ˌɪmiˈteiʃənz
imitative => 'imitәtiv
imitatively => ˊimitәtivli
imitator => 'imi,teitә
imitators => 'ɪmɪtəɪtəz
immaculacy => i'mækjulәsi
immaculate => i'mækjulit
immanence => 'imәnәns
immanent => 'imәnәnt
immanentism => 'ɪmənəntɪzəm
immanentist => 'imənəntist
Immanuel => i'mænjuәl
immaterial => .imә'tiәriәl
immaterialism => .imә'tiәriәlizm
immateriality => 'imә.tiәri'æliti
immature => .imә'tjuә
immeasurability => i.meʒәrә'biliti
immeasurable => i'meʒәrәbl
immeasurably => i'meʒәrәbli
immediacy => i'mi:diәsi
immediate => i'mi:diәt
immediately => i'mi:diәtli
immediateness => i'mi:diәtnis
immedicable => i'medikәbl
Immelmann => 'imәlmәn
immemorial => .imi'mɒ:riәl
immense => i'mens
immensely => i'mensli
immensities => ɪ'mensətɪ
immensity => i'mensiti
immerse => i'mә:s
immersed => i'mә:st
immersing => iˈmə:sɪŋ
immersion => i'mә:ʃәn
immersive => ɪˈmɜ:sɪv
immigrant => 'imigrәnt
immigrate => 'imigreit
immigrated => ˈɪmɪˌgreɪtid
immigrates => ˈɪmɪˌgreɪts
immigrating => ˈɪmɪˌgreɪtɪŋ
immigration => .imi'greiʃәn
imminence => 'iminәns
imminent => 'iminәnt
imminently => 'ɪmɪnəntlɪ
immiscibility => ɪmɪsə'bɪlɪtɪ
immiscible => i'misәbl
immiserization => i,mizәrai'zeiʃәn
immiserize => i'mizәraiz
immitigable => i'mitigәbl
immittance => 'imitәns
immixture => i'mikstʃә
immobile => i'mәubail
immobilised => i'məubilaiz
immobilism => i'mәjbilizəm
immobility => .imәu'biliti
immobilization => i.mәubilai'zeiʃәn
immobilize => i'mәubilaiz
immobilized => ɪˈməʊbəˌlaɪzd
immobilizer => i'mәubilaizә
immobilizes => ɪˈməʊbəˌlaɪziz
immobilizing => ɪˈməʊbəˌlaɪzɪŋ
immoderate => i'mɒdәreit
immoderately => ɪ'mɒdərətlɪ
immoderation => i.mɒdә'reiʃәn
immodest => i'mɒdist
immodestly => ɪ'mɒdɪstlɪ
immodesty => i'mɔdisti
immolate => 'imәuleit
immolated => ˈɪməˌleɪtid
immolating => ˈɪməˌleɪtɪŋ
immolation => .imәu'leiʃәn
immolator => 'imәuleitә
immoral => i'mɒrәl
immoralism => i'mɔrәlizəm
immorality => ,imә'ræliti
immorally => ɪ'mɒrəlɪ
immortal => i'mɒ:tәl
immortality => .imɒ:'tæliti
immortalization => i.mɒ:tәlai'zeiʃәn
immortalize => i'mɒ:tәlaiz
immortalized => ɪˈmɔ:tlˌaɪzd
immortalizes => ɪˈmɔ:tlˌaɪziz
immortalizing => ɪˈmɔ:tlˌaɪzɪŋ
immortally => i'mɒ:tәli
immortals => ɪ'mɔ:tlz
immortelle => .imɒ:'tel
immortelles => ,ɪmɔː'tel
immotile => i'mә utl
immovability => i.mu:vә'biliti
immovable => i'mu:vәbl
immovably => ɪ'mu:vəblɪ
immune => i'mju:n
immune deficiency => iˈmju:n diˈfiʃənsi
immune response => iˈmju:n riˈspɔns
immune system => iˈmju:n ˈsistəm
immunisation => ˌɪmjʊnaɪ'zeɪʃən
immunise => 'imju:naiz
immunised => 'imju:naiz
immunity => i'mju:niti
immunization => .imju:nai'zeiʃәn
immunize => 'imju:naiz
immunizes => ˈɪmjəˌnaɪziz
immunizing => 'imju:naiziŋ
immuno- => 'imjjnәj,i'mju: nәj
immunoassay => ,imjunәu'æsei
immunoblot => 'ɪmjʊnəʊblɒt
immunochemistry => i'mju:nәu'kemistri
immunocompetence => ,imjjnәj'kɔmpitəns
immunocompetent => ,imjjnәj'kɔmpitәnt
immunocompromise => ɪmjʊnəʊ'kəmprəmɪs
immunocompromised => ɪmjʊnəʊ'kəmprəmɪst
immunocytochemistry => 'imjjnәj,saitәj'kemistri
immunodeficiency => ,imjunәudi'fiʃәnsi
immunodiffusion => ,imjunәudi'fju:ʒәn
immunoelectrophoresis => ,imjunәui,lektrәufә'ri:sis
immunofluorescence => i'mju:nәuflu:ә'resәns
immunofluorescent => -ənt
immunogenic => i,mju:nәu'dʒenik
immunogenicity => ɪmjʊnəʊdʒe'nɪsɪtɪ
immunoglobulin => i'mju:nәu'^lɔbjulin
immunohistochemical => 'imjjnәj,histәj'kemikəl
immunologically => ,imjunə'lɔdʒikəli
immunology => .imju'nɒlәdʒi
immunoreactivity => ɪmjʊnrɪæk'tɪvɪtɪ
immunosorbent => ,imjunәu'sɔ:bәnt
immunosuppressant => ,imjjnәjsә'presәnt
immunosuppressed => ,imjunəusə'pres
immunosuppression => ,imjunәusә'preʃәn
immunosuppressive => ,imjunәusә'presiv
immunotherapy => i'mju:nәu'θerәpi
immure => i'mjuә
immured => ɪˈmjʊəd
immurement => ɪm'jʊəmənt
immuring => ɪˈmjʊərɪŋ
immutability => i.mju:tә'biliti
immutable => i'mju:tәbl
immutably => i'mju:tәbli
imo => ,aɪɛm'o
Imogen => 'imәdʒen
imp => imp
impact => 'impækt
impacted => im'pæktid
impactful => 'ɪmpæktfʊl
impacting => ˈimpæktɪŋ
impaction => im'pækʃәn
impactive => im'pæktiv
impactor => im'pæktә
impacts => ˈimpækts
impair => im'pєә
impaired => im'pεәd
impairing => imˈpɛərɪŋ
impairment => im'peәmәnt
impairs => imˈpɛəz
impala => im'pɒlә
impale => im'peil
impaled => ɪmˈpeɪld
impalement => im'peilmәnt
impales => ɪmˈpeɪlz
impaling => ɪmˈpeɪlɪŋ
impalpability => im.pælpә'biliti
impalpable => im'pælpәbl
impalpably => ɪm'pælpəblɪ
impanation => ,impә'neiʃәn
impanel => im'pænәl
impanelled => imˈpænld
impanelling => imˈpænlɪŋ
impark => im'pɑ:k
imparked => ɪm'pɑːk
impart => im'pɑ:t
impartation => ˌɪmpa:'teɪʃən
imparted => im'pɑ:tid
impartial => im'pɑ:ʃәl
impartiality => 'im.pɑ:ʃi'æliti
impartially => ˌɪmˌpɑ:ʃəlɪ
imparting => imˈpɑ:tɪŋ
imparts => imˈpɑ:ts
impassability => 'im.pɑ:sә'biliti
impassable => im'pɑ:sәbl
impassableness => imˊpaːsәblnis
impassably => im'pɑ:sәbli
impasse => 'impɑ:s
impassibility => im.pæsi'biliti
impassible => im'pæsibl
impassion => im'pæʃәn
impassioned => im'pæʃәnd
impassive => im'pæsiv
impassiveness => ,impæ'sivəti
impassivity => impæ'siviti
impasto => im'pæstәu
impatience => im'peiʃәns
impatiens => im'peiʃәnz
impatient => im'peiʃәnt
impeach => im'pi:tʃ
impeachable => im'pi:tʃәbl
impeached => ɪmˈpi:tʃt
impeaches => ɪmˈpi:tʃiz
impeaching => ɪmˈpi:tʃɪŋ
impeachment => im'pi:tʃmәnt
impeccability => im.pekә'biliti
impeccable => im'pekәbl
impeccably => -bli
impecunious => .impi'kju:njәs
impedance => im'pi:dәns
impede => im'pi:d
impeded => imˈpi:did
impedes => imˈpi:dz
impediment => im'pedimәnt
impedimenta => im.pedi'mentә
impediments => ɪm'pedɪmənts
impeding => ɪm'pendɪŋ
impel => im'pel
impeller => im'pelә
impelling => im'peliŋ
impels => ɪmˈpelz
impend => im'pend
impending => im'pendiŋ
impenetrability => im.penitrә'biliti
impenetrable => im'penitrәbl
impenetrably => ɪmˌpenɪtrə'blɪ
impenitence => im'penitәns
impenitent => im'penitәnt
impenitently => ɪmpenɪ'təntlɪ
imperatival => im.perә'taivәl
imperative => im'perәtiv
imperativeness => imˊperәtivnis
imperatives => ɪm'perətɪvz
imperator => impә'rɑ:tɔ:
imperatorial => im.perә'tɒ:riәl
imperceptible => .impә'septibl
imperceptibly => .impә'septibli
imperceptive => ,impә'septiv
impercipience => ,impә'sipiәns
impercipient => .impә'sipiәnt
imperfect => im'pә:fikt
imperfection => .impә'fekʃәn
imperfective => ,impә'fektiv
imperfectly => im'pә:fiktli
imperforate => im'pә:fәreit
imperial => im'piәriәl
imperialism => im'piәriәlizm
imperialist => im'piәriәlist
imperialistic => im.piәriә'listik
imperialistically => impiәriәˊlistikәli
imperialists => ɪmˈpɪərɪəlɪsts
imperially => im'piәriәli
imperil => im'peril
imperiled => ɪm'perɪl; -r(ə)l
imperilled => ɪmpe'rəld
imperilling => ɪmpe'rəlɪŋ
imperils => ɪmˈperəlz
imperious => im'piәriәs
imperishability => im.periʃә'biliti
imperishable => im'periʃәbl
imperishably => imˊperiʃәbli
imperium => im'piәriәm
impermanence => im'pә:mәnәns
impermanent => im'pә:mәnәnt
impermanently => imˊpәːmәnәntli
impermeability => im.pә:miә'biliti
impermeable => im'pә:miәbl
impermissibility => ɪmpərmɪsə'bɪlɪtɪ
impermissible => ,impә'misәbl
impermissibly => ɪmpər'mɪsəblɪ
impersonal => im'pә:sәnәl
impersonal pronoun => ɪmˈpɜ:sənəl ˈprəunaun
impersonality => im.pә:sә'næliti
impersonate => im'pә:sәneit
impersonates => ɪmˈpɜ:səˌneɪts
impersonation => im.pә:sә'neiʃәn
impertinence => im'pә:tinәns
impertinences => imˈpə:tinənsiz
impertinent => im'pә:tinәnt
impertinently => ɪm'pɜ:tɪnəntlɪ
imperturbable => .impә'tә:bәbl
imperturbably => .impә'tә:bәbli
impervious => im'pә:viәs
imperviously => imˊpәːvjәsli
impetigo => .impi'taigәu
impetrate => 'impitreit
impetuosity => im.petʃu'ɒsiti
impetuous => im'petʃuәs
impetuously => ɪm'petʃʊəslɪ
impetuousness => ɪm'petʃʊəsnəs
impetus => 'impitәs
Imphal => 'imphʌl
impi => 'impi
impiety => im'paiәti
imping => 'impiŋ
impinge => im'pindʒ
impinged => ɪmˈpɪndʒd
impingement => im'pindʒmәnt
impinges => ɪmˈpɪndʒz
impinging => im'pindʒiŋ
impious => 'impiәs
impiously => ɪm'pɪəslɪ
impish => 'impiʃ
impishly => 'impiʃli
impishness => 'impiʃnis
implacability => im.plækә'biliti
implacable => im'plækәbl
implacably => im'plækәbli
implant => im'plɑ:nt
implantable => im'plɑ:ntәbl;-'plæn-
implantation => .implɑ:n'teiʃәn
implants => ɪmˈplænts
implausibility => im.plɒ:zә'biliti
implausible => im'plɒ:zәbl
implausibly => im'plɔ:zəbli
implement => 'implimәnt
implementation => .implimen'teiʃәn
implementer => 'implimentә
implicate => 'implikeit
implicated => 'ɪmplɪkeɪtɪd
implicates => ˈɪmplɪˌkeɪts
implication => .impli'keiʃәn
implicative => im'plikәtiv
implicature => ˈɪmplɪkətʃə(r)
implicit => im'plisit
implied => 'implaid
impliedly => -'plaiidli
implode => im'plәud
imploded => ɪmˈpləʊdid
implodes => ɪmˈpləʊdz
imploding => ɪmp'ləʊdɪŋ
implore => im'plɒ:
implored => ɪmˈplɔ:d
implores => ɪmˈplɔ:z
imploring => im'plɒ:riŋ
imploringly => ɪmp'lɔ:rɪŋlɪ
implosion => im'plәuʒәn
implosive => im'plәusiv
impluvium => im'plu:viәm
imply => im'plai
impolder => im'pәuldә
impolite => .impә'lait
impolitely => ˌɪmpə'laɪtlɪ
impoliteness => impәˊlaitnis
impolitic => im'pɒlitik
impoliticly => 'ɪmpɒlətɪklɪ
imponderability => im.pɒndәrә'biliti
imponderable => im'pɒndәrәbl
imponderables => ɪmˈpɔndərəbəlz
import => im'pɒ:t
importable => im'pɒ:tәbl
importance => im'pɒ:tәns
important => im'pɒ:tәnt
importation => .impɒ:'teiʃәn
importer => im'pɒ:tә
importers => ɪmˈpɔ:təz
importunate => im'pɒ:tjunәt
importune => .impɒ:'tju:n
importuned => ˌɪmpɔ:ˈtu:nd
importunes => ˌɪmpɔ:ˈtu:nz
importuning => ˌɪmpɔ:ˈtu:nɪŋ
importunities => ˌimpɔ:ˈtju:nətiz
importunity => .impɒ:'tju:nәti
impose => im'pәuz
imposes => imˈpəuziz
imposing => im'pәuziŋ
imposition => .impә'ziʃәn
impossibilities => imˈpɔsəblz
impossibility => im.pɒsә'biliti
impossible => im'pɒsәbl
impossibly => im'pɒsәbli
impost => 'impәust
impostor => im'pɒstә
impostors => ɪmˈpɔstəz
imposture => im'pɒstʃә
impotence => 'impәtәns
impotent => 'impәtәnt
impotently => 'impətəntli
impound => im'paund
impounded => ɪmˈpaʊndid
impounding => im'paundiŋ
impoundment => im'paundmәnt
impoundments => im'paundmənt
impounds => ɪmˈpaʊndz
impoverish => im'pɒvәriʃ
impoverished => im'pɔvәriʃt
impoverishes => ɪmˈpɔvərɪʃiz
impoverishing => ɪmˈpɔvərɪʃɪŋ
impoverishment => im'pɒvәriʃmәnt
impracticable => im'præktikәbl
impracticably => im'præktikәbli
impractical => im'præktikәl
impracticality => im,prækti'kæliti
impractically => ɪm'præktɪkəlɪ
imprecate => 'imprikeit
imprecated => ˈɪmprɪkeɪtid
imprecating => ˈɪmprɪkeɪtɪŋ
imprecation => .impri'keiʃәn
imprecations => ˌɪmprɪˈkeɪʃənz
imprecatory => 'imprikәtәri
imprecise => .impri'saiz
imprecisely => ˌɪmprɪ'saɪslɪ
imprecision => .impri'siʒәn
impregnability => ɪmpreɡnə'bɪlɪtɪ
impregnable => im'pregnәbl
impregnate => 'impregneit
impregnated => ɪmˈpregneɪtid
impregnates => ɪmˈpregneɪts
impregnating => im'pre^neitiŋ
impregnation => .impreg'neiʃәn
impresario => .impri'sɑ:riәu
impresarios => ˌɪmprɪˈsɑ:ri:ˌəʊz
imprescriptible => ,impris'kriptibl
impress => im'pres
impressible => im'presәbl
impressing => imˈpresɪŋ
impression => im'preʃәn
impressionability => im,preʃәnә'biliti
impressionable => im'preʃәnәbl
impressional => im'preʃәnәl
impressionism => im'preʃәnizm
impressionist => im'preʃәnist
impressionistic => im.preʃә'nistik
impressionists => ɪmp'reʃənɪsts
impressive => im'presiv
impressiveness => imˊpresivnis
impressment => im'presmәnt
imprest => 'imprest
imprimatur => ,impri'meitә
imprimatura => ,impri'meitrә
imprint => im'print
imprinting => im'printiŋ
imprints => ɪmˈprɪnts
imprison => im'prizn
imprisoned => ɪmˈprɪzənd
imprisoning => ɪmˈprɪzənɪŋ
imprisonment => im'priznmәnt
imprisons => ɪmˈprɪzənz
impro => 'imprәu
improbability => im.prɒbә'biliti
improbable => im'prɒbәbl
improbably => im'prɒbәbli
improbity => im'prәubiti
impromptu => im'prɒmptju:
improper => im'prɒpә
improper fraction => ɪmˈprɔpə ˈfrækʃən
impropriate => im'prәuprieit
impropriation => ɪmprəʊpr'ɪeɪʃən
impropriator => im'prәjprieitә(r)
improprieties => ˌɪmprəˈpraɪɪti:z
impropriety => .imprә'praiәti
improv => ɪmp'ru:v
improvability => im.pru:vә'biliti
improvable => im'pru:vәbl
improve => im'pru:v
improved => im'pru:vd
improvement => im'pru:vmәnt
improvements => ɪmp'ru:vmənts
improver => im'pru:vә
improves => imˈpru:vz
improvidence => im'prɒvidәns
improvident => im'prɒvidәnt
improving => im'pru:viŋ
improvisation => .imprәvai'zeiʃәn
improvisational => ,imprәvai'zeiʃәnәl
improvisatorial => im,prɔvizә'tɔ:riәl
improvisatory => ɪmprəvaɪ'zeɪtərɪ
improvise => 'imprәvaiz
improvised => 'imprәvaizd
improviser => 'imprәvaizә
improvises => ˈɪmprəˌvaɪziz
imprudence => im'pru:dәns
imprudent => im'pru:dәnt
imprudently => ɪm'pru:dntlɪ
imps => ɪmps
impudence => 'impjudәns
impudent => 'impjudәnt
impudicity => .impju'disiti
impugn => im'pju:n
impugnable => im'pju:nәbl
impugned => ɪmˈpju:nd
impugning => ɪmˈpju:nɪŋ
impugnment => im'pju:nmәnt
impugns => ɪmˈpju:nz
impuissance => im'pju(:)isns
impuissant => im'pju:isnt
impulse => 'impʌls
impulses => 'ɪmpʌlsɪz
impulsion => im'pʌlʃәn
impulsive => im'pʌlsiv
impulsiveness => ɪm'pʌlsɪvnəs
impulsivity => ɪmpʌl'sɪvɪtɪ
impunity => im'pju:niti
impure => im'pjuә
impurely => ɪmp'jʊəlɪ
impureness => ɪmp'jʊənəs
impurity => im'pjuәriti
imputable => im'pju:tәbl
imputation => .impju:'teiʃәn
impute => im'pju:t
imputed => im'pju:tid
imputes => ɪmˈpju:ts
imputing => ɪmˈpju:tɪŋ
in => in
in a bad way => in ə bæd wei
in absentia => in æb'sentiә
in attendance => in əˈtendəns
in check => in tʃek
in company => in ˈkʌmpəni
in convoy => in ˈkɔnˌvɔɪ
in exchange => in iksˈtʃeindʒ
in favour => in ˈfeivə
in flagrante delicto => in flә^rænt di'liktәj
in full view => in ful vju:
in league => in li:ɡ
in memoriam => ˌɪn məˈmɔ:riəm
in microcosm => in ˈmaɪkrəˌkɔzəm
in midstream => in ˈmidˈstri:m
in mitigation => in ˌmitiˈɡeiʃən
in motion => in ˈməuʃən
in name only => in neim ˈəunli
in on => in ɔn
in opposition => in ˌɔpəˈzɪʃən
in order for => in ˈɔ:də fɔ:
in pawn => in pɔ:n
in personam => ,inpә'sәunæm
in re => in'ri:, -'ri
in relief => in riˈli:f
in rem => in'rem
in situ => in'saitju:
in that case => in ðæt keis
in the altogether => in ðə ˌɔ:ltəˈɡeðə
in the balance => in ðə ˈbæləns
in the buff => in ðə bʌf
in the can => in ðə kæn
in theory => in ˈθiəri
in vino veritas => in'vi:nәu'veritæs, in'vainәu-
in vivo => in'vi:vәu
in writing => in ˈraitiŋ
in- => in
in-and-out => 'inәnd'aut
in-between => ,inbi'twi:n
in-box => 'ɪnb'ɒks
in-car => in kɑ:
in-company => 'in,kʌmpәni
in-country => 'in'kʌntri
in-crowd => 'inkraud
in-depth => 'in'depθ
in-flight => 'in'flait
in-group => 'in^ru:p
in-house => in'haus
in-joke => ˈɪnˌdʒəʊk
in-law => 'inlɔ:
in-line => 'in'lain
in-line skating => ˈinˈlain ˈskeɪtɪŋ
in-off => 'inɔf
in-service => 'in'sә:vis
in-store => in stɔ:
in-your-face => ˈɪnˌjʊəˈfeɪs, -ˌjɔ:-, -ˌjəʊr-, -jə
ina => 'ainә
inability => .inә'biliti
inaccessibility => 'inæk.sesә'biliti
inaccessible => .inæk'sesәbl
inaccessibly => .inæk'sesәbli
inaccuracies => ɪnˈækjərəsi:z
inaccuracy => in'ækjurәsi
inaccurate => in'ækjurit
inaccurately => ɪn'ækjərətlɪ
inaction => in'ækʃәn
inactivate => in'æktiveit
inactivated => inˈæktiveitid
inactivating => ɪ'næktɪveɪtɪŋ
inactivation => in,ækti'veiʃәn
inactivator => in'æktiveitә
inactive => in'æktiv
inactively => ɪ'næktɪvlɪ
inactivity => .inæk'tiviti
inadequacies => ɪnˈædɪkwəsi:z
inadequacy => in'ædikwәsi
inadequate => in'ædikwәt
inadmissibility => inәdmisә'bilәti
inadmissible => .inәd'misәbl
inadvertent => .inәd'vә:tәnt
inadvertently => ˌɪnədˈvɜ:təntli
inadvisable => .inәd'vaizәbl
inalienability => in.eiljәnә'biliti
inalienable => in'eiljәnәbl
inalterability => ɪneɪltərə'bɪlɪtɪ
inalterable => in'ɒ:ltәrәbl
inamorata => in.æmә'rɑ:tә
inamorato => in.æmә'rɑ:tәu
inane => i'nein
inanely => i'neinli
inanga => 'i:nɑ:ŋ^ɑ:
inanimate => in'ænimәt
inanimately => in'ænimətli
inanities => ɪˈnænɪti:z
inanition => .inә'niʃәn
inanity => i'næniti
inapparent => .inә'pærәnt
inappetence => in'æpitәns
inappetent => in'æpitәnt
inapplicability => ɪnæplɪkə'bɪlɪtɪ
inapplicable => in'æpәlikәbl
inapposite => in'æpәzit
inappositely => inˊæpәzitli
inappreciable => .inә'pri:ʃәbl
inappreciably => inәˊpriːʃәbli
inappreciation => 'inә.pri:ʃi'eiʃәn
inappreciative => .inә'pri:ʃiәtiv
inappropriate => .inә'prәupriәt
inappropriateness => ,inə'pəupriitnis
inapt => in'æpt
inaptitude => in'æptitju:d
inaptly => ɪ'næptlɪ
inarch => in'ɑ:tʃ
inarching => in'ɑ:tʃiŋ
inarguable => in'ɑ:^juәbl
inarticulacy => ,inɑ:'tikjjlәsi
inarticulate => .inɑ:'tikjulәt
inarticulated => ,ɪnɑː'tɪkjʊlət
inarticulately => ˌɪnɑ:'tɪkjələtlɪ
inartistic => .inɑ:'tistik
inasmuch => .inәz'mʌtʃ
inattention => .inә'tenʃәn
inattentive => .inә'tentiv
inattentively => ˌɪnə'tentɪvlɪ
inattentiveness => ˌɪnə'tentɪvnɪs
inaudibility => in.ɒ:dә'biliti
inaudible => in'ɒ:dәbl
inaudibly => in'ɒ:dәbli
inaugural => i'nɒ:gjurәl
inaugurate => i'nɒ:gjureit
inaugurated => iˈnɔ:ɡjureitid
inaugurates => iˈnɔ:ɡjureits
inaugurating => iˈnɔ:ɡjureitɪŋ
inauguration => i,nɔ:^ju'reiʃәn
inaugurator => i'nɒ:gjureitә
inauguratory => i'nɔ:^jurәtәri
inauspicious => i.nɒ:'spiʃәs
inauspiciously => ,inɔ:s'piʃəsli
inauspiciousness => inɒːsˊpiʃәsnis
inauthentic => ,inɔ: 'θentik
inauthenticity => 'inɔ: ,θen'tisәti
inbetween => inbitwi:n
inboard => 'inbɒ:d
inborn => 'inbɔ:n
inbound => 'in'baund
inbounds => ˈɪnbaʊndz
inbreathe => .in'bri:ð
inbred => 'in'bred
inbreed => 'in'bri:d
inbreeding => 'in'bri:diŋ
inbuilt => 'in'bilt
inca => 'iŋkә
incalculable => in'kælkjulәbl
incalculably => ɪn'kælkjələblɪ
Incan => 'iŋkən
incandesce => .inkæn'des
incandesced => ˌinkænˈdest
incandescence => .inkæn'desәns
incandescent => .inkæn'desnt
incandescing => ˌinkænˈdesɪŋ
incant => in'kænt
incantation => .inkæn'teiʃәn
incantations => ˌɪnkænˈteɪʃənz
incantatory => ɪn'kæntətɔ:rɪ
incapability => in.keipә'biliti
incapable => in'keipәbl
incapacitant => .inkә'pæsitәnt
incapacitate => .inkә'pæsiteit
incapacitated => ˌɪnkəˈpæsɪˌteɪtid
incapacitates => ˌɪnkəˈpæsɪˌteɪts
incapacitating => ˌɪnkəˈpæsɪˌteɪtɪŋ
incapacitation => 'inkә.pæsi'teiʃәn
incapacity => .inkә'pæsәti
incarcerate => in'kɑ:sәreit
incarcerates => ɪnˈkɑ:səˌreɪts
incarceration => in.kɑ:sә'reiʃәn
incarnadine => in'kɑ:nәdain
incarnadined => inˈkɑ:nədaind
incarnadining => inˈkɑ:nədainɪŋ
incarnate => in'kɑ:neit
incarnated => ɪnˈkɑ:nɪtid
incarnates => ɪnˈkɑ:nɪts
incarnating => ɪnˈkɑ:nɪtɪŋ
incarnation => .inkɑ:'neiʃәn
incarnations => ˌɪnkɑ:ˈneɪʃənz
incase => in'keis
incased => ɪn'keɪst
incasing => inˈkeisɪŋ
incaution => in'kɒ:ʃәn
incautious => in'kɒ:ʃәs
incautiously => ɪn'kɔ:ʃəslɪ
incautiousness => inˊkɒːʃәsnis
incendiaries => ɪnˈsendi:ˌeri:z
incendiarism => in'sendjәrizm
incendiary => in'sendjәri
incensation => ,insen'seiʃәn
incense => 'inseins
incense cedar => ˈinsens ˈsi:də
incenses => ˈinsensiz
incensory => 'insensәri
incentive => in'sentiv
incentives => ɪn'sentɪvz
incentivize => ɪn'sentɪvaɪz
incentre => 'insentә(r)
incept => in'sept
inception => in'sepʃәn
inceptive => in'septiv
inceptor => in'septә
incertitude => in'sә:titju:d
incessancy => in'sesnsi
incessant => in'sesnt
incessantly => ɪn'sesntlɪ
incessantness => inˊsesntnis
incest => 'insest
incestuous => in'sestjuәs
incestuously => in'sestjuəsli
inch => intʃ
inched => intʃt
inching => 'intʃiŋ
inchmeal => 'intʃmi:l
inchoate => in'kәueit
inchoative => in'kәuәtiv
inchworm => 'intʃwә:m
incidence => 'insidәns
incidences => ˈinsidənsiz
incident => 'insidәnt
incident room => ˈinsidənt ru:m
incidental => .insi'dentәl
incidental music => ˌɪnsɪˈdentl ˈmju:zik
incidentally => .insi'dentәli
incidentals => ˌɪnsɪ'dentlz
incidents => 'ɪnsɪdənts
incinerate => in'sinәreit
incinerated => ɪnˈsɪnəˌreɪtid
incinerates => ɪnˈsɪnəˌreɪts
incinerating => ɪnˈsɪnəˌreɪtɪŋ
incineration => in.sinә'reiʃәn
incinerator => in'sinәreitә
incinerators => ɪnˈsɪnəˌreɪtəz
incipience => in'sipiәns
incipiency => ɪn'sɪpɪənsɪ
incipient => in'sipiәnt
incipiently => inˊsipiәntli
incipit => 'insipit
incircle => in'sә:kl
incise => in'saiz
incised => in'saizd
incises => ɪnˈsaɪziz
incising => ɪnˈsaɪzɪŋ
incision => in'siʒәn
incisional => ɪn'sɪʒənəl
incisions => ɪnˈsɪʒənz
incisive => in'saisiv
incisively => ɪn'saɪsɪvlɪ
incisiveness => ɪn'saɪsɪvnəs
incisor => in'saizә
incisors => ɪn'saɪzəz
incisure => in'siʒә
incitation => ,insai'teiʃәn
incite => in'sait
incited => inˈsaitid
incitement => in'saitmәnt
incites => inˈsaits
inciting => ɪn'saɪtɪŋ
incivilities => ˌɪnsɪˈvɪlɪti:z
incivility => .insi'viliti
inclemency => in'klemәnsi
inclement => in'klemәnt
inclinable => in'klainәbl
inclination => .inkli'neiʃәn
inclinations => ˌɪnkləˈneɪʃənz
incline => in'klain
inclined => in'klaind
inclines => inˈklainz
inclining => in'klainiŋ
inclinometer => .inkli'nɒmitә
inclose => in'klәuz
inclosing => inˈkəusɪŋ
inclosure => in'klәuʒә
include => in'klu:d
included => in'klu:did
inclusion => in'kluʒәn
inclusive => in'klu:siv
inclusive of => inˈklu:siv ɔv
incog => in'kɔ^
incognito => in'kɒgnitәu
incognitos => ˌɪnkɔgˈni:təʊz
incognizance => in'kɒgnizәns
incognizant => in'kɒgnizәnt
incoherence => ,inkәj'hiәrәns
incoherency => ˌɪnkəʊ'hɪərənsi:
incoherent => .inkәu'hiәrәnt
incohesion => ,inkәu'hi:ʒәn
incombustible => .inkәm'bʌstәbl
income => 'inkʌm
income support => ˈinkəm səˈpɔ:t
income tax => ˈinkəm tæks
incomer => 'in.kʌmә
incoming => 'inkʌmiŋ
incommensurable => .inkә'menʃәrәbl
incommensurate => .inkә'menʃәreit
incommode => .inkә'mәud
incommoded => inkəˈməudid
incommoding => inkəˈməudɪŋ
incommodious => .inkә'mәudjәs
incommodiousness => inkәˊmoudjәsnis
incommunicability => ɪnkəmju:nɪkə'bɪlɪtɪ
incommunicable => .inkә'mju:nikәbl
incommunicado => ,inkә,mju:ni'kɑ:dәu
incommunicative => .inkә'mju:nәkәtiv
incommutable => .inkә'mju:tәbl
incomparable => in'kɒmpәrәbl
incompatibilities => 'ɪnkəm,pætə'bɪlətɪ
incompatibility => 'inkәm,pætә'biliti
incompatible => .inkәm'pætәbl
incompatibly => ˌɪnkəm'pætɪblɪ
incompetence => in'kɔmpitәns
incompetent => in'kɒmpitәnt
incompetently => ɪn'kɒmpɪtəntlɪ
incompetents => ɪnˈkɔmpɪtənts
incomplete => .inkәm'pli:t
incompletely => .inkәm'pli:tli
incompletion => .inkәm'pli:ʃәn
incomprehensibility => ɪnˌkɒmprɪˌhensə'bɪlətɪ
incomprehensible => in.kɒmpri'hensәbl
incomprehensibly => ɪnˌkɒmprɪˌhensəblɪ
incomprehension => in,kɔmpri'henʃәn
incompressible => .inkәm'presәbl
incomputable => .inkәm'pju:tәbl
inconceivable => .inkәn'si:vәbl
inconclusive => .inkәn'klu:siv
inconclusively => ˌɪnkən'klu:sɪvlɪ
inconclusiveness => ɪnkənk'lu:sɪvnəs
incongruence => in'kɒŋgruәns
incongruent => in'kɔŋɡruәnt
incongruities => ˌɪnkɔŋˈgru:ɪtɪz
incongruity => .inkɒŋ'gru:iti
incongruous => in'kɒŋgruәs
incongruously => ɪn'kɒŋɡrʊəslɪ
inconnu => .inkә'nu:
inconsecutive => .inkәn'sekjutiv
inconsecutively => inkәnˊsekjutivli
inconsequence => in'kɒnsikwәns
inconsequent => in'kɒnsikwәnt
inconsequential => .inkɒnsi'kwenʃәl
inconsequentiality => 'inkɔnsi,kwenʃi'æləti
inconsequentially => inkɔnsə'kwenʃiəli
inconsequently => in'kɒnsikwәntli
inconsiderable => .inkәn'sidәrәbl
inconsiderate => .inkәn'sidәrәt
inconsiderately => ˌɪnkən'sɪdərətlɪ
inconsiderateness => 'inkən,sidə'reiʃən
inconsistencies => ˌinkənˈsistənsiz
inconsistency => .inkәn'sistәnsi
inconsistent => .inkәn'sistәnt
inconsistently => ˌɪnkən'sɪstəntlɪ
inconsolability => 'ɪnkən,səʊlə'bɪlətɪ
inconsolable => .inkәn'sәulәbl
inconsonance => in'kɒnsәnәns
inconsonant => in'kɒnsәnәnt
inconspicuous => .inkәn'spikjuәs
inconspicuously => ,inkəns'pikjuəsli
inconstancy => in'kɒnstәnsi
inconstant => in'kɒnstәnt
inconstantly => ɪn'kɒnstəntlɪ
incontestability => 'inkən,testə'biləti
incontestable => .inkәn'testәbl
incontestably => inkәnˊtestәbli
incontinence => in'kɒntinәns
incontinent => in'kɒntinәnt
incontinently => in'kɔntinәntli
incontrovertibility => in,kɔntrəvə:tə'biləti
incontrovertible => .inkɒntrә'vә:tәbl
incontrovertibly => ˌɪnkɒntrə'vɜ:təblɪ
inconvenience => .inkәn'vi:njәns
inconvenienced => ˌɪnkənˈvi:njənst
inconveniences => ˌɪnkənˈvi:njənsiz
inconveniencing => ˌɪnkənˈvi:njənsɪŋ
inconvenient => .nkәn'vi:njәnt
inconveniently => ˌɪnkən'vi:nɪəntlɪ
inconvertible => .inkәn'vә:tibl
incorporate => in'kɒ:pәreit
incorporated => in'kɔ:pәreitid
incorporates => inˈkɔ:pəreits
incorporating => inˈkɔ:pəreitɪŋ
incorporation => in.kɒ:pә'reiʃәn
incorporative => ɪn'kɔ:pərətɪv
incorporator => in'kɒ:pәreitә
incorporeal => .inkɒ:'pɒ:riәl
incorporeity => in.kɒ:pә'ri:iti
incorrect => .inkә'rekt
incorrigibility => in.kɒridʒә'biliti
incorrigible => in'kɒridʒәbl
incorrigibly => ɪn'kɒrɪdʒəblɪ
incorrupt => ,inkә'rʌpt
incorruptibility => 'inkә,rʌptә'bilәti
incorruptible => .inkә'rʌptibl
incorruptibly => ɪnkə'rʌptəblɪ
incrassate => in'kræseit
incrassated => in'kræseitid
increasable => in'kri:sәbl
increase => in'kri:s
increased => in'kri:st
increases => inˈkri:siz
increasing => in'kri:siŋ
increasingly => in'kri:siŋli
increate => .inkri:'eit. 'inkri:eit
incredibility => in.kredi'biliti
incredible => in'kredәbl
incredibly => in'kredәbli
incredulity => .inkri'dju:liti
incredulous => in'kredjulәs
incredulously => ɪn'kredjələslɪ
increment => 'inkrimәnt
incremental => .inkri'mentl
incrementalism => ˌɪnkrə'mentlˌɪzəm
incrementalist => ,inkri'mentəlist
incrementally => ,inkri'məntəli
increments => 'ɪnkrəmənts
incriminate => in'krimineit
incriminated => ɪnˈkrɪməˌneɪtid
incriminates => ɪnˈkrɪməˌneɪts
incrimination => ɪnˌkrɪmɪ'neɪʃn
incriminatory => in'kriminәtәri
incrust => in'krʌst
incrustation => .inkrʌs'teiʃәn
incrusted => ɪnk'rʌstɪd
incrusting => in'krʌstiŋ
incubate => 'inkjubeit
incubated => ˈɪnkjəˌbeɪtid
incubates => ˈɪnkjəˌbeɪts
incubating => ˈɪnkjəˌbeɪtɪŋ
incubation => .inkju'beiʃәn
incubative => 'inkjubeitiv
incubator => 'inkjubeitә
incubators => 'ɪnkjʊbeɪtəz
incubatory => 'inkjubeitәri
incubous => 'inkjubәs
incubus => 'iŋkjubәs
incudes => iŋ'kju:di:z
inculcate => 'inkʌlkeit
inculcated => ɪnˈkʌlˌkeɪtid
inculcates => ɪnˈkʌlˌkeɪts
inculcating => ɪnˈkʌlˌkeɪtɪŋ
inculcation => .inkʌl'keiʃәn
inculcator => 'inkʌlkeitә
inculpate => 'inkʌlpeit
inculpated => ˈiŋkʌlpeitid
inculpating => ˈiŋkʌlpeitɪŋ
inculpation => .inkʌl'peiʃәn
inculpatory => in'kʌlpәtәri
incumbencies => ɪnˈkʌmbənsi:z
incumbency => in'kʌmbәnsi
incumbent => in'kʌmbәnt
incumbents => ɪn'kʌmbənts
incunabula => ,inkjj'næbjjlә
incunabulum => .inkju:'næbjulәm
incur => in'kә:
incurability => in.kjurә'biliti
incurable => in'kjurәbl
incurably => in'kjuәrәbli
incuriosity => .inkjuәri'ɒsiti
incurious => in'kjuәriәs
incurrence => in'kʌrәns
incurrent => in'kә:rәnt
incurs => inˈkə:z
incursion => in'kә:ʃәn
incursive => in'kә:siv
incurvate => in'kә:veit
incurvated => ˈinkə:veitid
incurvating => ˈinkə:veitɪŋ
incurvation => .inkә'veiʃәn
incurve => 'inkә:v
incurving => ɪn'kɜːv
incus => 'iŋkәs
incuse => in'kju:z
indaba => in'dɑ:bɑ:
indebted => in'detid
indebtedness => in'detidnis
indecencies => inˈdi:snsiz
indecency => in'di:sәnsi
indecent => in'di:sәnt
indecipherable => .indi'saifәrәbl
indecision => .indi'siʒәn
indecisive => .indi'saisiv
indecisively => ˌɪndɪ'saɪsɪvlɪ
indecisiveness => [ˌɪndɪˈsaɪsɪvnɪs]
indeclinable => .indi'klainәbl
indecomposable => ,indi:kәm'pәuzәbl
indecorous => in'dekәrәs
indecorously => ɪn'dekərəslɪ
indecorousness => ɪn'dekərəsnəs
indecorum => .indi'kɒ:rәm
indeed => in'di:d
indeedy => in'di:di
indefatigable => .indi'fætigәbl
indefatigably => ˌɪndɪ'fætɪɡəblɪ
indefeasible => .indi'fi:zәbl
indefeasibly => ,indi'fi:zəbli
indefectible => .indi'fektәbl
indefensibility => 'indi,fensә'bilәti
indefensible => .indi'fensәbl
indefensibly => ɪndɪ'fensəblɪ
indefinable => .indi'fainәbl
indefinably => ˌɪndɪ'faɪnəblɪ
indefinite => in'definit
indefinite article => inˈdefinit ˈɑ:tikl
indefinite pronoun => inˈdefinit ˈprəunaun
indefiniteness => ɪn'defɪnətnes
indehiscence => ,indi'hisəns
indehiscent => .indi'hisnt
indelibility => in.deli'biliti
indelible => in'delibl
indelicacy => in'delikәsi
indelicate => in'delikit
indelicately => inˊdelikitli
indemnification => in.demnifi'keiʃәn
indemnified => ɪnˈdemnəˌfaɪd
indemnifies => ɪnˈdemnəˌfaɪz
indemnify => in'demnifai
indemnifying => ɪnˈdemnəˌfaɪŋ
indemnities => ɪnˈdemnɪti:z
indemnity => in'demniti
indemonstrable => in'demәnstrәbl
indene => 'indi:n
indent => in'dent
indentation => .inden'teiʃәn
indentations => ˌɪndenˈteɪʃənz
indented => in'dentid
indenter => in'dentә
indenting => in'dentiŋ
indention => in'denʃәn
indents => ɪnˈdents
indenture => in'dentʃә
indentured => ɪnˈdentʃəd
indenturing => ɪnˈdentʃərɪŋ
independence => .indi'pendәns
independency => .indi'pendәnsi
independent => .indi'pendәnt
independent clause => ˌɪndiˈpendənt klɔ:z
independently => .indi'pendәntli
independents => ˌɪndiˈpendənts
indescribable => .indi'skraibәbl
indescribably => ˌɪndɪ'skraɪbəblɪ
indestructible => .indi'strʌktәbl
indestructibly => indisˊtrʌktәbli
indeterminable => .indi'tә:minәbl
indeterminably => ɪndɪ'tɜ:mɪnəblɪ
indeterminacy => indi'tә:minәsi
indeterminacy principle => indiˈtə:minəsi ˈprinsəpl
indeterminate => .indi'tә:minәt
indeterminately => indiˊtәːminitli
indeterminism => .indi'tә:minizm
indeterminist => ,indi'tә:minist
index => 'indeks
index case => ˈindeks keis
index fossil => ˈindeks ˈfɔsl
index-linked => ˈindeks liŋkt
indexation => ,indek'seiʃәn
indexed => 'indekst
indexer => in'deksә
indexical => in'deksikәl
indexing => 'indeksiŋ
India => 'indjә
Indiaman => 'indiәmәn
Indian => 'indiәn
Indiana => .indi'ænә
indianapolis => 'indiә'næpәlis
Indianism => 'indiənizəm
Indianization => indjәnai'zeiʃә
Indianize => 'indiәnaiz
Indianness => 'indiәnnis
Indic => 'indik
indican => 'indikæn
indicant => 'indikәnt
indicate => 'indikeit
indicated => ˈindikeitid
indicating => 'indikeitiŋ
indication => .indi'keiʃәn
indicative => in'dikәtiv
indicator => 'indikeitә
indicators => 'ɪndɪkeɪtəz
indicatory => 'indikәtәri
indicatrix => ,indi'keitriks
indices => 'indisi:z
indicia => in'diʃiә
indicolite => in'dikә,lait
indict => in'dait
indictable => in'daitәbl
indicted => inˈdaitid
indictee => .indai'ti:
indicter => in'daitә
indicting => inˈdaitɪŋ
indiction => in'dikʃәn
indictment => in'daitmәnt
indictments => ɪnˈdaɪtmənts
indicts => inˈdaits
indie => 'indi
indies => 'indiz
indifference => in'difәrәns
indifferent => in'difәrәnt
indifferentism => in'difәrәntizm
indifferentist => ɪndɪfrən'tɪst
indifferently => in'difәrәntli
indigence => 'indidʒәns
indigene => 'indidʒi:n
indigenization => in,didʒinai'zeiʃәn;-ni'z-
indigenize => in'didʒinaiz
indigenous => in'didʒinәs
indigenously => ɪn'dɪdʒɪnəslɪ
indigent => 'indidʒәnt
indigested => ,indi'dʒestid, indai'dʒestid
indigestible => .indi'dʒestәbl
indigestion => .indi'dʒestʃәn
indigestive => .indi'dʒestiv
Indigirka => ,indi'^irkә
indignant => in'dignәnt
indignantly => in'dignәntli
indignation => .indig'neiʃәn
indignities => ɪnˈdɪgnɪti:z
indignity => in'digniti
indigo => 'indigәu
indigoid => 'indi^ɔid
indigotin => in'digәtin
indirect => .indi'rekt
indirect discourse => ˌɪndiˈrekt ˈdiskɔ:s
indirect object => ˌɪndiˈrekt ˈɔbdʒikt
indirect question => ˌɪndiˈrekt ˈkwestʃən
indirect speech => ˌɪndiˈrekt spi:tʃ
indirect taxation => ˌɪndiˈrekt tækˈseɪʃən
indirection => .indi'rekʃәn
indiscernible => .indi'sә:nәbl
indiscernibly => indiˊsәːnәbli
indiscipline => in'disiplin
indiscreet => .indis'kri:t
indiscreetly => ˌɪndɪ'skri:tlɪ
indiscrete => .indis'kri:t
indiscretion => .indis'kreʃәn
indiscretions => ˌɪndɪˈskreʃənz
indiscriminate => .indis'kriminit
indiscriminately => ˌɪndɪ'skrɪmɪnətlɪ
indiscriminating => ,indis'krimineitiŋ
indiscrimination => 'indis,krimi'neiʃәn
indispensable => .indis'pensәbl
indispensably => 'ɪndɪ'spensəblɪ
indispose => .indis'pәuz
indisposed => .indis'pәuzd
indisposition => .indispә'ziʃәn
indispositions => ,ɪndɪspə'zɪʃ(ə)n
indisputable => .indis'pju:tәbl
indissociable => ,indi'sәuʃәbl
indissoluble => .indi'sɒljubl
indissolubly => indi'sɔljubli
indistinct => .indis'tiŋkt
indistinctly => .indis'tiŋktli
indistinctness => ɪndɪs'tɪŋktnəs
indistinguishable => .indis'tiŋgwiʃәbl
indistinguishably => ɪndɪs'tɪŋɡwɪʃəblɪ
indite => in'dait
indited => inˈdaitid
inditing => inˈdaitɪŋ
indium => 'indiәm
individual => .indi'vidʒuәl
individualise => ,indi'vidjjәlaiz, -dʒj-
individualised => ,indi'viduəlaiz, -dʒu-
individualism => .indi'vidʒuәlizm
individualist => .indi'vidʒuәlist
individualistic => ,indi,vidjuә'listik
individualists => ˌindiˈvidjuəlists
individualities => ˌɪndəˌvɪdʒu:ˈælɪti:z
individuality => 'indi.vidʒu'æliti
individualization => ˌɪndɪvɪdʒʊəlaɪ'zeɪʃn
individualize => ,indi'vidjuәlaiz
individualized => ˌɪndɪˈvɪdʒuəlaɪzd
individualizes => ˌindiˈvidjuəlaiziz
individualizing => ˌindiˈvidjuəlaizɪŋ
individually => .indi'vidʒuәli
individuate => ,indi'vidjueit
individuated => ˌindiˈvidjueitid
individuating => ˌindiˈvidjueitɪŋ
individuation => 'indi.vidʒu'eiʃәn
indivisibility => 'indi.vizә'biliti
indivisible => .indi'vizәbl
indivisibly => ˌɪndɪ'vɪzəbli
Indo- => 'indәj
Indo-Aryan => 'indәu'æriәn; -jәn
Indo-European => 'indәu,juәrә'pi(:)әn
Indo-Germanic => 'indәudʒә:'mænik
Indo-Iranian => 'indәui'reiniәn
Indo-Pacific => 'indәjpә'sifik
Indochina => 'indәj'tʃainә
indochinite => 'indәu'tʃai,nait
indocile => in'dәusail
indocility => .indәu'siliti
indoctrinate => in'dɒktrineit
indoctrinated => ɪnˈdɔktrəˌneɪtid
indoctrinates => ɪnˈdɔktrəˌneɪts
indoctrinating => ɪnˈdɔktrəˌneɪtɪŋ
indoctrination => in.dɒktri'neiʃәn
indoctrinatory => in'dɔktrineitәri
indole => 'indәul
indolence => 'indәlәns
indolent => 'indәlәnt
indolently => 'ɪndələntlɪ
Indologist => in'dɔlәdʒist
Indology => in'dɔlәdʒi
indomethacin => ,indәu'meθәsin
indomitability => 'indəumitə'biləti
indomitable => in'dɒmitәbl
indomitably => inˊdɒmitәbli
Indonesia => .indәu'ni:ʒә
Indonesian => .indәu'ni:ʒәn
indoor => 'indɒ:
indoors => 'in'dɒ:z
Indore => in'dɔ:
indorse => in'dɔ:s
indorsed => inˈdɔ:st
indorsement => in'dɔ:smәnt
indorsing => inˈdɔ:sɪŋ
indoxyl => in'dɔksl
Indra => 'indrә
indraught => 'indrɑ:ft; -dræft
indrawn => 'indrɒ:n
indri => 'indri
indubitable => in'dju:bitәbl
induce => in'dju:s
induced => in'dju:st
inducement => in'dju:smәnt
inducements => ɪnd'ju:smənts
inducer => in'dju:sә
induces => inˈdju:siz
inducible => in'dju:sәbl
inducing => in'dju:siŋ
induct => in'dʌkt
inductance => in'dʌktәns
inducted => ɪnˈdʌktid
inductee => .indʌk'ti:
induction => in'dʌkʃәn
inductions => ɪnˈdʌkʃənz
inductive => in'dʌktiv
inductiveness => inˊdʌktivnis
inductivism => in'dʌktivizәm
inductivist => in'dʌktivist
inductor => in'dʌktә
inducts => ɪnˈdʌkts
indue => in'dju:
indulge => in'dʌldʒ
indulged => inˈdʌldʒd
indulgence => in'dʌldʒәns
indulgences => ɪnˈdʌldʒənsiz
indulgent => in'dʌldʒәnt
indulgently => ɪn'dʌldʒəntlɪ
indulges => inˈdʌldʒz
indulging => inˈdʌldʒɪŋ
induline => 'indjjli:n,-lin
indult => in'dʌlt
indumentum => ,indju'mentәm
induna => in'du:nә
indurate => 'indjureit
indurated => ˈindjureitid
indurating => ˈindjureitɪŋ
induration => .indjuә'reiʃәn
indurative => 'indjuәreitiv
Indus => 'indәs
indusium => in'dju:ziәm, -'du:ziәm
industrial => in'dʌstriәl
industrial action => inˈdʌstriəl ˈækʃən
industrial archaeology => inˈdʌstriəl ˌɑ:kiˈɔlədʒi
industrial estate => inˈdʌstriəl isˈteit
industrial melanism => inˈdʌstriəl ˈmelənizəm
industrial relations => inˈdʌstriəl riˈleiʃənz
industrialisation => ɪndʌstrɪəlaɪzeɪ'ʃən
industrialise => in'dʌstriәlaiz
industrialised => in'dʌstriəlaiz
industrialism => in'dʌstriәliz(ә)m
industrialist => in'dʌstriәlist
industrialists => ɪn'dʌstrɪəlɪsts
industrialization => in,dʌstriәlai'zeiʃn
industrialize => in'dʌstriәlaiz
industrialized => in'dʌstriәlaizd
industrializes => inˈdʌstriəlaiziz
industrializing => inˈdʌstriəlaizɪŋ
industrious => in'dʌstriәs
industriously => in'dʌstriəsli
industriousness => ɪn'dʌstrɪəsnɪs
industry => 'indәstri
indwell => .in'dwel
indweller => 'ɪndwelə
indwelling => .in'dweliŋ
indwelt => ,in'dwelt
inebriate => i'ni:briәt
inebriated => i'ni:brieitid
inebriation => i.ni:bri'eiʃәn
inebriety => .ini:'braiәti
inedibility => in.edi'biliti
inedible => in'edibl
inedited => in'editid
ineducability => in,edjjkә'bilәti,-dʒj-
ineducable => in'edjukәbl
ineffability => in,efə'biləti
ineffable => in'efәbl
ineffably => ɪne'fəblɪ
ineffaceability => 'ini,feisə'biləti
ineffaceable => .ini'feisәbl
ineffective => .ini'fektiv
ineffectively => ˌɪnɪ'fektɪvlɪ
ineffectual => .ini'fektʃuәl
ineffectually => ˌɪnɪ'fektʃʊəlɪ
inefficacious => .inefi'keiʃәs
inefficacy => in'efikәsi
inefficiencies => ˌɪnɪˈfɪʃənsɪz
inefficiency => .ini'fiʃәnsi
inefficient => .ini'fiʃәnt
inefficiently => ˌɪnɪ'fɪʃntlɪ
inegalitarian => 'ini,^æli'teәriәn
inelastic => .ini'læstik
inelasticity => .inilæs'tisiti
inelegant => in'eligәnt
inelegantly => ɪn'elɪɡəntlɪ
ineligibility => in.elidʒi'biliti
ineligible => in'elidʒәbl
ineluctability => 'ini.lʌktә'biliti
ineluctable => .ini'lʌktәbl
ineluctably => ini'lʌktəbli
ineludible => .ini'lu:dәbl
inept => in'ept
ineptitude => in'eptitju:d
ineptness => i'neptnis
inequality => .ini'kwɒliti
inequitable => in'ekwitәbl
inequities => ɪ'nekwɪtɪz
inequity => in'ekwiti
inequivalve => in'i:kwәvælv
ineradicable => .ini'rædikәbl
ineradicably => ɪnɪ'rædɪkəblɪ
inerrancy => in'erәnsi
inerrant => in'erәnt
inert => i'nә:t
inertia => i'nә:ʃә
inertia reel => iˈnə:ʃjə ri:l
inertial => i'nә:ʃәl
inertly => ɪ'nɜ:tlɪ
inertness => ɪ'nɜ:tnɪs
inescapability => ini.skeipә'bilәti
inescapable => .ini'skeipәbl
inescapably => ˌɪnɪ'skeɪpəblɪ
inessential => .ini'senʃәl
inessentials => ɪ'nɪsenʃlz
inestimable => in'estimәbl
inestimably => ɪ'nestɪməblɪ
inevitabilities => inˌevitəˈbilətiz
inevitability => in.evitә'biliti
inevitable => in'evitәbl
inevitably => in'evitәbli
inexact => .inig'zækt
inexactitude => .inig'zæktitju:d
inexactly => ɪnɪɡ'zæktlɪ
inexactness => ɪnɪɡ'zæktnəs
inexcusable => .inik'skju:zәbl
inexcusably => ˌɪnɪk'skju:zəblɪ
inexhaustible => .inig'zɒ:stәbl
inexhaustibly => ɪnɪɡ'zɔ:stəblɪ
inexistent => .inig'zistәnt
inexorability => in.eksәrә'biliti
inexorable => in'eksәrәbl
inexpediency => ɪnɪks'pi:dɪənsɪ
inexpedient => .inik'spi:djәnt
inexpensive => .inik'spensiv
inexperience => .inik'spiәriәns
inexperienced => .inik'spiәriәnst
inexpert => .inek'spә:t
inexpertly => in'ekspə:tli
inexpiable => in'ekspiәbl
inexplicable => in'eksplikәbl
inexplicably => in'eksplikәbli
inexplicit => .inik'splisit
inexpressible => .inik'spresәbl
inexpressibly => .inik'spresәbli
inexpressive => ,iniks'presiv
inexpressiveness => ɪnɪksp'resɪvnəs
inexpugnable => .inik'spʌgnәbl
inextensible => .inik'stensәbl
inextinguishable => .inik'stiŋgwiʃәbl
inextremis => ,iniks'tri:mis
inextricable => in'ekstrәkәbl
Inez => 'i:nez
infall => in'fɔ:l
infallibility => in,fælә'biliti
infallible => in'fælәbl
infallibly => in'fælibli
infamies => ˈɪnfəmi:z
infamous => 'infәmәs
infamy => 'infәmi
infancy => 'infәnsi
infant => 'infәnt
infant mortality => ˈinfənt mɔ:'tæləti
infant prodigy => ˈinfənt ˈprɔdidʒi
infanta => in'fæntә
infante => in'fæntei
infanticidal => in'fæntisaidәl
infanticide => in'fæntisaid
infantile => 'infәntail
infantilism => in'fæntilizm
infantility => ɪnfæn'tɪlɪtɪ
infantilize => 'infәntilaiz
infantine => 'infәntain
infantry => 'infәntri
infantryman => 'infәntrimәn
infants => ˈinfənts
infarct => in'fɑ:kt
infarction => in'fɑ:kʃәn
infatuate => in'fætjueit
infatuated => in'fætjjeitid
infatuation => in.fætju'eiʃәn
infatuations => ɪˌfætʃu:ˈeɪʃənz
infauna => 'infɔ:nә
infaunal => 'in,fɔ:nə
infeasibility => ɪnfi:zə'bɪlɪtɪ
infeasible => in'fi:zәbl
infect => in'fekt
infected => in'fektid
infecting => inˈfektɪŋ
infection => in'fekʃәn
infectious => in'fekʃәs
infective => in'fektiv
infector => ɪn'fektə
infects => inˈfekts
infecund => in'fi:kәnd
infecundity => infi'kʌnditi
infeed => 'infi:d
infelicities => ˌɪnfiˈlisitiz
infelicitous => .infi'lisitәs
infelicitously => infiˊlisitәsli
infelicity => .infi'lisiti
infer => in'fә:
inferable => in'fә:rәbl
inference => 'infәrәns
inferences => ˈinfərənsiz
inferential => .infә'renʃәl
inferentially => ɪnfə'renʃəlɪ
inferior => in'fiәriә
inferior conjunction => inˈfiəriə kənˈdʒʌŋkʃən
inferior planet => inˈfiəriə ˈplænit
inferiority => in.fiәri'ɒriti
infernal => in'fә:nl
infernally => ɪn'fɜ:nəlɪ
inferno => in'fә:nәu
infernos => ɪnˈfɜ:nəʊz
inferred => inˈfə:d
inferring => inˈfə:ɪŋ
infers => inˈfə:z
infertile => in'fә:tail
infertility => .infә'tiliti
infest => in'fest
infestation => .infe'steiʃәn
infestations => infesˈteiʃənz
infested => ɪnˈfestid
infesting => ɪnˈfestɪŋ
infests => ɪnˈfests
infeudation => ,infju'deiʃәn
infibulate => in'fibjjleit
infibulation => ,infibju'leiʃәn
infidel => 'infidl
infidelities => ˌɪnfɪˈdelɪti:z
infidelity => .infi'deliti
infidels => 'ɪnfɪdəlz
infield => 'infi:ld
infielder => 'infi:ldә
infighter => 'in,faitә
infighting => 'infaitiŋ
infill => 'infil
infilling => in'filiŋ
infiltrate => in'filtreit
infiltrated => ɪnˈfɪlˌtreɪtid
infiltrates => ɪnˈfɪlˌtreɪts
infiltrating => ɪn'fɪltreɪtɪŋ
infiltration => .infil'treiʃәn
infiltrations => ,ɪnfɪl'treɪʃən
infiltrative => 'ɪnfɪltrətɪv
infiltrator => 'infiltreitә(r),in'fil-
infimum => in'faimәm
infinite => 'infinit
infinitely => 'infinitli
infinitesimal => .infini'tesiml
infinitesimally => ˌɪnfɪnɪ'tesɪməlɪ
infinities => ɪnˈfɪnɪti:z
infinitival => in.fini'taivәl
infinitive => in'finitiv
infinitives => ɪnˈfɪnɪtɪvz
infinitude => in'finitju:d
infinity => in'finiti
infirm => in'fә:m
infirmaries => ɪnˈfɜ:məri:z
infirmary => in'fә:mәri
infirmities => ɪnˈfɜ:mətɪz
infirmity => in'fә:miti
infirmly => in'fә:mli
infix => in'fiks
infixation => ,infik'seiʃən
infixed => ɪn'fɪks
infixes => ɪn'fɪks
infixing => ɪn'fɪks
inflame => in'fleim
inflamer => ɪnf'leɪmər
inflames => ɪnf'leɪmz
inflaming => ɪnˈfleɪmɪŋ
inflammability => in.flæmә'biliti
inflammable => in'flæmәbl
inflammableness => ɪnf'læməblnəs
inflammation => .inflә'meiʃәn
inflammations => ˌɪnfləˈmeɪʃənz
inflammatory => in'flæmәtәri
inflatable => in'fleitәbl
inflate => in'fleit
inflated => in'fleitid
inflater => ɪnf'leɪtər
inflates => inˈfleits
inflation => in'fleiʃәn
inflationary => in'fleiʃәnәri
inflationism => in'fleiʃәnizm
inflationist => in'fleiʃәnist
inflator => in'fleitә
inflect => in'flekt
inflected => ɪnˈflektid
inflecting => ɪnˈflektɪŋ
inflection => in'flekʃәn
inflectional => in'flekʃәnәl
inflections => ɪnf'lekʃnz
inflective => in'flektiv
inflects => ɪnˈflekts
inflexed => in'flekst
inflexibility => in.fleksә'biliti
inflexible => in'fleksәbl
inflexibly => ɪn'fleksəblɪ
inflexion => in'flekʃәn
inflexions => ɪn'flekʃən
inflict => in'flikt
inflictable => in'fliktәbl
inflicted => inˈfliktid
inflicter => ɪnf'lɪktər
inflicting => inˈfliktɪŋ
infliction => in'flikʃәn
inflicts => inˈflikts
inflorescence => .inflɒ:'resәns
inflow => 'inflәu
inflowing => 'inflәuiŋ
inflows => ˈɪnˌfləʊz
influence => 'influәns
influenced => ˈinfluənst
influences => ˈinfluənsiz
influencing => 'influәnsiŋ
influent => 'influәnt
influential => .infu'enʃәl
influentially => ɪnfl'ʊenʃəlɪ
influenza => .influ'enzә
influx => 'inflʌks
info => 'infәu
infobahn => ˈɪnfəʊbɑ:n
infold => in'fәuld
infomercial => ˌɪnfəʊˈmɜ:ʃl
inform => in'fɒ:m
informal => in'fɒ:mәl
informality => .infɒ:'mæliti
informant => in'fɒ:mәnt
informants => ɪnˈfɔ:mənts
informatics => ,infә'mætiks
information => .infә'meiʃәn
informative => in'fɒ:mәtiv
informatory => in'fɔ:mәtәri
informed => in'fɒ:md
informed consent => ɪnˈfɔ:md kənˈsent
informer => in'fɒ:mә
informers => ɪn'fɔ:məz
informing => in'fɔ:miŋ
infotainment => ˌɪnfəʊˈteɪnmənt
infotech => 'ɪnfəʊtek
infra => 'infrә
infra- => 'infrә
infraction => in'frækʃәn
infractions => ɪn'frækʃ(ə)n
infractor => ɪnf'ræktə
infradian => in'freidiәn
infralapsarian => ,infrәlæp'seәriәn, -'sær-
infrangibility => in,frændʒi'bilәti
infrangible => in'frændʒibl
infraorder => ,infrə'ɔ:də
infrared => .infrә'red
infrarenal => ,infrә'ri:nәl
infrasonic => ,infrә'sɔnik
infrasound => ,infrә'saund
infraspecific => ,infrәspi'sifik
infrastructural => ˌɪnfrə'strʌktʃərəl
infrastructure => 'infrәstrʌktʃә
infrastructures => ɪnfrəst'rʌktʃəz
infrequency => in'fri:kwәnsi
infrequent => in'fri:kwәnt
infringe => in'frindʒ
infringed => ɪnˈfrɪndʒd
infringement => in'frindʒmәnt
infringements => ɪnˈfrɪndʒmənts
infringes => ɪnˈfrɪndʒz
infringing => ɪnˈfrɪndʒɪŋ
infructescence => in'frʌk,tesәns
infula => in'fjulә
infundibular => ,infʌn'dibjjlә(r)
infundibulum => ,infʌn'dibjulәm
infuriate => in'fjuәrieit
infuriated => ɪnf'jʊərɪeɪtɪd
infuriates => ɪnˈfjʊəri:ˌeɪts
infuriating => ɪnˈfjʊərieɪtɪŋ
infuse => in'fju:z
infused => ɪnˈfjoəʊzd
infuser => in'fju:zә
infuses => ɪnˈfjoəʊziz
infusible => in'fju:zәbl
infusing => ɪnˈfjoəʊzɪŋ
infusion => in'fju:ʒәn
infusions => ɪnf'ju:ʒnz
ingather => 'ingæðә
ingeminate => in'dʒemineit
ingeminated => ɪn'dʒemɪneɪt
ingeminates => ɪn'dʒemɪneɪt
ingeminating => ɪn'dʒemɪneɪt
ingenious => in'dʒi:njәs
ingeniously => ɪn'dʒi:nɪəslɪ
ingeniousness => in'dʒinjəsnis
ingenue => ænʒei'nju:
ingenues => ænʒeiˈnju:z
ingenuity => .indʒi'nju:iti
ingenuous => in'dʒenjuәs
ingenuously => ɪn'dʒenjʊəslɪ
ingenuousness => ɪn'dʒenjʊəsnɪs
ingest => in'dʒest
ingesta => in'dʒestә
ingested => ɪnˈdʒestid
ingestion => in'dʒestʃәn
ingle => 'iŋgl
inglenook => 'iŋglnuk
inglorious => in'glɒ:riәs
ingloriously => ɪn'ɡlɔ:rɪəslɪ
ingoing => 'ingәuiŋ
ingot => 'iŋgәt
ingots => 'ɪŋɡəts
ingraft => in'^rɑ:ft
ingrafted => ɪn'ɡrɑːft
ingrafting => ɪn'ɡrɑːft
ingrafts => ɪn'ɡrɑːft
ingrain => in'grein
ingrained => in'greind
ingraining => ɪn'greɪn
ingrains => ɪn'greɪn
ingram => 'iŋ^rәm
Ingrams => 'iŋɡrəm
ingrate => in'greit
ingrates => 'ɪngreɪt; ɪn'greɪt
ingratiate => in'greiʃieit
ingratiated => ɪnˈgreɪʃi:ˌeɪtid
ingratiates => ɪnˈgreɪʃi:ˌeɪts
ingratiating => in'greiʃieitiŋ
ingratiatingly => in'greiʃieitiŋli
ingratiation => in.ɡreiʃi'eiʃәn
ingratitude => in'grætitju:d
ingravescence => ,in^rә'vesns
ingravescent => .ingrә'vesәnt
ingredient => in'gri:diәnt
ingress => 'ingres
ingression => in'^reʃәn
ingressive => in'^resiv
Ingrid => 'iŋ^rid
ingrow => ɪŋ'rəʊ
ingrowing => 'ingrәuiŋ
ingrown => 'ingrәun
ingrowth => 'ingrәuθ
inguinal => 'iŋgwinәl
inguinally => 'iŋ^winәli
ingulf => in'^ʌlf
ingurgitate => in'gә:dʒiteit
ingurgitated => inˈɡə:dʒiteitid
ingurgitating => inˈɡə:dʒiteitɪŋ
Ingush => 'in^jʃ
inhabit => in'hæbit
inhabitability => inhæbitә'biliti
inhabitable => in'hæbitәb(ә)l
inhabitancy => in'hæbitәnsi
inhabitant => in'hæbitәnt
inhabitants => ɪn'hæbɪtənts
inhabitation => in,hæbi'teiʃәn
inhabited => in'hæbitid
inhabiting => inˈhæbitɪŋ
inhabits => inˈhæbits
inhalant => in'heilәnt
inhalation => .inhә'leiʃәn
inhalator => 'inhәleitә
inhale => in'heil
inhaled => inˈheild
inhaler => in'heilә
inhales => inˈheilz
inharmonic => .inhɑ:'mɒnik
inharmonious => .inhɑ:'mәuniәs
inhaul => 'in,hɔ:l
inhere => in'hiә
inhered => inˈhiəd
inherence => in'hiәrәns
inherent => in'hiәrәnt
inherently => in'hiәrәntli
inhering => inˈhiərɪŋ
inherit => in'herit
inheritability => in,heritə'biləti
inheritable => in'heritәbl
inheritance => in'heritәns
inheritances => ɪnˈherɪtənsiz
inherited => in'heritid
inheriting => inˈheritɪŋ
inheritor => in'heritә(r)
inheritors => inˈheritəz
inherits => inˈherits
inhesion => in'hi:ʒәn
inhibin => in'hibin
inhibit => in'hibit
inhibited => in'hibitid
inhibiting => in'hibitiŋ
inhibition => .inhi'biʃәn
inhibitions => ˌɪnhəˈbɪʃənz
inhibitive => in'hibitiv
inhibitor => in'hibitә(r)
inhibitory => in'hibitәri
inhibits => inˈhibits
inhomogeneity => 'in,hɔmәudʒe'ni:iti
inhomogeneous => ,inhәumә'dʒi:niәs, -hɔmә-
inhospitable => in'hɒspitәbl
inhospitably => ɪn'hɒspɪtəblɪ
inhospitality => 'in.hɒspi'tæliti
inhuman => in'hju:mәn
inhumane => .inhju:'mein
inhumanely => ,inhju:'meinli
inhumanity => .inhju:'mæniti
inhumanly => ɪnh'ju:mənlɪ
inhumation => .inhju:'meiʃәn
inhume => in'hju:m
inimical => i'nimikәl
inimically => ɪ'nɪmɪklɪ
inimitability => i'nimitə'biləti
inimitable => i'nimitәbl
inimitably => ɪ'nɪmɪtəblɪ
inion => 'iniәn
iniquities => ɪˈnɪkwɪti:z
iniquitous => i'nikwәtәs
iniquitously => ɪ'nɪkwɪtəslɪ
iniquity => i'nikwiti
initial => i'niʃәl
initial public offering => iˈniʃəl ˈpʌblik ˈɔ:fərɪŋ
initialese => i,niʃә'li:z
initialism => i'niʃәliz(ә)m
initialization => i,niʃәlai'zeiʃәn
initialize => i'niʃәlaiz
initialled => iˈniʃəld
initialling => iˈniʃəlɪŋ
initially => i'niʃәli
initiand => i'niʃi,ænd
initiate => i'niʃieit
initiated => iˈniʃieitid
initiates => iˈniʃieits
initiation => i.niʃi'eiʃәn
initiative => i'niʃiәtiv
initiatives => ɪ'nɪʃətɪvz
initiator => i'niʃieitә
initiatory => i'niʃiәtәri
inject => in'dʒekt
injectable => in'dʒedtәbl
injected => inˈdʒektid
injecting => inˈdʒektɪŋ
injection => in'dʒekʃәn
injections => inˈdʒekʃənz
injective => in'dʒektiv
injector => in'dʒektә
injects => inˈdʒekts
injudicious => .indʒu:'diʃәs
Injun => 'indʒәn
injunct => in'dʒʌŋkt
injunction => in'dʒʌŋkʃәn
injunctions => ɪnd'ʒʌŋkʃnz
injunctive => in'dʒʌŋktiv
injure => 'indʒә
injured => 'indʒәd
injures => ˈindʒəz
injuries => ˈindʒəriz
injuring => ˈindʒərɪŋ
injurious => in'dʒuәriәs
injuriously => ɪnd'ʒʊərɪəslɪ
injuriousness => in'dʒuəriəs
injury => 'indʒәri
injury time => ˈindʒəri taim
injustice => in'dʒʌstis
injustices => ɪnˈdʒʌstɪsiz
ink => iŋk
ink-blot test => iŋk blɔt test
ink-jet printer => ˈɪŋkˌdʒet
inkberry => 'ink,beri
inkblot => 'iŋkblɒt
inker => 'iŋkә
inkhorn => 'iŋkhɒ:n
inkiness => 'iŋkinis
inkjet printer => ˈɪŋkdʒet prɪntə(r)
inkle => 'iŋkl
inkling => 'iŋkliŋ
inklings => ˈɪŋklɪŋz
inkpot => 'iŋkpɒt
inks => iŋks
inkstand => 'iŋkstænd
inkwell => 'iŋkwel
inkwells => ˈinkwelz
inky => 'iŋki
inlaid => 'inleid
inland => 'inlәnd
inlander => 'inlәndә
inlay => 'inlei
inlet => 'inlet
inlets => 'ɪnlets
inlier => 'inlaiә
inly => 'inli
inmate => 'inmeit
inmates => ˈinmeits
inmost => 'inmәust
inn => in
innards => 'inәdz
innate => i'neit
innateness => ɪ'neɪtnɪs
inner => 'inә
inner circle => ˈinə ˈsə:kl
inner city => ˈinə ˈsiti
inner planet => ˈinə ˈplænit
innermost => 'inәmәust
innervate => i'nә:veit
innervated => ˈinə:veitid
innervating => ˈinə:veitɪŋ
innervation => .inә'veiʃәn
inning => 'iniŋ
innit => 'ɪnɪt
innkeeper => 'inki:pә(r)
innkeepers => ˈinˌki:pəz
innocence => 'inәsәns
innocency => 'inәsnsi
innocent => 'inәsәnt
innocents => 'ɪnəsnts
innocuous => i'nɒkjuәs
innocuousness => iˊnɒkjuәsnis
innominate => i'nɒminit
innominate artery => iˈnɔminit ˈɑ:təri
innominate vein => iˈnɔminit vein
innovate => 'inәuveit
innovated => ˈɪnəˌveɪtid
innovates => ˈɪnəˌveɪts
innovating => ˈɪnəˌveɪtɪŋ
innovation => .inәu'veiʃәn
innovations => ɪnə'veɪʃnz
innovative => 'inәjveitiv
innovatively => 'inəuveitivli
innovator => 'inәuveitә
innovators => ˈɪnəveɪtə(r)
innovatory => 'inәuveitәri
Innsbruck => 'inzbruk
innuendo => .inju:'endәu
innuit => ˈɪnju:ɪt
innumerability => ɪˌnju:mərə'bɪlɪtɪ
innumerable => i'nju:mәrәbl
innumerably => iˊnjuːmәrәbli
innumeracy => i'nju:mәrәsi
innumerate => ɪˈnju:mərət
innutrition => .inju:'triʃәn
innutritious => .inju:'triʃәs
inobservance => .inәb'zә:vәns
inoculable => i'nɔkjulәbl
inoculate => i'nɒkjuleit
inoculated => ɪˈnɔkjəˌleɪtid
inoculates => ɪˈnɔkjəˌleɪts
inoculation => i.nɒkju'leiʃәn
inoculations => ɪ,nɒkjʊ'leɪʃn
inoculator => i'nɔkjjleitә(r)
inoculum => i'nɒkjulәm
inodorous => in'әudәrәs
inoffensive => .inә'fensiv
inoffensively => ,inə'fensivli
inoperable => in'ɒpәrәbl
inoperative => in'ɒpәrәtiv
inopportune => in'ɒpәtju:n
inordinate => i'nɒ:dinәt
inorganic => .inɒ:'gænik
inorganics => ,inɔ:'^æniks
inosculate => i'nɒskjuleit
inosculated => iˈnɔskjuleitid
inosculating => iˈnɔskjuleitɪŋ
inosculation => i.nɒskju'leiʃәn
inosine => 'inәsi:n
inositol => i'nәusitɒl
inotropic => ,inә'trɔpik
inpatient => 'inpeiʃәnt
inpouring => 'inpɔ:riŋ
input => 'input
inquest => 'inkwest
inquests => ˈɪnˌkwests
inquietude => in'kwaiәtju:d
inquiline => 'inkwilain, -lin
inquire => in'kwaiә
inquired => inˈkwaiəd
inquirer => in'kwaiәrә
inquires => inˈkwaiəz
inquiries => inˈkwaiəriz
inquiring => in'kwaiәriŋ
inquiry => in'kwaiәri
inquiry agent => inˈkwaiəri ˈeidʒənt
inquisition => .inkwi'ziʃәn
inquisitional => .inkwi'ziʃәnl
inquisitions => ˌɪnkwɪˈzɪʃənz
inquisitive => in'kwizәtiv
inquisitively => ɪn'kwɪzətɪvlɪ
inquisitiveness => ɪn'kwɪzətɪvnəs
inquisitor => in'kwizitә
inquisitorial => in.kwizi'tɒ:riәl
inquisitors => inˈkwizitəz
inquorate => ɪnˈkwɔ:rət
inro => 'inrəu
inroad => 'inrәud
inroads => 'ɪnrəʊdz
inrush => 'inrʌʃ
insalubrious => .insә'lu:briәs
insalubrity => .insә'lu:briti
insane => in'sein
insanitary => in'sænitәri
insanity => in'sæniti
insatiability => in.seiʃjә'biliti
insatiable => in'seiʃjәbl
insatiate => in'seiʃiit
inscape => 'inskeip
inscribable => in'skraibәbl
inscribe => in'skraib
inscribed => in'skraibd
inscribes => ɪnˈskraɪbz
inscription => in'skripʃәn
inscriptions => ɪnsk'rɪpʃnz
inscriptive => in'skriptiv
inscrutability => in.skru:tә'biliti
inscrutable => in'skru:tәbl
inscrutably => ɪn'skru:təblɪ
inseam => 'insi:m
insect => 'insekt
insectan => in'sektən
insectarium => ,insek'teәriәm
insecticidal => in,sekti'saidәl
insecticide => in'sektisaid
insecticides => ɪn'sektɪsaɪdz
insectile => in'sektail
Insectivora => ,insek'tivәrә
insectivore => in'sektivɒ:
insectivores => ɪnsek'tɪvrz
insectivorous => .insek'tivәrәs
insecure => .insi'kjuә
insecurities => ˌɪnsɪˈkjʊərɪtɪz
insecurity => .insi'kjuәrәti
inselberg => in'selbә:^
inseminate => in'semineit
inseminated => inˈsemineitid
inseminates => inˈsemineits
inseminating => inˈsemineitɪŋ
insemination => in.semi'neiʃәn
insensate => in'senseit
insensibility => in.sensә'biliti
insensible => in'sensәbl
insensibly => in'sensәbli
insensitive => in'sensitiv
insensitively => ɪn'sensətɪvlɪ
insentience => in'senʃiəns
insentient => in'senʃiәnt
inseparability => in.sepәrә'biliti
inseparable => in'sepәrәbl
inseparably => in'sepәrәbli
insert => in'sә:t
inserted => in'sә:tid
inserter => in'sә:tә
insertion => in'sә:ʃәn
inset => 'inset
insets => ˈinˈsets
insetting => 'ɪnset
inshallah => in'ʃɑ:iɑ:
inshore => 'in'ʃɒ:
inside => 'in'said
insider => 'in'saidә
insiders => ɪnˈsaɪdəz
insidious => in'sidiәs
insidiousness => ɪn'sɪdɪəsnəs
insight => 'insait
insightful => 'in.saitful
insignia => in'signiә
insignificance => .insig'nifikәns
insignificancy => .insig'nifikәnsi
insignificant => .insig'nifikәnt
insincere => .insin'siә
insincerely => ,insin'siəli
insincerity => .insin'seriti
insinuate => in'sinjueit
insinuated => ɪnˈsɪnju:ˌeɪtid
insinuates => ɪnˈsɪnju:ˌeɪts
insinuating => in'sinjueitiŋ
insinuation => in.sinju'eiʃәn
insinuations => ɪnsɪnjʊ'eɪʃ(ə)n
insipid => in'sipid
insipidity => .insi'piditi
insipidly => ɪn'sɪpɪdlɪ
insipidness => ɪn'sɪpɪdnəs
insist => in'sist
insisted => inˈsistid
insistence => in'sistәns
insistency => in'sistәnsi
insistent => in'sistәnt
insistently => ɪn'sɪstəntlɪ
insisting => inˈsistɪŋ
insists => inˈsists
insobriety => .insәu'braiәti
insofar => .insәu'fɑ:
insolation => .insә'leiʃәn
insole => 'insәul
insolence => 'insәlәns
insolent => 'insәlәnt
insoles => ɪn'səʊlz
insolubility => in.sɒlju'biliti
insolubilize => in'sɔljubәlaiz
insoluble => in'sɒljubl
insolvable => in'sɒlvәbl
insolvency => in'sɒlvәnsi
insolvent => in'sɒlvәnt
insomnia => in'sɒmniә
insomniac => in'sɒmniæk
insomniacs => inˈsɔmniæks
insomuch => ,insәu'mʌtʃ
insouciance => in'su:sjәns
insouciant => in'su:siәnt
inspan => in'spæn
inspect => in'spekt
inspected => inˈspektid
inspecting => inˈspektɪŋ
inspection => in'spekʃәn
inspections => ɪnˈspekʃənz
inspector => in'spektә
inspectorate => in'spektәrit
inspectorates => inˈspektərits
inspectors => ɪnˈspektəz
inspectorship => in'spektәʃip
inspects => inˈspekts
inspiration => .inspә'reiʃәn
inspirational => .inspә'reiʃәnәl
inspirations => ˌɪnspəˈreiʃənz
inspiratory => in'spairәtәri
inspire => in'spaiә
inspired => in'spaiәd
inspirer => ɪns'paɪrɚ
inspires => inˈspaiəz
inspiring => in'spaiәriŋ
inspiringly => inˊspaiәriŋli
inspirit => in'spirit
inspirited => inˈspiritid
inspirits => inˈspirits
inspissate => in'spiseit
inspissated => 'ɪnspɪseɪtɪd
inspissation => .inspi'seiʃәn
instabilities => ˌɪnstəˈbɪlɪti:z
instability => .instә'biliti
install => in'stɒ:l
installation => .instә'leiʃәn
installations => ɪnstə'leɪʃnz
installment => in'stɒ:lmәnt
installments => inˈstɔ:lmənts
installs => ɪns'tɔ:lz
instalment => in'stɒ:lmәnt
instalments => inˈstɔ:lmənts
instamatic => ,instә'mætik
instance => 'instәns
instances => ˈinstənsiz
instancy => 'instәnsi
instant => 'instәnt
instantaneity => in,stæntә'ni:iti
instantaneous => .instәn'teinjәs
instantaneousness => instәnˊteinjәsnis
instanter => in'stæntә
instantiate => in'stænʃieit
instantiating => ɪn'stænʃɪeɪt
instantiation => in.stænʃieiʃәn
instantly => 'instәntli
instar => 'instɑ:
instate => in'steit
instated => inˈsteitid
instating => inˈsteitɪŋ
instauration => .instɒ:'reiʃәn
instead => in'sted
instep => 'instep
insteps => ˈinsteps
instigate => 'instigeit
instigated => ˈɪnstɪˌgeɪtid
instigates => ˈɪnstɪˌgeɪts
instigating => ˈɪnstɪˌgeɪtɪŋ
instigation => .insti'geiʃәn
instigator => 'instigeitә
instigators => 'ɪnstɪɡeɪtəz
instil => in'stil
instill => in'stil
instillation => .insti'leiʃәn
instilled => ɪns'tɪld
instilling => ɪns'tɪlɪŋ
instilment => inˊstilmәnt
instils => ɪnˈstɪlz
instinct => 'instiŋkt
instinctive => in'stiŋktiv
instinctual => in'stiŋktʃuәl
institute => 'institju:t
institution => .insti'tju:ʃәn
institutional => .insti'tju:ʃәnәl
institutionalisation => 'ɪnstɪ,tjʊʃənəlɪ'zeʃən
institutionalise => ,insti'tju:ʃәnәlaiz
institutionalism => ɪnstɪt'ju:ʃənəlɪzəm
institutionalize => ,insti'tju:ʃәnәlaiz
institutionalized => .insti'tju:ʃәnәlaizd
institutionalizes => ˌɪnstiˈtju:ʃənəlaiziz
institutionalizing => ˌɪnstiˈtju:ʃənəlaizɪŋ
instruct => in'strʌkt
instructing => inˈstrʌktɪŋ
instruction => in'strʌkʃәn
instructional => in'strʌkʃәnәl
instructive => in'strʌktiv
instructiveness => ɪnst'rʌktɪvnəs
instructor => in'strʌktә
instructors => ɪnst'rʌktəz
instructorship => in'strʌktәʃip
instructress => in'strʌktris
instructs => inˈstrʌkts
instrument => 'instrumәnt
instrumental => .instru'mentәl
instrumental conditioning => ˌɪnstruˈmentl kənˈdiʃəniŋ
instrumentalism => ,instrj'mentәlizәm,,instrә-
instrumentalist => .instru'mentәlist. instrә-
instrumentalists => ˈɪnstrʊməntəlɪsts
instrumentalities => ɪnstrʊmen'tælɪtɪz
instrumentality => .instrumen'tæliti
instrumentalization => 'ɪnstrʊ,mɛntəlɪ'zeʃən
instrumentation => .instrumen'teiʃәn
instrumented => 'instrumentid
insubordinate => .insә'bɒ:dinәt
insubordinately => insәˊbɒːdәnitli
insubstantial => .insәb'stænʃәl
insubstantiality => 'insəb,stænʃi'æləti
insufferable => in'sʌfәrәbl
insufferably => ɪn'sʌfrəblɪ
insufficiency => .insә'fiʃәnsi
insufficient => .insә'fiʃәnt
insufficiently => ˌɪnsə'fɪʃntlɪ
insufflate => 'insәfleit
insufflation => ,insә'fleiʃәn
insufflator => 'insәfleitә(r)
insula => 'insjulә
insulant => 'insjulәnt
insular => 'insjulә
insularity => .insju'læriti
insulate => 'insjuleit
insulated => 'insә.leitәd
insulates => ˈinsjuleits
insulation => .insju'leiʃәn. 'insә-
insulator => 'insjuleitә
insulators => 'ɪnsjʊleɪtəz
insulin => 'insjulin
insult => 'insʌlt
insulted => inˈsʌltid
insulter => ɪn'sʌltə
insulting => in'sʌltiŋ
insultingly => ɪn'sʌltɪŋlɪ
insuperability => insju:pәrә'bilәti
insuperable => in'sju:pәrәbl
insuperably => ɪns'ju:prəblɪ
insupportable => .insә'pɒ:tәbl
insupportably => ɪnsə'pɔ:təblɪ
insurable => in'ʃurәbl
insurance => in'ʃurәns
insure => in'ʃuә
insured => in'ʃuәd
insurer => in'ʃuәrә
insurers => ɪn'ʃʊərəz
insures => inˈʃuəz
insurgence => in'sә:dʒәns
insurgency => in'sә:dʒәnsi
insurgent => in'sә:dʒәnt
insurgents => ɪnˈsɜ:dʒənts
insuring => inˈʃuərɪŋ
insurmountable => .insә'mauntәbl
insurrection => .insә'rekʃәn
insurrectionary => ,insә'rekʃәnәri
insurrections => ˌɪnsəˈrekʃənz
insusceptible => .insә'septәbl
inswing => 'in,swiŋ
inswinger => 'in,swiŋә(r)
intact => in'tækt
intactness => ɪn'tæktnəs
intagliated => in'tælieitid
intaglio => in'tæliәu
intake => 'inteik
intakes => 'ɪnteɪks
intangibility => in.tændʒә'biliti
intangible => in'tændʒәbl
intangibly => in'tændʒәbli
intarsia => in'tɑ:siә
integer => 'intidʒә
integers => 'ɪntɪdʒəz
integrability => ,inti^rә'biliti
integrable => 'inti^rәbl
integral => 'intigrәl
integrality => .inti'græliti
integrally => ɪn'teɡrəlɪ
integrand => 'intiɡrәnd
integrant => 'intigrәnt
integrate => 'intigreit
integrated => 'intәgreitid
integrates => ˈintiɡreits
integration => .inti'greiʃәn
integrationist => ,inti'^reiʃәnist
integrative => 'intigreitiv
integrator => 'intigreitә
integrators => 'ɪntɪgreɪtə
integrin => ɪn'teɡrɪn
integrity => in'tegriti
integument => in'tegjumәnt
integumentary => in,te^ju'mentәri
intellect => 'intәlekt
intellection => .intә'lekʃәn
intellective => .intә'lektiv
intellects => 'ɪntəlekts
intellectual => .intә'lektʃuәl
intellectualism => ,intә'lektjjәlizәm,-tʃjә-
intellectualist => ,intә'lektjjәlist,-tʃjә-
intellectuality => ,inti,lektju'æliti
intellectualization => ɪntɪlektjʊəlaɪzeɪnʃ
intellectualize => .intә'lektʃuәlaiz
intellectuals => ɪntə'lektʃʊəlz
intelligence => in'telidʒәns
intelligencer => in'telidʒәnsә
intelligent => in'telidʒәnt
intelligential => in,teli'dʒenʃәl
intelligentsia => in.teli'dʒetsiә
intelligible => in'telidʒәbl
intelligibly => in'telidʒәbli
intemperance => in'tempәrәns
intemperate => in'tempәrit
intend => in'tend
intendancy => in'tendәnsi
intendant => in'tendәnt
intended => in'tendid
intending => in'tendiŋ
intendment => in'tendmәnt
intends => inˈtendz
intense => in'tens
intensely => ɪn'tenslɪ
intenseness => in'tensnis
intensification => in,tensifi'keiʃәn
intensified => inˈtensifaid
intensifier => in'tensifaiә
intensifiers => ɪn'tensɪfaɪəz
intensify => in'tensifai
intension => in'teʃәn
intensional => in'tenʃənəl
intensities => inˈtensitiz
intensity => in'tensәti
intensive => in'tensiv
intensive care => inˈtensiv kɛə
intent => in'tent
intention => in'tenʃәn
intentional => in'tenʃәnәl
intentionality => ɪnˌtenʃə'nælɪtɪ
intentioned => in'tenʃәnd
intentions => inˈtenʃənz
intently => in'tentli
intentness => in'tentnis
intents => inˈtents
inter => in'tә:
inter alia => intәr 'æliә
inter alios => ,intә'eiliәus
inter vivos => ,intә(:)'vi:vәus
inter- => 'intә(r)
interact => .intәr'ækt
interactant => ,intәr'æktәnt
interacted => ˌɪntərˈæktid
interaction => .intәr'ækʃәn
interactionism => ɪntə'rækʃnɪzəm
interactions => ɪntə'rækʃnz
interactive => ,intәr'æktiv
interacts => ˌɪntərˈækts
interagency => ˌɪntər'eɪdʒənsɪ
interannual => ɪntə'rænjʊəl
interarticular => ,intәɑ:'tikjulә
interatomic => ,intәrә'tɔmik
interaural => ,intә'ɔ:rәl
interbank => ,intә'bæŋk
interbed => 'intәbed
interbedded => ,intә'bedid
interbred => ˌintəˈbri:did
interbreed => .intә'bri:d
intercalary => in'tә:kәlәri
intercalate => in'tә:kәleit
intercalated => ɪntɜ:kə'leɪtɪd
intercalating => inˈtə:kəleitɪŋ
intercalation => in.tә:kә'leiʃәn
intercede => .intә'si:d
interceded => ˌɪntəˈsi:did
interceder => ɪntɜ:'si:də
intercedes => ˌɪntəˈsi:dz
interceding => ˌɪntəˈsi:dɪŋ
intercellular => .intә'seljulә
intercensal => ,intә'sensәl
intercept => .intә'sept
intercepted => ˌɪntəˈseptid
interception => ,intә(:)'sepʃәn
interceptive => .intә'septiv
interceptor => .intә'septә
interceptors => intəˈseptəz
intercepts => ˌɪntəˈsepts
intercession => .intә'seʃәn
intercessions => ˌɪntəˈseʃənz
intercessor => .intә'sesә
intercessory => .intә'sesәri
interchange => .intә'tʃeindʒ
interchangeability => ,intә(:),tʃeindʒә'biliti
interchangeable => .intә'tʃeindʒәbl
interchanged => ˌɪntəˈtʃeɪndʒd
interchanges => ˌɪntəˈtʃeɪndʒz
intercity => .intә'siti
intercoastal => ,intә(:)'kәustl
intercollegiate => .intәkә'li:dʒiәt
intercolonial => .intәkә'lәunjәl
intercolumnar => .intәkә'lʌmnә
intercolumniation => 'intә(:)kә,lʌmni'eiʃәn
intercom => 'intәkɔm
intercommunal => ,intә'kɔmjunl
intercommunicate => ,intә(:)kә'mju:nikeit
intercommunicated => ˌintə(:)kəˈmju:nikeitid
intercommunication => 'intәkә,mju:ni'keiʃәn
intercommunion => .intәkә'mju:njәn
intercommunity => .intәkә'mju:nәti
intercoms => 'ɪntəkɒmz
interconnect => .intәkә'nekt
interconnected => ,intəkə'nektid
interconnection => .intәkә'nekʃәn
interconnects => ˌɪntəkəˈnekts
intercontinental => ,intә,kɔnti'nentl
interconversion => ,intә(:)kәn'vә:ʃәn
interconvert => ,intәkәn'vә:t
interconvertible => .intәkәn'vә:tәbl
intercooler => .intә'ku:lә
intercostal => .intә'kɒstәl
intercourse => 'intәkɒ:s
intercrop => .intә'krɒp
intercropping => ,intә'krɔpiŋ
intercross => ,intә(:)'krɔs
intercrural => ,intә'krurәl
intercultural => .intә'kʌltʃәrәl
intercurrent => .intә'kʌrәnt
intercut => ,intә(:)'kʌt
interdenominational => ,intәdi,nɔmi'neiʃәnl
interdepartmental => ,intә(:)di,pɑ:t'mentl
interdepend => .intәdi'pend
interdependence => .intәdi'pendәns.-dәnsi
interdependent => .intәdi'pendәnt
interdict => .intә'dikt
interdicted => ˌɪntəˈdɪktid
interdicting => ˌɪntəˈdɪktɪŋ
interdiction => .intә'dikʃәn
interdicts => ˌɪntəˈdɪkts
interdigital => ,intә'didʒitәl
interdigitate => ,intә(:)'didʒiteit
interdisciplinary => ,intә(:)'disiplinәri
interest => 'intrist
interest-free => 'intristfri:
interested => 'intristid
interestedly => 'ɪntrəstɪdlɪ
interesting => 'intristiŋ
interestingly => 'intristiŋli
interests => ˈintrists
interface => 'intәfeis
interfaced => 'intә:feist
interfaces => ˈintəfeisiz
interfacial => .intә'feiʃәl
interfacing => 'intәfeisiŋ
interfaith => 'intә(:),feiθ
interfere => .intә'fiә
interfered => ˌɪntəˈfiəd
interference => .intә'fiәrәns
interferences => ɪntə'fɪərənsɪz
interferential => intәfiә'renʃәl
interferes => ˌɪntəˈfiəz
interfering => ,intә'fiәriŋ
interferometer => .intәfә'rɒmitә
interferometric => 'intә,ferәj'metrik
interferometry => ,intәfiә'rɔmitri
interferon => .intә'fiәrɒn
interfile => ,intә'fail
interflow => .intә'flәu
interfluve => 'intә(:)flu:v
interfuse => .intә'fju:z
interfusion => .intә'fju:ʒәn
intergalactic => .intәgә'læktik
intergenerational => ,intә(:),dʒenә'reiʃәnl
intergeneric => ,intәdʒә'nerik
interglacial => .intә'gleiʃәl
intergovernmental => ,intә^ʌvәn'mentәl
intergradation => ,intә^rei'deiʃәn
intergrade => 'intәgreid
intergroup => 'intә(:)'^ru:p
intergrowth => 'intә(:)^rәuθ
interim => 'intәrim
interior => in'tiәriә
interior angle => inˈtiəriə ˈæŋɡl
interior decoration => inˈtiəriə ˌdekəˈreɪʃən
interior decorator => inˈtiəriə ˈdekəˌreɪtə
interior design => inˈtiəriə diˈzain
interior designer => inˈtiəriə dɪˈzaɪnə
interior monologue => inˈtiəriə ˈmɔnəlɔɡ
interiority => in,tiәri'ɔ:riti
interiorize => in'tiәriә,raiz
interiorly => in'tiәriәli
interiors => inˈtiəriəz
interject => .intә'dʒekt
interjected => ˌɪntəˈdʒektid
interjecting => ˌɪntəˈdʒektɪŋ
interjection => .intә'dʒekʃәn
interjectional => .intә'dʒekʃәnәl
interjections => ɪntəd'ʒekʃnz
interjectory => .intә'dʒektәri
interjects => ˌɪntəˈdʒekts
interlace => .intә'leis
interlaced => ,intә'leist
interlacement => ,intә'leismәnt
interlacing => ,intә(:)'leisiŋ
interlanguage => ,intә'læŋ^widʒ
interlard => .intә'lɑ:d
interlay => .intә'lei
interlayer => 'intә(:),leiә
interleaf => 'intәli:f
interleave => .intә'li:v
interleaved => ɪntə'lɪvd
interleaves => 'ɪntəli:vz
interleaving => ,intә(:)'li:viŋ
interlibrary => ,intә'laibrәri
interline => .intә'lain
interlinear => .intә'liniә
interlineate => ,intә'linieit
interlineation => 'intә.lini'eiʃәn
interlined => ˌintə(:)ˈlaind
Interlingua => ,intә'liŋ^wә
interlining => .intә'lainiŋ
interlink => .intә'liŋk
interlinks => ˌintə(:)ˈliŋks
interlock => .intә'lɒk
interlocked => ˌɪntəˈlɔkt
interlocker => ,intә(:)'lɔkә
interlocking => .intә'lɒkiŋ
interlocks => ,intә(:)'lɔks
interlocution => .intәlәu'kju:ʃәn
interlocutor => .intә'lɒkjutә
interlocutors => ˌɪntəˈlɔkjətəz
interlocutory => .intә'lɒkjutәri
interlope => ,intә(:)'lәup
interloped => ,ɪntə'ləʊp
interloper => 'intәlәjpә(r)
interlopers => ˈintələupəz
interlopes => ,ɪntə'ləʊp
interloping => ,ɪntə'ləʊp
interlude => 'intәlu:d
interludes => ˈɪntəˌlu:dz
intermarriage => .intә'mæridʒ
intermarried => ˌɪntəˈmæri:d
intermarries => ˌɪntəˈmæri:z
intermarry => .intә'mæri
intermarrying => ˌɪntəˈmæri:ɪŋ
intermediacy => ,intә(:)'midiәsi
intermediaries => ,ɪntɚ'midɪ,ɛri
intermediary => .intә'mi:diәri
intermediate => .intә'mi:diәt
intermediate host => ˌɪntəˈmi:djət həust
intermediately => ɪntə'mi:dɪətlɪ
intermediates => ˌɪntər'mi:dɪəts
intermediation => 'intә.mi:di'eiʃәn
intermediator => .intә'mi:dieitә
intermedin => 'intә(:)'mi:din
intermedium => .intә'mi:diәm
interment => in'tә:mәnt
intermesh => ,intә(:)'meʃ
intermeshed => 'ɪntɜ:rmeʃt
intermezzo => .intә'metsәu
interminable => in'tә:minәbl
interminableness => ɪn'tɜ:mɪnəblnəs
interminably => ɪn'tɜ:mɪnəblɪ
intermingle => .intә'miŋgl
intermingled => ˌɪntəˈmɪŋgəld
intermingles => ˌɪntəˈmɪŋgəlz
intermingling => ˌɪntə'mɪŋgəlɪŋ
intermission => .intә'miʃәn
intermissions => ˌɪntəˈmɪʃənz
intermit => .intә'mit
intermitted => ˌɪntə'mɪtɪd
intermittence => .intә'mitәns
intermittency => ɪntə'mɪtənsɪ
intermittent => .intә'mitәnt
intermitting => ɪntə'mɪtɪŋ
intermix => .intә'miks
intermixed => ˌintə(:)ˈmikst
intermixing => 'ɪntəm'ɪksɪŋ
intermixture => .intә'mikstʃә
intermodal => ,intә(:)'mәudl
intermolecular => ,intә(:)mә'lekjulә
intermountain => ɪntɜ:r'maʊntɪn
intern => in'tә:n
internal => in'tә:nәl
internal market => inˈtə:nəl ˈmɑ:kit
internal rhyme => inˈtə:nəl raim
internal-combustion engine => ɪnˈtɜ:nəlkəmˈbʌstʃən
internalise => ɪn'tɜ:ˌnəlˌɑɪz
internalised => in'tə:nəlaiz
internality => .intә'næliti
internalize => in'tә:nәlaiz
internalized => inˈtə:nəˌlaizd
internalizes => inˈtə:nəˌlaiziz
internalizing => inˈtə:nəˌlaizɪŋ
internally => in'tәnәli
international => .intә'næʃәnәl
Internationale => ,intәnæʃә'nɑ:l, -'næʃәnәl
internationalisation => ɪntɜ:næʃənəlaɪ'zeɪʃən
internationalise => ,intә'næʃənәlaiz
internationalism => .intә'næʃәnәlizm
internationalist => .intә'næʃәnәlist
internationality => 'intә.næʃә'nælәti
internationalization => intә,næʃәnәlai'zeiʃәn
internationalize => .intә'næʃәnәlaiz
internationalized => ˌɪntəˈnæʃənəlaizd
internationalizes => ˌɪntəˈnæʃənəlaiziz
internationalizing => ˌɪntəˈnæʃənəlaizɪŋ
internationally => .intә'næʃәnәli
internaut => ,intə'nɔ:t
interne => in'tә:n
internecine => .intә'ni:sain
internee => .intә'ni:
internees => ˌintə:ˈni:z
internegative => ,intә(:)'ne^әtiv
internet => 'intәnet
interneuron => ,intә'njuәrɔn, -'nuә-
interneuronal => ,intә'njuәrɔnәl
interning => ˈɪnˌtɜ:nɪŋ
internist => in'tә:nist
internment => in'tә:nmәnt
internments => ɪn'tɜːnmənt
internode => 'intә,nәud
internship => 'intә:nʃip
internships => ˈintə:nʃips
internuclear => ,intә'nju:kliә
internuncial => ,intә(:)'nʌnʃәl
interoceanic => 'intәr.әuʃi'ænik
interoceptive => ,intәrәj'septiv
interoceptor => .intәrәu'septә
interoperability => 'intәr,ɔpərә'bilәti
interoperable => ,intәr'ɔpərәbl
interoperate => ,intə'ɔpəreit
interorganizational => ɪntɜ:rəɡənaɪ'zeɪʃnəl
interosseous => ,intәr'ɔsiәs
interpellate => in'tә:peleit
interpellated => ˌintə(:)ˈpeleitid
interpellating => ˌintə(:)ˈpeleitɪŋ
interpellation => in.tә:pe'leiʃәn
interpellator => in'tә:peleitә
interpenetrate => .intә'penitreit
interpenetrated => ˌintə(:)ˈpenitreitid
interpenetrative => ɪntɜ:'penɪtrətɪv
interpersonal => .intә'pә:sәnәl
interphase => 'intә(:)feiz
interphone => 'intәfәun
interplanetary => .intә'plænitәri
interplant => ,intә(:)'plɑ:nt
interplay => 'intәplei
interpleader => ,intә'pli:dә(r)
Interpol => 'intә(:)pәul
interpolate => in'tә:pәuleit
interpolates => ɪnˈtɜ:pəˌleɪts
interpolation => in.tә:pәu'leiʃәn
interpolations => ɪntɜ:pə'leɪʃnz
interpolator => in'tә:pәuleitә
interpole => 'intә(:)pәul
interpose => .intә'pәuz
interposed => ˌɪntəˈpəʊzd
interposes => ˌɪntəˈpəʊziz
interposing => ˌɪntəˈpəʊzɪŋ
interposition => in.tә:pә'ziʃәn
interpret => in'tә:prit
interpretability => ɪntɜ:prɪ'təbɪlɪtɪ
interpretable => in'tә:pritәbl
interpretation => in.tә:pri'teiʃәn
interpretations => ɪntɜ:prɪ'teɪʃnz
interpretative => in'tә:priteitiv
interpreted => inˈtə:pritid
interpreter => in'tә:pritә
interpretive => in'tә:pritiv
interprets => inˈtə:prits
interprovincial => ,intәprә'vinʃəl
interracial => .intә'reiʃjәl
interracially => ,intə'reiʃiəli
interradial => ,intә(:)'reidiәl
interred => ɪnˈtɜ:d
interregional => ,intә(:)'ri:dʒәnәl
interregnum => .intә'regnәm
interregnums => ˌɪntəˈregnəmz
interrelate => .intәri'leit
interrelated => .intәri'leitid
interrelates => ˌɪntərɪˈleɪts
interrelating => ˌɪntərɪˈleɪtɪŋ
interrelation => .intәri'leiʃәn
interrelationships => 'ɪntərɪl'eɪʃənʃɪps
interreligious => ,intәri'lidʒәs
interring => ɪnˈtɜ:ɪŋ
interrogate => in'terәgeit
interrogated => ɪnˈterəˌgeɪtid
interrogates => ɪnˈterəˌgeɪts
interrogation => in.terәu'geiʃәn
interrogation point => ɪnˌterəˈgeɪʃɵn pɔint
interrogational => ɪnterə'ɡeɪʃənəl
interrogations => ɪnˌterəˈgeɪʃɵnz
interrogative => .intә'rɒgәtiv
interrogatives => ˌɪntəˈrɔgətɪvz
interrogator => in'terәugeitә
interrogatories => ˌintəˈrɔɡətəriz
interrogators => ɪn'terəʊɡeɪtə
interrogatory => .intә'rɒgәtәri
interrupt => .intә'rʌpt
interrupted => ,intә'rʌptid
interrupter => .intә'rʌptә
interruption => .intә'rʌpʃәn
interruptions => ˌɪntəˈrʌpʃənz
interruptive => ,intә'rʌptiv
interrupts => ˌɪntəˈrʌpts
interscholastic => .intәskә'læstik
intersect => .intә'sekt
intersected => .intә'sektid
intersection => .intә'sekʃәn
intersectional => ,intә'sekʃənәl
intersections => ɪntə'sekʃnz
intersects => ˌɪntəˈsekts
intersegmental => ,intәse^'mentl
interseptal => ,intә'septəl
intersession => 'intә,seʃәn
intersex => 'intәseks
intersexual => .intә'sekʃuәl
intersexuality => ,intә,seksju'æliti
interspace => 'intәspeis
interspecific => ,intә(:)spi'sifik
intersperse => .intә'spә:s
interspersed => intə'spə:st
intersperses => ˌɪntəˈspɜ:siz
interspersing => ˌɪntəˈspɜ:sɪŋ
interspersion => .intә'spә:ʃәn
interspinal => ,intә'spainәl
interspinous => ,intә'spainәs
interstadial => ,intә(:)'steidiәl
interstate => .intә'steit
interstellar => 'intә'stelә
interstice => in'tә:stis
interstices => ɪn'tɜ:stɪsɪz
interstitial => .intә'stiʃәl
intersubjective => ,intәsәb'dʒektiv
intersubjectivity => ˌɪntəsəbˌdʒek'tɪvɪtɪ
intertextuality => ˌɪntətekstʃuˈæləti
intertidal => ,intә(:)'taidl
intertribal => .intә'traibl
intertrigo => ,intә'trai^әu
intertwine => .intә'twain
intertwined => ˌɪntɜ:'waɪnd
intertwining => 'ɪntətwaɪnɪŋ
interurban => .intә'ә:bәn
interval => 'intәvәl
interval training => ˈintəvəl ˈtreiniŋ
intervallic => intә'vælik
intervalometer => ,intәvә'lɔmitә
intervals => 'ɪntevl
intervene => .intә'vi:n
intervened => ˌɪntəˈvi:nd
intervenes => ˌɪntəˈvi:nz
intervenient => .intә'vi:njәnt
intervenor => ,intә'vi:nә(r)
intervention => .intә'venʃәn
interventionism => ,intә'venʃənizəm
interventionist => .intә'venʃәnist
interventions => ɪntə'venʃnz
intervertebral => ,intә(:)'vә:tibrәl
intervertebral disc => intəˈvə:tibrəl disk
interview => 'intәvju:
interviewed => ˈintəvju:d
interviewee => .intәvju:'i:
interviewees => ˌɪntəvju:ˈi:z
interviewer => 'intәvju:ә
interviewers => ˈintəvju:əz
interviews => ˈintəvju:z
intervocalic => .intәvәu'kælik
interwar => 'intә(:)'wɔ:
interweave => intә'wi:v
interweaves => ˌɪntəˈwi:vz
interweaving => ˌɪntəˈwi:vɪŋ
interwind => ,intә(:)'waind
interwove => ,intә'wәjv
interwoven => .intә'wәuvәn
intestacy => in'testәsi
intestate => in'testeit
intestinal => in'testinәl
intestine => in'testin
intestines => ɪn'testɪnz
intifada => 'ɪntɪfeɪdə
intima => 'intimә
intimacies => ˈɪntəməsi:z
intimacy => 'intimәsi
intimate => 'intimәt
intimated => ˈɪntɪmətid
intimately => 'intimitli
intimates => ˈɪntɪməts
intimating => ˈɪntɪmətɪŋ
intimation => .inti'meiʃәn
intimations => ˌintiˈmeiʃənz
intimidate => in'timideit
intimidated => ɪnˈtɪmɪdeɪtɪd
intimidates => inˈtimideits
intimidating => ɪnˈtɪmɪdeɪtɪŋ
intimidation => in,timi'deiʃәn
intimidatory => in'timideitəri
intimism => 'intimizm
intimist => 'intimist
intinction => in'tiŋkʃәn
intitule => in'titju:l
into => 'intu:
intolerable => in'tɒlәrәbl
intolerably => in'tɒlәrәbli
intolerance => in'tɒlәrәns
intolerant => in'tɔlәrәnt
intonation => .intәu'neiʃәn
intonations => ˌɪntəˈneɪʃənz
intone => in'tәun
intoned => inˈtəund
intoner => ɪn'təʊnə
intones => inˈtəunz
intoning => inˈtəunɪŋ
intoxicant => in'tɒksikәnt
intoxicants => ɪn'tɒksɪk(ə)nt
intoxicate => in'tɒksikeit
intoxicated => in'tɔksikeitid
intoxicating => in'tɔksikeitiŋ
intoxication => in.tɒksi'keiʃәn
intoximeter => ,intɔk'simitә
intra- => 'intrә
intracellular => ,intrә'seljulә
intracranial => ,intrә'kreiniәl
intractability => in.træktә'biliti
intractable => in'træktәbl
intractableness => inˊtræktәblnis
intractably => ɪn'træktəblɪ
intraday => 'intrәdei
intradermal => ,intrә'dә:ml
intrados => in'treidɒs
intraepithelial => 'intrә,epi'θi:liәl
intramolecular => ,ɪntrəmə'lekjʊlə
intramural => .intrә'mjurәl
intramuscular => ,intrә'mʌskjulә
intranasal => ,intrә'neizəl
intranet => 'intrәnet
intransigence => in'trænsidʒәns
intransigency => inˊtrænsidʒәnsi
intransigent => in'trænsidʒәnt
intransitive => in'trænsitiv
intransitively => ɪn'trænsətɪvlɪ
intransitivity => ɪntrænsə'tɪvɪtɪ
intraocular => ,intrә'ɔkjulә
intraoperative => ,intrә'ɔpərәtiv,-reitiv
intraoral => ɪntr'əɔ:rəl
intraparty => 'intrә'pɑ:ti
intrapreneur => ɪntræprə'ni:ɜ:
intrapsychic => ,intrә'saikik
intraracial => ɪntræ'reɪʃl
intraspecific => ,intrәspi'sifik
intrastate => .intrә'steit
intrathecally => ɪnt'rɑ:θɪklɪ
intrauterine => .intrә'ju:tәrain
intravascular => ,intrә'væskjulә
intravenous => .intrә'vi:nәs
intrazonal => ,intrә'zәunl
intrench => in'trentʃ
intrenched => ɪn'trentʃ
intrenches => ɪn'trentʃ
intrenching => ɪn'trentʃ
intrepid => in'trepid
intrepidity => .intri'piditi
intrepidly => ɪntre'pɪdlɪ
intricacies => 'ɪntrɪkəsɪz
intricacy => 'intrikәsi
intricate => 'intrikit
intricately => 'ɪntrɪkətlɪ
intrigant => 'intri^әnt
intrigue => in'tri:g
intrigued => ɪnˈtri:gd
intrigues => inˈtri:ɡz
intriguing => in'tri:giŋ
intriguingly => in'tri:giŋli
intrinsic => in'trinsik
intro => 'intrәu
intro- => 'intrәj
introduce => .intrә'dju:s
introduced => ɪntrəd'ju:st
introducer => .intrә'dju:sә
introduction => .intrә'dʌkʃәn
introductions => ˌɪntrəˈdʌkʃənz
introductory => .intrә'dʌktәri
introgression => ,intrә'^reʃәn
introit => in'trɒit
introject => ,intrә'dʒekt
introjected => ,ɪntrəʊ'dʒekt
introjecting => ,ɪntrəʊ'dʒekt
introjection => .intrәu'dʒekʃәn
introjects => ,ɪntrəʊ'dʒekt
intromission => ,intrәu'miʃәn
intron => 'intrɔn
introrse => in'trɒ:s
introspect => ,intrәu'spekt
introspected => ˌintrəuˈspektid
introspecting => ˌintrəuˈspektɪŋ
introspection => .intrәu'spekʃәn
introspective => .intrәu'spektiv
introspectively => ɪntrəs'pektɪvlɪ
introspectiveness => ɪntrəs'pektɪvnəs
introversion => .intrәu'vә:ʃәn
introversive => .intrәu'vә:siv
introvert => 'intrәuvә:t
introverting => 'ɪntrəvɜːt
introverts => ˈɪntrəˌvɜ:ts
intrude => in'tru:d
intruded => in'tru:did
intruder => in'tru:dә
intruders => ɪnˈtru:dəz
intrudes => inˈtru:dz
intruding => in'tru:diŋ
intrusion => in'tru:ʒәn
intrusions => ɪnˈtru:ʒənz
intrusive => in'tru:siv
intrusively => ɪnt'ru:sɪvlɪ
intrust => in'trʌst
intubate => 'intju:beit
intubated => ˈintjubeitid
intubating => ˈintjubeitɪŋ
intuit => in'tjuit
intuited => inˈtju(:)itid
intuiting => inˈtju(:)itɪŋ
intuition => .intju:'iʃәn
intuitional => ,intju:'iʃənәl
intuitionism => ,intju:'iʃənizəm
intuitionist => ,intju:'iʃənist
intuitions => ˌɪntjuˈiʃənz
intuitive => in'tju:itiv
intuits => inˈtju(:)its
intumesce => .intju:'mes
intumesced => ˌintju(:)ˈmest
intumescence => .intju:'mesns
intumescent => .intju:'mesnt
intumescing => ˌintju(:)ˈmesɪŋ
intussusception => .intәssә'sepʃәn
intwine => in'twain
inulin => 'injulin
inunction => in'ʌŋkʃәn
inundate => 'inʌndeit
inundated => 'ɪnəndeɪtɪd
inundates => ˈɪnʌnˌdeɪts
inundating => ˈɪnʌnˌdeɪtɪŋ
inundation => .inʌn'deiʃәn
inure => i'njuә
inuring => ɪnˈjʊərɪŋ
inurn => in'ә:n
inutile => in'ju:tail
inutility => .inju:'tiliti
invade => in'veid
invaded => inˈveidid
invader => in'veidә
invades => inˈveidz
invading => inˈveidɪŋ
invaginate => in'vædʒineit
invaginated => inˈvædʒineitid
invaginating => inˈvædʒineitɪŋ
invagination => in,vædʒi'neiʃәn
invalid => in'vælid
invalidate => in'vælideit
invalidated => ɪnˈvælɪˌdeɪtid
invalidates => ɪnˈvælɪˌdeɪts
invalidating => ɪnˈvælɪˌdeɪtɪŋ
invalidation => in.væli'deiʃәn
invaliding => inˈvælidɪŋ
invalidism => 'invәli:dizm
invalidity => .invә'liditi
invalidly => ˊinvәlidli
invalids => inˈvælidz
invaluable => in'væljuәbl
invaluably => in'væljuәbli
invariability => in.vєәriә'biliti
invariable => in'vєәriәbl
invariably => in'vєәriәbli
invariance => in'veәriәns
invariant => in'vєәriәnt
invasion => in'veiʒәn
invasions => inˈveiʒənz
invasive => in'veisiv
invected => in'vektid
invective => in'vektiv
inveigh => in'vei
inveighed => inˈveid
inveighing => inˈveiŋ
inveighs => inˈveiz
inveigle => in'veiɡl. -'vi:-
inveigled => ɪnˈveɪgəld
inveigles => ɪnˈveɪgəlz
inveigling => ɪnˈveɪgəlɪŋ
invent => in'vent
invented => ɪn'ventɪd
inventing => inˈventɪŋ
invention => in'venʃәn
inventions => inˈvenʃənz
inventive => in'ventiv
inventively => in'ventivli
inventor => in'ventә
inventories => /ˈɪnvəntri/
inventors => ɪn'ventəz
inventory => 'invәntәri
inventress => in'ventris
invents => inˈvents
inveracity => .invә'ræsәti
inverness => ,invә'nes
inverse => in'vә:s
inversion => in'vә:ʃәn
inversions => ɪnˈvɜ:ʒənz
inversive => in'vә:siv
invert => in'vә:t
invertase => in'vә:teis
invertebrate => in'vә:tәbrit
invertebrates => ɪn'vɜ:təbreɪts
inverted => in'vә:tid
inverted snobbery => inˈvə:tid ˈsnɔbəri:
inverter => in'vә:tә
invertible => in'vә:tibl
inverts => inˈvə:ts
invest => in'vest
investable => in'vestәbl
investigable => in'vesti^әbl
investigate => in'vestigeit
investigated => inˈvestiɡeitid
investigates => inˈvestiɡeits
investigation => in.vesti'geiʃәn
investigations => ɪnvestɪ'ɡeɪʃnz
investigative => in'vestigeitiv
investigator => in'vestigeitә
investigators => ɪn'vestɪɡeɪtəz
investigatory => in'vesti^eitәri
investiture => in'vestitʃә
investitures => ɪnˈvestəˌtʃʊəz
investment => in'vestmәnt
investor => in'vestә
investors => ɪn'vestəz
invests => inˈvests
inveteracy => in'vetәrәsi
inveterate => in'vetәrit
inveterately => ɪn'vetərətlɪ
inviability => ɪnvɪə'bɪlɪtɪ
inviable => in'vaiәbl
invidious => in'vidiәs
invidiously => ɪn'vɪdɪəslɪ
invidiousness => ɪn'vɪdɪəsnəs
invigilate => in'vidʒileit
invigilated => inˈvidʒileitid
invigilates => inˈvidʒileits
invigilating => ɪn'vɪdʒɪleɪtɪŋ
invigilation => ɪnˌvɪdʒɪ'leɪʃn
invigilator => in'vidʒileitә(r)
invigorate => in'vigәreit
invigorated => ɪnˈvɪgəˌreɪtid
invigorates => ɪnˈvɪgəˌreɪts
invigorating => in'vigәreitiŋ
invigoration => in.vigә'reiʃәn
invigorator => in'vigәreitә
invincibility => in.vinsә'biliti
invincible => in'vinsәbl
invincibly => in'vinsәbli
inviolability => in.vaiәlә'biliti
inviolable => in'vaiәlәbl
inviolably => in'vaiәlәbli
inviolacy => in'vaiәlәsi
inviolate => in'vaiәlit
inviolately => ɪn'vaɪələtlɪ
inviscid => in'visid
invisibility => in.vizә'biliti
invisible => in'vizәbl
invisibly => in'vizәbli
invitation => .invi'teiʃәn
invitational => ,invi'teiʃənәl
invitations => ˌɪnviˈteiʃənz
invitatory => in'vaitәtәri
invite => in'vait
invitee => .invai'ti:
invites => inˈvaits
inviting => in'vaitiŋ
invitingly => ɪn'vaɪtɪŋlɪ
invocation => .invәu'keiʃәn
invocations => ˌɪnvəˈkeɪʃənz
invocatory => in'vɒkәtәri
invoice => 'invɒis
invoicing => 'invɔisiŋ
invoke => in'vәuk
invokes => ɪnˈvəʊks
involatile => in'vɔlәtail
involucre => 'invәlu:kә
involuntarily => in'vɒlәntәrili
involuntariness => in'vɔlәntәrinis
involuntary => in'vɒlәntәri
involute => 'invәlu:t
involuted => 'invәlju:tid
involution => .invә'lu:ʃәn
involve => in'vɒlv
involved => in'vɔlvd
involvement => in'vɔlvmәnt
involvements => ɪnˈvɔlvmənts
invulnerability => in.vʌlnәrә'biliti
invulnerable => in'vʌlnәrәbl
invulnerably => in'vʌlnərəbl
inwale => 'in,weil
inward => 'inwәd
inward investment => ˈinwəd inˈvestmənt
inward-looking => 'ɪnwədl'ʊkɪŋ
inwardly => 'inwәdli
inwardness => 'inwәdnis
inwards => 'inwәdz
inwrap => in'ræp
inwreathe => in'ri:ð
inwrought => .in'rɒ:t
inyanga => ɪn'jɑ:ŋə
IO => 'aiәu
iod- => 'ɪəd
iodate => 'aiәudeit
iodide => 'aiәdaid
iodinate => 'aiәdineit
iodinated => aɪədɪ'neɪtɪd
iodine => 'aiәdi:n
iodism => 'aiәdizm
iodize => 'aiәdaiz
iodo- => ɪə'dəʊ
iodoform => ai'ɒdәfɒ:m
iodometry => ,aiә'dɔmitri
iodophor => ai'ɔdәfɔ:(r),-'әjdә-
ion => 'aiәn
ion exchange => ˈaɪən iksˈtʃeindʒ
Ionia => ai'әunjә
Ionian => ai'әunjәn
ionic => ai'ɒnik
ionise => 'aiәnaiz
ionised => 'aiənaiz
ionising => 'aiənaiz
ionizable => 'aɪənaɪzəbl
ionization => .aiәnai'zeiʃәn
ionize => 'aiәnaiz
ionized => 'ɑɪəˌnɑɪz
ionizing => 'aɪənaɪzɪŋ
ionomer => 'aiәnәmә
ionopause => ai'ɔnә,pɔ:z
ionophore => ai'ɔnәfɔ:
ionosphere => ai'ɒnә.sfiә
ionospheric => ai,ɔnə'sferik
iontophoresis => ai,ɔntәfә'ri:sis
iota => ai'әutә
IOU => 'aiәu'ju:
Iowa => 'aiәwә
Iowan => 'aiəwən; 'aiəuən
ipecacuanha => .ipikækju'ænә
Iphigenia => i.fidʒi'naiә
Ipoh => 'i:pәj
ipomoea => ,ipә'mi:ә, ,aipә'mi:ә
ippon => i:'pɔn
iproniazid => ,aiprәj'naiәzid
ipsative => 'ɪpsətɪv
ipse dixit => 'ipsi 'diksit
ipsilateral => ,ipsi'lætәrәl
ipsissima verba => ip'sisimә 'vә:bә
ipso facto => 'ipsәu 'fæktәu
Ipswich => 'ipswitʃ
Iquitos => i'ki:tәjs
ira => 'aiәrә
irade => i'rɑ:de
Iran => i'rɑ:n
Irangate => i'rɑ:nɡeit
Iranian => i'reiniәn
Iraq => i'rɑ:k
Iraqi => i'rɑ:ki
irascibility => i.ræsә'biliti
irascible => i'ræsәbl
irascibly => iˊræsibli
irate => 'aireit
irateness => ai'reit; 'aireit
ire => aiә
ireful => 'aiәful
Ireland => 'aiәlәnd
Irene => ai'ri:n
irenic => ai'renik
irenical => ai'renikәl
irenicon => ai'renikәn
irenics => ai'reniks, ai'ri:niks
Irgun => ir'^jn
Irian => ,iәri'ɑ:n
iridaceous => .airi'deiʃәs
iridectomy => ,iri'dektәmi, ,aiәri-
iridescence => .iri'desәns
iridescent => .iri'desәnt
iridium => ai'ridiәm
iridologist => ,iri'dɔlədʒist
iridology => ,iri'dɔlәdʒi,,aiəri'd-
iris => 'airis
irised => 'aiәrist
irises => ˈaɪərɪsiz
Irish => 'airiʃ
Irishman => 'airiʃmәn
irishmen => 'aiəriʃmən
Irishwoman => 'airiʃwumәn
iritis => aiә'raitis
irk => ә:k
irked => ɜ:kt
irking => ɜ:kɪŋ
irks => ɜ:ks
irksome => 'ә:ksәm
irksomely => ˊәːksәmli
irksomeness => ˊәːksәmnis
Irkutsk => ә:'kutsk, iә'kutsk
iron => 'aiәn
iron man => ˈaiən mæn
iron-grey => ˈaiən ɡrei
iron-on => 'aiən'ɔn
ironbark => ˊaiәnbaːk
ironclad => 'aiәnclæd
ironed => ˈaiənd
ironer => 'aiәnә
ironic => aiә'rɔnik
ironical => ai'rɒnikl
ironies => ˈaiərəniz
ironing => 'aiәniŋ
ironist => 'airәnist
ironize => 'aiәrәnaiz
ironmaster => 'aiәnmɑ:stә(r)
ironmonger => 'aiәnmʌŋ^ә(r)
ironmongery => 'aiәn,mʌŋ^əri
ironside => 'aiәnsaid
ironstone => 'aiәnstwәjn
ironware => 'aiәnwєә
ironwood => 'aiәnwud
ironwork => 'aiәnwә:k
irony => 'aiәrәni
Iroquoian => ,irә'kwɔiәn
Iroquois => 'irәkwɔi, 'irәkwɔiz
irradiance => i'reidiәns
irradiant => i'reidiәnt
irradiate => i'reidieit
irradiated => ɪˈreɪdi:ˌeɪtid
irradiates => ɪˈreɪdi:ˌeɪts
irradiating => ɪˈreɪdi:ˌeɪtɪŋ
irradiation => i.reidi'eiʃәn
irradiations => ɪ,reɪdɪ'eɪʃ(ə)n
irrational => i'ræʃәnәl
irrationalism => i'ræʃәnәlizm
irrationality => i.ræʃә'næliti
irrationalize => i'ræʃәnәlaiz
irrationally => ɪ'ræʃnəlɪ
Irrawaddy => ,irә'wɔdi
irreclaimable => .iri'kleimәbl
irreconcilability => i'rekənsailə'biləti
irreconcilable => i'rekәnsailәbl
irrecoverable => .iri'kʌvәrәbl
irrecusable => .iri'kju:zәbl
irredeemability => 'iri,di:mə'biləti
irredeemable => .iri'di:mәbl
irredeemably => ˌiri'diːməbl
irreducible => .iri'dju:sәbl
irreducibly => -əbli
irreflexive => ,iri'fleksiv
irreformable => ,iri'fɔ:mәbl
irrefragable => i'refrәgәbl
irrefutability => i.refjutә'biliti
irrefutable => i'refjutәbl
irregardless => ,iri'^ɑ:dlis
irregular => i'regjulә
irregularities => ɪreɡjʊ'lærɪtɪz
irregularity => i.regju'læriti
irregulars => ɪ'regju:ləz
irrelative => i'relәtiv
irrelevance => i'relivәns
irrelevances => iˈreləvənsiz
irrelevancies => ɪˈreləvənsi:z
irrelevant => i'relәvәnt
irrelevantly => ɪ'reləvəntlɪ
irreligion => .iri'lidʒәn
irreligious => .iri'lidʒәs
irreligiously => ɪrɪ'lɪdʒəslɪ
irremediable => .iri'mi:diәbl
irremediably => ,iri'mi:diəbli
irremissible => .iri'misәbl
irremovability => ˊirimuːvәˊbiliti
irremovable => iri'mu:vәbl
irreparability => i.repәrә'biliti
irreparable => i'repәrәbl
irreparably => i'repәrәbli
irreplaceable => .iri'pleisәbl
irrepressibility => 'iri.presә'biliti
irrepressible => .iri'presәbl
irrepressibly => ˌɪrɪ'presəblɪ
irreproachability => ˊiriproutʃәˊbiliti
irreproachable => .iri'prәutʃәbl
irreproachably => .iri'prәutʃәbli
irreproducible => i,ri:prә'dju:sәbl
irresistibility => 'iri.zistә'biliti
irresistible => .iri'zistәbl
irresistibly => ˌɪrɪ'zɪstəblɪ
irresoluble => i'rezәljubl
irresolute => i'rezәlu:t
irresolutely => ɪ'rezəlu:tlɪ
irresoluteness => ɪrezə'lu:tnəs
irresolution => 'i.rezә'lu:ʃәn
irresolvable => .iri'zɒlvәbl
irrespective => .iri'spektiv
irrespectively => ˌɪrɪs'pektɪvlɪ
irresponsibility => 'iri,spɔnsә'bilәti
irresponsible => .iri'spɔnsәbl
irresponsibly => ,iri'spɔnsəbli
irresponsive => .iris'pɒnsiv
irretrievability => ɪrɪtri:və'bɪlɪtɪ
irretrievable => .iri'tri:vәbl
irretrievably => ˌɪrɪ'tri:vəblɪ
irreverence => i'revәrәns
irreverent => i'revәrәnt
irreverential => ,irevә'renʃәl
irreverently => ɪ'revərəntlɪ
irreversibility => 'iri.vә:sә'biliti
irreversible => ,iri'vә:sәbl,-sib-
irreversibly => ˌɪrɪ'vɜ:səblɪ
irrevocability => i.revәkә'biliti
irrevocable => i'revәkәbl
irrevocably => ɪ'revəkəblɪ
irrigable => 'irigәbl
irrigate => 'irigeit
irrigated => ˈɪrɪˌgeɪtid
irrigates => ˈɪrɪˌgeɪts
irrigating => ˈɪrɪˌgeɪtɪŋ
irrigation => .iri'geiʃәn
irrigator => 'irigeitә
irritability => .iritә'biliti
irritable => 'iritәbl
irritancy => 'iritәnsi
irritant => 'iritәnt
irritants => ˈɪrɪtənts
irritate => 'iriteit
irritated => 'iriteitid
irritates => ˈiriteits
irritating => 'iriteitiŋ
irritatingly => 'ɪrɪteɪtɪŋlɪ
irritation => .iri'teiʃәn
irritations => ˌɪrɪˈteɪʃənz
irritative => 'iriteitiv
irrotational => .irәu'teiʃәnәl
irrupt => i'rʌpt
irrupted => iˈrʌptid
irrupting => iˈrʌptɪŋ
irruption => i'rʌpʃ(ә)n
irruptive => i'rʌptiv
Irvin => 'ә:vin
irving => 'ә:viŋ
irwin => 'ә:win
is => iz
isaac => 'aizәk
isabel => 'izәbel
isabella => ,izә'belә
isagogic => ,aisә'^ɔdʒik
isagogics => ,aɪsə'ɡɒdʒɪks
Isaiah => ai'zeiә
isallobar => ai'sælәbɑ:
isallobaric => ɪ'zæləʊbærɪk
isatin => 'aisәtin
ischial => 'iskiәl
ischium => 'iskiәm
ISE => 'i:sәi
isentropic => aisen'trɔpik
Isherwood => 'iʃә(:)wud
Ishmael => 'iʃmeil
Ishmaelite => 'iʃmiәlait
Isidore => 'izidɔ:(r)
isinglass => 'aiziŋglæs
isis => 'aisis
Iskenderun => is'kendәru:n
Islam => 'izlɑ:m
ISLAMABAD => is'lɑ:mәbɑ:d
Islamic => iz'læmik
Islamism => 'izlәmizm
Islamist => iz'lɑ:mist
Islamization => ,izləmai'zeiʃən
Islamize => 'islәmaiz, 'iz-
island => 'ailәnd
islander => 'ailәndә
islanders => ˈaɪləndəz
isle => ail
isles => ailz
islet => 'ailit
islets => ˈailits
ism => 'izm
isn't => 'iznt
ISO => 'aisәj
iso- => 'aisәj
isoagglutination => ,aisәuә^lu:ti'neiʃәn
isobar => 'aisәbɑ:
isobaric => .aisәu'bærik
Isobel => 'izәbel
isobutane => ,aisәu'bju:tein
isobutyl => ,aisәu'bju:til
isobutylene => ,aɪsəʊ'bjuːtaɪliːn; ,aɪsəʊ'bjuːtɪliːn
isocheim => 'aisәu,kaim
isochromatic => aisәukrәu'mætik
isochron => 'aisәjkrɔn
isochronous => ai'sɔkrәnәs
isoclinal => .aisәu'klainәl
isoclinic => ,aisәj'klinik
Isocrates => ai'sɔkrti:z
isocratic => .aisә'krætik
isocyanide => ,aisә'saiәnaid
isodiametric => ,aisә,daiә'metrik
isodynamic => .aisәudʒai'næmik
isoelectric => ,aisәui'lektrik
isoelectronic => ,aisәuilek'trɔnik
isoenzyme => ,aisәu'en,zaim
isoflavone => ,aisәu'fleivәun
isogamete => ,aisәu'^æmit,-^ә'mi:t
isogamous => ai'sɔ^әmәs
isogamy => ai'sɔ^әmi
isogenic => ,aisәj'dʒenik
isogeotherm => ,aisәu'dʒiәθә:m
isogeothermal => 'aisəu,dʒi:ə'θə:mə
isogloss => 'aisәu^lɔs
isogonic => .aisәu'gɒnik
isohel => 'aisәuhel
isohyet => ,aisә'haiәt
isokinetic => ,aisәuki'netik
isolable => 'aisәlәbl
isolatable => 'aisәleitәbl
isolate => 'aisәleit
isolated => 'aisәleitid
isolating => 'aisәleitiŋ
isolation => .aisә'leiʃәn
isolationism => aisә'leiʃәniz(ә)m
isolationist => .aisә'leiʃәnist
isolator => 'aisәleitә
Isolde => i'zɔldə
isolette => ,aisә'let
isoleucine => ,aisәu'lu:si:n, -sin
isoline => 'aisәulain
isomer => 'aisәmә
isomerase => ai'sɔmәreis
isomeric => .aisә'merik
isomerism => ai'sɒmәrizm
isomerize => ai'sɔmәraiz
isomerizes => ai'sɔməraiz
isomerizing => ai'sɔməraiz
isomerous => ai'sɔmәrәs
isomers => 'aɪsəʊməz
isometric => ,aisәu'metrik
isometrics => ,aisәu'metriks
isometry => ai'sɔmitri
isomorphic => .aisәu'mɒ:fik
isomorphism => .aisәu'mɒ:fizm
isomorphous => .aisәu'mɒ:fәs
isoniazid => ,aisәu'naiәzid
isonitrile => ,aisә'naitril
isooctane => aisәu'ɒktein
isopach => 'aisә,pæk
isophote => 'aisә,fәut
isopleth => 'aisәupleθ
isopod => 'aisәpɒd
isoprenaline => 'aisәu'prenәli(:)n
isoprene => 'aisәupri:n
isopropanol => ,aisə'prəupənɔl
isopropyl => ,aisәu'prәupil
isoproterenol => ,aisәuprә'terәnɔl
Isoptera => aɪsɒp'tərə
isopycnic => ,aisә'piknik
isosceles => ai'sɒsili:z
isosceles triangle => aɪˌsɒsəli:z ˈtraɪæŋgl
isoseismal => .aisә'saizәml
isosmotic => ,aisɔs'mɔtik
isospin => 'aisә,spin
isostasy => ai'sɒstәsi
isostatic => .aisәu'stætik
isotactic => ,aisәu'tæktik
isothere => 'aisәu,θiә
isotherm => 'aisәuθә:m
isothermal => .aisәu'θә:ml
isothermally => aɪsəʊ'θɜ:məlɪ
isotherms => aɪsə'θɜ:mz
isotonic => .aisәu'tɒnik
isotope => 'aisәutәup
isotopic => ,aisәu'tɔpik
isotopy => ai'sɔtәpi
isotropic => .aisәu'trɒpik
isotropy => ai'sɔtrәpi
isozyme => 'aisәuzaim
Israel => 'izreil
Israeli => iz'reili
israelis => ɪzˈreɪli:z
israelite => 'izriәlait
israelites => 'izriəlaits
Issa => i:'sɑ:
issuable => 'iʃjuәbl
issuance => 'iʃjuәns
issuant => 'iʃu(:)әnt
issue => 'isju
issueless => 'isju:lis
issuer => 'iʃjuә
issuers => 'ɪsju:əz
issuing => ˈisju:ɪŋ
Istanbul => .istæn'bu:l
isthmian => 'isθmiәn
isthmus => 'ismәs
istle => 'istli
it => it
it'll => 'itl
it's => its
italia => i'tɑ:ljɑ:
Italian => i'tæljәn
Italianate => i'tæljәneit
Italianism => i'tæljәnizm
Italianist => i'tæljәnist
Italianize => i'tæljәnaiz
italians => ɪˈtæljənz
italic => i'tælik
italicise => i'tælisaiz
italicised => i'tælisaiz
italicization => i,tælisai'zeiʃən; -si'z-
italicize => i'tælisaiz
italicized => iˈtælisaizd
italicizing => iˈtælisaizɪŋ
italics => i'tæliks
Italiot => i'tæliәt
Italy => 'itәli
itch => itʃ
itched => itʃt
itches => itʃiz
itching => 'itʃiŋ
itchy => 'itʃi
item => 'aitәm
itemization => ,aitәmai'zeiʃən;-mi'z-
itemize => 'aitәmaiz
itemized => ˈaɪtəˌmaɪzd
itemizes => ˈaɪtəˌmaɪziz
itemizing => ˈaɪtəˌmaɪzɪŋ
iterate => 'itәreit
iterated => ˈɪtəˌreɪtid
iterating => ɪtə'reɪtɪŋ
iteration => .itә'reiʃәn
iterative => 'itәrәtiv
ithaca => 'iθәkә
ithyphallic => ,θi'fælik
itineracy => i'tinәrәsi
itinerancy => i'tinәrәnsi, ai't-
itinerant => i'tinәrәnt
itinerants => aɪˈtɪnərənts
itineraries => aɪˈtɪnəˌreri:z
itinerary => ai'tinәrәri
itinerate => i'tinәreit
itinerated => iˈtinəreitid
itinerating => iˈtinəreitɪŋ
itineration => i.tinә'reiʃәn
its => its
itself => it'self
itsy-bitsy => 'itsi'bitsi
ivan => 'aivәn
Ives => aivz
ivied => 'aivid
ivies => ˈaiviz
Ivor => 'aivə; 'i:və
Ivorian => 'aivәriәn
ivories => ˈaivəriz
ivorine => 'aivәrain
ivory => 'aivәri
Ivory Coast => 'aivәri'kәust
ivory nut => ˈaivəri nʌt
ivy => 'aivi
ixia => 'iksiә
Ixion => 'ik'saiәn
ixtle => 'ikstli, 'is-
izard => 'izәd
Izmir => iz'miә
Izvestia => iz'vestjә
izzat => 'izәt