V => vi:
V-chip => 'vi:tʃip
V-neck => 'vi:nek
VA => vɑ:
Vaal => vɑ:l
Vaasa => 'vɑ:sɑ:
vac => væk
vacancy => 'veikәnsi
vacant => 'veikәnt
vacant lot => ˈveikənt lɔt
vacate => vә'keit
vacated => ˈveɪˌkeɪtid
vacates => ˈveɪˌkeɪts
vacating => ˈveɪˌkeɪtɪŋ
vacation => vei'keiʃәn
vacationer => vә'keiʃənә(r),vei-
vacationist => vә'keiʃənist,vei-
vacationland => vә'keiʃənlænd,vei-
vacations => vəˈkeiʃənz
vaccinate => 'væksineit
vaccinated => ˈvæksəˌneɪtid
vaccinates => ˈvæksəˌneɪts
vaccinating => ˈvæksəˌneɪtɪŋ
vaccination => .væksi'neiʃәn
vaccinations => ˌvæksəˈneɪʃənz
vaccinator => 'væksineitә(r)
vaccine => 'væksi:n
vaccines => vækˈsi:nz
vaccinia => væk'siniә
vaccinology => væksɪ'nɒlədʒɪ
vacillate => 'væsileit
vacillated => ˈvæsəˌleɪtid
vacillates => ˈvæsəˌleɪts
vacillating => 'væsileitiŋ
vacillation => .væsi'leiʃәn
vacs => 'væks
vacua => 'vækjuә
vacuity => væ'kju:iti
vacuolar => ,vækjj'әjlә(r),'vækjjәlә(r)
vacuolation => ,vækjjә'leiʃən
vacuole => 'vækjuәul
vacuous => 'vækjuәs
vacuousness => 'vækjʊəsnəs
vacuum => ''vækjuәm
vacuum-clean => 'vækjʊəm'klɪn
vacuum-packed => 'vækjjәm pækt
vade mecum => .veidi'mi:kәm
vadose => 'veidәus
Vaduz => fɑ:'du:ts
vagabond => 'vægәbɒnd
vagabondage => 'væ^әbɔndidʒ
vagabonds => ˈvægəˌbɔndz
vagal => 'vei^l
vagaries => ˈveɪgəriz
vagarious => vә'gєәriәs
vagary => 'veigәri
vagi => 'veidʒai
vagina => vә'dʒainә
vaginal => vә'dʒainl
vaginismus => ,vædʒi'nizmәs
vaginitis => ,vædʒi'naitis
vaginosis => vædʒɪ'nəʊsɪs
vagotomy => vei'^ɔtәmi
vagrancy => 'veigrәnsi
vagrant => 'veigrәnt
vagrants => 'veɪɡrənts
vague => veig
vaguely => 'veigli
vagueness => 'veignis
vagus => 'veigәs
vail => veil
vain => vein
vainer => veinə
vainglorious => .vein'glɒ:riәs
vainglory => vein'^lɔ:ri
vainly => 'veinli
vair => vєә
Vaishnava => 'vaiʃnәvә
Vaisya => 'vaiʃiә
Val => væl
valance => 'vælәns
valances => ˈvælənsiz
Valdez => væl'di:z
vale => veil
valediction => .væli'dikʃәn
valedictions => ,vælɪ'dɪkʃən
valedictorian => ,vælidik'tɔ:riәn
valedictory => .væli'diktәri
valence => 'veilәns
valences => 'veɪl(ə)ns
Valencia => vә'lenʃiә
Valenciennes => ,vælәnsi'en
valencies => ˈveilənsiz
valency => 'veilәnsi
Valentina => ,vælәn'ti:nә
valentine => 'vælәntain
valentines => ˈvælənˌtaɪnz
VALENTINO => ,vælən'ti:nəu
valerate => 'vælәreit
valerian => vә'liәriәn
valerie => 'vælәri
vales => veɪlz
valet => 'vælit
valeta => vә'li:tә
valeted => ˈvælɪtid
valeting => ˈvælɪtɪŋ
valets => ˈvælɪts
valetudinarian => 'væli,tju:di'neәriәn
valetudinarianism => ,vælitju;di'neәriәnizәm
valetudinary => ,væli'tju:dinәri
valgus => 'væl^әs
Valhalla => væ'hælә
valiant => 'væljәnt
valiantly => 'vælɪəntlɪ
valid => 'vælid
validate => 'vælideit
validates => ˈvælɪˌdeɪts
validation => .væli'deiʃәn
validity => vә'liditi
validly => 'vælidli
valine => 'væli:n
valise => vә'li:z, -li:s
valises => vəˈli:siz
valium => 'væliәm
valkyrie => væl'kiәri
Valladolid => ,bɑ:ljɑ:dɔ:'li:ð
vallecula => vә'lekjulә
valley => 'væli
valleys => ˈvæliz
vallum => 'vælәm
Valois => 'vælwɑ:
Valona => vɑ:'lɔ:nɑ:
valonia => vә'lәuniә
valor => 'vælә
valorization => .vælәrai'zeiʃәn
valorize => 'vælәraiz
valorous => 'vælәrәs
valour => 'vælә
Valpolicella => ,vælpɔli'selә
valproate => væl'prәjeit
valse => vɑ:ls
valuable => 'væljuәbl
valuably => 'væljuәbli
valuate => 'væljueit
valuated => ˈvæljueitid
valuating => ˈvæljueitɪŋ
valuation => .vælju'eiʃәn
valuations => ˌvælju:ˈeɪʃənz
valuator => 'væljueit
value => 'vælju:
value-laden => ˈvælju ˈleɪdn
valued => 'vælju:d
valueless => 'væljulis
valuer => 'vælju:ә
valuers => ˈvæljuəz
valuing => ˈvæljuɪŋ
valuta => vә'lu:tә
valvate => 'vælveit
valve => vælv
valvular => 'vælvjulә
valvulitis => ,vælvju'laitis
vambrace => 'væmbreis
vamoose => vә'mu:s
vamp => væmp
vamping => væmp
vampire => 'væmpaiә
vampires => ˈvæmˌpaɪəz
vampiric => 'væmprɪk
vampirism => 'væmpaiәrizәm
vamplate => 'væmpleit
vamps => væmps
van => væn
Van Allen => væn'ælәn
vanadate => 'vænәdeit
vanadinite => vә'nædinait
vanadium => vә'neidiәm
vanaspati => vә'nʌspәti
Vanbrugh => 'vænbrә
vance => væns
vancomycin => ,vænkә'maisin
vancouver => væn'ku:vә
vandal => 'vændәl
vandalise => 'vændәlaiz
vandalised => 'vændəlaiz
vandalism => 'vændәlizm
vandalize => 'vændәlaiz
vandalized => ˈvændlˌaɪzd
vandalizes => ˈvændlˌaɪziz
vandalizing => ˈvændlˌaɪzɪŋ
vandals => ˈvændəlz
Vandyke => væn'daik
vane => vein
vaned => 'vænd
vanessa => vә'nesә
vang => væŋ
vanguard => 'vængɑ:d
vanilla => vә'nilә
vanillin => vә'nilin, 'vænilin
vanish => 'væniʃ
vanishes => ˈvæniʃiz
vanishing => 'væniʃiŋ
vanishing cream => 'væniʃiŋ
vanishingly => 'væniʃiŋli
vanities => ˈvænitiz
vanity => 'væniti
vanity unit => ˈvæniti ˈju:nit
vanload => væn'ləʊd
vanquish => 'væŋkwiʃ
vanquishes => ˈvæŋkwɪʃiz
vanquishing => ˈvæŋkwɪʃɪŋ
vantage => 'væntidʒ
vantage point => ˈvɑ:ntɪdʒ pɔɪnt
Vanuatu => ,vɑ:nu:'ɑ:tu:
Vanuatuan => ,vɑ:nu:'ɑ:tu:әn
vapid => 'væpid
vapidity => væ'piditi
vapidly => 'væpɪdlɪ
vapor => 'veipә
vaporetto => vɑ:pәu'retәu
vaporise => 'veipәraiz
vaporization => .veipәrai'zeiʃәn
vaporize => 'veipәraiz
vaporized => ˈveɪpəˌraɪzd
vaporizer => 'veipәraizә
vaporizes => ˈveɪpəˌraɪziz
vaporizing => ˈveɪpəˌraɪzɪŋ
vaporous => 'veipәrәs
vapors => ˈveipəz
vapour => 'veipә
vapour density => ˈveipə ˈdensiti
vapour lock => ˈveipə lɔk
vapour trail => ˈveipə treil
vapouring => 'veipәriŋ
vapours => 'veɪpəz
vapoury => 'veipәri
vaquero => væ'keәrәu
VAR => vɑ:(r)
varactor => vә'ræktә
Varanasi => vә'rɑ:nәsi:
Varangian => vә'rændʒiәn
varec => 'værek
Varese => vɑ:'rese
variability => .vєәriә'biliti
variable => 'vєәriәbl
variable star => ˈvɛəriəbl stɑ:
variableness => 'vεəriəbl
variably => 'vєәriәbli
variance => 'vєәriәns
variances => 'veərɪənsɪz
variant => 'vєәriәnt
variants => ˈveəri:ənts
variate => 'veәriit
variation => .vєәri'eiʃәn
variational => .vєәri'eiʃәnl
variceal => ,væri'si:әl
varicella => væri'selә
varices => 'værisi:z
varicocele => 'værikәsi:l
varicoloured => 'veәrikʌlәd
varicose => 'værikәus
varicosed => 'værɪkəʊs; -kəs; -z
varicosity => .væri'kɒsiti
varied => 'vєәrid
variedly => ˊvєәridli
variegated => 'vєәrigeitid
variegation => .vєәri'geiʃәn
varietal => vә'raiәtl
varieties => vəˈraiətiz
varietist => vә'raiәtist
variety => vә'raiәti
varifocal => 'veәrifәukәl
variform => 'vєәrifɒ:m
varimax => 'veәrimæks
variola => vә'raiәlә
variolar => vә'raiәlә(r)
varioloid => 'vєәriәlɒid
variolous => vә'raiәlәs
variometer => ,veәri'ɔmitә
variorum => .vєәri'ɒ:rәm
various => 'vєәriәs
variously => 'veәriәsli
variousness => ˊvєәriәsnis
varistor => vә'ristә(r)
varix => 'vєәriks
varlet => 'vɑ:lit
varletry => 'vɑ:litri
Varley => 'vɑ:li
varmint => 'vɑ:mint
varmints => 'vɑːmɪnt
Varna => 'vɑ:nә
varnish => 'vɑ:niʃ
varnished => 'vɑ:rnɪʃt
varnishes => ˈvɑ:niʃiz
varnishing => 'vɑ:nɪʃɪŋ
varsity => 'vɑ:sәti
Varuna => 'vә:runә, 'vær-, 'vɑ:r-
varus => 'vєәrәs
varve => vɑ:v
vary => 'vєәri
vas => væs
vas deferens => ˌvæs ˈdefərenz
Vasa => 'veisә,-zә
vasal => 'veisәl
vascular => 'væskjulә
vascular cylinder => ˈvæskjələ ˈsilində
vascular plant => ˈvæskjələ plɑ:nt
vascularity => .væskju'læriti
vasculature => 'væskjjlәtʃә(r),-tʃjә(r)
vasculitic => ,væskjj'litik
vasculitis => ,væskjj'laitis
vasculum => 'væskjulәm
vase => veis
vasectomies => væˈsektəmiz
vasectomize => væ'sektә,maiz
vasectomy => væ'sektәmi
vaseline => 'væsili:n
vaso- => 'veizәj,-sәj,'væsәj,'væzәj
vasoactive => ,veizәj'æktiv,,veis-,,væs-,væz-
vasoconstriction => ,væsәukәn'strikʃәn
vasoconstrictive => ,veizәjkәn'striktiv,,veis-,,væs-,,væz-
vasoconstrictor => .væsәukәn'striktә
vasodilation => ,veizәjdai'leiʃәn,-di-,,veis-,,væs-,,væz-
vasodilator => .væsәudai'leitә
vasomotor => .væsә'mәutә
vasopressin => ,væsәu'presin, ,veiz-
vasopressor => ,væsәu'presә, ,veiz-
vasospasm => 'væsәu,spæzm,'veiz-
vasospastic => ,væsәu'spæstik
vasovagal => ,væsәu'vei^l, 'veiz-
vassal => 'væsәl
vassalage => 'væsәlidʒ
vassals => 'væsəlz
vast => vɑ:st
vaster => vɑ:stə
vastly => 'vɑ:stli
vastness => 'vɑ:stnis
VAT => væt
vatic => 'vætik
Vatican => 'vætikәn
vaticinal => vә'tisinl
vaticinate => vә'tisineit
vaticinated => væˈtisineitid
vaticinates => væˈtisineits
vaticinating => væˈtisineitɪŋ
vaticination => .vætisi'neiʃәn
vats => 'væts
vatted => 'vætted
vatting => 'vætiŋ
vatu => 'veɪtu:
Vaud => vәj
vaudeville => 'vәudәvil
vaudevillian => .vәudә'viljәn
vaughan => vɔ:n
Vaughn => vɔ:n
vault => vɒ:lt
vaulted => 'vɒ:ltid
vaulting => 'vɒ:ltiŋ
vaults => vɔ:lts
vaunt => vɒ:nt
vaunting => 'vɒ:ntiŋ
vauntingly => 'vɒntɪŋlɪ
vaunts => vɔ:nts
Vaux => vɔ:z, vɔks
vavasory => 'vævәsәri
vavasour => 'vævә,sjә(r)
veal => vi:l
Veblen => 'veblәn
vector => 'vektә
vectorization => ,vektәri'zeiʃәn
veda => 'veidә, 'vi:dә
Vedanta => vi'dɑ:ntә, -'dæn-
vedette => vi'det
Vedic => 'veidik, 'vi:dik
vee => vi:
veejay => 'vi:dʒei
veena => 'vi:nә
veep => vi:p
veer => viә
veered => vɪəd
veering => 'viәriŋ
veers => vɪəz
veery => 'viәri
veg => vedʒ
vega => 'vi:^ә
vegan => 'vegәn
vegans => ˈvedʒənz
Vegeburger => 'vedʒibə:ɡə
vegetable => 'vedʒәtәbl
vegetable ivory => ˈvedʒitəbl ˈaivəri
vegetable marrow => ˈvedʒitəbl ˈmærəʊ
vegetable sponge => ˈvedʒitəbl spʌndʒ
vegetal => 'vedʒitl
vegetarian => .vedʒi'tєәriәn
vegetarianism => vedʒi'teәriәniz(ә)m
vegetarians => ˌvedʒɪˈteəri:ənz
vegetate => 'vedʒiteit
vegetated => ˈvedʒəteɪtɪd
vegetates => ˈvedʒɪˌteɪts
vegetating => ˈvedʒɪˌteɪtɪŋ
vegetation => .vedʒi'teiʃәn
vegetational => vedʒɪ'teɪʃənl
vegetative => 'vedʒitәtiv
vegetative cell => ˈvedʒitətiv sel
vegetatively => ˊvedʒitәtivli
veggie => 'vedʒi
veggie burger => ˈvedʒi: ˈbə:ɡə
vehemence => 'vi:imәns
vehement => 'vi:imәnt
vehemently => 'vi:əməntlɪ
vehicle => 'vi:ikl
vehicular => vi'hikjulә
veil => veil
veiled => veild
veiling => 'veiliŋ
veils => veilz
vein => vein
veined => 'veind
veining => 'veiniŋ
veinless => 'veɪnles
veinlet => 'veinlit
veinous => 'veinәs
veinstone => 'veinstәjn
veiny => 'veini
vela => 'vi:lә
velamen => vә'leimәn
velar => 'vi:lә
velarium => vi'lєәriәm
velarization => ,vi:lәrai'zeiʃәn;-ri'z-
velarize => 'vi:lәraiz
veld => velt
veldt => velt
veleta => 'veletə
veliger => 'vi:lidʒә(r)
velleity => ve'li:әti
vellum => 'velәm
velocimeter => ,velә'simitә
velocipede => vi'lɒsipi:d
velociraptor => vəˌlɒsɪˈræptə(r)
velocities => viˈlɔsitiz
velocity => vi'lɒsәti
velodrome => 'vi:lәdrәum
velour => vә'luә
velours => vә'luәz
velum => 'vi:lәm
velvet => 'velvit
velvet ant => ˈvelvit ænt
velvet bean => ˈvelvit bi:n
velveteen => .velvi'ti:n
velvetleaf => 'velvi,li:f
velvety => 'velviti
vena => 'vi:nә
vena cava => 'vi:nә'keivә
venal => 'vi:nl
venality => vi:'nælәti
venally => 'vi:nəlɪ
venation => vi:'neiʃәn
vend => vend
Venda => 'vendə
vendace => 'vendeis
vended => vendid
vender => 'vendә
vendetta => ven'detә
vendettas => venˈdetəz
vendible => 'vendibl
vending machine => 'vendiŋ
vendor => 'vendә
vendors => 'vendəz
vends => vendz
vendue => ven'dju:
veneer => vә'niә
veneered => vɪ'nɪə
veneering => vә'niәriŋ
veneers => vəˈnɪəz
venepuncture => 'veni ,pʌŋktʃә, 'vi:ni-
venerability => .venәrә'biliti
venerable => 'venәrәbl
venerably => 'venərəblɪ
venerate => 'venәreit
venerated => ˈvenəˌreɪtid
venerates => ˈvenəˌreɪts
venerating => ˈvenəˌreɪtɪŋ
veneration => .venә'reiʃәn
venerator => 'venәreitә
venereal => vә'niәriәl
venereologist => vənɪə'rɪələdʒɪst
venereology => vi, niәri'ɔlәdʒi
venery => 'venәri
venesection => .veni'sekʃәn
Venetian => vә'ni:ʃәn
venetian blind => vəˌni:ʃn ˈblaɪnd
Veneto => 'venetɔ:
Venezuela => ,vene'zweilә
venezuelan => ,venә'zweilәŋ
vengeance => 'vendʒәns
vengeful => 'vendʒful
vengefully => 'vendʒfəlɪ
venial => 'vi:njәl
veniality => .vi:ni'æliti
Venice => 'venis
venipuncture => 'veni.pʌŋktʃә
venison => 'venizn
Venite => vi'naiti
Venn => ven
vennel => 'venәl
venogram => 'venә,^ræm
venography => vi'nɔ^rәfi
venom => 'venәm
venomed => 'venəmd
venomous => 'venәmәs
venomously => 'venəməslɪ
venomousness => ˊvenәmәsnis
venosity => vi'nɔsiti
venous => 'vi:nәs
vent => vent
vented => ventid
venter => 'ventә
ventiduct => 'ventidʌkt
ventifact => 'ventifækt
ventil => 'ventil
ventilate => 'ventileit
ventilated => 'ventileitid
ventilates => ˈventileits
ventilation => .venti'leiʃәn
ventilator => 'ventileitә
ventilators => 'ventɪleɪtəz
ventilatory => 'ventilәtәri
venting => 'ventiŋ
ventless => 'ventlis
ventral => 'ventrәl
ventral fin => ˈventrəl fin
ventricle => 'ventrikl
ventricles => 'ventrɪklz
ventricular => ven'trikjulә
ventriculography => ven,trikju'lɔ^rәfi
ventriloquial => .ventri'lәukwiәl
ventriloquism => ven'trilәkwiz(ә)m
ventriloquist => ven'trilәkwist
ventriloquists => venˈtriləkwists
ventriloquize => ven'trilәkwaiz
ventriloquy => ven'trilәkwi
ventrolateral => ,ventrәj'lætәrәl
ventromedial => ,ventrәj'mi:diәl
Ventura => ven'turə
venture => 'ventʃә
venture capital => ˈventʃə ˈkæpitl
venture capitalist => ˈventʃə ˈkæpɪtlɪst
ventured => ˈventʃəd
ventures => ˈventʃəz
venturesome => 'ventʃәsәm
venturesomely => ˊventʃәsәmli
venturesomeness => ˊventʃәsәmnis
venturi => ven'tuәri
venturing => ˈventʃərɪŋ
venturous => 'ventʃәrәs
venue => 'venju:
venule => 'venju:l
Venus => 'vi:nәs
Venusian => vi:n'ju:siәn
VER => vә:
vera => 'viәrә
veracious => vә'reiʃәs
veraciously => və'reɪʃəslɪ
veraciousness => və'reɪʃəsnəs
veracity => vә'ræsiti
veranda => vә'rændә
verandaed => və'rændəd
verandah => vә'rændә
verandas => vəˈrændəz
verapamil => ,virә'pæmil,,verә-
veratrine => 'veәrә,tri:n, -trin
veratrum => vә'reitrәm
verb => vә:b
verbal => 'vә:bl
verbalization => .vә:bәlai'zeiʃәn
verbalize => 'vә:bәlaiz
verbalized => ˈvə:bəlaizd
verbalizes => ˈvə:bəlaiziz
verbalizing => ˈvə:bəlaizɪŋ
verbatim => vә:'beitim
verbena => vә:'bi:nә
verbiage => 'vә:biidʒ
verbose => vә'bәus
verbosely => 'vɜ:bəʊslɪ
verbosity => vә:'bɒsiti
verboten => feә'bәutәn
verdancy => 'vә:dnsi
verdant => 'vә:dnt
verdantly => 'vədntlɪ
Verdi => 'vɛədi:
verdict => 'vә:dikt
verdicts => 'vɜ:dɪkts
verdigris => 'vә:digri:s
verdin => 'vә:din
verditer => 'vә:ditә
Verdun => 'vεdʌn
verdure => 'vә:dʒә
verdurous => 'vә:dʒәrәs
verge => vә:dʒ
vergence => 'vә:dʒәns
verger => 'vә:dʒә
verges => və:dʒz
verglas => veә'^lɑ:
veridical => ve'ridikl
veridicality => və,ridi'kæliti
veridically => veˊridikәli
veriest => 'veriist
verifiable => 'verifaiәbl
verification => .verifi'keiʃәn
verified => 'verifaid
verifier => 'verifaiә
verifies => ˈverifaiz
verify => 'verifai
verily => 'verili
verisimilar => .veri'similә
verisimilitude => .verisi'militju:d
verism => 'viәrizm
verismo => vei'ri:zmәu
veritable => 'veritәbl
veritably => 'veritәbli
verities => ˈveritiz
verity => 'veriti
verjuice => 'vә:dʒu:s
Verkhneudinsk => ,vjerknәu:'djintsk
verkrampte => fә'kræmptә, -'krɑ:-
verligte => fә'liktә
vermeil => 'vә:meil
vermian => 'vә:miәn
vermicelli => .vә:mi'seli
vermicide => 'vә:misaid
vermicular => vә:'mikjulә
vermiculate => vә:'mikjulit
vermiculated => -leitid
vermiculation => vә:.mikju'leiʃәn
vermiculite => vә:'mikjulait
vermiform => 'vә:mifɒ:m
vermifuge => 'vә:mifju:dʒ
vermilion => vә'miljәn
vermin => 'vә:min
verminate => 'vә:mineit
verminous => 'vә:minәs
vermis => 'vә:mis
Vermont => vә:'mɔnt
vermouth => 'vә:mәθ, 'vә:mu:θ
vermouths => ˈvə:məθs
vern => vә:n
vernacular => vә'nækjulә
vernacularism => və'nækjʊlərɪzəm
vernaculars => vəˈnækjələz
vernal => 'vә:nl
vernalization => .vә:nәlai'zeiʃәn
vernalize => 'vә:nәlaiz
vernally => ˊvәːnli
vernation => vә:'neiʃәn
Verne => və:n
verneuk => veә'nu:k
vernier => 'vә:niә
vernier engine => ˈvə:niə ˈendʒin
vernissage => ,veәni'sɑ:ʒ
vernix => 'vә:niks
vernon => 'vә:nәn
verona => vi'rәunә
Veronese => verә'ni:z
Veronica => vә'rɔnikә
verruca => ve'ru:kә
verrucas => veˈru:kəz
verrucose => ve'ru:kәus
verrucous => 'verukәs
vers => vә:s
vers libre => veә'li:br
Versailles => veә'sai, vә:'seilz
versal => 'vә:sәl
versant => 'vә:sәnt
versatile => 'vә:sәtail
versatility => .vә:sә'tiliti
verse => vә:s
versed => vә:st
verses => və:siz
verset => 'vә:set, 'vә:sit
versicle => 'vә:sikl
versicolor => 'vә:sikʌlә
versification => .vә:sifi'keiʃәn
versified => ˈvə:sifaid
versifier => 'vә:sifaiә
versify => 'vә:sifai
versifying => ˈvə:sifaiŋ
version => 'vә:ʒәn
verso => 'vә:sәu
verst => 'vә:st
versus => 'vә:sәs
vert => vә:t
vertebra => 'vә:tibrә
vertebral => 'vә:tibrәl
vertebral column => ˈvə:tibrəl ˈkɔləm
vertebrate => 'vә:tibreit
vertex => 'vә:teks
vertical => 'vә:tikl
vertical fin => ˈvə:tikəl fin
vertical stabilizer => ˈvə:tikəl ˈsteɪbəˌlaɪzə
verticality => .vә:ti'kæliti
vertically => 'vetikli
vertices => 'vә:tisi:z
vertiginous => vә:'tidʒinәs
vertigo => 'vә:tigәu
vertisol => 'vә:tisɔl
vertu => vә:'tu:
vervain => 'vә:vein
verve => vә:v
vervet => 'vә:vit
very => 'veri
vesica piscis => 'pisis, 'pai-, 'piskis, 'pi:sis
vesical => 'vesikәl
vesicant => 'vesikәnt
vesicate => 'vesikeit
vesicatory => 'vesikәtәri
vesicle => 'vesikl
vesicular => vi'sikjulә
vesiculate => vi'sikjulit
vesiculation => vi,sikju'leiʃәn
Vespasian => ves'peiʒiən
Vesper => 'vespә
vespers => 'vespәz
vespertilionid => ,vespә'tiliәnid
vespertine => 'vespәtain
vessel => 'vesl
vest => vest
vesta => 'vestә
vestal => 'vestl
vestal virgin => 'vest(ә)l
vested => 'vestid
vested interest => 'vestid
vestee => ves'ti:
vestiary => 'vestieәri
vestibular => ves'ti:bjulә
vestibule => 'vestibju:l
vestibules => ˈvestəˌbju:lz
vestibulocochlear nerve => veˌstɪbjələʊˈkɔkli:ə, -ˈkəʊkli:-
vestige => 'vestidʒ
vestiges => 'vestɪdʒɪz
vestigial => ves'tidʒiәl
vesting => 'vestiŋ
vestiture => 'vestitʃә
vestment => 'vestmәnt
vestry => 'vestri
vestryman => 'vestrimәn
vesture => 'vestʃә
vestured => ˈvestʃəd
vestures => ˈvestʃəz
vesturing => ˈvestʃərɪŋ
vesuvianite => vi'su:viәnait
vesuvius => vi'su:vjәs
vet => vet
vetch => vetʃ
vetches => vetʃiz
vetchling => 'vetʃliŋ
veteran => 'vetәrәn
veteran car => ˈvetərən kɑ:
veterans => 'vetərənz
veterinarian => .vetәri'nєәriәn
veterinarians => vetə'rɪneərɪənz
veterinary => 'vetәrinәri
vetiver => 'veitivә
veto => 'vi:tәu
vetoed => 'viːtəʊ
vetoes => 'vi:təʊz
vetoing => 'viːtəʊ
vets => vets
vetted => vetid
vex => veks
vexation => vek'seiʃәn
vexations => vekˈseɪʃənz
vexatious => vek'seiʃәs
vexatiously => vek'seɪʃəslɪ
vexed => vekst
vexedly => 'veksidli
vexes => veksiz
vexillologist => ,veksi'lɔlədʒist
vexillology => ,veksi'lɔlәdʒi
vexillum => vek'silәm
via => vaiә
Via Crucis => 'kru:sis
via media => 'mi:diә, 'mediɑ:
viability => .vaiә'biliti
viable => 'vaiәbl
viaduct => 'vaiәdʌkt
viaducts => ˈvaɪəˌdʌkts
vial => 'vaiәl
vials => ˈvaɪəlz
viand => 'vaiәnd
viands => 'vaɪəndz
viaticum => vai'ætikәm
vibe => vaɪb
vibes => vaibz
vibist => 'vaibist
vibracular => vai'brækjulә
vibraculum => vai'brækjulәm
vibrancy => 'vaibrәnsi
vibrant => 'vaibrәnt
vibraphone => 'vaibrәfәun
vibraphonist => 'vaibrәfәunist
vibrate => 'vaibreit
vibrates => vaiˈbreits
vibratile => 'vaibrәtail
vibrating => vai'breitiŋ
vibration => vai'breiʃәn
vibrational => vai'breiʃәnl
vibrations => 'vaɪbreɪʃənz
vibrato => vi'brɑ:tәu
vibrator => 'vaibreitә
vibrators => vaiˈbreitəz
vibratory => 'vaibrәtәri
vibratos => viˈbrɑ:təuz
vibrissae => vaɪbrɪ'si:
vibrotactile => ,vaibrә'tæktail
viburnum => vai'bә:nәm
vic => vik
vicar => 'vikә
vicar apostolic => ˈvikə ˌæpəsˈtɔlik
vicarage => 'vikәridʒ
vicarages => ˈvikəridʒz
vicarial => vai'kєәriәl
vicariance => vai'keәriәns
vicariate => vai'keәriit, -eit
vicarious => vai'kєәriәs
Vicars => 'vɪkə
vicarship => 'vikәʃip
vice => vais
vice- => vais-
vice-admiral => 'vais'ædmərəl
vice-chancellor => 'vais'tʃɑ:nsәlә
vice-presidency => 'vaɪsi:pr'ezɪdənsɪ
vice-president => 'vais'prezidәnt
vicegerency => .vais'dʒerәnsi
vicegerent => .vais'dʒerәnt
Vicenza => vi:'tʃendzɑ:, -tsɑ:
viceregal => .vais'ri:gl
vicereine => 'vais'rein
viceroy => 'vaisrɒi
viceroyalty => .vais'rɒiәti
viceroyship => 'vaɪsrɔɪʃɪp
vichy => 'vi:ʃi:
vichyssoise => .viʃi'swɑ:z
vicinage => 'visinidʒ
vicinal => 'visnl
vicinity => vi'siniti
vicious => 'viʃәs
vicissitude => vi'sisitju:d
vicissitudinous => vi.sisi'tju:dinәs
vicky => 'viki
vicomte => vi'kt
vicomtesse => vi'ktes
victim => 'viktim
victim support => ˈviktim səˈpɔ:t
victimisation => ,viktimai'zeiʃən
victimization => .viktimai'zeiʃәn
victimize => 'viktimaiz
victimized => ˈvɪktəˌmaɪzd
victimizes => ˈvɪktəˌmaɪziz
victimizing => ˈvɪktəˌmaɪzɪŋ
victimless => 'viktimlis
victimology => ,vikti'mɔlәdʒi
victor => 'viktә
victoria => vik'tɔ:riә
Victorian => vik'tɔ:riәn
victoriana => vik,tɔ:ri'einə
Victorianism => vik'tɔ:riәnizәm
victories => ˈviktəriz
victorine => 'viktәri:n
victorious => vik'tɔ:riәs
victoriously => vɪk'tɔ:rɪəslɪ
victoriousness => vikˊtɒːriәsnis
victors => ˈviktəz
victory => 'viktәri
victrix => 'viktriks
victual => 'vitәl
victualled => ˈvitld
victualling => 'vɪtəlɪŋ
vicuna => vi'ku:njә
vid => vid
vide => 'vaidi(:)
videlicet => vi'di:liset, vai-
video => 'vidiәu
video arcade => ˈvidiəu ɑ:ˈkeɪd
video camera => ˈvidiəu ˈkæmərə
video card => ˈvidiəu kɑ:d
video diary => ˈvidiəu ˈdaiəri
video jockey => ˈvidiəu ˈdʒɔki
video nasty => ˈvidiəu ˈnɑ:sti
videocam => 'vidiəu,kæm
videocassette => ˌvɪdɪəʊkə'set
videocassettes => vɪdɪəʊkə'set
videoconference => ,vidiәj'kɔnfәrәns
videoconferencing => ˈvɪdiəʊkɒnfərənsɪŋ
videodisc => 'vidiәjdisk
videofit => vɪ'defɪt
videographer => ,vidi'ɔ^rәfә(r)
videography => ,vidi'ɔ^rәfi
videophile => 'vidiәjfail
videophone => 'vidiәu'fәun
videotaped => ˈvɪdi:əʊˌteɪpt
videotaping => ˈvɪdi:əʊˌteɪpɪŋ
videotelephony => ˌvɪdiəʊtəˈlefəni
videotex => 'vidiәuteks
vidicon => 'vidikɔn
vie => vai
Vienna => vi'enә
viennese => viә'ni:z
Vientiane => vjen'tjæn
viet => vjet
Vietcong => 'vjet'kɔŋ
vietminh => 'viәt'min, 'vjet-
Vietnam => .vjet'næm
vietnamese => 'vjetnә'mi:z
Vietnamization => ,vjetnәmai'zeiʃәn, ,vi:әt-, vi,et-; -mi'z-
view => vju:
view halloo => vju: həˈlu:
viewable => 'vju:әbl
viewdata => 'vju:'deitә
viewed => vju:d
viewer => 'vju:ә
viewers => 'vju:əz
viewership => 'vju:әʃip
viewfinder => 'vju:.faindә
viewfinders => ˈvju:ˌfaɪndəz
viewgraph => vju:gra:f
viewing => 'vju:iŋ
viewless => 'vju:lis
viewpoint => 'vju:pɒint
viewpoints => v'ju:pɔɪnts
viewport => 'vju:pɒ:t
vig => vi^
viga => 'vi:^ә
vigesimal => vai'dʒesimәl
vigil => 'vidʒil
vigilance => 'vidʒilәns
vigilant => 'vidʒilәnt
vigilante => .vidʒi'lænti
vigilantes => ˌvidʒiˈlæntiz
vigilantism => ,vidʒi'læntizәm
vigilantly => 'vɪdʒɪləntlɪ
vigils => ˈvɪdʒəlz
vigneron => vi:njә'rɔ:n
vignette => vi'njet
vignettes => viˈnjets
vigor => 'vigә
vigorish => 'vi^әriʃ
vigorous => 'vigәrәs
vigorousness => ˊvigәrәsnis
vigour => 'vigә
vihara => vi'hɑ:rә
vihuela => bi:'weilɑ:
Vijayawada => ,vi:dʒәjә'wɑ:dә
viking => 'vaikiŋ
vikings => ˈvaikiŋz
Vila => 'vi:lә
vilayet => vi'lɑ:jet
vile => vail
vilely => 'vaɪllɪ
vileness => vaɪlnəs
viler => vailə
vilification => .vilifi'keiʃәn
vilified => ˈvɪləˌfaɪd
vilifier => 'vilifaiә(r)
vilifies => ˈvɪləˌfaɪz
vilify => 'vilifai
vilifying => ˈvɪləˌfaɪŋ
vill => vil
villa => 'vilә
Villafranchian => 'vilә'fr æŋkiәn
village => 'vilidʒ
villager => 'vilidʒә
villages => 'vɪlɪdʒəz
villagization => ,vilidʒi'zeiʃәn
villain => 'vilәn
villainies => ˈvɪləni:z
villainous => 'vilәnәs
villainously => ˊvilәnәsli
villains => ˈvilənz
villainy => 'vilәni
villanella => 'vilә'nelә
villanelle => ,vilә'nel
villas => ˈvɪləz
villein => 'vilein
villeinage => 'vilinidʒ
villi => 'vilai
villous => 'vilәs
villus => 'vilәs
Vilnius => 'vilnijs, -әs
vim => vim
vin => væŋ
vin ordinaire => 'vænɔ:di'neә
vina => 'vi:nә
vinaceous => vai'neiʃәs
vinaigrette => ,vinei'^ret
vinblastine => vin'blɑ:sti:n
vinca => 'viŋkә
vince => vins
Vincent => 'vinsәnt
vinci => 'vintʃi(:)
vincible => 'vinsibl
vincristine => viŋ'kristi:n, -tin
vinculum => 'viŋkjulәm
vindaloo => 'vindәlu:
vindicable => 'vindikәbl
vindicate => 'vindikeit
vindicated => ˈvɪndɪˌkeɪtid
vindicates => ˈvɪndɪˌkeɪts
vindicating => ˈvɪndɪˌkeɪtɪŋ
vindication => .vindi'keiʃәn
vindicative => 'vindikәtiv
vindicator => 'vindikeitә
vindicatory => 'vindikәtәri
vindictive => vin'diktiv
vindictively => vɪn'dɪktɪvlɪ
vindictiveness => vɪn'dɪktɪvnɪs
vine => vain
vinegar => 'vinigә
vinegary => 'vinigәri
vinery => 'vainәri
vineyard => 'vinjәd
vineyards => ˈvɪnjədz
vingt-et-un => 'væntei'ә:ŋ
viniculture => 'vini,kʌltʃә
vinifera => vai'nifәrә
vinification => ,vinifi'keiʃәn
vinify => 'vinifai
Vinny => 'vini
vino => 'vi:nәu
vinosity => vai'nɒsiti
vinous => 'vainәs
vint => vint
vintage => 'vintidʒ
vintage car => ˈvɪntɪdʒ kɑ:
vintager => 'vintidʒә
vintages => ˈvɪntɪdʒz
vintner => 'vintnә
vintners => ˈvɪntnəz
viny => 'vaini
vinyl => 'vainil
viol => 'vaiәl
viola => 'vaiәlә
viola da braccio => vi'əulədə'brætʃiəu
viola da gamba => vɪˈəʊlə dɑ: ˈɡæmbə
violable => 'vaiәlәbl
violaceous => vaiә'leiʃәs
violas => vɪˈəʊləz
violate => 'vaiәleit
violated => ˈvaiəleitid
violates => ˈvaiəleits
violating => ˈvaiəleitɪŋ
violation => .vaiә'leiʃәn
violations => vaɪə'leɪʃnz
violative => 'vaiәleitiv, -lә-
violator => 'vaiәleitә
violators => 'vaiəleitə
violence => 'vaiәlәns
violent => 'vaiәlәnt
violent storm => ˈvaiələnt stɔ:m
violently => 'vaiәlәntli
violet => 'vaiәlit
violets => ˈvaiəlits
Violetta => ,vaiә'letә
violin => .vaiә'lin
violinist => .vaiә'linist
violinists => vaɪəˈlɪnɪsts
violins => vaɪə'lɪnz
violist => 'vaiәlist
violoncellist => ,vaiәlәn'tʃelist, ,viә-
violoncello => .vaiәlәn'tʃelәu
violone => viә'lәunei
viper => 'vaipә
viperfish => 'vaipәfiʃ
viperine => 'vaipәrin
viperish => 'vaipәriʃ
viperous => 'vaipәrәs
vipers => ˈvaɪpəz
vir => vә:
viraemia => vai'ri:miә
virago => vi'rɑ:gәu
viragos => viˈrɑ:ɡəuz
viral => 'vairәl
viral marketing => ˈvaɪərəl ˈmɑ:kɪtɪŋ
virelay => 'virәlei
virement => 'virimәnt
viremia => vai'ri:miә
vireo => 'viriәu
vires => 'vaiәri:z
virescence => vi'resns
virescent => vi'resnt
virga => 'vә:^ә
virgate => 'vә:git
virgil => 'vә:dʒil
virgin => 'vә:dʒin
virginal => 'vә:dʒinl
virginals => vɜ:dʒɪnzl
Virginia => vә'dʒinjә
virginity => vә'dʒiniti
virgins => ˈvə:dʒinz
virgo => 'vә:ɡәu
virgo intacta => ˌvɜ:gəʊ ɪnˈtæktə
Virgoan => 'və:ɡəu,æn
virgule => 'vә:gju:l
viridescence => .viri'desns
viridescent => .viri'densnt
viridian => vi'ridiәn
virile => 'virail
virilism => 'virilizm
virility => vi'riliti
virilocal => ,viri'lәjkәl
virino => vaɪ'ri:nəʊ
virion => 'vaiәriɔn
virions => 'vɪrɪɒn
viroid => 'vaiәrɔid
virologist => vai'rɒlәdʒist
virology => vai'rɒlәdʒi
viropexis => ,vaiәrә'peksis
virtu => vә:'tu:
virtual => 'vә:tʃuәl
virtual reality => ˈvə:tjuəl riˈæliti
virtualize => 'vɜ:tʃʊəlaɪz
virtually => 'vә:tʃuәli
virtue => 'vә:tju:
virtues => 'vɜ:tʃu:z
virtuosic => ,vɜːtʃʊ'ɒsɪk
virtuosity => .vә:tju'ɒsiti
virtuoso => .vә:tju'әuzәu
virtuous => 'vә:tʃuәs
virtuous circle => ˈvɜ:tʃu:əs ˈsə:kl
virtuousness => ˊvәːtjuәsnis
virulence => 'virjulәns
virulent => 'virjulәnt
virulently => ˈvɪrʊləntlɪ
virus => 'vaiәrәs
visa => 'vi:zә
visage => 'vizidʒ
visaged => 'vɪzɪdʒd
visages => ˈvɪzɪdʒz
Visakhapatnam => vi,sɑ:kә'pʌtnәm
visas => ˈvi:zəz
Visby => 'vizbi, 'vi:sbju:
viscacha => vis'kɑ:tʃә
viscera => 'visәrә
visceral => 'visәrәl
viscerotropic => ,visәrә'trɔpik
viscid => 'visid
viscidity => vi'siditi
viscoelastic => ,viskәui'læstik
viscoelasticity => 'viskәu,ilæs'tisiti
viscometer => vis'kɔmitә
viscometric => vɪs'kʌmetrɪk
viscometry => vis'kɔmitri
viscose => 'viskәus
viscosimeter => ,viskә'simitә
viscosity => vis'kɒsiti
viscount => 'vaikaunt
viscountcy => 'vaikajntsi
viscountess => 'vaikajntis
viscounts => ˈvaɪˌkaʊnts
viscounty => 'vaikajnti
viscous => 'viskәs
viscousness => ˊviskәsnis
viscus => 'viskәs
vise => vais
vishnu => 'viʃnu:
visibility => .vizi'biliti
visible => 'vizәbl
visibleness => ˊvizәblnis
visibles => 'vizәblz
visibly => 'vizәbli
visigoth => 'vizi^ɔθ, -^ɔ:θ
vision => 'viʒәn
vision mixer => ˈviʒən ˈmɪksə
vision quest => ˈviʒən kwest
visional => 'viʒәnәl
visionaries => ˈvɪʒəˌneri:z
visionary => 'viʒәnәri
visioning => 'vɪʒ(ə)n
visionless => 'viʒәnlis
visit => 'vizit
visitable => 'vɪzɪtəbl
visitant => 'vizitәnt
visitation => .vizi'teiʃәn
visitations => ˌviziˈteiʃənz
visitatorial => .vizitә'tɒ:riәl
visiting => 'vizitiŋ
visiting fireman => ˈvizitiŋ ˈfaiəmən
visitor => 'vizitә
visitorial => ,vizi'tɔ:riәl
Visking => 'viskiŋ
visna => 'viznә
visor => 'vaizә
visored => 'vaɪzə
visors => ˈvaizəz
vista => 'vistә
vistas => ˈvɪstəz
Vistula => 'vistjjlә, -tʃj-
visual => 'viʒuәl
visual agnosia => ˈviʒuəl æɡˈnəusiə
visualisation => ,vizjjәlai'zeiʃәn, -ʒjә-; - li'z-
visualise => 'vizjjәlaiz, -ʒjә-
visualization => .viʒuәlai'zeiʃәn
visualize => 'viʒuәlaiz
visualizes => ˈviʒuəlaiziz
visualizing => 'vizjuәlaiziŋ
visually => 'vizjjәli
visually impaired => ˈvɪʒʊəlɪ ɪmˈpeəd
visuals => 'vɪʒʊəlz
visuomotor => ,vizjjәj'mәjtә(r), -ʒjәj-
visuospatial => ,vizjjәj'speiʃәl
vita => 'vaitә; 'wi:tɑ:
vitae => 'vi:tai
vital => 'vaitl
vitalism => 'vaitlizm
vitalist => 'vaitlist
vitalistic => .vaitә'listik
vitality => vai'tæliti
vitalization => .vaitәlai'zeiʃәn
vitalize => 'vaitlaiz
vitalized => ˈvaitəlaizd
vitalizes => ˈvaitəlaiziz
vitalizing => ˈvaitəlaizɪŋ
vitally => 'vaitli
vitals => 'vaitlz
vitamin => 'vaitәmin
vitaminize => 'vitәminaiz, 'vaitә-
vitamins => vaɪtəmɪnz
Vitebsk => 'vi:'tepsk
vitellin => vi'telin
vitelline => vi'telin
vitelline membrane => viˈtelin ˈmemˌbreɪn
vitellogenin => vi,telәj'dʒenin, vai-
vitellus => vi'telәs
vitiate => 'viʃieit
vitiated => ˈvɪʃi:ˌeɪtid
vitiates => ˈvɪʃi:ˌeɪts
vitiating => ˈvɪʃi:ˌeɪtɪŋ
vitiation => .viʃi'eiʃәn
vitiator => 'viʃieitә
viticultural => .viti'kʌltʃәrәl
viticulture => 'vitikʌltʃә, 'vait-
viticulturist => .viti'kʌltʃәrist
vitiligo => .viti'laigәu
vito => 'vi:tәj
Vitoria => vi'tɔ:riә, bi:'tɔ:rjɑ:
vitrectomy => vi'trektәmi
vitreous => 'vitriәs
vitreousness => 'vɪtrɪəsnəs
vitrescence => vi'tresns
vitrescent => vi'tresnt
vitrifaction => ,vitri'fækʃәn
vitrifiable => 'vitrifaiәbl
vitrification => .vitrifi'keiʃәn
vitrified => 'vɪtrɪfaɪd
vitrifies => ˈvitrifaiz
vitriform => 'vitrifɒ:m
vitrify => 'vitrifai
vitrine => vi'tri:n
vitrinite => vɪt'rɪnaɪt
vitriol => 'vitriәl
vitrioled => 'vɪtrɪəl
vitriolic => .vitri'ɒlik
vitrioling => 'vɪtrɪəl
vitriols => 'vɪtrɪəl
vitta => 'vitә
vittle => 'vitl
Vittoria => vi:t'tɔ:ri:ɑ:
Vittorio => vi'tɔ:riәj
vituperate => vi'tju:pәreit
vituperated => vaɪˈtu:pəˌreɪtid
vituperates => vaɪˈtu:pəˌreɪts
vituperating => vaɪˈtu:pəˌreɪtɪŋ
vituperation => vitju:pә'reiʃәn
vituperative => vi'tju:pәreitiv
vituperator => vi'tju:pәreitә(r), vai-
viva => 'vi:vә
viva voce => 'vaivә'vәusi
vivace => vi'vɑ:tʃi
vivacious => vi'veiʃәs
vivaciously => vaɪ'veʃəsli
vivacity => vi'væsiti
Vivaldi => vi'va:ldi:
vivarium => vai'vєәriәm
vivas => ˈvi:vəz
vivat => 'vaivæt
vive => vi:v
vivers => 'vaivәz
vives => vaivz
vivian => 'viviәn
vivianite => 'viviәnait
vivid => 'vivid
vividness => 'vɪvɪdnəs
Vivienne => 'viviən
vivification => .vivifi'keiʃәn
vivified => ˈvivifaid
vivify => 'vivifai
viviparity => .vivi'pæriti
viviparous => vai'vipәrәs
viviparously => vɪ'vɪpərəslɪ
vivisect => .vivi'sekt
vivisection => .vivi'sekʃәn
vivisectionist => .vivi'sekʃәnist
vivisectionists => ,vɪvɪ'sekʃənɪst
vivisector => .vivi'sektә
vivisects => ˈvivifaiz
vivo => 'vi:vәu
vixen => 'viksn
vixenish => 'viksniʃ
vixens => ˈvɪksənz
Viyella => vai'jelә, vi-
viz => vɪz
vizard => 'vizɑ:d, -zәd
vizier => vi'ziә, 'viziә
vizor => 'vaizә
vizsla => 'viʒlә,'vi:zlɑ:
Vlach => vlæk, vlɑ:k
Vladikavkaz => ,vlɑ:dikɑ:f'kɑ:s
Vladimir => vlɑ'dimɪr
Vladivostok => vlædi'vɔstɔk
Vltava => 'vʌltәvә, 'vәltɑ:vɑ:
vocab => 'vəʊkæb
vocable => 'vәukәbl
vocabularies => vəˈkæbjuləriz
vocabulary => vә'kæbjulәri
vocal => 'vәukl
vocalese => ,vәjkә'li:z
vocalic => vәu'kælik
vocalisation => ,vәjkәlai'zeiʃәn; - li'z-
vocalise => 'vәjkәlaiz
vocalism => 'vәukәlizm
vocalist => 'vәukәlist
vocalists => ˈvəʊkəlɪsts
vocality => vəʊ'kælɪtɪ
vocalization => .vәukәlai'zeiʃәn
vocalize => 'vәukәlaiz
vocalized => ˈvəʊkəˌlaɪzd
vocalizes => ˈvəʊkəˌlaɪziz
vocalizing => ˈvəʊkəˌlaɪzɪŋ
vocally => 'vәukli
vocals => 'vəʊkəlz
vocation => vәu'keiʃәn
vocational => vәu'keiʃәnl
vocationalism => vəʊ'keɪʃnəlɪzəm
vocationalize => vәj'keiʃәnәlaiz
vocations => vəʊˈkeɪʃənz
vocative => 'vɒkәtiv
vocatives => 'vɒkətɪvz
vociferant => vәu'sifәrәnt
vociferate => vәu'sifәreit
vociferated => vəʊˈsɪfəˌreɪtid
vociferates => vəʊˈsɪfəˌreɪts
vociferating => vəʊˈsɪfəˌreɪtɪŋ
vociferation => .vәusifә'reiʃәn
vociferous => vәu'sifәrәs
vociferously => və'sɪfərəslɪ
vocoder => 'vәu.kәudә
vodka => 'vɒdkә
vodkas => ˈvɔdkəz
vodun => vәj'du:n
voe => vәu
voetstoots => 'fjtstjts, 'vjt-
vogue => vәug
voguish => 'vәugiʃ
voice => vɒis
voiced => vɒist
voiceless => 'vɒislis
voicelessly => vɔɪs'lezslaɪ
voicemail => ˈvɔɪsmeɪl
voiceprint => 'vɒisprint
void => vɒid
voidable => 'vɒidәbl
voidance => 'vɒidәns
voided => ˈvɔidid
voile => vɒil
voir dire => ,vwɑ:'diә
Vojvodina => 'vɔivәdi:nә, -nɑ:
vol-au-vent => 'vɔlәjvɑŋ
Volans => 'vәulәns
volant => 'vәulәnt
volar => 'vәulә
volatile => 'vɒlәtail
volatility => .vɒlә'tiliti
volatilizable => vɔ'lætilaizәbl; 'vɔlәti-
volatilization => vɒ.lætilai'zeiʃәn
volatilize => 'vɒlәtilaiz
volatilized => vəˈlætilaizd
volatilizes => vəˈlætilaiziz
volatilizing => vəˈlætilaizɪŋ
volcanic => vɒl'kænik
volcanic glass => vɔlˈkænɪk ɡlɑ:s
volcanically => vɒl'kænikli
volcanicity => ,vɔlkә'nisiti
volcaniclastic => vɔl,kæni'klæstik
volcanics => vɔl'kæniks
volcanism => 'vɒlkәnizm
volcano => vɒl'keinәu
volcanologist => vɔlkә'nɔlәdʒist
volcanology => .vɒlkә'nɒlәdʒi
vole => vәul
voles => vəulz
Volga => 'vɔl^ә
Volgograd => 'vɔl^ә^rɑ:d
volition => vәu'liʃәn
volitional => vәu'liʃәnl
volitionally => və'lɪʃnəlɪ
volitive => 'vɒlitiv
volk => fɔ:lk
Volkskammer => 'fәulkskɑ:mә
volkswagen => 'fɔ:lks,vɑ:^әn
volley => 'vɒli
volleyball => 'vɒlibɒ:l
volleyed => ˈvɔlid
volleying => ˈvɔliŋ
volleys => ˈvɔliz
Vologda => 'vɔ:lɔ^dɑ:
Volos => 'vɔ:lɔ:s, 'vәjlɔs
volplane => 'vɔlplein
Volscian => 'vɔlʃәn
volt => vәult
volta => 'vɔ:ltɑ:
voltage => 'vәultidʒ
voltages => ˈvəultidʒz
voltaic => vɒl'teiik
volte => vɔlt, vәjlt, vɔ:lt
volte-face => ,vɔltә'fɑ:s
voltmeter => 'vәultmi:tә
volts => vəults
volubility => .vɒlju'biliti
voluble => 'vɒljubl
volume => 'vɒljum
volumes => 'vɒlju:mz
volumetric => vɔljj'metrik
voluminous => vә'lju:minәs
voluminously => və'lu:mɪnəslɪ
voluminousness => vәˊljuːminәsnis
volumizer => ˈvɔljumaizə
voluntaries => ˈvɔləntəriz
voluntarily => .vɒlәn'terili
voluntariness => 'vɒlәntәrinis
voluntarism => 'vɒlәntәrizm
voluntarist => 'vɒləntrɪst
voluntary => 'vɒlәntәri
voluntaryism => 'vɒlәntәriizm
volunteer => .vɒlәn'tiә
volunteered => ˌvɔlənˈtiəd
volunteering => ˌvɔlənˈtiərɪŋ
volunteerism => ˌvɒlən'tɪərɪzəm
volunteers => ˌvɔlənˈtiəz
voluptuary => vә'lʌptʃuәri
voluptuous => vә'lʌptjәs
voluptuously => və'lʌptʃʊəslɪ
voluptuousness => və'lʌptʃʊəsnɪs
volute => vә'lju:t
volution => vә'lju:ʃәn
volva => 'vɔlvә
volvo => 'vɔlvәj
volvox => 'vɔlvɔks
volvulus => 'vɔlvjjlәs
vomer => 'vәjmә(r)
vomit => 'vɒmit
vomitorium => ,vɔmi'tɔ:riәm
vomitory => 'vɒmitәri
vomitous => 'vɔmitәs
vomits => ˈvɔmits
vomitus => 'vɔmitәs
Von => vɔn;fɔn;fәn
voodoo => 'vu:du:
voodooed => ˈvu:du:d
voodooing => ˈvu:du:ɪŋ
voodooism => 'vu:du:izәm
voodooist => -ist
voodoos => ˈvu:du:z
voracious => vә'reiʃәs
voraciously => və'reɪʃəslɪ
voraciousness => və'reɪʃəsnəs
voracity => vә'ræsiti
Voronezh => vɔ'rɔ:neʃ
Voroshilovgrad => vɔrɔ'ʃi:lɔf^rɑ:t
vortex => 'vɒ:teks
vortical => 'vɒ:tikl
vortically => ˊvɒːtikәli
vorticella => .vɒ:ti'selә
vortices => 'vɔ:tisi:z
vorticity => vɒ:'tisiti
vorticose => 'vɔ:tikәjs
vorticular => vɔ:'tikjjlә(r)
votaries => ˈvəʊtəri:z
votarist => 'vәjtәrist
votary => 'vәutәri
vote => vәut
vote of confidence => vəut ɔv ˈkɔnfidəns
vote of no confidence => vəut ɔv nəu ˈkɔnfidəns
voter => 'vәutә
voting => 'vәutiŋ
votive => 'vәutiv
vouch => vautʃ
vouched => vaʊtʃt
voucher => 'vautʃә
vouchers => ˈvaʊtʃəz
vouches => vaʊtʃiz
vouchsafe => vautʃ'seif
vouchsafed => vaʊtʃˈseɪft
vouchsafes => vaʊtʃˈseɪfs
vouchsafing => vaʊtʃˈseɪfɪŋ
voussoir => 'vu:swɑ:
vow => vau
vowel => 'vauәl
vowel point => ˈvaʊəl pɔint
vowelize => 'vaʊɪlaɪz
vowelizes => 'vaʊəlaɪz
vowelless => 'vajәllis
vowels => ˈvaʊəlz
vox => vɔks
vox humana => 'vɔkshju:'mɑ:nə
vox populi => vɔks 'pɔpjjlai
voyage => 'vɒiidʒ
voyageable => 'vɒiidʒәbl
voyaged => ˈvɔiidʒd
voyager => 'vɒiidʒә
voyages => ˈvɔiidʒz
voyaging => ˈvɔiidʒɪŋ
voyeuristic => ,vwɑ:jә'ristik
voyeurs => vɔɪˈjɜ:z
vroom => vru:m, vrjm, vә'ru:m, -'rjm
vroomed => vru:md
vrooming => vru:mɪŋ
vrooms => vru:mz
vrouw => vraj, fraj
vug => vʌ^, vj^
vugular => 'vʌ^jjlә(r)
vulcanism => 'vʌlkәnizәm
vulcanite => 'vʌlkәnait
vulcanization => vʌlkәnai'zeiʃәn
vulcanize => 'vʌlkәnaiz
vulcanizes => ˈvʌlkənaiziz
vulcanizing => 'vʌlkənaɪzɪŋ
vulcanology => ˌvʌlkəˈnɒlədʒi
vulgar => 'vʌlgә
vulgar fraction => ˈvʌlɡə ˈfrækʃən
vulgarian => vʌl'gєәriәn
vulgarism => 'vʌlgәrizm
vulgarity => vʌl'gæriti
vulgarization => .vʌlgәrai'zeiʃәn
vulgarize => 'vʌlgәraiz
vulgarized => ˈvʌlɡəraizd
vulgarizes => ˈvʌlɡəraiziz
vulgarizing => ˈvʌlɡəraizɪŋ
vulgarly => 'vʌlgɚli
vulgate => 'vʌl^eit
vulnerabilities => vʌlnərə'bɪlɪtɪz
vulnerability => .vʌlnәrә'biliti
vulnerable => 'vʌlnәrәbl
vulnerably => 'vʌlnərəbli
vulnerary => 'vʌlnәrәri
Vulpecula => vʌl'pekjulә
vulpine => 'vʌlpain
vulture => 'vʌltʃә
vultures => ˈvʌltʃəz
vulturine => 'vʌltʃurin
vulturish => 'vʌltʃjriʃ, -tʃә-
vulturous => 'vʌltʃjrәs, -tʃә-
vulva => 'vʌlvә
vulvas => ˈvʌlvəz
vulvitis => vʌl'vaitis
vuvuzela => vuːvəˈzɛlə
Vyatka => 'vjɑ:tkɑ:
vying => 'vaiiŋ