double act => ˈdʌbl ækt
double bar => ˈdʌbl bɑ:
double bass => ˈdʌbl beis
double bassoon => ˈdʌbl bəˈsu:n
double bed => ˈdʌbl bed
double bill => ˈdʌbl bil
double bind => ˈdʌbl baind
double bluff => ˈdʌbl blʌf
double bogey => ˈdʌbl ˈbəuɡi
double boiler => ˈdʌbl ˈbɔɪlə
double cream => ˈdʌbl kri:m
double dagger => ˈdʌbl ˈdæɡə
double date => ˈdʌbl deit
double eagle => ˈdʌbl ˈi:ɡl
double fault => ˈdʌbl fɔ:lt
double feature => ˈdʌbl ˈfi:tʃə
double glazing => ˈdʌbl ˈɡleiziŋ
double negative => ˈdʌbl ˈneɡətiv
double play => ˈdʌbl pleɪ
double reed => ˈdʌbl ri:d
double standard => ˈdʌbl ˈstændəd
double star => ˈdʌbl stɑ:
double take => ˈdʌbl teik
double top => ˈdʌbl tɔp
double whammy => ˈdʌbl ˈwæmi
double-acting => 'dʌbl'æktiŋ
double-blind => ˈdʌbl blaind
double-checked => ˈdʌbl tʃekt
double-checking => ˈdʌbl ˈtʃekiŋ
double-decker => 'dʌbl'dekә(r)
double-digit => 'dʌbl'didʒit
double-dip => 'dʌbld'ɪp
double-dipper => 'dʌbl'dip
double-dyed => 'dʌbl'daid
double-ender => 'dʌbl'endər
double-entry => 'dʌbl'entrɪ
double-faced => 'dʌbl'feist
double-headed => 'dʌbl'hedid
double-header => 'dʌbl'hedә(r)
double-hung => 'dʌblh'ʌŋ
double-lock => ,dʌbl'lɔk
double-park => ˈdʌbəlˈpɑ:k
double-parking => ˈdʌbl ˈpɑ:kɪŋ
double-quick => 'dʌbl'kwik
double-sided => 'dʌbl'saidid
double-team => 'dʌbl'ti:m
double-time => 'dʌbltaim
doubleness => dʌbl'nes
doubler => 'dʌblә
doublespeak => 'dʌblspi:k
doublet => 'dʌblit
doublethink => 'dʌblθiŋk
doubleton => 'dʌbltәn
doubletree => 'dʌbltri:
doublets => 'dʌblɪts
doubling => 'dʌbliŋ
doubloon => dʌ'blu:n
doublure => du:'bljuә
doubly => 'dʌbli
doubt => daut
doubted => dautid
doubter => 'dautә
doubtful => 'dautful
doubtfulness => 'daʊtfʊlnɪs
doubtless => 'dautlis
doubtlessly => 'daʊtlɪslɪ
doubts => dauts
douce => du:s
douceur => du:'sә:
douche => du:ʃ
douche bag => du:ʃ bæɡ
douched => du:ʃt
douches => du:ʃiz
douching => du:ʃɪŋ
dough => dәu
doughboy => 'dәubɒi
doughiness => 'dәuinis
doughnut => 'dәunʌt
doughnuts => 'dəʊnʌts
doughs => dəuz
doughtily => 'dautili
doughtiness => 'dauti,nis
doughty => 'dauti
doughy => 'dәui
douglas => 'dʌ^lәs
Doulton => 'dәjltәn
dour => duә
dourly => 'duəli
Douro => 'djәrәj
douroucouli => ,djәrj'ku:h
douse => daus
doused => daʊst
douses => daʊsiz
dove => dʌv
dovecot => 'dʌvkɒt
dovecote => 'dʌvkɔt
dovekie => 'dʌvki:
dovelike => 'dʌvlaik
Dover => 'dәuvә
doves => dәuvs
dovetail => 'dʌvteil
dovetailed => 'dʌvteɪld
dovetailing => 'dʌvteɪlɪŋ
dovetails => ˈdʌvteilz
dovish => 'dʌviʃ
dow => daj
dowager => 'dauәdʒә
dowagers => ˈdauədʒəz
Dowd => dajd
dowdier => ˈdaʊdi:ə
dowdily => 'daudili
dowdy => 'daudi
dowel => 'dauәl
dowelled => ˈdaʊəld
dowels => 'daʊəlz
dower => 'dauә
dowering => 'daʊə
dowers => 'daʊə
Dowie => 'daui; 'dəui
dowitcher => 'dajitʃә(r)
down => daun
down payment => daun ˈpeimənt
down-at-heel => 'daʊn'æth'i:l
down-home => 'daun'həum
down-the-line => 'daunðə'lain
downbeat => 'dajnbi:t
downburst => 'daʊnbɜ:st
downcast => 'daunkɑ:st
downcomer => 'dajn,kʌmә(r)
downdraft => 'daundrɑ:ft
downdraught => ˈdaʊndrɑ:ft
downdrift => 'daundrift
downed => daund
downer => 'daunә
downers => ˈdaunəz
Downey => 'dauni
downfall => 'daunfɒ:l
downfield => 'dajn'fi:ld
downgrade => 'dajn^reid
downgraded => ˈdaunɡreidid
downgrades => ˈdaunɡreidz
downhaul => 'dajnhɔ:l
downhearted => 'daun'hɑ:tid
downhill => 'daun'hil
downhiller => 'daʊnhɪlə
downhole => 'daun,hәul
downiness => 'daʊnɪnəs
downlink => 'dajnliŋk
downloaded => ˈdaunləudid
downloading => 'daunlaudiŋ
downmarket => ˌdaʊnˈmɑ:kɪt
downmost => 'dajnmәjst
Downpatrick => ,daun'pætrik
downplay => 'daunplei
downplayed => ˈdaʊnˌpleɪd
downplaying => ˈdaʊnˌpleɪŋ
downplays => ˈdaʊnˌpleɪz
downpour => 'daunpɔ:
downpours => ˈdaʊnˌpɔ:z
downrate => 'daunreit
downright => 'daunrait
downriver => 'dajn'rivә(r)
downscale => ˌdaʊnˈskeɪl
downshift => 'daun,ʃift
downside => 'daunsaid
downsize => daun'saiz
downsized => ˈdaunˌsaizd
downslope => 'daʊnsləʊp
downspout => 'daunspaut
downstage => 'daun'steidʒ
downstairs => 'daun'stєәz
downstate => 'daun'steit
downstater => 'daʊnsteɪtər
downstream => 'daun'stri:m
downstroke => 'daun,strәuk
downswing => 'dajnswiŋ
downthrow => 'daunθru:
downtime => 'dauntaim
downtown => 'daun'taun
downtrodden => 'dajntrɔd(ә)n
downturn => 'dauntә:n
downturns => ˈdaʊnˌtɜ:nz
downward => 'daunwәd
downwards => 'daunwәdz
downwarp => 'daʊnwəp
downwash => 'dajnwɔʃ
downwelling => dajn'weliŋ
downwind => 'daun'wind
downwinder => daʊn'wɪnd
downy => 'dauni
downy mildew => ˈdauni ˈmɪlˌdu:
downzone => 'daun,zəun
dowries => ˈdaʊəri:z
dowry => 'dauәri
dowse => dauz
dowsed => daust
dowser => 'dauzә
dowses => dausiz
dowsing => daʊzɪŋ
doxastic => dɔks'æstik
doxies => 'dɒksɪ
doxological => ,dɔksə'lɔdʒikəl
doxology => dɒk'sɒlәdʒi
doxorubicin => ,dɔksәj'ru:bisin
doxy => 'dɔksi
doxycycline => dɔksi'saiklin
doyen => 'dɒiәn
doyenne => dwɑ:'jæŋ
doyens => ˈdɔiənz
doyle => dɔil
doze => dәuz
dozed => dəuzd
dozen => 'dʌzn
dozenth => 'dʌznθ
dozer => 'dәuzә
dozes => dəuziz
dozier => ˈdəuziə
dozing => dəuzɪŋ
dozy => 'dәuzi
drab => dræb
drabber => dræbə
drabble => 'dræbl
drabbled => 'dræb(ə)l
drably => 'dræbli
drabness => dræbnəs
dracaena => drә'si:nә
drachm => dræm
drachma => 'drækmә
drachmas => ˈdrækməz
Draco => 'dreikәu
dracone => 'dreikәun
draconian => drә'kәjniәn
draconic => drә'kɔnik
Dracula => 'drækjulə
draegerman => 'dreigәmәn
draff => dræf
draft => dræft. drɑ:ft
drafted => drɑ:ftid
draftee => dræf'ti:
drafter => 'dræftә
drafters => 'drɑ:ftə, 'dræftə
drafting => 'drɑ:ftiŋ
draftnik => 'drɑːftnɪk
drafts => drɑ:fts
draftsman => 'dræftsmәn
draftsmanship => 'drɑ:ftsmәnʃip; 'dræft-
drafty => 'dræfti
drag => dræg
drag lift => dræɡ lift
drag queen => dræɡ kwi:n
drag race => dræɡ reis
drag racing => dræɡ ˈreisiŋ
drag up => dræɡ ʌp
drag-and-drop => dræɡ ænd drɔp
dragger => 'dræ^ә
dragging => 'dræ^iŋ
draggle => 'drægl
draggled => ˈdræɡld
draggy => 'drægi
dragline => 'dræ^lain
dragnet => 'drægnet
dragoman => 'drægәumәn
dragon => 'drægәn
dragon arum => ˈdræɡən ˈɛərəm
dragon boat => ˈdræɡən bəut
dragon tree => ˈdræɡən tri:
dragonet => 'dræ^әnit
dragonfish => 'dræ^әn'fiʃ
dragonflies => ˈdrægənˌflaɪz
dragonfly => 'drægәnflai
dragonnade => ,dræ^ә'neid
dragoon => drә'gu:n
dragooned => drəˈgu:nd
dragooning => drəˈgu:nɪŋ
dragoons => drəˈgu:nz
drags => dræ^z
dragster => ˈdrægstə(r)
drail => dreil
drain => drein
drainage => 'dreinidʒ
drained => dreɪnd
drainer => 'dreinә
draining => 'dreiniŋ
drainpipe => 'dreinpaip
drainpipes => d'reɪnpaɪps
drains => dreinz
drake => dreik
drakes => dreiks
dram => dræm
drama => 'drɑ:mә
drama queen => ˈdrɑ:mə kwi:n
dramatic => drә'mætik
dramatic irony => drəˈmætik ˈaiərəni
dramatically => drә'mætikli
dramatics => drә'mætiks
dramatise => 'dræmәtaiz
dramatised => 'dræmətaiz
dramatist => 'dræmәtist
dramatists => d'ræmətɪsts
dramatization => .dræmәtai'zeiʃәn
dramatize => 'dræmәtaiz
dramatized => ˈdræməˌtaɪzd
dramatizes => ˈdræməˌtaɪziz
dramatizing => ˈdræməˌtaɪzɪŋ
dramaturgic => .dræmә'tә:dʒik
dramaturgically => ,dræmə'tə:dʒikəli
dramaturgy => 'dræmәtә:dʒi
Drambuie => dræm'bju:i
drams => dræmz
drank => dræŋk
drape => dreip
draped => dreɪpt
draper => 'dreipә
draperies => ˈdreɪpəri:z
drapers => ˈdreipəz
drapery => 'dreipәri
drapes => dreɪps
draping => 'dreipiŋ
drastic => 'dræstik
drastically => 'dræstikәli
drat => dræt
dratted => 'drætid
draught => drɑ:ft. dræft
draughtboard => 'drɑ:ftbɒ:d
draughted => drɑːft
draughtier => ˈdrɑ:ftiə
draughting => 'drɑ:ftiŋ
draughtproof => 'dræftprʊf
draughts => drɑ:fts
draughtsman => 'drɑ:ftsmәn
draughtsmen => 'drɑːf(t)smən
draughty => 'drɑ:fti
Dravidian => drә'vidiәn
draw => drɒ:
draw breath => drɔ: breθ
drawback => 'drɒ:bæk
drawbacks => d'rɔ:bæks
drawbar => 'drɒ:bɑ:
drawbridge => 'drɒ:bridʒ
drawbridges => ˈdrɔ:ˌbrɪdʒz
drawcard => ˊdrɒːkaːd
drawcord => 'drɔːkɔːd
drawdown => 'draudaun
drawee => drɒ:'i:
drawer => 'drɒ:ә
drawerful => 'drɔ:fjl
drawers => drɔ:z
drawing => 'drɒ:iŋ
drawknife => 'drɒ:naif
drawl => drɒ:l
drawled => drɔ:ld
drawling => 'drɔ:liŋ
drawls => drɔ:lz
drawly => d'rɔ:lɪ
drawn => drɒ:n
drawn butter => drɔ:n ˈbʌtə
drawn-out => 'drɔ:n'ajt
drawstring => 'drɒ:striŋ
drawstrings => ˈdrɔ:striŋz
dray => dreil
drayman => 'dreimәn
draymen => 'dreɪmən
drays => dreiz
Drayton => 'dreitn
dread => dred
dreadful => 'dredful
dreadfully => 'dredfjli
dreading => dredɪŋ
dreadlock => 'dredlɔk
dreadlocked => d'redlɒkt
dreads => dredz
dream => dri:m
dream on => dri:m ɔn
dream team => dri:m ti:m
dream ticket => dri:m ˈtikit
dreamboat => 'dri:mbәut
dreamer => 'dri:mә
dreamers => ˈdri:məz
dreamful => 'dri:mfjl
dreamier => ˈdri:mi:ə
dreamily => 'dri:mili
dreaminess => 'dri:minis
dreamland => 'dri:mlænd
dreamless => 'dri:mlis
dreamlike => 'dri:mlaik
dreamscape => 'dri:mskeip
dreamt => dremt
dreamtime => 'dri:mtaim
dreamwork => 'dri:mwə:k
dreamworld => ˈdri:mwɜ:ld
dreamy => 'dri:mi
drear => driә
drearier => ˈdriəriə
drearily => 'driәrili
dreariness => 'driәrinis
dreary => 'driәri
dreck => drek
drecky => 'dreki
dredge => dredʒ
dredged => dredʒd
dredger => 'dredʒә
dredgers => ˈdredʒəz
dredges => dredʒz
dredging => 'dredʒiŋ
dree => dri:
dreggy => 'dregi
dregs => dre^z
dreich => dri:x
dreidel => d'reɪdəl
Dreiser => 'draisә
drek => d'ri:k
drench => drentʃ
drenched => drentʃd
drenches => drentʃiz
drenching => 'drentʃiŋ
Drenthe => 'drentə
Dresden => 'drezdәn
dress => dres
dress circle => dres ˈsə:kl
dress down => dres daun
dress shield => dres ʃi:ld
dress shirt => dres ʃə:t
dressage => 'dresɑ:ʒ
dressed => 'dresid
dressed to kill => drest tu: kil
dresser => 'dresә
dressers => ˈdresəz
dresses => dresiz
dressier => ˈdresiə
dressily => 'dresili
dressing => 'dresiŋ
dressing case => ˈdresiŋ keis
dressing gown => ˈdresiŋ ɡaun
dressing room => ˈdresiŋ ru:m
dressing table => ˈdresiŋ ˈteibl
dressmaker => 'dresmeikә
dressmakers => ˈdresˌmeɪkəz
dressmaking => 'dresmeikiŋ
dressy => 'dresi
drew => dru:
drey => drei
Dreyfus => 'dreifәs,drei'fjus
drib => drib
dribble => 'dribl
dribbled => ˈdrɪbəld
dribbles => ˈdrɪbəlz
dribbling => 'dribliŋ
driblet => 'driblit
dried => draid
drier => 'draiә
drift => drift
drift ice => drift ais
drift net => drift net
drifted => driftid
drifter => 'driftә
drifters => d'rɪftəz
drifting => 'driftiŋ
driftway => d'rɪftweɪ
driftwood => 'driftwud
drifty => d'rɪftɪ
drill => dril
drill down => dril daun
drilled => drild
driller => 'drilә
drilling => 'driliŋ
drilling rig => ˈdriliŋ riɡ
drily => 'draili
drink => driŋk
drink up => driŋk ʌp
drink-driver => driŋk ˈdraivə
drink-driving => driŋk ˈdraiviŋ
drinkable => 'driŋkәbl
drinker => 'driŋkә
drinkers => ˈdrɪŋkəz
drinking => 'driŋkiŋ
drinking chocolate => ˈdrɪŋkɪŋ ˈtʃɔkəlit
drinking fountain => 'drinkiŋ
drinking song => ˈdrɪŋkɪŋ sɔŋ
drinking water => ˈdrɪŋkɪŋ ˈwɔ:tə
drip => drip
drip-dry => 'dripdrai
dripped => d'rɪpt
dripping => 'dripiŋ
drippings => 'drɪpɪŋ
drippy => 'dripi
drips => drips
dripstone => 'dripstәun
drivability => ,draivә'bilәti
drivable => d'raɪvəbl
drive => draiv
drive bay => draiv bei
drive time => draiv taim
drive-by => ˈdraɪvˌbaɪ
drive-by-wire => d'raɪvb'aɪw'aɪər
drive-in => 'draiv'in
drive-through => draiv θru:
drivel => 'drivәl
driveline => 'draivlain
drivelled => 'drɪv(ə)l
drivels => 'drɪv(ə)l
driven => 'drivn
driver => 'draivә
driverless => d'raɪvərles
drivetrain => 'draivtrein
driveway => 'draivwei
driveways => ˈdraivweiz
driving => 'draiviŋ
driving licence => ˈdraiviŋ ˈlaisəns
driving range => ˈdraiviŋ reindʒ
driving test => ˈdraiviŋ test
drizzle => 'drizl
drizzled => ˈdrizld
drizzles => ˈdrizlz
drizzling => ˈdrizlɪŋ
drizzly => 'drizli
Drogheda => 'drɔ:idə
drogue => drәug
drogue parachute => drəuɡ ˈpærəʃu:t
droid => drɔid
droit => drɒit
droll => drɒl
drolleries => 'drəʊlərɪ
drollery => 'drɒlәri
drollness => d'rəʊlnes
drolly => 'drәuli
drome => drәum
dromedaries => 'drɒmɪd(ə)rɪ; 'drʌm-
dromedary => 'drɒmәdәri
dromond => 'drɔmәnd
dromos => 'drɔmәs
drone => drәun
droned => drəʊnd
drones => drəʊnz
drongo => 'drɔŋ^әj
droning => 'drәjniŋ
droob => dru:b
droog => dru:^
drool => dru:l
drooled => dru:ld
drools => dru:lz
droop => dru:p
drooped => dru:pt
droopier => ˈdru:piə
drooping => 'dru:piŋ
droops => dru:ps
droopy => 'dru:pi
drop => drɒp
drop goal => drɔp ɡəul
drop hammer => drɔp ˈhæmə
drop handlebars => drɔp ˈhændlbɑ:z
drop kick => drɔp kik
drop tank => drɔp tæŋk
drop the ball => drɔp ðə bɔ:l
drop zone => drɔp zəun
drop-dead => ˈdrɔpˌded
drop-off => 'drɔpɔf
dropcloth => 'drɔpklɔθ
drophead => 'drɔphed
dropkick => 'drɒpkik
dropkicked => 'drɔpkik
dropkicking => 'drɔpkik
dropkicks => 'drɔpkik
droplet => 'drɒplit
droplets => d'rɒplets
dropout => 'drɒpaut
dropouts => 'drɒpˌaʊts
droppable => 'drɔpәbl
dropped => drɔpt
dropper => 'drɒpә
droppers => ˈdrɔpəz
dropping => 'drɒpiŋ
dropsical => 'drɔpsikәl
dropsy => 'drɔpsi
dropwort => 'drɔpwә:t
drosera => 'drɔsәrә
droshky => 'drɔʃki
drosophila => drә'sɒfilә
dross => drɒs
drossy => 'drɒsi
drought => draut
droughts => d'raʊts
droughty => 'drajti
drouth => drajθ
drouthy => 'drauθi
drove => drәuv
drover => 'drәuvә
drown => draun
drowned => draund
drowning => 'drauniŋ
drowns => draunz
drowse => drauz
drowsed => draʊzd
drowses => draʊziz
drowsier => ˈdraʊzi:ə
drowsily => 'drauzili
drowsiness => 'drauzinis
drowsing => draʊzɪŋ
drowsy => 'drauzi
drub => drʌb
drubbed => drʌb
drubbing => 'drʌbiŋ
drubs => drʌb
drudge => drʌdʒ
drudged => drʌdʒ
drudgery => 'drʌdʒәri
drudges => drʌdʒz
drudging => drʌdʒ
drug => drʌg
drug abuse => drʌɡ əˈbju:s
drug baron => drʌɡ ˈbærən
drug-free => d'rʌɡfr'i:
drugged => drʌgd
drugget => 'drʌgit
druggie => 'drʌ^i
druggist => 'drʌgist
druggists => ˈdrʌɡists
druggy => 'drʌ^i
drugmaker => 'drʌ^,meikә(r)
drugstore => 'drʌgstɒ:
drugstores => d'rʌɡstɔ:z
druid => 'dru:id
druidical => d'ru:ɪdɪkəl
druids => ˈdru:idz
drum => drʌm
drum brake => drʌm breik
drum kit => drʌm kit
drum major => drʌm ˈmeidʒə
drum majorette => drʌm ˌmeidʒəˈret
drum roll => drʌm rəul
drumbeat => 'drʌmbi:t
drumbeats => ˈdrʌmbi:ts
drumfish => 'drʌmfiʃ
drumhead => 'drʌmhed
drumlin => 'drʌmlin
drummed => 'drʌmd
drummer => 'drʌmә
drummers => ˈdrʌməz
drumming => 'drʌmiŋ
drumroll => 'drʌmrәjl
drumstick => 'drʌmstik
drumsticks => 'drʌmstɪk
drunk => drʌŋk
drunk tank => drʌŋk tæŋk
drunk-driving => d'rʌŋkdr'aɪvɪŋ
drunkard => 'drʌŋkәd
drunkards => ˈdrʌŋkədz
drunken => 'drʌŋkәn
drupaceous => dru:'peiʃәs
drupe => dru:p
drupel => 'dru:pәl
drupelet => 'dru:plit
Drury => 'drjәri
drusy => 'dru:si
druther => 'drʌðә(r)
druthers => 'drʌðәz
druze => dru:z
dry => drai
dry dock => drai dɔk
dry eye => drai ai
dry farming => drai ˈfɑ:miŋ
dry fly => drai flai
dry hole => drai həul
dry land => drai lænd
dry measure => drai ˈmeʒə
dry milk => drai milk
dry out => drai aut
dry wash => drai wɔʃ
dry-cure => 'draikjjә(r)
dry-eyed => drai aid
dry-salt => 'draisɔ:lt
dryad => 'draiәd
dryer => 'draiә
dryers => d'raɪəz
drying => 'draiiŋ
dryish => 'draiiʃ
dryland => 'drailænd
dryly => 'draili
dryness => 'drainis
dryopithecine => ,draiәu'piθә,si:n, -,sain
Dryopithecus => ,draiəu'piθikəs
drystone => d'rɪstəʊn
drywall => 'draɪwɔ:l
DTI => ,di: ti: 'ai
du jour => duˈʒuə
dual => 'dju:әl
dual carriageway => ˈdju:əl ˈkærɪdʒweɪ
dual-use => d'ju:əlj'u:s
dualism => 'dju:әlizm
dualist => 'dju:әlist
dualistic => dju:ә'listik
duality => dju:'æliti
dualize => 'dju:ә,laiz
Duane => dwein; du:'ein
dub => dʌb
dubai => 'dju:bai
dubbin => 'dʌbin
dubbing => 'dʌbiŋ
dubiety => dju:'baiiti
dubious => 'dju:biәs
dubitable => 'dju:bitәbl
dubitation => .dju:bi'teiʃәn
dubitative => 'dju:bitәtiv
Dublin => 'dʌblin
dubliner => 'dʌblinə
dubnium => ˈdʌbniəm
Dubois => dju'bwɑ:
Dubrovnik => 'du:brɔ:vnik
dubs => dʌbz
ducal => 'dju:kәl
ducat => 'dʌkәt
ducats => 'dʌkət
duchess => 'dʌtʃis
duchesse => dʊ'ʃɛs
duchesses => ˈdʌtʃɪsiz
duchies => ˈdʌtʃiz
duchy => 'dʌtʃi
duck => dʌk
duckbill => 'dʌkbil
duckboard => 'dʌkbɔ:d
ducker => 'dʌkә
duckie => 'dʌki
ducking => 'dʌkiŋ
ducking stool => ˈdʌkiŋ stu:l
duckling => 'dʌkliŋ
ducklings => 'dʌklɪŋz
duckpin => 'dʌkpɪn
ducks and drakes => dʌks
ducktail => 'dʌkteil
duckweed => 'dʌkwi:d
ducky => 'dʌki
duct => dʌkt
duct tape => dʌkt teip
ductile => 'dʌktail
ductility => dʌk'tiliti
ducting => 'dʌktiŋ
ductless => 'dʌktlis
ductless gland => ˈdʌktlɪs
ductule => 'dʌktjul
dud => dʌd
dude => dju:d
dude ranch => dju:d rɑ:ntʃ
dudes => dju:dz
dudgeon => 'dʌdʒәn
dudish => 'dju:diʃ
dudley => 'dʌdli, 'dju-
duds => dʌdz
due => dju:
due diligence => dju: ˈdɪlədʒəns
duel => 'dju:әl
duelist => 'dju:əlist
duelled => 'djuːəl
duels => ˈdu:əlz
duende => du'endi
duenna => dju(:)'enә
Duero => 'dweәrәj
duet => dju:'et
duets => dju':ets
duettist => dju:'etist
duff => dʌf
duffed => dʌft
duffel => 'dʌfәl
duffel bag => ˈdʌfl bæg
duffel coat => 'dʌfəl kəʊt
duffer => 'dʌfә
duffers => ˈdʌfəz
duffle bag => ˈdʌfəl
duffs => dʌfs
Duffy => 'dʌfi
dufus => 'du:fəs
dug => dʌg
dugong => 'dju:gɒn
dugout => 'dʌgaut
dugouts => ˈdʌɡauts
duh => du:
duiker => 'daikә
Duisburg => 'dju:sbjrk
duke => dju:k
dukedom => 'dju:kdәm
dukedoms => dju:kdəmz
dukes => du:ks
dulcet => 'dʌlsit
dulciana => .dʌlsi'ænә
Dulcie => 'dʌlsi
dulcification => ,dʌlsifi'keiʃәn
dulcified => 'dʌlsɪfaɪ
dulcifies => 'dʌlsɪfaɪ
dulcify => 'dʌlsifai
dulcifying => 'dʌlsɪfaɪ
dulcimer => 'dʌlsimә
dulcitone => 'dʌlsitәjn
dulia => du:'laiә
dull => dʌl
dullard => 'dʌlәd
dullards => ˈdʌlədz
dulled => dʌld
dulling => 'dʌliŋ
dullish => 'dʌliʃ
dullness => 'dʌlnis
dulls => dʌlz
dullsville => 'dʌlzvil
dully => 'dʌli
dulosis => du:'lәusis
dulotic => dju:'lɔtik
dulse => dʌls
dulux => 'dʌlәks
duly => 'dju:li
dum-dum => 'dəmd'əm
dum-dums => 'dʌm,dʌm
Duma => 'du:mɒ
dumas => dju'mɑ:
dumb => dʌm
dumb cane => dʌm kein
dumb show => dʌm ʃəu
dumb waiter => dʌm ˈweitə
dumb-ass => 'dʌm'æs
dumb-bell => dʌm bel
Dumbarton => dʌm'bɑ:tən
Dumbartonshire => ,dʌm'bɑ:tənʃə
dumbass => dʌm'bæs
dumbbell => 'dʌmbel
dumbbells => 'dʌmbel
dumbfound => dʌm'fajnd
dumbfounded => dʌmˈfaʊndɪd
dumbfounding => dʌm'faʊndɪŋ
dumbfounds => dʌmˈfaundz
dumbhead => 'dʌmhed
dumbly => 'dʌmli
dumbness => 'dʌmnis
dumbo => 'dʌmbәu
dumbos => 'dʌmbəu
dumbstruck => 'dʌmstrʌk
dumbwaiter => dʌm'weɪtər
dumdum => 'dʌmdʌm
dumfound => dʌm'faund
Dumfries => ,dʌm'fri:s
Dumfriesshire => ,dʌm'fri:sʃә(r)
dummies => ˈdʌmi:z
dummy => 'dʌmi
dummying => 'dʌmiiŋ
dumortierite => dju:'mɔ:tiәrait
dump => dʌmp
dump bin => dʌmp bin
dump on => dʌmp ɔn
dumper => 'dʌmpә
dumping => 'dʌmpiŋ
dumpling => 'dʌmpliŋ
dumplings => 'dʌmplɪŋz
dumps => dʌmps
dumpster => 'dʌmpstə(r)
dumpsters => 'dʌmpstə
dumpy => 'dʌmpi
dun => dʌn
dunam => 'djnәm
dunbar => 'dʌnbɑ:
duncan => 'dʌŋkәn
dunce => dʌns
dunces => dʌnsiz
Dundalk => 'dʌndɔ:k
Dundas => dʌn'dæs, 'dʌndæs
Dundee => dʌn'di:
dunderhead => 'dʌndәhed
dune => dju:n
dune buggy => du:n ˈbʌgi:
Dunedin => dʌ'ni:din
dunes => dju:nz
Dunfermline => dʌn'fə:mlin
dung => dʌŋ
dung beetle => dʌŋ ˈbi:tl
dungaree => .dʌŋgә'ri:
dunged => dʌŋ
Dungeness => 'dʌndʒәnes
Dungeness crab => 'dʌndʒənes
dungeon => 'dʌndʒәn
dungeons => ˈdʌndʒənz
dunghill => 'dʌŋhil
dunging => dʌŋ
Dunhuang => djn'hwɑ:ŋ
dunite => 'du:nait
dunk => dʌŋk
Dunkard => 'dʌŋkə; 'dʌŋkəd
dunked => dʌŋkt
dunking => dʌŋkɪŋ
Dunkirk => dʌn'kә:k
dunlin => 'dʌnlin
dunlop => dʌn'lɔp, 'dʌnlɔp
dunnage => 'dʌnidʒ
dunne => dʌn
dunned => dʌn
dunno => dʌ'nәj
dunnock => 'dʌnәk
dunny => 'dʌni
Dunstan => 'dʌnstәn
Dunstaple => 'dʌnstәpl
dunt => dʌnt
duo => 'dju:әu
duodecimal => .dju:ә'desimәl
duodecimo => .dju:ә'desimәu
duodenal => .dju:ә'di:nl
duodenary => .dju:ә'di:nәri
duodenitis => .dju:әdi'naitis
duodenum => .dju:ә'di:nәm
duologue => 'dju:әlɒg
duomo => 'dwɔ:mɔ:
duopolistic => dju,ɔpə'listik
duopoly => dju'ɔpәli
duotone => 'dju:әtәun
dup => dʌp
dupable => 'dju:pәbl
dupe => dju:p
duped => du:pt
duper => 'dju:pә
dupery => 'dju:pәri
duping => du:pɪŋ
dupion => 'dju:piәjn
duple => 'dju:pl
duplet => 'dju:plit
duplex => 'dju:pleks
duplexer => 'dju:pleksә
duplexes => ˈdju:pleksiz
duplexing => 'dju:pleksiŋ
duplicable => 'dju:plikәbl
duplicate => 'dju:plikeit
duplicate bridge => ˈdju:plikit bridʒ
duplicates => ˈdju:plikits
duplicating => 'dju:plikeitiŋ
duplication => .dju:pli'keiʃәn
duplicator => 'dju:plikeitә
duplicators => 'djuːplɪkeɪtə
duplicities => djuː'plɪsɪtɪ; djʊ-
duplicitous => dju:'plisitәs
duplicity => dju:'plisiti
dupondius => dju:'pɔndiәs
duppy => 'dʌpi
dur => du:
dura => 'djuәrә
durability => ,djuәrә'biliti
durable => 'djurәbl
durables => 'djʊrəbls
dural => djuә'ræl
duramen => djuә'reimen
durance => 'djurәns
duration => dju'reiʃәn
durations => djʊ'reɪʃnz
durative => 'djurәtiv
Durazzo => du'rɑ:tsəu
Durban => 'dә:bәn
durbar => 'dә:bɑ:
duress => djuә'reis
Durex => 'du:reks
Durham => 'dә:rәm
durian => 'du:riәn
duricrust => 'djuәrikrʌst
during => 'djuәriŋ
durn => dә:n
durned => dɜːn
Duroc => 'djuәrɔk
durra => 'durә
Durrell => 'dә:rel
durrie => 'dɝri
durst => dә:st
durum => 'djuәrәm
Dushanbe => dju:'ʃɑ:nbi
dusk => dʌsk
dusked => dʌskt
duskily => 'dʌskili
duskiness => 'dʌskinis
dusking => dʌskɪŋ
dusky => 'dʌski
Dusseldorf => 'dusldɔ:f
dust => dʌst
dust bowl => dʌst bəul
dust devil => dʌst ˈdevl
dust jacket => dʌst ˈdʒækit
dust sheet => dʌst ʃi:t
dust-up => dʌst ʌp
dustball => ˈdʌstbɔ:l
dustbin => 'dʌstbin
dustbins => ˈdʌstˌbɪnz
dustcoat => 'dʌstkәjt
duster => 'dʌstә
dusters => 'dʌstəz
dustheap => 'dʌsthi:p
dustier => ˈdʌsti:ə
dustily => 'dʌstili
Dustin => 'dʌstin
dusting => 'dʌstiŋ
dustless => 'dʌstlis
dustman => 'dʌstmәn
dustpan => 'dʌstpæn
dustpans => ˈdʌstpænz
dustup => 'dʌstʌp
dusty => 'dʌsti
dusty miller => ˈdʌsti: ˈmɪlə
Dutch => dʌtʃ
Dutchman => 'dʌtʃmәn
dutchmen => 'dʌtʃmən
Dutchwoman => 'dʌtʃ,wumən
duteous => 'dju:tjәs
duteously => ˊdjuːtjәsli
duteousness => ˊdjuːtjәsnis
dutiable => 'dju:tjәbl
dutiful => 'dju:tiful
duty => 'dju:ti
duumvir => dju:'ʌmvә
duumvirate => dju:'ʌmvirit
duvet => du:'vei
duvets => ˈdu:veiz
dux => dʌks
dwale => dweil
dwarf => dwɒ:f
dwarfing => 'dwɔ:fiŋ
dwarfish => 'dwɒ:fiʃ
dwarfism => 'dwɔ:fizәm
dweeb => dwi:b
dwell => dwel
dweller => 'dwelә
dwellers => ˈdweləz
dwelling => 'dweliŋ
dwells => dwelz
dwelt => dwelt
dwight => dwait
dwindle => 'dwindl
dwindled => ˈdwindld
dwindles => ˈdwindlz
dwindling => ˈdwindlɪŋ
Dy => dai
dyad => 'daiæd
dyadic => dai'ædik
Dyak => 'daiæk
dyarchy => 'daiɑ:ki
dybbuk => 'daibәk
dye => dai
dyeable => 'daiәbl
dyeing => 'daiiŋ
dyeline => 'dailain
dyer => 'daiә
dyestuff => 'daistʌf
Dyfed => 'dʌved
dying => 'daiiŋ
dyke => daik
dykes => daɪks
dykey => 'daiki
dynamic => dai'næmik
dynamical => dai'næmikәl
dynamicist => dai'næmisist
dynamics => dai'næmiks
dynamism => 'dainәmizm
dynamist => 'dainәmist
dynamite => 'dainәmait
dynamited => ˈdainəmaitid
dynamiter => 'dainәmaitә
dynamites => ˈdainəmaits
dynamiting => ˈdainəmaitɪŋ
dynamize => daɪ'nɑ:maɪz
dynamo => 'dainәmәu
dynamometer => .dainә'mɒmitә
dynast => 'dainæst
dynastic => dai'næstik
dynasties => ˈdainəstiz
dynasty => 'dainæsti
dyne => dain
dyno => 'dainәu
dynode => 'dainәud
dysaesthesia => ,dises' θi:ziә
dysarthria => dis'ɑ:θriә
dyscalculia => ,diskæl'kju:liә
dyscrasia => dis'kreiziә
dysenteric => .disәn'terik
dysentery => 'disәntәri
dysfunction => dis'fʌŋkʃәn
dysfunctional => dɪsˈfʌŋkʃənl
dysgenic => dis'dʒenik
dysgraphia => dis'^ræfiә
dyskinesia => ,diski'ni:ʒә
dyslectic => dis'lektik
dyslexia => dis'leksiә
dyslexic => dis'leksik
dysmenorrhoea => dɪsmenə'rɪə
dysmorphic => dɪs'mɔ:fɪk
dyspareunia => ,dispә'ru:niә
dyspepsia => dis'pepsiә
dyspeptic => dis'peptik
dysphagia => dis'feidʒiә
dysphasia => dis'feiʒiә
dysphasic => dis'feizik
dysphemism => 'disfimizәm
dysphonia => dis'fәuniә
dysphoria => dis'fɔ:riә
dysphoric => -'fɔrik
dysplasia => dis'pleiziә, -'pleiʒә
dyspnea => dis'pni:ә
dyspnoea => dis'pni:ә
dyspnoeic => 'dɪspni:ɪk
dyspraxia => dis 'præksiә
dysprosium => dis'prәusiәm
dysregulation => di:zreɡjʊ'leɪʃn
dysrhythmic => dis'riðmik; -'riθmik
dysthymia => dis'θaimiә
dysthymic => dɪs'θɪmɪk
dystocia => dis'tәuʃiә
dystonia => dis'tәuniә
dystopia => dis'tәupiә
dystopian => dis'tәjpiәn
dystrophic => dis'trɔfik
dystrophin => di:st'rɒfɪn
dystrophy => 'distrәfi
dysuria => dis'juәriә
dytiscid => di'tisid
Dzerzhinsk => diә'ʒinsk
dzo => dzәu