D => di:
D-Day => 'di:-dei
DA => ,di:'ei
da capo => dɑ: 'kɑ:pәj
Da Nang => 'dɑ:'nɑ:ŋ
dab => dæb
dabbed => dæbd
dabber => 'dæbә
dabbing => 'dæbiŋ
dabble => 'dæbl
dabbled => ˈdæbəld
dabbler => 'dæblә
dabblers => 'dæblə
dabbles => ˈdæbəlz
dabbling duck => ˈdæblɪŋ
dabchick => 'dæbtʃik
dabs => dæbz
dacca => 'dækә
dace => deis
dacha => 'dætʃә
dachshund => 'dækshund
dachshunds => ˈdækshundz
Dacia => 'deiʃə
dacite => 'dæsait
dacoit => dә'kɒit
dacoity => dә'kɒiti
dactyl => 'dæktil
dactylic => dæk'tilik
dad => dæd
dada => 'dɑ:dɑ:
Dadaist => 'dɑ:dɑ:ist
daddies => ˈdædi:z
daddy => 'dædi
dado => 'deidәu
dado rail => ˈdeidəu reil
dadoing => deɪ'dəʊɪŋ
dados => ˈdeidəuz
dads => dædz
Daedalus => 'di:dәlәs
daemon => 'di:mәn
daemonic => di:'mɔnik
daff => dæf
daffodil => 'dæfәdil
daffodils => ˈdæfədɪlz
daffy => 'dæfi
daft => dɑ:ft. dæft
dafter => dæftə
dag => dæ^
Dagenham => 'dæɡnəm
Dagestan => ,dɑ:ɡi'stɑ:n
dagga => 'dæ^ә
dagger => 'dægә
daggerboard => 'dæ^әbɔ:d
daggers => ˈdæɡəz
dago => 'deigәu
Dagon => 'dei^ɔn
dagos => 'deɪgəʊ
dags => dæ^z
Daguerre => dә'^er
daguerreotype => dә'gerәutaip
Dagwood => 'dæ^wjd
dah => dɑ:
dahabeeyah => dəhə'bi:jə
dahi => 'dɑ:,hi
dahlia => 'deiljә
dahlias => ˈdeiljəz
Dahomey => dә'hәumi
dai => dai
daikon => 'daikәn
Dail => dail
dailies => ˈdeiliz
dailiness => 'deilinis
daily => 'deili
daily life => ˈdeili laif
daimon => 'daimɔn
daimonic => dai'mɔnik
daimyo => 'daimjәj
daintier => ˈdeɪnti:ə
daintily => 'deintili
daintiness => 'deintinis
dainty => 'deinti
daiquiri => 'daikiri
Dairen => 'dai'ren
dairies => ˈdɛəriz
dairy => 'dєәri
dairying => 'deәriiŋ
dairymaid => 'dєәrimeid
dairymaids => 'deərɪmeɪd
dairyman => 'deәrimәn
dairymen => 'deərɪmən
dais => 'deiis
daisies => ˈdeɪzi:z
daisy => 'deizi
daisy wheel => ˈdeɪzi: hwi:l
dak => dɑ:k
dakar => 'dækә
dakota => dә'kәutә
Dakotan => dә'kәutәn
dal => dɑ:l
dal segno => dæl 'seinjәu
dale => deil
Dalek => 'dɑ:lek
dales => deɪlz
Dali => 'dɑ:li:
dalian => 'dɑ:ljәn
Daliesque => ,dɑ:li:'esk
dallas => 'dælәs
dalliance => 'dæliәns
dallied => 'dælɪd
dallies => 'dælɪz
dally => 'dæli
Dalmatia => dæl'meiʃiә
dalmatian => dæl'meiʃiәn
dalmatic => dæl'mætik
dalton => 'dɔ:ltәn
daltonism => 'dɒ:ltәnizm
daly => 'deili
dam => dæm
damage => 'dæmidʒ
damage control => ˈdæmidʒ kənˈtrəul
damage limitation => ˈdæmidʒ ˌlimiˈteiʃən
damaged => 'dæmidʒid
damaging => 'dæmidʒiŋ
damagingly => 'dæmɪdʒɪŋlɪ
damar => 'dæmә
Damaraland => dә'mɑ:rәlænd
damascene => 'dæmәsi:n
damascened => 'dæməsi:n
Damascus => dә'mæskәs
damask => 'dæmәsk
damask rose => ˈdæməsk rəuz
dame => deim
dame school => deɪm sku:l
dames => deɪmz
damfool => 'dæm'fu:l
damiana => ,dæmi'ænә
Damietta => ,dæmi'etə
daminozide => dæ'mainәzaid
dammar => 'dæmә(r)
damming => 'dæmiŋ
dammit => 'dæmit
damn => dæm
damn all => dæm ɔ:l
damnable => 'dæmnәbl
damnably => 'dæmnәbli
damnation => dæm'neiʃәn
damnatory => 'dæmnәtәri
damndest => 'dæmdist
damned => dæmd
damnedest => 'dæmdist
damnification => .dæmnifi'keiʃәn
damnify => 'dæmnifai
damning => 'dæmiŋ
damningly => 'dæmɪŋlɪ
damns => dæmz
damnum => 'dæmnәm
Damocles => 'dæmәkli:z
damon => 'deimәn
damp => dæmp
damp course => dæmp kɔː(r)s
damp-dry => 'dæmp'drai
dampen => 'dæmpәn
dampened => ˈdæmpənd
dampens => ˈdæmpənz
damper => 'dæmpә
Dampier => 'dæmpjә
damping => 'dæmpiŋ
damping off => ˈdæmpiŋ ɔf
dampish => 'dæmpiʃ
damply => 'dæmpli
damps => dæmps
damsel => 'dæmzәl
damselfish => 'dæmzel,fiʃ
damselfly => 'dæmzәflai
damsels => ˈdæmzəlz
damson => 'dæmzәn
damsons => ˈdæmznz
dan => dæn
dance => dæns. dɑ:ns
dance band => dɑ:ns bænd
dance floor => dɑ:ns flɔ:
dance hall => dɑ:ns hɔ:l
dance of death => dɑ:ns ɔv deθ
danceable => 'dɑ:nseɪbl
danced => dɑ:nst
dancer => 'dɑ:nsә
dancers => 'dɑ:nsəz
dancing => 'dænsiŋ
dandelion => 'dændilaiәn
dandelion coffee => ˈdændlˌaɪən ˈkɔfi
dandelions => 'dændɪlaɪənz
dander => 'dændә
dandiacal => dæn'daiәkәl
dandies => ˈdændiz
dandified => 'dændifaid
dandiprat => 'dændipræt
dandle => 'dændl
dandled => 'dænd(ə)l
dandles => 'dænd(ə)l
dandling => 'dænd(ə)l
dandruff => 'dændræf
dandy => 'dændi
dandyish => 'dændiiʃ
dandyism => 'dændiizm
Dane => dein
Danegeld => 'dein,^eld
Danelaw => 'deinlɒ:
danewort => 'deinw\\\\:t
dang => dæŋ
danged => dæŋd
danger => 'deindʒә
dangerous => 'deindʒәrәs
dangerousness => 'deɪndʒərəsnəs
dangers => ˈdeindʒəz
dangle => 'dæŋgl
dangled => ˈdæŋgəld
dangler => 'dæŋglә
dangles => ˈdæŋgəlz
dangly => 'dæŋ^li
daniel => 'dænjәl
DANIELLE => dæn'jel
danio => 'dæni,әu
Danish => 'deiniʃ
dank => dæŋk
dankly => ˊdæŋkli
dankness => dæŋknəs
Danmark => 'dænmɑ:k
Danny => 'dæni
danseur => dɑ:ŋ'sә:r
danseur noble => dɔŋ'sə:'nɔ:blə
danseuse => dɒŋ'sә:z
dante => 'dænti
Dantean => dæn'ti:әn
Dantesque => dæn'tesk
danthonia => dæn'θәjniә
Danube => 'dænju:b
danubian => dæn'ju:biәn
danzig => 'dæntsi^
dap => dæp
daphne => 'dæfni
daphnia => 'dæfniә
Daphnis => 'dæfnis
dapper => 'dæpә
dapperly => ˊdæpәli
dapping => 'dæpiŋ
dapple => 'dæpl
dapple grey => ˌdæpl ˈgreɪ
dapple-grey => 'dæplɡr'eɪ
dappled => 'dæpld
dappling => 'dæp(ə)l
Dapsang => dəp'sʌŋ
dapsone => 'dæpsәjn
Daqing => 'dɑ:'tʃiŋ
Dar es Salaam => 'dɑ:r es sә'lɑ:m
darbies => 'dɑ:bɪz
darby => 'dɑ:bi
Darcy => 'dɑ:si
Dard => dɑ:b
Dardanelles => ,dɑ:dә'nelz
Dardic => 'dɑ:dik
dare => dєә
daredevil => 'dєә.devәl
daredevilry => 'deә,devəlri
daredevils => ˈdeəˌdevəlz
dares => dɛəz
daresay => 'deә'sei
darg => 'dɑ:ɡ
daring => 'dєәriŋ
dariole => 'dæriәjl
darius => dә'raiәs
Darjeeling => dɑ:'dʒi:liŋ
dark => dɑ:k
dark matter => dɑ:k ˈmætə
dark star => dɑ:k stɑ:
darken => 'dɑ:kn
darkened => 'da:kənd
darkening => 'dɑ:kәniŋ
darkens => ˈdɑ:kənz
darkie => ˈdɑ:ki
darkies => 'dɑːkɪ
darkish => 'dɑ:kiʃ
darkle => 'dɑ:kl
darkling => 'dɑ:kliŋ
darkly => 'dɑ:kli
darkness => 'dɑ:knis
darkroom => 'dɑ:krum
darkrooms => ˈdɑ:kru:mz
darksome => 'dɑ:ksәm
darky => 'dɑ:ki
darling => 'dɑ:liŋ
darlings => ˈdɑ:liŋz
Darmstadt => 'dɑ:mstæt
darmstadtium => 'dɑ:mʃtætɪəm
darn => dɑ:n
darndest => 'dɑ:ndist
darned => dɑ:nd
darnel => 'dɑ:nәl
darner => 'dɑ:nә
darning => 'dɑ:niŋ
darning needle => ˈdɑ:niŋ ˈni:dl
Darnley => 'dɑ:nli
darns => dɑ:nz
darrell => 'dærәl
Darren => 'dærən
darshan => 'dә:ʃә n
dart => dɑ:t
dartboard => 'dɑ:tbɔ:d
dartboards => ˈdɑ:tbɔ:dz
darted => dɑ:tid
darter => 'dɑ:tә
darting => dɑ:tɪŋ
Dartmoor => 'dɑ:tmuә
dartmouth => 'dɑ:tmәθ
Darwin => 'dɑ:win
Darwinian => dɑ:'winiәn
Darwinism => 'dɑ:winizm
Darwinist => 'dɑ:winist
Daryl => 'dæril
dash => dæʃ
dashboard => 'dæʃbɒ:d
dashboards => ˈdæʃbɔ:dz
dashed => dæʃt
dasheen => ,dæ'ʃi:n
dasher => 'dæʃә
dashes => dæʃiz
dashi => 'dɑ:ʃi:
dashiki => dɑ:'ʃi:ki
dashing => 'dæʃiŋ
dashpot => 'dæʃ,pɔt
dassie => 'dɑ:si:
dastard => 'dæstәd
dastardliness => 'dæstədlɪnəs
dastardly => 'dæstәdli
dasyure => 'dæsiju:ә
DAT => dæt
data => 'deitә
data capture => ˈdeitə ˈkæptʃə
data mining => ˈdeitə ˈmaɪnɪŋ
data warehouse => ˈdeitə ˈwɛəhaus
databank => 'deitәbæŋk
database => 'deitәbeis
datable => 'deitәbl
dataflow => deɪ'təfləʊ
datcha => 'dɑ:tʃɑ:
date => deit
date rape => deit reip
dateable => 'deitәbl
datebook => 'deitbuk
dated => 'deitid
dateless => 'deitlis
datelined => 'deɪtlaɪn
datelines => 'deɪtlaɪn
datelining => 'deɪtlaɪn
dating => 'deitiŋ
dating agency => ˈdeitiŋ ˈeidʒənsi
dative => 'deitiv
Datong => 'dɑ:'tɔŋ
datum => 'deitәm
datura => dә'tjuәrә
daub => dɒ:b
daube => dәjb
daubed => dɔ:bd
dauber => 'dɒ:bә
daubs => dɔ:bz
daughter => 'dɒ:tә
daughter cell => ˈdɔ:tə sel
daughterboard => ˈdɔ:təbɔ:d
daughterhood => 'dɔ:tәhjd
daughterly => 'dɒ:tәli
daunorubicin => ,dɔ:nә'ru:bisin
daunt => dɒ:nt
daunted => dɔ:ntid
daunting => 'dɒ:ntiŋ
dauntingly => 'dɔːntɪŋlɪ
dauntless => 'dɒ:ntlis
daunts => dɔ:nts
dauphin => 'dɒ:fin
dauphine => 'dɔ:fi:n,-fin
Davao => 'dɑ:vaj
dave => deiv
daven => 'dɑ:vәn
davenport => 'dævәnpɒ:t
Davey => 'deivi
david => 'deivid
davidson => 'deividsn
davis => 'deivis
davit => 'dævit
davy => 'deivi
daw => dɒ:
dawdle => 'dɒ:dl
dawdled => ˈdɔ:dld
dawdler => 'dɒ:dlә
dawdles => ˈdɔ:dlz
dawdling => 'dɔ:dliŋ
Dawes => dɔ:z
dawn => dɒ:n
dawn chorus => dɔ:n ˈkɔ:rəs
dawn redwood => dɔ:n ˈredˌwʊd
dawned => dɔ:nd
dawning => 'dɒ:niŋ
dawns => dɔ:nz
dawson => 'dɔ:sn
day => dei
day boy => dei bɔi
day care => dei kɛə
day girl => dei ɡə:l
day labourer => dei ˈleɪbrə
day lily => dei ˈlili
day of rest => dei ɔv rest
day off => dei ɔf
day out => dei aut
day return => dei riˈtə:n
day trading => dei ˈtreɪdɪŋ
day trip => dei trip
Day-Glo => 'dei,ɡləu
day-tripper => 'dei,tripә(r)
Dayak => 'daiæk
Dayan => dʌ'jʌn; 'dʌjən
daybed => 'deibed
daybook => 'deibuk
daybreak => 'deibreik
daycare => 'deikεә
daydream => 'deidri:m
daydreamed => ˈdeɪˌdri:md
daydreamer => 'deidri:mә
daydreams => ˈdeɪˌdri:mz
daylight => 'deilait
daymare => 'deimeә(r)
daypack => 'deɪpæk
days => deiz
dayside => 'deisaid
dayspring => 'deispriŋ
daytime => 'deitaim
dayton => 'deitən
daywork => 'deiwә:k
dayworker => deɪ'wɜ:kər
daze => 'deiz
dazed => 'deizd
dazibao => 'dɑ:dzi'baj
dazzle => 'dæzl
dazzles => ˈdæzlz
dazzling => 'dæzliŋ
dbl => 'di:b'i:'el
DDE => ,di:,di:'i:
DDT => ,di:,di:'ti:
de => di:
de facto => dei'fæktәj
De Forest => dә'fɔrist
de novo => di: 'nәjvәj
de profundis => ,di: prәu'fʌndis, dei-
De Quincey => dә'kwinsi
de rigueur => dә ri'^\\\\:(r)
de trop => dә'trәu
de-escalate => di:'eskәleit
de-escalation => ,di:eskә'leiʃən
de-ice => ˌdi: ˈaɪs
de-icer => ˌdi: ˈaɪsə(r)
de-stress => ˌdi: ˈstres
deaccession => ,di:ik'seʃən
deacon => 'di:kәn
deaconess => 'di:kәnis
deacons => ˈdi:kənz
deaconship => 'di:kənʃɪp
deactivate => di:'æktiveit
deactivated => di:'æktɪveɪtɪd
deactivates => di:ˈæktiveits
deactivating => di:ˈæktiveitɪŋ
deactivation => di:ækti'veiʃәn
deactivator => di:'æktiveitә
dead => ded
dead centre => ded ˈsentə
dead meat => ded mi:t
dead ringer => ded ˈriŋə
dead set => ded set
deadbeat => 'ded'bi:t
deaden => 'dedn
deadened => 'dedәnd
deadener => 'dedәnә
deadening => 'dedniŋ
deadens => ˈdednz
deadeye => 'dedai
deadfall => 'dedfɒ:l
deadhead => 'dedhed
deadlight => 'dedlait
deadline => 'dedlain
deadlines => ˈdedlainz
deadliness => 'dedlinis
deadlock => 'dedlɒk
deadlocked => 'dedlɒkt
deadly => 'dedli
deadly sin => ˈdedli sin
deadman => 'dedmæn
deadness => 'dednis
deadpan => 'dedpæn
deadrise => 'ded,raiz
deadweight => 'dedweit
deaerate => di:'єәreit
deaeration => di,eiә'reiʃәn
deaf => def
deaf-aids => 'defeid
deaf-and-dumb => 'defәn'dʌm
deaf-mute => 'def'mju:t
deaf-mutes => 'defmj'u:ts
deafen => 'defәn
deafened => ˈdefənd
deafening => 'defәniŋ
deafeningly => 'defniŋli
deafens => ˈdefənz
deafer => defə
deafferentation => di,æfәren'teiʃәn
deafferented => di:'æfәrәntid
deafness => 'defnis
deal => di:l
dealer => 'di:lә
dealership => 'di:lәʃip
dealerships => ˈdi:ləʃips
dealfish => 'di:lfiʃ
dealing => 'di:liŋ
dealt => delt
deamination => di:,æmi'neiʃәn
dean => di:n
deane => di:n
deaneries => 'diːn(ə)rɪ
deanery => 'di:nәri
deanna => di'ænә
deans => di:nz
dear => 'diә
dearie => 'diәri
dearies => 'diəri
dearly => 'diәli
dearness => 'diәnis
dears => dɪə(r)
dearth => dә:θ
deary => 'diәri
deasil => 'di:zil
death => deθ
death blow => deθ bləu
death camp => deθ kæmp
death knell => deθ nel
death rate => deθ reit
death rattle => deθ ˈrætl
death ray => deθ rei
death row => deθ rəu
death squad => deθ skwɔd
death toll => deθ təul
death wish => deθ wiʃ
deathbed => 'deθbed
deathbeds => ˈdeθbedz
deathblow => 'deθblәu
deathless => 'deθlis
deathlike => 'deθlaik
deathly => 'deθli
deathtrap => 'deθtræp
deathwatch => 'deθwɒtʃ
Deauville => 'dəuvil
deb => deb
debacle => dei'bɑ:kl
debacles => dɪˈbɑ:kəlz
debag => di:'bæ^
deballast => di'bælәst
debar => di'bɑ:
debark => di'bɑ:k
debarkation => .di:bɑ:'keiʃәn
debarking => dɪ'bɑ:kɪŋ
debarment => dɪ'bɑ:mənt
debarred => dɪ'bɑ:d
debarring => dɪ'bɑ:rɪŋ
debars => di:ˈbɑ:z
debase => di'beis
debased => dɪ'beɪsd
debases => dɪˈbeɪsiz
debasing => dɪˈbeɪsɪŋ
debatable => di'beitәbl
debatably => dɪˈbeɪtəb(ə)lɪ
debate => di'beit
debated => diˈbeitid
debater => di'beitә
debaters => di:ˈbeitəz
debates => diˈbeits
debating => di'beitiŋ
debauch => di'bɒ:tʃ
debauchee => .debɒ:'tʃi:
debauchery => di'bɒ:tʃәri
debbie => 'debi
debby => 'debi
debe => 'debe
debeak => di:'bi:k
debenture => di'bentʃә
debentures => dɪˈbentʃəz
debilitate => di'biliteit
debilitated => dɪ'bɪlɪˌteɪtɪd
debilitates => dɪˈbɪlɪˌteɪts
debilitating => dɪ'bɪlɪteɪtɪŋ
debilitation => di,bili'teiʃən
debilitative => dɪ'bɪlɪ,teɪtɪv
debility => di'biliti
debit => 'debit
debiting => ˈdebɪtɪŋ
debits => ˈdebɪts
deblur => di'blә:
debonair => .debә'nєә
debone => di:'bәjn
deborah => 'debәrә
debouch => di'bautʃ
debouched => dɪ'baʊtʃ; -'buːʃ
debouches => dɪ'baʊtʃ; -'buːʃ
debouching => dɪ'baʊtʃ; -'buːʃ
debouchment => di'bajtʃmәnt
debra => 'debrә
Debrecen => 'debretsen
Debrett => di'bret
debrief => di:'bri:f
debriefed => di:ˈbri:ft
debriefing => ˌdi:'bri:fɪŋ
debriefs => di:ˈbri:fs
debris => 'deibri:
debt => det
debtor => 'detә
debtors => ˈdetəz
debug => di:'bʌg
debugged => ˌdi:ˈbʌɡd
debugger => di:'bʌ^ә
debugging => di:'bʌ^iŋ
debugs => ˌdi:ˈbʌɡz
debunk => di:'bʌŋk
debunked => di:ˈbʌŋkt
debunker => di:'bʌŋkər
debunking => di:ˈbʌŋkɪŋ
debunks => di:ˈbʌŋks
deburr => di'bә:
debus => di:'bʌs
debut => 'deibju:
debutant => 'debju:tɒŋt
debutante => 'debju:tɑ:nt
debutantes => ˈdebjʊˌtɑ:nts
debuts => ˈdeibu:z
Debye => dә'bai
deca- => 'dekә
decadal => 'dekәdәl
decade => 'dekeid
decadence => 'dekәdәns
decadent => 'dekәdәnt
decades => ˈdekeidz
decaf => 'di:kæf
decaffeinate => di'kæfiәneit
decaffeinated => ˌdi:ˈkæfɪneɪtɪd
decaffeinates => di'kæfiəneit
decaffeinating => di'kæfiəneit
decaffeination => di,kæfiə'neiʃən
decagon => 'dekәgәn
decagonal => de'kægәnәl
decahedral => .dekә'hi:drәl
decahedron => .dekә'hi:drәn
decal => 'di:kæl. di'kæl
decalcification => 'di:kælsifi'keiʃәn
decalcified => ,diː'kælsɪfaɪ
decalcify => .di:'kælsifai
decalcomania => di,kælkә'meinjә
decalogue => 'dekәlɔ^
decals => dɪ'kælz
Decameron => di'kæmәrәn
decametric => ,dekә'mi:trik
decamp => di'kæmp
decamped => dɪˈkæmpt
decamping => dɪˈkæmpɪŋ
decampment => dɪ'kæmpmənt
decamps => dɪˈkæmps
decan => 'dekәn
decanal => di'keinәl
decane => 'dekein
decani => di'keinai
decant => di'kænt
decanted => diˈkæntid
decanter => di'kæntә
decanters => diˈkæntəz
decanting => di'kæntiŋ
decants => diˈkænts
decapitate => di'kæpiteit
decapitated => dɪˈkæpɪˌteɪtid
decapitates => dɪˈkæpɪˌteɪts
decapitating => dɪˈkæpɪˌteɪtɪŋ
decapitation => .di:kæpi'teiʃәn
decapitator => di'kæpiteitә(r)
decapod => 'dekәpɒd
decapsulation => di:,kæpsju'leiʃәn
decarbonization => di:,kɑ:bәnai'zeiʃәn
decarbonize => di:'kɑ:bәaiz
decarbonized => diː'kɑːb(ə)naɪz
decarbonizer => di:'kɑ:bənaɪzər
decarbonizes => diː'kɑːb(ə)naɪz
decarbonizing => di:'kɑ:bәnaiziŋ
decarboxylase => ,di:kɑ:'bɔksәleis
decarboxylate => ,di:kɑ:'bɔksәleit
decarboxylation => ,dikɑ:,bɔksә'leiʃәn
decarburization => di:,kɑ:bjjәrai'zeiʃən; -ri'z-
decarburize => di:'kɑ:bjuәraiz
decarburized => diː'kɑːbjʊraɪz
decarburizes => diː'kɑːbjʊraɪz
decarburizing => di:kɑ:b'jʊəraɪzɪŋ
decastyle => 'dekәstail
decasyllabic => .dekәsi'læbik
decathlete => di'kæθli:t
decathlon => di'kæθlɒn
decay => di'kei
decayed => di'keid
decays => diˈkeiz
decca => 'dekә
Deccan => 'dekәn
decease => di'si:s
deceased => di'si:st
deceasing => dɪ'siːs
decedent => di'si:dәnt
deceit => di'si:t
deceitful => di'si:tful
deceitfully => dɪ'si:tfəlɪ
deceitfulness => di'si:tfəlnis
deceivable => di'si:vәbl
deceive => di'si:v
deceived => diˈsi:vd
deceiver => di'si:vә
deceives => diˈsi:vz
deceiving => diˈsi:vɪŋ
decelerate => .di:'selәreit
decelerated => di:ˈseləˌreɪtid
decelerates => di:ˈseləˌreɪts
decelerating => di:ˈseləˌreɪtɪŋ
deceleration => .di:selә'reiʃәn
decelerator => di:'selәreitә
decelerometer => di:,selә'rɔ,mi:tә
December => di'sembә
Decembrist => di'sembrist
decency => 'di:sәnsi
decennial => di'senjәl
decennium => di'seniәm
decent => 'di:sәnt
decentering => di'sentәriŋ
decentralisation => di:,sentrәlai'zeiʃən
decentralise => ,di:'sentrәlaiz
decentralised => ,di:'sentrəlaiz
decentralising => ,di:'sentrəlaiz
decentralization => di:,sentrәlai'zeiʃәn
decentralize => di:'sentrәlaiz
decentralizes => di:ˈsentrəˌlaɪziz
decentralizing => di:ˈsentrəˌlaɪzɪŋ
decentre => di'sentә
deception => di'sepʃәn
deceptions => dɪˈsepʃənz
deceptive => di'septiv
deceptiveness => di'septivnis
decerebrate => di:'seribreit
decerebrated => di:'seribrət, -breit, di:'seribreit
decerebrates => di:'seribrət, -breit, di:'seribreit
decerebrating => di:'seribrət, -breit, di:'seribreit
decerebration => di:,serә'breiʃәn
decertification => dɪsɜ:'tɪfɪkeɪʃn
decertified => diː'sɜːtɪfaɪ
decertifies => diː'sɜːtɪfaɪ
decertify => di:'sә:tifai
decertifying => diː'sɜːtɪfaɪ
deci- => 'desi
decibel => 'desibel
decibels => 'desɪbelz
decidable => di'saidәbl
decide => di'said
decided => di'saidid
decidedly => di'saididli
decides => diˈsaidz
deciding => di'saidiŋ
decidua => di'sidʒu:wә
deciduous => di'sidjuәs
decile => 'desil
deciliter => 'desili:tә(r)
decimal => 'desimәl
decimalization => .desimәlai'zeiʃәn
decimalize => 'desimәlaiz
decimalized => 'desɪm(ə)laɪz
decimalizing => 'desɪm(ə)laɪz
decimally => 'desimәli
decimate => 'desimeit
decimated => ˈdesəˌmeɪtid
decimates => ˈdesəˌmeɪts
decimating => ˈdesəˌmeɪtɪŋ
decimation => .desi'meiʃәn
decimator => 'desimeitә
decimetre => 'desi,mi:tә(r)
Decimus => 'desiməs
decipher => di'saifә
decipherable => di'saifәrәbl
deciphered => dɪˈsaɪfəd
decipherment => di'saifәmәnt
deciphers => dɪˈsaɪfəz
decision => di'siʒәn
decisive => di'saisiv
decisiveness => dɪˈsaɪsɪvnəs
Decius => 'di:ʃiəs
deck => dek
deck shoe => dek ʃu:
deck tennis => dek ˈtenis
decked => dekt
decker => 'dekә
deckhand => 'dekhænd
deckhead => 'dekhed
deckhouse => 'dekhaus
deckie => 'deki
decking => 'dekiŋ
deckle => 'dekl
deckle-edged => 'dekl'edʒd
deckled => 'dek(ə)l
declaim => di'kleim
declaimed => dɪˈkleɪmd
declaimer => di'kleimә
declaiming => dɪˈkleɪmɪŋ
declaims => dɪˈkleɪmz
declamation => .deklә'meiʃәn
declamatory => di'klæmәtәri
declarable => di'klærәbl, -'kler-
declarant => di'klєәrәnt
declaration => .deklә'reiʃәn
declarative => di'klærәtiv
declarator => di'klærәtә
declaratory => di'klærәtәri
declare => di'klєә
declared => di'klєәd
declaredly => di'klєәridli
declarer => di'klєәrә
declares => diˈklɛəz
declass => .di:'klɑ:s
declassified => di:ˈklæsəˌfaɪd
declassifies => di:ˈklæsəˌfaɪz
declassify => di:'klæsifai
declassifying => di:ˈklæsəˌfaɪŋ
declaw => diː'klɔː
declension => di'klenʃәn
declensional => di'klenʃənәl
declinable => di'klainәbl
declination => .dekli'neiʃәn
declinational => dekliˊneiʃәnl
declinature => di'klainәtʃә
decline => di'klain
declined => diˈklaind
declines => diˈklainz
declining => di'klainiŋ
declivities => dɪ'klɪvɪtɪ
declivitous => di'klivitәs
declivity => di'kliviti
declutch => .di:'klʌtʃ
declutching => ,di:'klʌtʃ
deco => 'dekәu
decoct => di'kɒkt
decocted => dɪ'kɒkt
decoction => di'kɒkʃәn
decocts => dɪ'kɒkt
decode => di:'kәud
decoded => di:ˈkəudid
decoder => di:'kәudә
decoders => di:ˈkəʊdəz
decodes => di:ˈkəudz
decoding => di'kәudiŋ
decoke => di'kәuk
decoked => di:'kəuk
decokes => di:'kəuk
decoking => di'kәukiŋ
decollate => di'kɒleit
decollated => dɪ'kɒleɪt; 'dekəleɪt
decollates => dɪ'kɒleɪt; 'dekəleɪt
decollating => dɪ'kɒleɪt; 'dekəleɪt
decollation => .di:kә'leiʃәn
decollator => ,di'kɔleitә
decollement => ,de'kɔlimәnt
decolletage => deikɔl'tɑ:ʒ
decolonization => di:,kɔlәnai'zeiʃən; -ni'z-
decolonize => di:'kɒlәnaiz
decolonized => diː'kɒlənaɪz
decolonizes => diː'kɒlənaɪz
decolonizing => diː'kɒlənaɪz
decolorization => di:kʌləraɪ'zeɪʃən
decolorize => di:'kʌlәraiz
decommission => .di:kә'miʃәn
decommissioned => ˌdi:kəˈmiʃənd
decommissions => ˌdi:kəˈmiʃənz
decompensation => di:.kɒmpen'seiʃәn
decomposable => ,di:kәm'pәjzәbl
decompose => .di:kәm'pәuz
decomposed => .di:kәm'pәuzd
decomposer => .di:kәm'pәuzә
decomposes => di:kəm'pəʊzɪz
decomposing => ˌdi:kəmˈpəʊzɪŋ
decomposition => .di:kɒmpә'ziʃәn
decompress => .di:kәm'pres
decompressed => ,diːkəm'pres
decompresses => ,diːkəm'pres
decompressing => di:kəmp'resɪŋ
decompression => ,di:kәm'preʃәn
decompressor => ,di:kәm'presә(r)
decondition => dekɒn'dɪʃn
decongest => ,di:kәn'dʒest
decongestant => ,di:kәn'dʒestәnt
decongestants => ˌdi:kənˈdʒestənts
decongestion => ,di:kәn'dʒestʃən
deconsecrate => di:'kɔnsikreit
deconsecration => 'di:,kɔnsi'kreiʃən
deconstruct => ˌdi:kənˈstrʌkt
deconstructed => ˌdi:kənˈstrʌktid
deconstructing => di:kənst'rʌktɪŋ
deconstruction => ,di:kәn'strʌkʃən
deconstructionism => dikən'strʌkʃənizm
deconstructionist => ,di:kən'strʌkʃənist
deconstructs => ˌdi:kənˈstrʌkts
decontaminate => .di:kәn'tæmineit
decontaminated => ˈdi:kənˈtæmineitid
decontaminates => ˈdi:kənˈtæmineits
decontaminating => ˈdi:kənˈtæmineitɪŋ
decontrol => .di:kәn'trәul
deconvolution => ,di:kɔnvә'lu:ʃәn
decor => 'deikɔ:(r); (?@) dei'kɔ:r
decorate => 'dekәreit
decorated => 'dekәreitid
decorates => ˈdekəreits
decoration => .dekә'reiʃәn
decorative => 'dekәreitiv
decorator => 'dekәreitә
decorators => ˈdekəˌreɪtəz
decorous => 'dekәrәs
decorously => 'dekərəslɪ
decorousness => ˊdekәrәsnis
decorticate => di:'kɒ:tikeit
decorticated => diː'kɔːtɪkeɪt
decorticates => diː'kɔːtɪkeɪt
decorum => di'kɒ:rәm
decoupage => .deiku:'pɑ:ʒ
decouple => di'kʌpl
decoupled => diˈkʌpld
decouples => diˈkʌplz
decoupling => di'kʌpliŋ
decoy => di'kɒi
decoys => ˈdi:ˌkɔɪz
decrease => 'di:kri:s
decreased => di:ˈkri:st
decreases => di:ˈkri:siz
decreasing => di'kri:siŋ
decreasingly => di:'kri:siŋli
decree => di'kri:
decree nisi => 'naisai
decreed => dɪ'kriːd
decrees => diˈkri:z
decrement => 'dekrimәnt
decrepit => di'krepit
decrepitate => di'krepiteit
decrepitated => dɪ'krepɪteɪt
decrepitates => dɪ'krepɪteɪt
decrepitating => dɪ'krepɪteɪt
decrepitude => di'krepitju:d
decrescendo => 'di:kri'ʃendәu
decrescent => di'kresnt
decretal => di'kri:tәl
decried => dɪˈkraɪd
decrier => di'kraiә
decries => dɪˈkraɪz
decriminalization => di:,kriminәlai'zeiʃən; -li'z-
decriminalize => di:ˈkrɪmɪnəlaɪz
decriminalized => di:ˈkrɪmənəˌlaɪzd
decriminalizes => di:ˈkrɪmənəˌlaɪziz
decriminalizing => di:ˈkrɪmənəˌlaɪzɪŋ
decry => di'krai
decrying => dɪˈkraɪŋ
decrypt => di:'kript
decrypted => diː'krɪpt
decryption => di:'kripʃәn
decrypts => diː'krɪpt
decubitus => di'kju:bitәs
decubitus ulcer => diˈkju:bitəs ˈʌlsə
decumbent => di'kʌmbәnt
decumbiture => di'kʌmbitʃə
decurrent => di'kʌrәnt
decurve => di:'kә:v
decurved => di'kә:vd
decussate => di'kʌseit
decussated => dɪ'kʌseɪt; 'dekəseɪt
decussates => dɪ'kʌseɪt; 'dekəseɪt
decussating => dɪ'kʌseɪt; 'dekəseɪt
decussation => ,di:kʌ'seiʃәn
dedans => dә'dә:ŋ
dedendum => di'dendәm
dedicate => 'dedikeit
dedicated => 'dedikeitid
dedicatee => .dedikә'ti:
dedicates => ˈdedikeits
dedicating => ˈdedikeitɪŋ
dedication => .dedi'keiʃәn
dedications => ˌdedɪˈkeɪʃənz
dedicator => 'dedikeitә
dedicatory => 'dedikәtәri
dedifferentiate => di:,difә'renʃieit
dedifferentiation => di:,difәrenʃi'eiʃәn
deduce => di'dju:s
deduced => diˈdju:st
deduces => diˈdju:siz
deducible => di'dju:sәbl
deducing => diˈdju:sɪŋ
deduct => di'dʌkt
deducted => diˈdʌktid
deductibility => di,dʌkti'biliti
deductible => di'dʌktәbl
deductibles => di'dʌktəblz
deducting => diˈdʌktɪŋ
deduction => di'dʌkʃәn
deductions => dɪ'dʌkʃnz
deductive => di'dʌktiv
deductively => dɪ'dʌktɪvlɪ
deducts => diˈdʌkts
dee => di:
deed => di:d
deed poll => di:d pəul
deeds => di:dz
deedy => 'di:di
deejay => 'di:dʒei
deem => di:m
deemed => di:md
deeming => di:mɪŋ
deems => di:mz
deemster => 'di:mstә
deep => di:p
deep six => di:p sɪks
deep structure => di:p ˈstrʌktʃə
deep-dish => 'di:pdiʃ
deep-drawn => ,di:p'drɔ:n
deep-dyed => 'di:pdaid
deep-fried => 'di:p'fraid
deep-fries => 'di:p'frai
deep-fry => ˈdi:pˈfraɪ
deep-set => 'di:pset
deep-six => di:p sɪks
deepen => 'dipәn
deepened => ˈdi:pənd
deepening => 'di:pәniŋ
deepens => ˈdi:pənz
deepest => dipɪst
deeply => 'di:pli
deepness => 'di:pnis
deer => diә
deer mouse => diə maus
deerhound => 'diәhaund
deerskin => 'diәskin
deerstalker => 'diәstɒ:kә
deface => di'feis
defaced => diˈfeist
defaces => diˈfeisiz
defacing => diˈfeisɪŋ
defacto => di:'fæktәu
defaecate => 'defәkeit
defalcate => di'fælkeit
defalcated => 'diːfælkeɪt
defalcates => 'diːfælkeɪt
defalcating => 'diːfælkeɪt
defalcation => .di:fæl'keiʃәn
defalcator => di'fælkeitә
defamation => .defә'meiʃәn
defamatory => di'fæmәtәri
defame => di'feim
defamed => dɪˈfeɪmd
defames => dɪˈfeɪmz
defaming => dɪ'feɪmɪŋ
defang => di:'fæŋ
defat => di:'fæt
default => di'fɒ:lt
defaulted => diˈfɔ:ltid
defaulter => di'fɒ:ltә
defaulters => diˈfɔ:ltə(r)
defeasance => di'fi:zәns
defeasible => di'fi:zәbl
defeat => di'fi:t
defeated => diˈfi:tid
defeating => diˈfi:tɪŋ
defeatism => di'fi:tizm
defeatist => di'fi:tist
defeatists => dɪˈfi:tɪsts
defeats => diˈfi:ts
defecate => 'defikeit
defecated => ˈdefikeitid
defecates => ˈdefikeits
defecating => ˈdefikeitɪŋ
defecation => .defi'keiʃәn
defecator => 'defikeitә
defecatory => 'defi,keitәri
defect => di'fekt
defection => di'fekʃәn
defections => dɪ'fekʃn
defective => di'fektiv
defectively => dɪ'fektɪvlɪ
defectiveness => diˊfektivnis
defector => di'fektә
defectors => dɪˈfektəz
defeminize => di:'femәnaiz
defence => di'fens
defence mechanism => diˈfens ˈmekənizəm
defenceless => di'fenslis
defences => dɪ'fensɪs
defend => di'fend
defendable => di'fendәbl
defendant => di'fendәnt
defendants => dɪ'fendənts
defended => diˈfendid
defender => di'fendә
defending => diˈfendɪŋ
defends => diˈfendz
defenestrate => diː'fenɪstreɪt
defenestration => di:.feni'streiʃәn
defense => di'fens
defenseless => di'fenslis
defenseman => di'fensmәn
defensibility => di.fensi'biliti
defensible => di'fensәbl
defensibly => diˊfensәbli
defensive => di'fensiv
defensively => di'fɛnsivli
defensiveness => dɪ'fensɪvnəs
defer => di'fә:
deference => 'defәrәns
deferent => 'defәrәnt
deferential => .defә'renʃәl
deferentially => ˌdefə'renʃəlɪ
deferment => di'fә:mәnt
deferments => diˈfə:mənts
deferrable => di'fә:rәbl
deferral => di'fә:rәl
deferrals => dɪ'fɜ:rəlz
deferred => di'f\\\\:d
defers => diˈfə:z
defervesce => ,difә'ves
defervescence => ,difә'vesns
defiance => di'faiәns
defiant => di'faiәnt
defibrillate => di'fibrileit, -'faibri-
defibrillation => di:,faibrә'leiʃәn
defibrillator => di'fɑibrileitә(r)
deficiencies => diˈfiʃənsiz
deficiency => di'fiʃәnsi
deficient => di'fiʃәnt
deficit => 'defisit
deficits => ˈdefisits
defied => diˈfaid
defier => di'faiә
defies => diˈfaiz
defilade => .defi'leid
defile => di'fail
defiled => dɪˈfaɪld
defilement => di'failmәnt
defiles => dɪˈfaɪlz
defiling => dɪˈfaɪlɪŋ
definable => di'fainәbl
define => di'fain
defined => di'faind
definiendum => di,fini'endәm
definiens => di'fini,әnz
definite => 'definit
definite article => ˈdefinit ˈɑ:tikl
definitely => 'definitli
definiteness => de'fɪnətnes
definition => .defi'niʃәn
definitive => di'finitiv
definitively => dɪ'fɪnətɪvlɪ
deflagrate => 'deflәgreit
deflagrated => 'defləgreɪt
deflagrates => 'defləgreɪt
deflagrating => 'defləgreɪt
deflagration => ,deflә'^reiʃәn
deflate => di'fleit
deflates => dɪˈfleɪts
deflating => dɪˈfleɪtɪŋ
deflation => di'fleiʃәn
deflationary => di'fleiʃәnәri
deflationist => di'fleiʃәnist
deflect => di'flekt
deflected => dɪf'lektɪd
deflection => di'flekʃәn
deflections => dɪf'lekʃnz
deflector => di'flektә
deflects => diˈflekts
deflexed => di'flekst
deflocculate => di:'flɔkjuleit
deflocculation => di,flɔkjj'leiʃәn
defloration => .di:flɒ:'reiʃәn
deflower => di:'flauә
deflowered => di:ˈflauəd
deflowering => di:ˈflauərɪŋ
deflowers => di:ˈflauəz
defocus => di'fәukәs
defoe => di'fәu, dә'fәu
defog => di:'fɒg
defogger => di:'fɔ^ә(r)
defoliant => di:'fәuliәnt
defoliants => di:ˈfəuliənts
defoliate => di:'fәulieit
defoliated => di:ˈfəulieitid
defoliates => di:ˈfəulieits
defoliating => di:ˈfəulieitɪŋ
defoliation => di:fәuli'eiʃәn
defoliator => di'fәulieitә
deforce => di'fɔ:s
deforest => .di:'fɒrist
deforestation => di:.fɒ:ri'steiʃәn
deforested => diˈfɔristid
deforesting => diˈfɔristɪŋ
deforests => diˈfɔrists
deform => di'fɒ:m
deformable => ,di'fɔ:mәbl
deformation => .di:fɒ:'meiʃәn
deformations => di:fɔ:'meɪʃənz
deformed => di'fɒ:md
deformities => dɪˈfɔ:mɪti:z
deformity => di'fɒ:mәti
deforms => dɪˈfɔ:mz
defraud => di'frɒ:d
defrauded => dɪˈfrɔ:did
defrauding => dɪˈfrɔ:dɪŋ
defrauds => dɪˈfrɔ:dz
defray => di'frei
defrayed => dɪˈfreɪd
defraying => dɪˈfreɪŋ
defrays => dɪˈfreɪz
defrock => di'frɔk
defrost => .di:'frɒst
defrosted => di:ˈfrɔ:stid
defroster => di:'frɒstә
defrosting => di:'frɒstɪŋ
defrosts => di:ˈfrɔ:sts
deft => deft
defter => deftə
deftness => 'deftnis
defunct => di'fʌŋkt
defund => dɪ'fʌnd
defuse => .di:'fju:z
defused => di:ˈfju:zd
defuses => di:ˈfju:ziz
defusing => di:ˈfju:zɪŋ
defy => di'fai
defying => diˈfaiŋ
degas => di:'gæs
degassed => diː'gæs
degassing => di:'^æsiŋ
degauss => di:'gaus
degaussed => diː'gaʊs
degausses => diː'gaʊs
degaussing => 'di:'^ausiŋ
degeneracy => di'dʒenәrәsi
degenerate => di'dʒenәreit
degeneration => di.dʒenә'reiʃәn
degenerative => di'dʒenәrәtiv
degenerescence => di,dʒenә'resns
deglaciation => di:,^leiʃi'eiʃәn
deglamorize => di:ˈɡlæməraiz
deglaze => ˌdi:'ɡleɪz
deglutition => .di:glu:'tiʃәn
degradability => di,^reidә'biliti
degradable => di'greidәbl
degradation => .degrә'deiʃәn
degradations => ˌdegrəˈdeɪʃənz
degradative => 'de^rәdeitiv
degrade => di'greid
degraded => di'greidid
degrades => diˈɡreidz
degrading => di'greidiŋ
degranulation => di:,^rænju'leiʃәn
degreasant => di:'^ri:sәnt
degrease => di:'gri:z
degreased => diː'griːs
degreaser => di:'^ri:zә
degreasing => di:'^ri:ziŋ
degree => di'gri:
degree day => diˈɡri: dei
degressive => di'gresiv
degu => 'dei^u:
degust => di'^ʌst
degustation => ,di:^әs'teiʃәn
dehisce => di'his
dehiscence => di'hisәns
dehiscent => di'hisәnt
dehisces => dɪ'hɪs
dehiscing => dɪ'hɪs
dehorn => di'hɔ:n
dehorned => diː'hɔːn
dehorning => di:'hɔ:nɪŋ
dehorns => diː'hɔːn
dehors => dә'hɔ:s
dehumanise => di:'hjʊmənaɪz
dehumanization => di:,hju:mәnai'zeiʃәn; -ni'z-
dehumanize => di:'hju:mәnaiz
dehumanized => di:ˈhju:məˌnaɪzd
dehumanizes => di:ˈhju:məˌnaɪziz
dehumanizing => di:ˈhju:məˌnaɪzɪŋ
dehumidification => 'di:hju:,midifi'keiʃәn
dehumidified => diːhjuː'mɪdɪfaɪ
dehumidifier => ,di:hju(:)'midifaiә
dehumidifies => diːhjuː'mɪdɪfaɪ
dehumidify => .di:hju:'midifai
dehydrate => .di:'haidreit
dehydrated => ˌdi:haɪ'dreɪtɪd
dehydration => .di:hai'dreiʃәn
dehydrator => di:'haidreitә
dehydroepiandrosterone => di:'haidrәj,epiæn'drɔstәrәjn
dehydrogenase => di:'haidrәdʒә,neis
dehydrogenate => di:'haidrәdʒәneit
dehydrogenation => di: ,haidrәdʒә'neiʃәn
deicide => 'di:isaid
deictic => 'daiktik
deification => .di:ifi'keiʃәn
deified => ˈdi:əˌfaɪd
deifies => ˈdi:əˌfaɪz
deify => 'di:ifai
deifying => ˈdi:əˌfaɪŋ
deign => dein
deigned => deɪnd
deigning => deɪnɪŋ
deigns => deɪnz
deil => di:l
Deimos => 'deimɔs
deindustrialization => di:,indʌstriәlai'zeiʃәn
deindustrialize => ,di:in'dʌstriәlaiz
deink => di:'iŋk
deinonychus => 'di:nwʌnaɪtʃəs
deinstitutionalization => dɪnstɪtju:ʃənəlaɪzɑ:'tɪ
deinstitutionalize => dɪnstɪt'ju:ʃənəlaɪz
deionization => di:aiәnai'zeiʃәn
deionize => di:'aiә,naiz
DEIRDRE => 'diədri
deism => 'di:zәm
deist => 'di:ist
deistic => di:'istik
deistical => di:'istikəl
deities => ˈdi:ɪti:z
deity => 'di:iti
deixis => 'daiksis
deject => di'dʒekt
dejected => di'dʒektid
dejectedly => dɪ'dʒektɪdlɪ
dejection => di'dʒekʃәn
dekaliter => 'dekә,li:tә
dekameter => 'dekә,mi:tә(r)
deke => di:k
Dekker => 'dekә
dekko => 'dekәu
DEL => del
delaminate => di:'læmәneit
delamination => di:,læmi'neiʃәn
delaney => di'leini
Delano => də'leinən
delate => di'leit
delated => dɪ'leɪt
delation => di'leiʃәn
Delaware => 'delәweә
Delawarean => ,delә'weәriәn
delay => di'lei
delayed => di'leid
delayer => di'leiә
delayering => ˌdi:'leɪərɪŋ
delays => diˈleiz
dele => 'di:li:
delectability => di,lektə'biləti
delectable => di'lektәbl
delectation => di:lek'teiʃәn
delegable => 'deli^әbl
delegacy => 'deligәsi
delegate => 'deligeit
delegates => ˈdeliɡits
delegation => .deli'geiʃәn
delegations => ˌdelɪˈgeɪʃənz
delegitimate => ,di:li'dʒitimeit
delegitimation => 'di:li,dʒiti'meiʃәn
delegitimization => ,di:li-,dʒitimai'zeiʃən; -mi'z-
delete => di'li:t
deleterious => .deli'tiәriәs
deleteriously => deliˊtiәriәsli
deletes => diˈli:ts
deletion => di'li:ʃәn
delft => delft
delftware => 'delftweə
delhi => 'deli
deli => 'deli
delia => 'di:ljә
Delian => 'di:ljәn
deliberate => di'libәrәt
deliberately => di'libәrәtli
deliberates => diˈlibərits
deliberating => diˈlibəritɪŋ
deliberation => di.libә'reiʃәn
deliberations => dɪˌlɪbəˈreɪʃənz
deliberative => di'libәrәtiv
deliberatively => dɪ'lɪbərətɪvlɪ
delicacies => 'delɪkəsɪz
delicacy => 'delikәsi
delicate => 'delikәt
delicateness => 'delɪkətnes
delicatessen => ,delikә'tesn
delicatessens => delɪkə'tesnz
delicious => di'liʃәs
deliciousness => di'liʃəsnis
delict => di'likt
delight => di'lait
delighted => di'laitid
delightedly => dɪ'laɪtɪdlɪ
delightful => di'laitful
delightfully => dɪ'laɪtfəlɪ
delightfulness => diˊlaitfulnis
delighting => diˈlaitɪŋ
delights => diˈlaits
Delilah => di'lailә
delimit => di'limit
delimitation => di.limi'teiʃәn
delimiter => di:'limitә
delimits => dɪˈlɪmɪts
delineate => di'linieit
delineated => dɪˈlɪni:ˌeɪtid
delineates => dɪˈlɪni:ˌeɪts
delineating => dɪˈlɪni:ˌeɪtɪŋ
delineation => di.lini'eiʃәn
delineator => di'linieitә
delinquencies => dɪˈlɪŋkwənsi:z
delinquency => di'liŋkwәnsi
delinquent => di'liŋkwәnt
delinquents => dɪ'lɪŋkwənts
deliquesce => .deli'kwes
deliquesced => ,delɪ'kwes
deliquescence => .deli'kwesns
deliquescent => .deli'kwesnt
deliquescing => ,delɪ'kwes
deliriant => di'liriәnt
delirious => di'liriәs
delirium => di'liriәm
delish => di'liʃ
delist => di:'list
delisted => di:ˈlistid
delisting => di'listiŋ
delists => di:ˈlists
deliver => di'livә
deliverable => di'livәrәbl
deliverance => di'livәrәns
delivered => di'livәd
deliverer => di'livәrә
delivering => diˈlivərɪŋ
delivers => diˈlivəz
delivery => di'livәri
deliverymen => dɪ'lɪvərɪmæn
dell => del
della => 'delә
Deller => del
dells => 'delz
delocalize => di:'lәukәlaiz
delocalizes => diː'ləʊk(ə)laɪz
delocalizing => diː'ləʊk(ə)laɪz
Delos => 'di:lɔs
delouse => di:'laus
deloused => diː'laʊs
delouses => diː'laʊs
delphi => 'delfai
Delphic => 'delfik
delphinium => del'finiәm
delphiniums => delˈfiniəmz
delta => 'deltә
delta wing => ˈdeltə wiŋ
deltaic => del'teiik
deltas => ˈdeltəz
deltiologist => ,delti'ɔlәdʒist
deltiology => ,delti'ɔlәdʒi
deltoid => 'deltɒid
delude => di'lu:d
deluded => dɪˈlu:did
deludes => dɪˈlu:dz
deluding => dɪˈlu:dɪŋ
deluge => 'delju:dʒ
deluged => ˈdelju:dʒd
deluges => ˈdelju:dʒz
deluging => ˈdelju:dʒɪŋ
delusion => di'lu:ʒәn
delusions => diˈlu:ʒənz
delusive => di'lu:siv
delusively => dɪ'lu:sɪvlɪ
delusiveness => diˊluːsivnis
delusory => di'lu:sәri
delustre => di:'lʌstә(r)
deluxe => dә'luks
delve => delv
delved => delvd
delver => 'delvə
delves => delvz
delving => delvɪŋ
DEM => dem
demagnetization => di:mæ^nitai'zeiʃәn
demagnetize => di:'mægnitaiz
demagnetized => diː'mægnɪtaɪz
demagnetizes => diː'mægnɪtaɪz
demagogic => ,demә'^ɔ^ik
demagogue => 'demәgɒg
demagoguery => 'demәgɒgәri
demagogues => ˈdeməɡɔɡz
demagogy => 'demә^ɔ^i
demand => di'mɑ:nd
demand-pull => di'mɑ:ndpjl
demanded => diˈmɑ:ndid
demander => di'mɑ:ndә
demanding => di'mɑ:ndiŋ
demands => diˈmɑ:ndz
demantoid => di'mæntɔid
demarcate => 'di:mɑ:keit
demarcated => dɪˈmɑ:ˌkeɪtid
demarcates => dɪˈmɑ:ˌkeɪts
demarcating => dɪˈmɑ:ˌkeɪtɪŋ
demarcation => .di:mɑ:'keiʃәn
demarcator => diː'mɑːkeɪtə
demarche => deɪ'mɑ:ʃ
demark => di'mɑ:k
dematerialization => di:mətɪərɪəlaɪzeɪnʃ
dematerialize => .di:mә'tiәriәlaiz
dematerialized => diːmə'tɪərɪəlaɪz
dematerializes => diːmə'tɪərɪəlaɪz
dematerializing => diːmə'tɪərɪəlaɪz
deme => di: m
demean => di'mi:n
demeaned => dɪˈmi:nd
demeaning => di'mi:niŋ
demeanor => di'mi:nә
demeanour => di'mi:nә
demeans => dɪˈmi:nz
dement => di'ment
demented => di'mentid
dementedly => di'mentidli
dementia => di'menʃiә
demerara => .demә'rerә
demerge => ˌdi:ˈmɜ:dʒ
demerger => di'mә:dʒә
demerit => di:'merit
demerits => dɪ'merɪts
demersal => di:'mә:sl
demesne => di'mein
demeter => di'mi:tә
Demetrius => dә'mi:triәs
Demi => 'di:mai
demi- => 'demi
demi-monde => ˌdemi ˈmɒnd
demi-sec => ˌdemi ˈsek
demigod => 'demigɒd
demigoddess => 'demigɒdis
demijohn => 'demidʒɒn
demijohns => 'demɪdʒɒn
demilitarise => ,di: 'militәraiz
demilitarize => di:'militәraiz
demilitarized => di:mɪlɪtəˌraɪzd
demilitarizes => di:ˈmilitəraiziz
demilitarizing => di:ˈmilitəraizɪŋ
demilune => 'demilu:n
demimonde => 'demi'mɔ:nd
demineralize => di:'minәrәlaiz
demineralizes => di:'minərəlaiz
demirep => 'demirep
demise => di'maiz
demisemiquaver => 'demisemi.kweivә
demission => di'miʃәn
demist => .di:'mist
demisted => ,di:'mist
demister => di'mistә
demisting => 'diːmɪstɪŋ
demists => ,di:'mist
demit => di'mit
demitasse => 'demitɑ:s
demitted => dɪ'mɪt
demitting => dɪ'mɪt
demiurge => 'demiә:dʒ
demiurgic => .demi'ә:dʒik
Demo => 'demәu
demob => di:'mɔb
demobbed => diː'mɒbd
demobbing => diː'mɒb
demobilisation => 'di:,məu-bilai'zeiʃən, -li'z-
demobilise => di: 'mәjbilaiz
demobilize => di:'mәubilaiz
demobilized => di:ˈməʊbəˌlaɪzd
demobilizes => di:ˈməʊbəˌlaɪziz
demobilizing => di:ˈməʊbəˌlaɪzɪŋ
demobs => diː'mɒb
democracies => diˈmɔkrəsiz
democracy => di'mɒkrәsi
democrat => 'demәkræt
democratic => .demә'krætik
democratic centralism => ˌdeməˈkrætik ˈsentrəlizəm
democratically => .demә'krætikli
democratise => di'mɔkrәtaiz
democratize => di'mɒkrәtaiz
democratized => diˈmɔkrətaizd
democratizes => diˈmɔkrətaiziz
democratizing => diˈmɔkrətaizɪŋ
Democritus => di'mɔkritәs
demodulate => di:'mɒdjuleit
demodulates => diː'mɒdjʊleɪt
demodulation => di:'mɒdju'leiʃәn
demodulator => di:'mɔdjuleitә
demographer => di:'mɒgrәfә
demographic => .demә'græfik
demographical => ,demə'ɡræfik;-kəl
demographics => .demә'ɡræfiks
demography => di:'mɒgrәfi
demoiselle => ,demwɑ:'zel
demoiselles => ,demwɑː'zel
demolish => di'mɒliʃ
demolished => diˈmɔliʃt
demolishes => diˈmɔliʃiz
demolishing => diˈmɔliʃɪŋ
demolition => .demә'liʃәn
demolition derby => ˌdeməˈlɪʃən ˈdɜ:bi:
demolitions => ˌdeməˈlɪʃənz
demon => 'di:mәn
demonetization => di:mʌnitai'zeiʃәn
demonetize => di:'mʌnitaiz
demonetized => diː'mʌnɪtaɪz; -mɒn-
demonetizes => diː'mʌnɪtaɪz; -mɒn-
demonetizing => diː'mʌnɪtaɪz; -mɒn-
demoniac => di'mәuniæk
demoniacal => di:mә'naiәk(ә)l
demoniacally => di:mə'naɪəklɪ
demonic => di'mɒnik
demonism => 'di:mәnizm
demonization => ,di:mənai'zeiʃən, -ni'z-
demonize => 'di:mәnaiz
demonized => ˈdi:mənaizd
demonizes => ˈdi:mənaiziz
demono- => 'di:mәnәj
demonolatry => .di:mә'nɒlәtri
demonological => di:mənɒ'lɒdʒɪkəl
demonologist => di:'mənɒlədʒɪst
demonology => ,di:mә'nɔlәdʒi
demonopolize => .di:mә'nɒpәlaiz
demonstrability => .demәnstrә'biliti
demonstrable => 'demәnstrәbl
demonstrably => 'demәnstrәbli
demonstrate => 'demәnstreit
demonstrated => ˈdemənstreitid
demonstrates => ˈdemənstreits
demonstrating => ˈdemənstreitɪŋ
demonstration => .demәn'streiʃәn
demonstrations => demənst'reɪʃnz
demonstrative => di'mɒnstrәtiv
demonstrative pronoun => dɪˈmɔnstrətɪv ˈprəunaun
demonstratives => 'dɪmɒnstrətɪvz
demonstrator => 'demәnstreitә
demonstrators => ˈdemənstreitəz
demoralisation => di,mɔrə-lai'zeiʃən; -li'z-
demoralise => di'mɔrәlaiz
demoralised => di'mɔrəlalz
demoralization => di.mɒrәlai'zeiʃәn
demoralize => di'mɒrәlaiz
demoralized => dɪˈmɔ:rəˌlaɪzd
demoralizes => dɪˈmɔ:rəˌlaɪziz
demoralizing => dɪ'mɒrəlaɪzɪŋ
demos => 'di:mɒs
Demosthenes => di'mɒsθәni:z
demote => .di:'mәut
demoted => dɪˈməʊtid
demotes => dɪˈməʊts
demotic => di'mɒtik
demoting => dɪˈməʊtɪŋ
demotion => di'mәuʃәn
demotivate => ˌdi:ˈməʊtɪveɪt
demotivation => di:,məuti'veiʃən
demount => di:'maunt
demountable => di:'majntәbl
Dempster => 'dempstә(r)
demulcent => di'mʌlsәnt
demur => di'mә:
demure => di'mjuә
demurely => dɪ'mjʊrli
demurrable => di'm\\\\:rәbl
demurrage => di'mʌridʒ
demurral => di'mә:rәl
demurred => dɪˈmɜ:d
demurrer => di'mә:rә
demurring => dɪˈmɜ:ɪŋ
demurs => dɪˈmɜ:z
demy => di'mai
demyelinate => di:'maiәlineit
demyelination => di:,maiәli'neiʃәn
demystification => di:,mistifi'keiʃәn
demystified => di:ˈmistifaid
demystifies => di:ˈmistifaiz
demystify => di:'mistifai
demystifying => di:ˈmistifaiŋ
demythologize => ,di:mi'θɔlәdʒaiz
demythologized => diːmɪ'θɒlədʒaɪz
demythologizes => diːmɪ'θɒlədʒaɪz
demythologizing => diːmɪ'θɒlədʒaɪz
den => den
den mother => den ˈmʌðə
Denali => dә'nɑ:li
denarius => di'neәriәs
denary => 'di:nәri
denationalization => di:næʃәnәlai'zeiʃ(ә)n
denationalize => di:'næʃnәlaiz
denaturalization => 'di:,nætʃәrәlai'zeiʃәn
denaturalize => di:'nætʃәrәlaiz
denaturalized => diː'nætʃ(ə)rəlaɪz
denaturalizes => diː'nætʃ(ə)rəlaɪz
denaturalizing => diː'nætʃ(ə)rəlaɪz
denaturant => di:'neitʃәrәnt
denaturation => di:.neitʃә'reiʃәn
denature => di:'neitʃә
denatured => di:'neɪtʃəd
denazification => di:,nɑ:tsifi'keiʃәn
denazified => diː'nɑːtsɪfaɪ
denazifies => diː'nɑːtsɪfaɪ
denazify => di:'nɑ:tsifai
denazifying => diː'nɑːtsɪfaɪ
Denbigh => 'denbi
Denbighshire => 'denbiʃә(r)
dendrimer => 'dendrɪmər
dendrite => 'dendrait
dendritic => den'dritik
dendro- => 'dendrəʊ
dendrochronological => dendrəu,krɔnə-'lɔdʒikəl
dendrochronology => ,dendrәukrә'nɔlәdʒi
dendrogram => 'dendrә^ræm
dendroid => 'dendrɒid
dendrological => ,dendrə'lɔdʒikəl
dendrology => den'drɒlәdʒi
dendron => 'dendrɔn
dene => di:n
Denebola => di'nebәlә
denervate => di:'nә:veit
dengue => 'deŋgi
deniability => di,naiə'biləti
deniable => di'naiәbl
denial => di'naiәl
denials => diˈnaiəlz
denier => di'naiә
denigrate => 'denigreit
denigrated => ˈdenɪˌgreɪtid
denigrates => ˈdenɪˌgreɪts
denigrating => ˈdenɪˌgreɪtɪŋ
denigratory => 'deni^rә,tәri
denim => 'denim
denis => 'denis
Denise => dә'ni:z, de'-
Denison => 'denisən
denitrification => di:naitrifi'keiʃәn
denitrified => diː'naɪtrɪfaɪ
denitrifies => diː'naɪtrɪfaɪ
denitrify => di:'naitrifai
denitrifying => 'denɪtrɪfaɪɪŋ
denizen => 'denizn
denizens => ˈdenɪzənz
Denmark => 'denmɑ:k
dennis => 'denis
Dennison => 'denisәn
denny => 'deni
denominal => di'nɔminәl
denominate => di'nɒmineit
denominated => dɪ'nɒmɪneɪt
denominates => dɪ'nɒmɪneɪt
denominating => dɪ'nɒmɪneɪt
denomination => di.nɒmi'neiʃәn
denominational => dinɔmi'neiʃәn(ә)l
denominationalism => di,nɔmi'neiʃәnәlizәm
denominations => dɪˌnɔməˈneɪʃənz
denominative => di'nɒminәtiv
denominator => di'nɒmineitә
denominators => dɪˈnɔməˌneɪtəz
denotation => .di:nәu'teiʃәn
denotative => di'nәutәtiv
denote => di'nәut
denoted => diˈnəutid
denotes => diˈnəuts
denoting => diˈnəutɪŋ
denouement => dei'nu:mɔŋ; (?@) dei'nu:mɔ:ŋ
denouements => ˌdeɪnu:ˈmɑ:ŋz
denounce => di'nauns
denounced => diˈnaunst
denounces => diˈnaunsiz
denouncing => diˈnaunsɪŋ
dens => denz
dense => dens
densely => 'densli
denseness => 'densnis
densification => ,densifi'keiʃәn
densify => 'densifai
densimeter => den'simitә
densities => ˈdensitiz
densitometer => ,densi'tɔmitә
densitometric => den'sɪtəmetrɪk
densitometry => ,densi'tɔmitri
density => 'densiti
dent => dent
dental => 'dentl
dental technician => ˈdentəl tekˈniʃən
dentalium => den'teiliәm
dentalize => 'dentәlaiz
dentally => 'dentəl
dentary => 'dentәri
dentate => 'denteit
dentelle => den'tel, dɑ:n-
dentex => 'denteks
denticle => 'dentikl
denticulate => den'tikjulit
dentifrice => 'dentifris
dentil => 'dentil
dentilingual => ,denti'liŋ^wәl
dentinal => 'dentinәl
dentine => 'denti:n
dentist => 'dentist
dentistry => 'dentistri
dentists => ˈdentists
dentition => den'tiʃәn
denton => 'dentәn
dents => 'dents
denture => 'dentʃә
dentures => ˈdentʃəz
denturist => 'dentʃәrist
denuclearization => di,njʊklɪərɪ'zeʃən
denuclearize => di:'nju:kliәraiz
denudation => .di:nju:'deiʃәn
denude => di'nju:d
denuded => dɪˈnu:did
denudes => dɪˈnu:dz
denuding => dɪˈnu:dɪŋ
denumerability => di:nju:mərə'bɪlɪtɪ
denumerable => di'nju:mәrәbl
denunciation => di.nʌnsi'eiʃәn
denunciations => dɪˌnʌnsi:ˈeɪʃənz
denunciator => di'nʌnsieitә
denunciatory => di'nʌnsiәtәri
Denver => 'denvә
deny => di'nai
denying => diˈnaiŋ
Deo volente => 'di:әu vәu'lenti
deodar => 'diәudɑ:
deodorant => di:'әudәrәnt
deodorants => di':əʊdərənts
deodorize => di:'әudәraiz
deodorized => di:ˈəudəraizd
deodorizer => di:'әudәraizә
deodorizes => di:ˈəudəraiziz
deontic => di'ɔntik
deontological => di:,ɔntə'lɔdʒikəl
deontology => .di:ɒn'tɒlәdʒi
deoxidation => di:,ɔksi'deiʃәn
deoxidize => di:'ɒksidaiz
deoxidizer => di:'ɒksidaizә
deoxidizing => di:ɒksɪ'daɪzɪŋ
deoxycorticosterone => di:'ɔksi,kɔ:ti'kɔstәrәjn
deoxygenate => di:'ɒksidʒineit
deoxyribonuclease => di:'ɔksi,rɑibәj'nju:klieis
deoxyribonucleic => di:'ɔksi,raibәu'nju:kli:ik
deoxyribose => di:,ɔksi'rɑibәjs
depart => di'pɑ:t
depart from => diˈpɑ:t frɔm
departed => di'pɑ:tid
departing => diˈpɑ:tɪŋ
department => di'pɑ:tmәnt
departmental => .di:pɑ:t'mentәl
departmentalism => ,di:pɑ:t'mentәlizәm
departmentalization => di:pɑ:t,mentәlai'zeiʃәn
departmentalize => ,di:pɑ:t'mentlaiz
departments => dɪ'pɑ:tmənts
departs => diˈpɑ:ts
departure => di'pɑ:tʃә
depasturage => di:'pɑ:stʃәridʒ
depasture => di:'pɑ:stʃә
depauperate => di:'pɒ:pәreit
depend => di'pend
dependability => di.pendә'biliti
dependable => di'pendәbl
dependably => di'pendәbli
dependant => di'pendәnt
dependants => dɪˈpendənts
depended => diˈpendid
dependence => di'pendәns
dependency => di'pendәnsi
dependent => di'pendәnt
dependent clause => diˈpendənt klɔ:z
depersonalization => di:,p\\\\:sәnәlai'zeiʃәn; -li'z-
depersonalize => di:'pә:sәnә,laiz
depersonalized => di:ˈpə:sənəˌlaizd
depersonalizes => di:ˈpə:sənəˌlaiziz
depersonalizing => di:ˈpə:sənəˌlaizɪŋ
dephlogisticated => diflɔ'dʒistikeitid
depict => di'pikt
depicted => diˈpiktid
depicting => diˈpiktɪŋ
depiction => di'pikʃәn
depictions => dɪˈpɪkʃənz
depicts => diˈpikts
depigment => di:'pi^mәnt
depigmentation => di:pi^mәn'teiʃәn
depilate => 'depileit
depilated => 'depɪleɪt
depilation => .depi'leiʃәn
depilator => 'depileitә
depilatory => di'pilәtәri
deplane => di:'plein
deplaned => diː'pleɪn
deplanes => diː'pleɪn
deplaning => 'di:pleɪnɪŋ
deplete => di'pli:t
depletes => diˈpli:ts
depleting => diˈpli:tɪŋ
depletion => di'pli:ʃәn
deplorable => di'plɒ:rәbl
deplorably => di'plɒ:rәbli
deplore => di'plɒ:
deplored => diˈplɔ:d
deplores => diˈplɔ:z
deploring => diˈplɔ:ɪŋ
deploy => di'plɒi
deployed => diˈplɔid
deploying => diˈplɔiŋ
deploys => diˈplɔiz
deplume => di'plu:m
deplumed => dɪ'pluːm
deplumes => dɪ'pluːm
depluming => dɪ'pluːm
depolarization => di:,pәulәrai'zeiʃәn
depolarize => di:'pәulәraiz
depoliticization => 'di:pə-,litisai'zeiʃən; -si'z-
depoliticize => ˌdi:pə'lɪtəˌsaɪz
depoliticized => diːpə'lɪtɪsaɪz
depolymerization => di:,pɔlimәrai'zeiʃәn
depolymerize => di:'pɔlimәraiz
deponent => di'pәunәnt
depopulate => di:'pɒpjuleit
depopulated => di:ˈpɔpjuleitid
depopulates => di:ˈpɔpjuleits
depopulating => di:ˈpɔpjuleitɪŋ
deport => di'pɒ:t
deportable => di'pɔ:tәbl
deportation => .di:pɒ:'teiʃәn
deportations => diːpɔː'teɪʃ(ə)n
deported => diˈpɔ:tid
deportee => .di:pɒ:'ti:
deporting => diˈpɔ:tɪŋ
deportment => di'pɒ:tmәnt
deports => diˈpɔ:ts
depose => di'pәuz
deposed => dɪˈpəʊzd
deposes => dɪˈpəʊziz
deposing => dɪˈpəʊzɪŋ
deposit => di'pɒzit
depositary => di'pɒzitәri
depositing => di'pɔzitiŋ
deposition => .depә'ziʃәn
depositor => di'pɒzitә
depositories => diˈpɔzitəriz
depositors => dɪ'pɒzɪtəz
depository => di'pɒzitәri
deposits => diˈpɔzits
depot => 'depәu
depots => 'depəʊz
depravation => .deprә'veiʃәn
deprave => di'preiv
depraved => di'preivd
depraves => diˈpreivz
depraving => diˈpreivɪŋ
depravity => di'præviti
deprecate => 'deprәkeit
deprecated => ˈdeprikeitid
deprecates => ˈdeprikeits
deprecating => ˈdeprikeitɪŋ
deprecatingly => 'deprәkeitiŋli
deprecation => .depri'keiʃәn
deprecative => 'deprikeitiv
deprecatory => 'deprikәtәri
depreciate => di'pri:ʃieit
depreciated => dɪˈpri:ʃi:ˌeɪtid
depreciates => dɪˈpri:ʃi:ˌeɪts
depreciating => dɪˈpri:ʃi:ˌeɪtɪŋ
depreciation => di.pri:ʃi'eiʃәn
depreciatory => di'pri:ʃiәtәri
depredation => .depri'deiʃәn
depredations => ˌdeprɪˈdeɪʃənz
depredatory => di'predәtәri,'depridei-
depress => di'pres
depressant => di'presnt
depressed => di'prest
depresses => diˈpresiz
depressible => di'presәbl
depressing => di'presiŋ
depressingly => dɪ'presɪŋlɪ
depression => di'preʃәn
depressions => dɪp'reʃnz
depressive => di'presiv
depressives => diˈpresivz
depressor => di'presә
depressurization => di:,preʃərai'zeiʃən, -ri'z-
depressurize => ,di: 'preʃәraiz
depressurized => diː'preʃəraɪz
depressurizes => diː'preʃəraɪz
deprival => di'praivәl
deprivation => .depri'veiʃәn
deprivations => ˌdeprəˈveɪʃənz
deprive => di'praiv
deprives => diˈpraivz
depriving => diˈpraivɪŋ
deprogrammer => di:'prəuɡræmə
deproteinize => di:'prәutinaiz
depth => depθ
depthless => 'depθlɪs
depts => dept
depurate => 'depjureit
depurative => di'pjurәtiv
deputation => .depju'teiʃәn
depute => di'pju:t
deputed => dɪˈpju:tid
deputes => dɪˈpju:ts
deputies => ˈdepjutiz
deputing => dɪˈpju:tɪŋ
deputize => 'depjutaiz
deputized => ˈdepjəˌtaɪzd
deputizes => ˈdepjəˌtaɪziz
deputizing => ˈdepjəˌtaɪzɪŋ
deputy => 'depjuti
deracinate => di'ræsineit
deracinated => dɪ'ræsɪneɪt
deracinates => dɪ'ræsɪneɪt
deracinating => dɪ'ræsɪneɪt
derail => di'reil
derailed => dɪ'reɪld
derailing => di:ˈreɪlɪŋ
derailleur => di:'reiljuә
derails => di:ˈreɪlz
derange => di'reindʒ
deranged => di'reindʒd
deranges => diˈreindʒdz
deranging => diˈreindʒdɪŋ
derate => .di:'reit
derated => di:'reitid
derates => diː'reɪt
derating => di'reitiŋ
deration => di:'ræʃәn
derbies => 'dɜ:rbɪz
derby => 'dɑ:bi
Derbyshire => 'dɑ:biʃiә
derealization => di:riәlai'zeiʃәn
deregister => di'redʒistә
deregulate => di:re^jjleit
deregulated => diˈreɡjuˌleitid
deregulates => diˈreɡjuˌleits
deregulating => diˈreɡjuˌleitɪŋ
deregulation => di:.regju'leiʃәn
derek => 'derik
derelict => 'derilikt
dereliction => .deri'likʃәn
derelicts => ˈderəˌlɪkts
derepress => ,di:ri'pres
derequisition => 'di:.rekwi'ziʃәn
derequisitioned => di:,rekwiə'ziʃən
derequisitioning => di:,rekwiə'ziʃən
derequisitions => di:,rekwiə'ziʃən
derestrict => 'di:ris'trikt
derestricted => ,diːrɪ'strɪkt
derestricting => ,diːrɪ'strɪkt
derestricts => ,diːrɪ'strɪkt
deride => di'raid
derided => dɪˈraɪdid
derides => dɪˈraɪdz
deriding => dɪˈraɪdɪŋ
derisible => di'rizibl
derision => di'riʒәn
derisive => di'raisiv
derisively => dɪ'raɪsɪvlɪ
derisiveness => diˊraisivnis
derisory => di'raisәri
derivable => di'raivәbl
derivate => 'deriveit
derivation => .deri'veiʃәn
derivational => ˌderɪ'veɪʃənəl
derivations => derɪ'veɪʃnz
derivative => di'rivәtiv
derivatively => diˊrivәtivli
derive => di'raiv
derives => diˈraivz
deriving => diˈraivɪŋ
derm => dә:m
derma => 'dә:mә
dermabrasion => ,dә:mә'breiʒәn
dermal => 'dә:mәl
dermapteran => d\\\\:'mæptәrәn
dermatitis => .dә:mә'taitis
dermatoglyph => 'dә:mәtәu^lif
dermatoglyphic => ,də:mətə'ɡlifik
dermatoglyphics => ,dә:mәtә'^lifiks
dermatologic => ,d\\\\:mәtә'lɔdʒik
dermatologist => .dә:mә'tɒlәdʒist
dermatology => .dә:mә'tɒlәdʒi
dermatome => 'dә:mәtәum
dermatomycosis => ,dә:mәtәumai'kәusis
dermatomyositis => ,dә:mәtә,maiә'saitis
dermatophyte => 'dә:mәtәufait, dә'mætә-
dermatophytosis => dә,mætәfai'tәusis
dermatosis => .dә:mә'tәusis
dermestid => d\\\\:'mestid
dermic => 'dә:mik
dermis => 'dә:mis
dermoid => 'dә:mɔid
dernier cri => dә:'njei kri:
derogate => 'derәugeit
derogated => 'derəgeɪt
derogates => 'derəgeɪt
derogating => 'derəgeɪt
derogation => .derә'geiʃәn
derogative => di'rɔ^әtiv
derogatorily => dɪrɒɡə'tərɪlɪ
derogatory => di'rɒgәtәri
derrick => 'derik
derricks => 'derɪks
derriere => ,deri'eә
derring-do => 'deriŋ'du:
derringer => 'derindʒә
derris => 'deris
Derry => 'deri
derv => dә:v
dervish => 'dә:viʃ
dervishes => ˈdə:viʃiz
Derwent => 'də:wənt
Des Moines => di'mɔinz
des res => ˌdez ˈrez
desacralization => di:,seikrəlai'zeiʃən; -li'z-
desacralize => di:'seikrәlaiz
desalinate => di:'sælineit
desalinated => di:'sælineit
desalination => di:,sæli'neiʃәn
desalinator => di:sælɪ'neɪtə
desalinization => di:.sælinai'zeiʃәn. -ni'z-
desalinize => di:'sælinaiz
desalinized => diː'sælɪnaɪz
desalinizes => diː'sælɪnaɪz
desalinizing => diː'sælɪnaɪz
desalt => di:'sɒ:lt
desalting => di:'sɔ:ltiŋ
desaturate => di:'sætʃәreit
desaturation => di:,sætju'reiʃәn
descale => di:'skeil
descaled => ,di:'skeil
descaler => di:'skeilә
descales => ,di:'skeil
descaling => di:'skeiliŋ
descant => 'deskænt
descanted => 'deskænt
descanting => 'deskænt
descants => ˈdesˌkænts
Descartes => dei'kɑ:t, dekart
descend => di'send
descendant => di'sendәnt
descendent => di'sendәnt
descender => di'sendә(r)
descendible => di'sendәbl
descending => di'sendiŋ
descending colon => diˈsendiŋ ˈkəulən
descends => diˈsendz
descent => di'sent
descents => diˈsents
describable => di'skraibәbl
describe => di'skraib
describer => dis'kraibә
description => di'skripʃәn
descriptive => di'skriptiv
descriptiveness => disˊkriptivnis
descriptivism => di'skriptivizəm
descriptor => dis'kriptә
descry => di'skrai
Desdemona => ,dezdi'məunə
desecrate => 'desikreit
desecrated => ˈdesɪˌkreɪtid
desecrates => ˈdesɪˌkreɪts
desecrating => ˈdesɪˌkreɪtɪŋ
desecration => .desi'kreiʃәn
deseed => di:'si:d
deseeder => di:'si:dә
desegregate => di:'segrigeit
desegregated => di:ˈseɡriˌɡeitid
desegregates => di:ˈseɡriˌɡeits
desegregating => di:ˈseɡriˌɡeitɪŋ
desegregation => .di:segri'geiʃәn
deselect => .di:si'lekt
desensitize => di:'sensitaiz
desensitized => ˌdi:ˈsensitaizd
desensitizes => ˌdi:ˈsensitaiziz
desensitizing => di:'sensɪtaɪzɪŋ
desert => 'dezәt. di'sә:t
desert boot => ˈdezət bu:t
desert island => ˈdezət ˈailənd
desert rose => ˈdezət rəuz
desert varnish => ˈdezət ˈvɑ:niʃ
deserted => di'zә:tid
deserter => 'dezәtә
deserters => di'zə:təz
desertification => ,dezә:tifi'keiʃәn
deserting => ˈdezətɪŋ
desertion => di'zә:ʃәn
deserts => dɪˈzɜ:ts
deserve => di'zә:v
deserved => di'zә:vd
deservedly => di'zә:vidli
deserves => diˈzə:vz
deserving => di'zә:viŋ
deservingly => diˊzәːviŋli
desex => di:'seks
desexualize => di:'seksjjәlaiz
desexualized => diː'seksjʊəlaɪz; -'sekʃʊəl-
desexualizes => diː'seksjʊəlaɪz; -'sekʃʊəl-
desexualizing => diː'seksjʊəlaɪz; -'sekʃʊəl-
desi => 'dezi:
desiccant => 'desikәnt
desiccate => 'desikeit
desiccated => ˈdesɪkeɪtɪd
desiccation => .desi'keiʃәn
desiccative => de'sikәtiv
desiccator => 'desikeitә
desiderata => di'zidә,reitә
desiderate => di'zidәreit
desiderated => dɪ'zɪdəreɪt; -'sɪd-
desiderative => di'zidәrәtiv
desideratum => di.zidә'reitәm
design => di'zain
designate => 'dezigneit
designated => 'deziɡ.neitid
designates => ˈdeziɡneits
designating => ˈdeziɡneitɪŋ
designation => .dezig'neiʃәn
designations => ˌdezɪgˈneɪʃənz
designator => 'dezigneitә
designed => di'zaind
designedly => di'zainidli
designee => ,dezi^'ni:, desi-
designer => di'zainә
designer drug => dɪˈzaɪnə drʌɡ
designing => di'zainiŋ
desirability => di.zairә'biliti
desirable => di'zairәbl
desirably => di'zairәbli
desire => di'zaiә
desired => di'zaiәd
Desiree => di'ziərei
desiring => diˈzaiərɪŋ
desirous => di'zaiәrәs
desist => di'zist
desisted => dɪˈsɪstid
desisting => dɪˈsɪstɪŋ
desists => dɪˈsɪsts
desk => desk
desk-bound => 'deskbaʊnd
deskill => di:ˈskɪl
desktop => 'desktɔp
desktop publishing => ˈdeskˌtɔp ˈpʌblɪʃɪŋ
desman => 'desmәn
desmid => 'desmid
desmoid => 'desmɔid
desmond => 'dezmәnd
desmosomal => 'dezmʊsəməl
desmosome => 'desmәsәm
desolate => 'desәlәt
desolated => ˈdesəlitid
desolately => 'desəlɪtlɪ
desolateness => 'desəleitə
desolates => ˈdesəlits
desolating => 'desələtɪŋ
desolation => desә'leiʃәn
desolator => 'desəleɪtə
desorb => di:'sɒ:b
desorbed => diː'sɔːb
desorbing => diː'sɔːb
desorbs => diː'sɔːb
desorption => di:'sɒ:pʃәn
despair => di'spєә
despaired => disˈpɛəd
despairing => dis'peәriŋ
despairingly => dɪ'speərɪŋlɪ
despairs => disˈpɛəz
despatch => di'spætʃ
despatched => dɪ'spætʃ
despatcher => dis'pætʃә
despatches => dɪ'spætʃ
desperado => .despә'rɑ:dәu
desperadoes => ˌdespəˈrɑ:dəuz
desperate => 'despәrәt
desperately => 'despәrәtli
desperateness => despə'rətnəs
desperation => .despә'reiʃәn
despicable => 'despikәbl
despise => di'spaiz
despised => disˈpaizd
despises => disˈpaiziz
despising => disˈpaizɪŋ
despite => di'spait
despiteful => di'spaitful
despoil => di'spɒil
despoiled => dɪˈspɔɪld
despoiling => dɪˈspɔɪlɪŋ
despoilment => dɪs'pɔɪlmənt
despoils => dɪˈspɔɪlz
despoliation => di.spәuli'eiʃәn
despond => di'spɒnd
despondency => di'spɒndәnsi
despondent => di'spɒndәnt
despondently => dɪ'spɒndəntlɪ
desponding => di'spɔndiŋ
despot => 'despɒt
despotic => de'spɒtik
despotically => de'spɒtikәli
despotism => 'despәtizәm
despots => ˈdespəts
desquamate => 'deskwәmeit
desquamates => 'deskwəmeɪt
desquamation => .deskwә'meiʃәn
desquamative => di'skwæmәtiv,'deskwәmeitiv
Dessau => 'desau
dessert => di'zә:t
dessert wine => diˈzə:t wain
desserts => dɪ'zɜ:ts
dessertspoon => di'z\\\\:tspu:n
destabilisation => di:,steibilai'zeiʃən; -li'z-
destabilise => di:'steɪbɪlaɪz
destabilization => di:,steibilai'zeiʃәn
destabilize => di:'steibilaiz
destabilizes => di:ˈsteibilaiziz
destabilizing => di:ˈsteibilaizɪŋ
destain => di:'stein
destination => .desti'neiʃәn
destinations => destɪ'neɪʃnz
destine => 'destin
destines => ˈdestɪnz
destinies => ˈdestiniz
destining => ˈdestɪnɪŋ
destiny => 'destini
destitute => 'destitju:t
destitution => .desti'tju:ʃәn
destock => di:'stɔk
destocking => di:'stɔkiŋ
destrier => 'destriә
destroy => di'strɒi
destroyer => di'strɒiә
destroyers => dɪˈstrɔɪəz
destroying => disˈtrɔiŋ
destroys => disˈtrɔiz
destruct => di'strʌkt
destructibility => di.strʌkti'biliti
destructible => di'strʌktibl
destruction => di'strʌkʃәn
destructive => di'strʌktiv
destructiveness => dɪ'strʌktɪvnəs
destructor => di'strʌktә
destructs => dɪ'strʌkt
desuetude => di'sju:itju:d
desulphurize => di:'sʌlfәraiz
desulphurized => di:'sʌlfjuraiz, -fə-
desulphurizes => di:'sʌlfjuraiz, -fə-
desultorily => 'desәltәrili
desultoriness => 'desәltәrinis
desultory => 'desәltәri
desuperheater => di:,sjupә'hi:tә
desynchronization => di:,siŋkrәnai'zeiʃәn
desynchronize => di:'siŋkrәnaiz
detach => di'tætʃ
detachability => di'tætʃә'biliti
detachable => di'tætʃәbl
detached => di'tætʃt
detached retina => dɪˈtætʃt ˈretnə
detaches => diˈtætʃiz
detachment => di'tætʃmәnt
detachments => dɪ'tætʃmənts
detail => 'di:teil
detailed => 'di:teild
detain => di'tein
detained => diˈteind
detainee => .di:tei'ni:
detainees => di:teɪ'ni:z
detainer => di'teinә
detaining => diˈteinɪŋ
detainment => di'teinmәnt
detains => diˈteinz
detect => di'tekt
detectability => di,tektә'biliti
detectable => di'tektәbl
detecting => di'tektiŋ
detection => di'tekʃәn
detective => di'tektiv
detectives => dɪ'tektɪvz
detector => di'tektә
detectorist => di,tek'tərist
detectors => dɪ'tektəz
detects => diˈtekts
detent => di'tent
detention => di'tenʃәn
detentions => dɪˈtenʃənz
deter => di'tә:
deterge => di'tә:dʒ
deterged => dɪ'tɜːdʒ
detergency => di't\\\\:dʒәnsi
detergent => di'tә:dʒәnt
detergents => dɪ'tɜ:dʒənts
deterging => dɪ'tɜːdʒ
deteriorate => di'tiәriәreit
deteriorated => diˈtiəriəreitid
deteriorates => diˈtiəriəreits
deteriorating => diˈtiəriəreitɪŋ
deterioration => di.tiәriә'reiʃәn
determinable => di'tә:minәbl
determinacy => di'tә:minәsi
determinant => di'tә:minәnt
determinants => dɪ'tɜ:mɪnənts
determinate => di'tә:minit
determinateness => dɪ'tɜ:mɪnətnɪs
determination => di.tә:mi'neiʃәn
determinations => diˌtə:miˈneiʃənz
determinative => di'tә:minәtiv
determine => di'tә:min
determined => di'tә:mind
determinedly => dɪ'tɜ:mɪndlɪ
determiner => di'tә:minә
determiners => dɪˈtɜ:mənəz
determines => diˈtə:minz
determinism => di'tә:minizm
determinist => di't\\\\:minist
deterministic => di.tә:mi'nistik
deterred => dɪˈtɜ:d
deterrence => di'tә:rәns
deterrent => di'tә:rәnt
deterrents => dɪˈtɜ:rənts
deterring => dɪˈtɜ:ɪŋ
deters => dɪˈtɜ:z
detest => di'test
detestable => di'testәbl
detestably => dɪ'testəblɪ
detestation => .di:te'steiʃәn
detested => dɪˈtestid
detesting => dɪˈtestɪŋ
detests => dɪˈtests
dethrone => di'θrәun
dethroned => diˈθrəund
dethronement => dɪ'θrəʊmənt
dethrones => diˈθrəunz
dethroning => diˈθrəunɪŋ
detinue => 'detinju:
detonate => 'detәneit
detonated => ˈdetnˌeɪtid
detonates => ˈdetnˌeɪts
detonating => ˈdetnˌeɪtɪŋ
detonation => .detә'neiʃәn
detonations => ˌdetnˈeɪʃənz
detonator => 'detәneitә
detonators => ˈdetnˌeɪtəz
detorsion => di:'tɔ:ʃәn
detour => 'di:tuә
detoured => ˈdi:tuəd
detouring => ˈdi:tuərɪŋ
detours => ˈdi:tuəz
detox => di:'tɔks
detoxed => di:ˈtɔkst
detoxes => di:ˈtɔksiz
detoxicate => di:'tɒksikeit
detoxicated => diː'tɒksɪkeɪt
detoxicating => di:'tɒksɪkeɪtɪŋ
detoxification => di:,tɔksifi'keiʃәn
detoxified => di:ˈtɔksiˌfaid
detoxifies => di:ˈtɔksiˌfaiz
detoxify => di:'tɒksifai
detoxifying => di:ˈtɔksiˌfaiŋ
detoxing => di:ˈtɔksɪŋ
detract => di'trækt
detracted => dɪˈtræktid
detracting => dɪˈtræktɪŋ
detraction => di'trækʃәn
detractive => di'træktiv
detractor => di'træktә(r)
detractors => dɪˈtræktəz
detracts => dɪˈtrækts
detrain => di:'trein
detrained => diː'treɪn
detraining => di:'treiniŋ
detrainment => di:'treinmәnt
detrains => diː'treɪn
detribalization => di:,traibəlai'zeiʃən; -li'z-
detribalize => di:'traibәlaiz
detribalized => diː'traɪb(ə)laɪz
detribalizes => diː'traɪb(ə)laɪz
detribalizing => diː'traɪb(ə)laɪz
detriment => 'detrimәnt
detrimental => .detri'mentәl
detrimentally => ˌdetrɪ'mentəlɪ
detrital => di'traitәl
detrition => di'triʃәn
detritivore => 'detritivɔ:
detritivorous => ,detri'tivәrәs
detritus => di'traitәs
Detroit => di'trɒit
detrusor => di'tru:sә
Dettol => 'ditәl
detumescence => .di:tju'mesns
detumescent => -'ənt
detune => di:'tju:n
Deucalion => dju:'keiljәn
deuce => dju:s
deuced => dju:st
deucedly => 'dju:sidli
deuces => dju:siz
deus => 'deius, 'diәs
deus ex machina => 'di:әs eks 'meikinei
deuteragonist => .dju:tә'rægәnist
deuteranope => 'dju:tәrәnәup
deuteranopia => .dju:tәrә'nәupiә
deuterated => 'dju:tәreitid
deuteration => ,dju: tә'reiʃən
deuteric => 'dju:tәrik
deuterium => dju:'tiәriәm
deuterocanonical => ,dju:tә,rәukә'nɔnikl, du:-
deuteron => 'dju:tәrɔn
Deuteronomy => .dju:tә'rɒnәmi
deuterons => 'djuːtərɒn
deutsch => dɔitʃ
Deutschland => 'dɒitʃlɑ:nt
deutschmark => ˈdɔɪtʃmɑ:k
deutzia => 'dju:tsjә
deva => 'deivә
devadasi => ,deivә'dɑ:si:
devalorize => di:'vælәraiz
devaluation => ,di:vælju'eiʃәn
devalue => di:'vælju:
devalued => di:ˈvælju:d
devalues => di:ˈvælju:z
devaluing => di:ˈvælju:ɪŋ
Devanagari => ,deivә'nɑ:^әri
devastate => 'devәsteit
devastated => ˈdevəsteɪtɪd
devastates => ˈdevəˌsteɪts
devastating => 'devәsteitiŋ
devastatingly => 'devəsteɪtɪŋlɪ
devastation => .devә'steiʃәn
devastations => ,devə'steɪʃn
devastator => 'devәsteitә(r)
devein => dɪ'veɪn
develop => di'velәp
developable => di'velәpәbl
developed => di'velәpid
developer => di'velәpә
developers => dɪ'veləpəz
developing => di'velәpiŋ
development => di'velәpmәnt
developmental => di.velәp'mentәl
develops => diˈveləps
deverbal => di:'v\\\\:bəl
DEVEREUX => 'devәru:
deviancy => ˈdi:viənsi
deviant => 'di:viәnt
deviants => ˈdi:vi:ənts
deviate => 'di:vieit
deviated => ˈdi:vieitid
deviates => ˈdi:vieits
deviating => ˈdi:vieitɪŋ
deviation => .di:vi'eiʃәn
deviationism => .di:vi'eiʃәnizm
deviationist => ,di:vi'eiʃənist
deviations => di:v'ɪeɪʃnz
deviator => 'di:vieitә
device => di'vais
devil => 'devәl
deviled => 'devəld
devilfish => 'devәlfiʃ
devilish => 'devliʃ
devilishly => ˈdevəlɪʃli
devilishness => ˊdevliʃnis
devilled => 'devld
devilling => de'vəlɪŋ
devilment => 'devlmәnt
devilry => 'devlri
deviltry => 'devltri
devious => 'di:viәs
deviously => 'di:vɪəslɪ
deviousness => 'di:viəsnis
devisable => di'vaizәbl
devise => di'vaiz
devised => diˈvaizd
devisee => devi'zi:, divai'zi:
deviser => di'vaizә
devises => diˈvaiziz
devising => diˈvaizɪŋ
devisor => di'vaizә
devitalize => di:'vaitәlaiz
devitalized => diː'vaɪt(ə)laɪz
devitrification => di:,vitrifai'keiʃәn
devitrifies => diː'vɪtrɪfaɪ
devitrify => di:'vi:trifai
devitrifying => diː'vɪtrɪfaɪ
devoice => di'vɔis
devoices => diː'vɒɪs
devoid => di'vɒid
devoir => dә'vwɑ:, 'devwɑ:
devolution => .devә'lu:ʃәn
devolutionist => ,di:vә'lju:ʃәnist
devolve => di'vɒlv
devolved => dɪˈvɒlvd
devolves => dɪˈvɔlvz
devolving => dɪˈvɔlvɪŋ
devon => 'devn
Devonian => dә'vәuniәn
Devonport => 'devən,pɔ:t
Devonshire => 'devәnʃiә
devote => di'vәut
devoted => di'vәutid
devoted to => dɪˈvəʊtɪd tu:
devotee => .devә'ti:
devotees => ˌdevəˈti:z
devotes => diˈvəuts
devoting => diˈvəutɪŋ
devotion => di'vәuʃәn
devotional => di'vәuʃәnl
devour => di'vauә
devoured => diˈvauəd
devouring => diˈvauərɪŋ
devouringly => di'vauriŋli
devours => diˈvauəz
devout => di'vaut
devoutly => dɪ'vaʊtlɪ
devoutness => dɪ'vaʊtnɪs
dew => dju:
dew worm => dju: wə:m
dewan => di'wɑ:n
Dewar => 'dju:ә
dewater => di:'wɒ:tә
dewatered => deju':ɔ:trd
dewatering => di:'wɔ:tәriŋ
dewax => di:'wæks
dewaxing => di:'wæksiŋ
dewberry => 'dju:bәri
dewclaw => 'dju:klɒ:
dewdrop => 'dju:drɔp
Dewey => 'dju(:)i
dewfall => 'dju:fɒ:l
dewiest => 'dju:i
dewily => 'dju:ili
dewiness => 'dju:inis
dewlap => 'dju:læp
dewlaps => 'djuːlæp
deworm => di:'w\\\\:m
dewy => 'dju:i
dewy-eyed => 'dju:iaid
dex => deks
dexamethasone => ,deksә'meθәzәjn
Dexedrine => 'deksәdri:n
dexter => 'dekstә
dexterity => dek'steriti
dexterous => 'dekstәrәs
dexterously => 'dekstrəslɪ
dexterousness => dekst'rəsnɪs
dextral => 'dekstrәl
dextrality => dekst'rəlɪtɪ
dextran => 'dekstrәn
dextrin => 'dekstrin
dextrorotation => ,dekstrәurәu'teiʃәn
dextrorotatory => 'dekstrәu'rәutәtәri
dextrose => 'dekstrәus
dextrous => 'dekstrәs
dexy => 'deksi
DHAKA => 'dækә
dhal => dɑ:l
dharma => 'dɑ:mә
dharna => 'dɑ:nә
dhobi => 'dәubi
Dhofar => dәj'fɑ:(r)
dhol => dәjl
dhole => dәul
dhoti => 'dәuti
dhow => 'dau
dhurrie => 'dʌri
dhyana => di'ɑ:nә
dia- => 'daiә
diabase => 'daiәbeis
diabetes => daiә'bi:ti:z
diabetes mellitus => 'melitәs
diabetic => daiә'betik
diabetics => ˌdaɪəˈbetɪks
diablerie => di'ɑ:blәri
diabolic => daiә'bɔlik
diabolical => daiә'bɒlikl
diabolically => ,daiə'bɔlikəli
diabolism => dai'æbәlizәm
diabolist => dai'æbәlist
diabolize => dai'æbәlaiz
diabolized => daɪ'æbəlaɪz
diabolizes => daɪ'æbəlaɪz
diabolizing => daɪ'æbəlaɪz
diabolo => di'ɑ:bәlәu
diacetylmorphine => 'daiә,si:til'mɔ:fi:n
diachroneity => daiәkrɔ'ni:iti
diachronic => daiә'krɒnik
diachronism => ,daiә'krɔnizәm
diachronous => ,daiә'krɔnәs
diachrony => dai'ækrәni
diaconal => dai'ækәnәl
diaconate => dai'ækәnit
diacritic => ,daiә'kritik
diacritical => daiә'kritikl
diacritically => daiәˊkritikәli
diadelphous => ,daiә'delfәs
diadem => 'daiәdem
diadems => ˈdaiədemz
diaeresis => dai'iәrisis
diagenesis => ,daiә'dʒenisis
diagenetic => daɪədʒe'netɪk
diagnose => 'daiәgnәuz
diagnosed => ˈdaiəɡnəuzd
diagnosis => .daiәg'nәusis
diagnostic => daiәg'nɒstik
diagnostically => daɪəɡ'nɒstɪklɪ
diagnostician => .daiәgnәus'tiʃәn
diagnostics => ,daiә^'nɔstiks
diagonal => dai'ægәnl
diagonally => dai'ægәnәli
diagonals => daɪˈægənəlz
diagram => 'daiәɡræm
diagrammatic => ,daiә^rә'mætik
diagrammatically => ,daiəgrə'mætikəli
diagramming => 'daiә,^ræmiŋ
diagrams => ˈdaiəɡræmz
diagrid => 'daiә^rid
diakinesis => ,daiәkai'ni:sis
dial => 'daiәl
dial-in => 'daɪəl'ɪn
dial-up => 'daiәlʌp
dialect => 'daiәlekt
dialectal => daiә'lektәl
dialectic => daiә'lektik
dialectical => ,daiә'lektikәl
dialectical materialism => ˌdaiəˈlektikəl məˈtɪəri:əˌlɪzəm
dialectician => .daiәlek'tiʃәn
dialectics => ,daiә'lektiks
dialectological => 'daiə,lektə'lɔdʒikəl
dialectologist => ,daiәlek'tɔlәdʒist
dialectology => .daiәlek'tɒlәdʒi
dialects => 'daɪəlekts
dialling code => ˈdaiəliŋ kəud
dialling tone => ˈdaiəliŋ təun
dialog => 'daiәlɒg
dialogic => ,daiә'lɔdʒik
dialogical => dɪə'lɒdʒɪkəl
dialogism => 'daɪælədʒɪzəm
dialogue => 'daiәlɒg
dialogues => ˈdaiəlɔɡz
dials => ˈdaiəlz
dialysate => dai'æli,seit
dialyse => 'daiәlaiz
dialysis => dai'ælisis
dialytic => daiә'litik
diamagnet => 'daiә ,mæ^nit
diamagnetic => .daiәmæg'netik
diamagnetism => daiә'mægnәtizәm
diamante => dju:mɒŋ'tei
diamantiferous => ,daiәmæn'tifәrәs
diamantine => 'daiәmænti:n
diameter => dai'æmitә
diameters => da'ɪæmɪtəz
diametral => dai'æmitrәl
diametric => ,daiә'metrik
diametrical => ,daiә'metrikәl
diametrically => ,daiә'metrikәli
diamine => dai'æmi:n, 'daiә,mi:n
diamond => 'daiәmәnd
diamond jubilee => ˈdaiəmənd ˈdʒu:bəˌli:
diamond wedding => ˈdaiəmənd ˈwediŋ
diamondback => 'daiәmәndbæk
diamondiferous => 'daiәmәn'difәrәs
diamorphine => 'daiәmɔ:fi:n
Diana => dai'ænә
diane => dai'æn
dianthus => dai'ænθәs
diapason => daiә'peisn
diapause => 'daiә'pɔ:z
diapedesis => ,daiәpi'di:sis
diaper => 'daiәpә
diapers => ˈdaɪəpəz
diaphanous => dai'æfәnәs
diaphone => 'daiәfәun
diaphorase => dai'æfә,reis
diaphoresis => .daiәfә'ri:sis
diaphoretic => .daiәfә'retik
diaphragm => 'daiәfræm
diaphragmatic => .daiәfræg'mætik
diaphragms => 'daɪəfræmz
diaphysis => dai'æfisis
diapir => 'daiәpiә(r)
diapiric => ,daiə'pirik
diapirism => 'daiәpirizәm
diapositive => ,daiә'pɔzitiv
diapsid => dai'æpsid
diarchy => 'daiɑ:ki
diaries => ˈdaiəriz
diarist => 'daiәrist
diaristic => -'ristik
diarists => ˈdaiərists
diarize => 'daiәraiz
diarrhea => ,daiә'riә
diarrhoea => daiә'riә
diarrhoeic => ,daiə'retik
diary => 'daiәri
Diaspora => dai'æspәrә
diaspore => 'daiә'spɔ:
diastase => 'daiәsteis
diastema => 'daiә'sti:mә
diastereoisomer => ,daiә,stiәriәu'aisәmә
diastole => dai'æstәli
diastolic => daiә'stɒlik
diathermy => 'daiәθә:mi
diathesis => dai'æθisis
diatom => 'daiәtәm
diatomaceous => .daiәtә'meiʃәs
diatomic => daiә'tɒmik
diatomite => dai'ætәmait
diatonic => daiә'tɒnik
diatonic scale => ˌdaiəˈtɔnik skeil
diatribe => 'daiәtraib
diatribes => ˈdaɪəˌtraɪbz
diazepam => daiә'zepәm
diazinon => dai'æzinɔn
diazo => dai'æzәu
diazomethane => dai,æzәu'meθein
diazonium => ,daiә'zәuniәm
dib => dib
dibasic => dai'beisik
dibatag => 'dibә,tæ^
dibber => 'dibә
dibble => 'dibl
dibbled => 'dɪb(ə)l
dibbler => 'dɪbələ
dibbles => 'dɪb(ə)l
dibbling => 'dɪblɪŋ
diborane => dai'bɔrein
dibs => dibz
dice => dais
diced => 'daɪst
dicentra => dai'sentrә
dicentric => dai'sentrik
dicer => 'daisә
dices => daisiz
dicey => 'daisi
dichasium => dai'keiziәm, -ʒi:-
dichlorvos => dai'klɔ:vɔs
dichogamous => dai'kɔ^әmәs
dichogamy => dai'kɒgәmi
dichondra => dai'kɔndrә
dichotic => dai'kәjtik
dichotomies => daɪˈkɔtəmi:z
dichotomize => di'kɔtәmaiz
dichotomized => daɪ'kɒtəmaɪz; dɪ-
dichotomizes => daɪ'kɒtəmaɪz; dɪ-
dichotomous => dai'kɒtәmәs
dichotomy => dai'kɒtәmi
dichroic => dai'krәuik
dichroism => 'daikrәuizm
dichromate => dai'krәumeit
dichromatic => .daikrәu'mætik
dichromatism => dai'krәumәtizm
dicier => ˈdaisiə
dicing => 'daisiŋ
dick => dik
dickcissel => dik'sisәl
dickens => 'dikinz
Dickensian => di'kenziәn
Dickenson => 'dikinsn
dicker => 'dikә
dickered => 'dɪkə
dickering => 'dɪkə
dickey => 'diki
dickhead => ˈdɪkhed
dickheads => ˈdɪkˌhedz
Dickie => 'diki
dickier => 'diki
dickiest => 'diki
dicky => 'diki
dickybird => ˊdikibәːd
dicot => 'daikɔt
dicotyledon => .daikɒti'li:dn
dicotyledonous => .daikɒti'li:dnәs
dicrotic => dai'krɔtik
dicta => 'diktә
dictaphone => 'diktәfәun
dictate => 'dikteit
dictated => dikˈteitid
dictates => dikˈteits
dictation => dik'teiʃәn
dictations => dikˈteiʃənz
dictator => 'dikteitә
dictatorial => diktә'tɒ:riәl
dictatorially => ˌdɪktə'tɔ:rɪəlɪ
dictators => ˈdɪkˌteɪtəz
dictatorship => dik'teitәʃip
dictatorships => dɪkˈteɪtəˌʃɪps
diction => 'dikʃәn
dictionaries => 'dɪkʃənərɪ
dictionary => 'dikʃәnәri
dictum => 'diktәm
dicty => 'dikti
dicynodont => dai'sinәdɔnt
did => did
didactic => di'dæktik(әl), dai-
didactically => di'dæktikәli
didacticism => dai'dæktisizm
didanosine => dɪdə'nəʊzaɪn
diddle => 'didl
diddled => ˈdidld
diddles => ˈdidlz
diddling => ˈdidlɪŋ
diddly-squat => 'dɪdlɪ skwɒt
diddums => ˈdɪdəmz
diddy => 'didi
dideoxyinosine => dɪdi:ɒksi:ɪnəʊ'zɪn
Diderot => 'di:dәrәu
didgeridoo => did'dʒeridu:
didn't => ˈdɪdnt
dido => 'daidәu
didst => didst
didy => 'daidi
didymium => di'dimjәm
die => dai
die back => dai bæk
die-cast => 'daikɑ:st
die-in => 'daiin
die-sinker => 'daɪi:s'ɪŋkər
dieback => da'ɪi:bæk
diehard => 'daihɑ:d
diehards => 'daɪi:hɑ:dz
diel => 'daiәl
dieldrin => 'di:ldrin
dielectric => .daii'lektrik
dielectrophoresis => 'daii,lektrәjfә'ri:sis
diencephalon => .daien'sefәlɒn
diene => 'daii:n
Dieppe => di:'ep
dieresis => dai'erisis
dies => 'daii:z
Dies Irae => 'daii:z 'aiәri:
dies non => ,daii:z'nɔn
diesel => 'di:zәl
diesel fuel => ˈdi:zəl fjuəl
diesel-hydraulic => di:zəlhai'drɔ:lik
dieselize => 'di:zәlaiz
diesels => ˈdi:zəlz
diesis => 'daiәsis
diestock => 'daistɔk
diet => 'daiәt
dietaries => 'daɪət(ə)rɪ
dietary => 'daiәtәri
dieter => 'daiәtә
dietetic => daiә'tetik
dietetics => daiә'tetiks
dieticians => ˌdaɪɪˈtɪʃənz
dietitian => ,daiә'tiʃәn
diets => ˈdaiəts
Dieu et mon droit => 'djɔ ei mәun 'drɔit
diff => dif
differ => 'difә
differed => ˈdifəd
difference => 'difәrәns
difference threshold => ˈdifərəns ˈθreʃhəuld
different => 'difәrәnt
differentia => difә'renʃiә
differentiability => 'difә,renʃiә'bilәti
differentiable => ,difә'renʃiәbl, -ʃә-
differential => difә'renʃәl
differential calculus => difә'renʃ(ә)l
differential coefficient => ˌdɪfəˈrenʃəl ˌkəʊəˈfɪʃənt
differentially => ,difə'renʃəli
differentials => dɪfə'renʃlz
differentiate => .difә'renʃieit
differentiates => ˌdifəˈrenʃieits
differentiation => .difәrenʃi'eiʃәn
differentiator => ,difә'renʃi,eitә
differently => 'difrentli
differing => ˈdifərɪŋ
differs => ˈdifəz
difficult => 'difikәlt
difficulties => ˈdifikəltiz
difficulty => 'difikәlti
diffidence => 'difidәns
diffident => 'difidәnt
diffidently => 'dɪfɪdəntlɪ
diffract => di'frækt
diffracting => dɪ'frækt
diffraction => di'frækʃәn
diffractive => di'fræktiv
diffractometer => ,difræk'tɔmitə
diffracts => dɪ'frækt
diffuse => di'fju:z
diffused => di'fju:zd
diffuseness => dɪf'ju:snəs
diffuser => di'fju:zә(r)
diffuses => diˈfju:siz
diffusible => di'fju:zәbl
diffusing => diˈfju:sɪŋ
diffusion => di'fju:ʒәn
diffusionism => dɪf'ju:ʒnɪzəm
diffusionist => di'fju:ʒənist
diffusive => di'fju:siv
diffusivity => difju'siviti
dig => dig
digamma => dai'^æmә
digastric => dai'gæstrik
digerati => ˌdɪdʒəˈrɑ:ti
digest => di'dʒest
digested => daiˈdʒestid
digester => di'dʒestә, dai-
digesters => dɪ'dʒestə
digestibility => di.dʒestә'biliti
digestible => di'dʒestәbl
digestif => di:ʒes'ti:f
digestion => di'dʒestʃәn
digestions => daɪˈdʒestʃənz
digestive => di'dʒestiv
digestive biscuit => daɪˈdʒestɪv ˈbiskit
digestive gland => daɪˈdʒestɪv ɡlænd
digestively => dɪd'ʒestɪvlɪ
digestives => daɪˈdʒestɪvz
digests => daiˈdʒests
digger => 'digә
digger wasp => ˈdiɡə wɔsp
diggers => ˈdiɡəz
digging => 'digiŋ
dight => dait
digicam => 'dɪɡɪkæm
digit => 'didʒit
digital => 'didʒitәl
digital audiotape => ˈdidʒitəl ˈɔ:di:əʊˌteɪp
digital camera => ˈdidʒitəl ˈkæmərə
digitalin => didʒi'tælin, -'teilin
digitalis => .didʒә'teilis
digitalization => ,didʒitәlai'zeiʃən;-li'z-
digitalize => 'didʒitәlaiz
digitate => 'didʒiteit
digitation => didʒi'teiʃәn
digitigrade => 'didʒitigreid
digitise => 'dɪdʒɪtaɪz
digitised => 'didʒitaiz
digitization => .didʒitai'zeiʃәn. -ti'z-
digitize => 'didʒitaiz
digitizer => 'didʒitaizә
digitizes => ˈdidʒitaiziz
digitoxin => ,didʒi'tɔksin
diglossia => dai'glɔsiә
diglossic => daɪ'glɑsɪə
dignified => 'dignifaid
dignify => 'dignifai
dignitaries => ˈdɪgnɪˌteri:z
dignitary => 'dignitәri
dignity => 'digniti
digoxin => dai'^ɔksin
digraph => 'daigrɑ:f
digraphic => dai'ɡræfik
digress => dai'gres
digressed => daɪˈgrest
digresses => daɪˈgresiz
digressing => daɪˈgresɪŋ
digression => dai'greʃәn
digressive => dai'^resiv
digressively => daɪɡ'resɪvlɪ
dihedral => dai'hi:drәl
dihybrid => dai'haibrid
dihydric => dai'haidrik
dihydrotestosterone => dai,haidrәn,tes'tɔstәrәun
dihydroxyacetone => dai,haidrәksi'æsitәun
dijon => 'di:ʒɔ:ŋ
dik-dik => ˈdikdik
dike => daik
diked => daɪk
diking => 'daikiŋ
dikkop => 'dikәp
diktat => dik'tɑ:t
Dilantin => dai'læntin
dilapidate => di'læpideit
dilapidated => di'læpideitid
dilapidation => di.læpi'deiʃәn
dilatable => dai'leitәbl
dilatancy => dai'leitәnsi
dilatation => ,dailei'teiʃәn
dilatation and curettage => ˌdɪləˈteɪʃən ænd ˌkjuəriˈtɑ:dʒ
dilate => dai'leit
dilated => dai'leitid. di-
dilates => daɪˈleɪts
dilating => daɪˈleɪtɪŋ
dilation => dai'leiʃәn
dilator => dai'leitә
dilatorily => dɪlə'tərɪlɪ
dilatoriness => 'dilәtәrinis
dilatory => 'dilәtәri
dildo => dildәu
dilemma => di'lemә
dilemmas => dɪ'leməz
dilettante => dili'tænti
dilettantish => ,dili'tæntiʃ
dilettantism => .dili'tæntisәm
dili => 'dili
diligence => 'dilidʒәns
diligent => 'dilidʒәnt
dill => dil
dill pickle => dil ˈpɪkəl
dillon => 'dilәn
dilly => 'dili
dilly-dally => ˈdɪli dæli
diluent => 'diljuәnt
dilute => dai'lju:t
diluted => dai'lju:tid. di-
dilutes => daiˈlju:ts
diluting => daiˈlju:tɪŋ
dilution => dai'lju:ʃәn, di'l-
dilutive => dai'lju:tiv
diluvial => dai'lju:viәl
diluvian => dai'lju:vjәn
DILYS => 'dilis
dim => dim
dim sum => 'dim'sʌm
dime => daim
dime store => daim stɔ:
dimension => dai'menʃәn
dimensional => dai'menʃәnәl
dimensionality => di,menʃә'næliti
dimensioned => dɪ'menʃ(ə)n; daɪ-
dimer => 'daimә
dimercaprol => ,daimә'kæprәul
dimeric => dai'merik
dimerization => ,daimәri'zeiʃәn
dimerize => 'daimә,raiz
dimerous => 'dimәrәs
dimes => daimz
dimeter => 'dimәtә
dimethoate => di'meθәueit
dimethyl => ,dai'meθil
dimetric => dai'metrik
dimidiate => di'midieit
dimidiation => di,midi'eiʃən
diminish => di'miniʃ
diminishable => di'miniʃәbl
diminished => di'miniʃt
diminishes => diˈminiʃiz
diminishing => di'miniʃiŋ
diminuendo => di,minju'endәu
diminution => .dimi'nju:ʃәn
diminutive => di'minjutiv
diminutively => dɪmɪn'jʊtɪvlɪ
diminutiveness => dɪ'mɪnjʊtɪvnɪs
dimissory => 'dimisәri, dai'misәri
Dimitri => dimitri
dimity => 'dimiti
dimly => 'dimli
dimmer => 'dimә
dimmers => ˈdiməz
dimmest => 'dɪmɪst
dimming => 'dimiŋ
dimmish => 'dimiʃ
dimness => 'dimnis
dimorphic => dɑi'mɔ:fik
dimorphism => dai'mɒ:fizәm
dimorphotheca => dɑi,mɔ:fә'θi:kә
dimple => 'dimpl
dimpled => ˈdɪmpld
dimples => 'dɪmplz
dimpling => 'dimpliŋ
dimply => 'dimpli
dims => 'dɪmz
dimwit => 'dimwit
dimwits => ˈdɪmˌwɪts
dimwitted => 'dimwitid
din => din
dina => 'dainә
dinah => 'dainә
dinar => di'nɑ:
dinars => diˈnɑ:z
dinas => 'di:nәs
dine => dain
dined => daind
diner => 'dainә
dinero => di'neәrәu
diners => ˈdainəz
dines => dainz
dinette => dai'net
ding => diŋ
ding-a-ling => 'diŋә'liŋ
ding-dong => ˈdɪŋ dɒŋ
dingbat => 'diŋbæt
dinged => dɪŋ
dinger => diŋə
dinghies => ˈdɪŋi:z
dinghy => 'diŋ^i,'diŋi
dingier => ˈdɪŋi:ə
dingily => 'dindʒili
dinginess => 'dindʒinis
dinging => 'dɪnɡɪŋ
dingle => 'diŋgl
dingo => 'diŋgәu
dings => 'dɪŋz
dingus => 'diŋ^әs
dingy => 'diŋdʒi
dining => 'dainiŋ
dining car => 'dainiŋ
dining hall => ˈdaɪnɪŋ hɔ:l
dining table => ˈdaɪnɪŋ ˈteibl
dink => diŋk
dinkum => 'diŋkәm
dinky => 'diŋki
dinner => 'dinә
dinner dance => ˈdinə dɑ:ns
dinner jacket => ˈdinə ˈdʒækit
dinner lady => ˈdinə ˈleidi
dinner pail => ˈdinə peɪl
dinner party => ˈdinə ˈpɑ:ti
dinner service => ˈdinə ˈsɜːvɪs
dinner suit => ˈdinə sju:t
dinner table => ˈdinə ˈteibl
dinner time => ˈdinə taim
dinners => ˈdinəz
dinnertime => 'dɪnərtaɪm
dinnerware => 'dinәwєә
dino => 'di:nәu
dinoflagellate => ,dainә'flædʒilit, -'leit
dinosaur => 'dainәsɒ:
dinosaurian => dainә'sɒ:riәn
dinosaurs => 'daɪnəsɔ:z
dint => diŋt
dinted => dɪnt
dinting => 'dintiŋ
diocesan => dai'ɒsisәn
diocese => 'daiәsis
dioceses => ˈdaɪəsi:z
diode => 'daiәud
dioecious => dai'i:ʃәs
dioecy => dai'i:si
dioestrus => dai'i:strәs
Diogenes => dai'ɔdʒini:z
diogenite => dai'ɔdʒi,nait
diol => 'daiәul
dion => 'daiәn
Dione => dai'әuni
dionysiac => ,dɑiә'niziæk
Dionysian => ,daiә'niziәn
Dionysius => daiә'nisiәs
Dionysus => ,daiә'naisәs
diopside => dai'ɔpsaid
dioptase => dai'ɔpteis
diopter => dai'ɔptә(r)
dioptric => dai'ɒptrik
dioptrics => dai'ɒptriks
diorama => daiә'rɑ:mә
diorite => 'daiәrait
dioritic => 'daɪərɪtɪk
Dioscuri => ,daiɔs'kjjәri
diosgenin => dai'ɔzdʒәnin
dioxane => dai'ɔksein
dioxide => dai'ɒksaid
dioxin => dai'ɔksin
dioxins => da'ɪɒksɪnz
dip => dip
dip-dye => 'dipdai
dipeptide => di'peptaid
diphenylamine => dai,fenilә'mi:n
diphtheria => dif'θiәriә
diphtherial => -riәl
diphtheritic => ,difθi'ritik
diphtheroid => 'difθәrɔid
diphthong => 'difθɒŋ
diphthongal => dif'θɒŋgәl
diphthongization => ,difθɔŋ^ai'zeiʃәn;-^i'z-
diphthongize => 'difθɒŋgaiz
diphthongized => 'difθɔŋɡaiz
diphthongizes => 'difθɔŋɡaiz
diphthongizing => 'difθɔŋɡaiz
diphthongs => ˈdɪfˌθɔ:ŋz
diphycercal => 'difi,sә:kl
diplegia => dai'pli:dʒiә
diplo- => 'diplәj
diploblastic => ,diplәu'blæstik
diplococcus => .diplәu'kɒkәs
diplodocus => di'plɒdәkәs
diploid => 'diplɒid
diploidy => 'diplɔidi
diploma => di'plәumә
diplomacy => di'plәumәsi
diplomat => 'diplәmæt
diplomate => 'diplәmeit
diplomatic => .diplә'mætik
diplomatic pouch => ˌdipləˈmætik paʊtʃ
diplomatically => ,diplә'mætikәli
diplomatist => di'plәumәtist
diplomats => 'dɪpləmæts
diplont => 'di,plɔnt
diplopia => di'plәupiә
diplopod => 'diplә,pɔd
diplotene => 'diplәu,ti:n
dipolar => dai'pәulә
dipole => 'daipәul
dipped => 'dɪpt
dipper => 'dipә
dippers => 'dipəz
dipping => 'dipiŋ
dippy => 'dipi
dipshit => 'dipʃit
dipso => 'dipsәj
dipsomania => .dipsәu'meiniә
dipsomaniac => .dipsәu'meiniæk
dipstick => 'dipstik
dipsticks => ˈdipstiks
dipteral => 'diptәrәl
dipteran => 'diptәrәn
dipterist => 'diptәrist
dipterocarp => 'diptәrәjkɑ:p
dipterous => 'diptәrәs
diptych => 'diptik
diquat => 'dikwæt
Dirac => di'ræk
dire => daiә
direct => di'rekt
direct deposit => diˈrekt diˈpɔzit
direct discourse => diˈrekt ˈdiskɔ:s
direct mail => diˈrekt meil
direct marketing => diˈrekt ˈmɑ:kɪtɪŋ
direct rule => diˈrekt ru:l
direct speech => diˈrekt spi:tʃ
direct-drive => dɪ'rektdr'aɪv
direct-grant school => dɪˈrɛkt ɡrænt skul
directed => di'rektid. dai-
direction => di'rekʃәn
directional => di'rekʃәnәl
directionality => di.rekʃә'nælәti. dai-
directionally => dɪ'rekʃənəlɪ
directionless => dəˈrekʃnləs
directive => di'rektiv
directives => dɪˈrektɪvz
directly => di'rektli, dai'rektli
directness => di'rektnis
Directoire => direk'twɑ:
director => di'rektә
director-general => diˈrektə ˈdʒenərəl
directorate => di'rektәrit
directorates => diˈrektərits
directorial => di.rek'tɒ:riәl
directorship => di'rektәʃip
directory => di'rektәri
directress => di'rektris
directrix => di'rektriks, dai-
directs => diˈrekts
direful => 'daiәful
direfully => 'daɪəfəlɪ
dirge => dә:dʒ
dirgeful => 'də:dʒəfəl
dirges => dɜ:dʒz
dirham => diә'hæm
dirigible => 'diridʒәbl
dirigisme => ,di:ri:'ʒi:sm
dirigiste => ,diːriː'ʒɪʒst
diriment impediment => ˈdirimənt imˈpedimənt
dirk => dә:k
dirndl => 'dә:ndl
dirt => dә:t
dirt bike => də:t baik
dirt cheap => də:t tʃi:p
dirt farmer => də:t ˈfɑ:mə
dirt track => də:t træk
dirtbag => dɜ:t'bæɡ
dirtied => ˈdə:tid
dirties => ˈdə:tiz
dirtily => 'dә:tili
dirtiness => 'dә:tinis
dirty => 'dә:ti
dirty bomb => ˈdə:ti bɔm
dirty old man => ˈdə:ti əuld mæn
dirty weekend => ˈdə:ti ˌwi:kˈend
dirty word => ˈdə:ti wə:d
dirtying => ˈdə:tiŋ
Dis => dis
dis- => dɪs
disabilities => ˌdisəˈbilitiz
disability => disә'biliti
disable => dis'eibl
disabled => dis'eibld
disablement => di'seiblmәnt
disables => disˈeiblz
disabuse => .disә'bju:z
disabused => ˌdɪsəˈbju:zd
disabuses => ˌdɪsəˈbju:ziz
disabusing => ˌdɪsəˈbju:zɪŋ
disaccharide => dai'sækәraid
disaccord => .disә'kɒ:d
disadvantage => .disәd'vɑ:ntidʒ
disadvantaged => disәd'vɑ:ntidʒ
disadvantageous => ,disædvɑ:n'teidʒәs
disadvantageously => dɪsædvən'teɪdʒəslɪ
disadvantages => ˌdisədˈvɑ:ntidʒz
disaffect => .disә'fekt
disaffected => .disә'fektid
disaffection => .disә'fekʃәn
disaffiliate => disә'filieit
disaffiliation => 'disə,filieiʃən
disaffirm => .disә'fә:m
disaffirmation => ,disæfә'meiʃәn
disafforest => .disә'fɒrist
disafforestation => ,disә,fɔris'teiʃәn
disafforested => ,dɪsə'fɒrɪst
disafforesting => ,dɪsə'fɒrɪst
disafforestment => dɪsəfɒ'restmənt
disafforests => ,dɪsə'fɒrɪst
disaggregate => dis'æɡriɡeit. -ɡәt. -ɡeit
disaggregated => dɪs'ægrɪgeɪt
disaggregation => dis,æ^ri'^eiʃәn
disagree => .disә'gri:
disagreeable => .disә'griәbl
disagreeably => ˌdɪsə'ɡri:əblɪ
disagreed => ˌdisəˈɡri:d
disagreeing => ˌdisəˈɡri:ɪŋ
disagreement => .disә'gri:mәnt
disagreements => dɪsəɡ'ri:mənts
disagrees => dɪsəɡ'ri:z
disallow => .disә'lau
disallowance => .disә'lauәns
disallowed => ˈdisəˈlaud
disallowing => ˈdisəˈlauɪŋ
disallows => ˈdisəˈlauz
disambiguate => dis,æmbi'^jueit
disambiguated => dɪsæm'bɪgjʊeɪt
disambiguating => daɪ'sæmbɪɡwɑ:tɪŋ
disambiguation => dis,æmbi^ju'eiʃәn
disamenity => disә'mi:niti
disappear => .disә'piә
disappearance => .disә'piәrәns
disappearances => dɪsə'pɪərənsɪz
disappearing => ˌdisəˈpiərɪŋ
disappears => ˌdisəˈpiəz
disappoint => .disә'pɒint
disappointed => .disә'pɒintid
disappointing => .disә'pɒintiŋ
disappointingly => ,disə'pɔintiŋli
disappointment => .disә'pɒintmәnt
disappointments => ˌdɪsəˈpɔɪntmənts
disappoints => ˌdisəˈpɔints
disapprobation => .disæprә'beiʃәn
disapproval => .disә'pru:vәl
disapprove => .disә'pru:v
disapproved => ˌdɪsəˈpru:vd
disapproves => ˌdɪsəˈpru:vz
disapproving => ˌdɪsəˈpru:vɪŋ
disapprovingly => .disә'pru:viŋli
disarm => dis'ɑ:m
disarmament => dis'ɑ:mәmәnt
disarmer => dɪs'ɑːmə
disarming => dis'ɑ:miŋ
disarmingly => dis'a:miŋli
disarms => dɪsˈɑ:mz
disarrange => disә'reindʒ
disarranged => dɪsə'reɪndʒd
disarranges => dɪsə'reɪn(d)ʒ
disarranging => dɪsə'reɪn(d)ʒ
disarray => .disә'rei
disarticulate => .disɑ:'tikjuleit
disarticulated => dɪsɑ:'tɪkjʊleɪtɪd
disarticulation => 'disɑ:,tikjj'leiʃәn
disassemble => .disә'sembl
disassembled => ˌdisəˈsembld
disassembles => ˌdisəˈsemblz
disassembly => ,disә'sembli
disassociate => .disә'sәuʃieit
disassociated => ˌdisəˈsəuʃieitid
disassociates => ˌdisəˈsəuʃieits
disassociating => ˌdisəˈsəuʃieitɪŋ
disassociation => 'disә.sәuʃi'eiʃәn
disaster => di'zɑ:stә
disasters => dɪ'zɑ:stəz
disastrous => di'zɑ:strәs
disastrously => dɪ'zɑ:strəslɪ
disavow => .disә'vau
disavowal => .disә'vauәl
disavowed => ˌdɪsəˈvaʊd
disavowing => ˌdɪsəˈvaʊɪŋ
disavows => ˌdɪsəˈvaʊz
disband => dis'bænd
disbanded => dɪsˈbændid
disbanding => dɪsˈbændɪŋ
disbandment => dɪs'bændmənt
disbands => dɪsˈbændz
disbar => dis'bɑ:
disbarring => dɪs'bɑː
disbars => dɪs'bɑː
disbelief => .disbi'li:f
disbelieve => .disbi'li:v
disbelieved => ˌdɪsbɪˈli:vd
disbelieves => ˌdɪsbɪˈli:vz
disbelieving => ˌdɪsbɪ'li:vɪŋ
disbelievingly => ˌdɪsbɪ'li:vɪŋlɪ
disbenefit => dis'benifit
disbound => dis'baund
disbud => dis'bʌd
disbudded => dɪs'bʌd
disbudding => 'dɪsbʌdɪŋ
disbuds => dɪs'bʌd
disburden => dis'bә:dn
disbursal => dis'bә:sәl
disburse => dis'bә:s
disbursed => dɪsˈbɜ:st
disbursement => dis'bә:smәnt
disbursements => dɪsˈbɜ:smənts
disburser => dɪs'bəsə
disburses => dɪsˈbɜ:siz
disbursing => dɪsˈbɜ:sɪŋ
disc => disk
disc brake => disk breik
disc drive => disk draiv
disc harrow => disk ˈhærəʊ
discalced => dis'kælst
discard => dis'kɑ:d
discarded => dɪs'kɑ:rdɪd
discarding => disˈkɑ:dɪŋ
discarnate => dis'kɑ:nәt,-neit
discectomy => dɪ'sektəmɪ
discern => di'zә:n
discernable => di's\\\\:nәbl,-'z\\\\:-
discerned => diˈsə:nd
discernible => di's\\\\:nәbl,-'z\\\\:-
discerning => di's\\\\:niŋ
discerns => diˈsə:nz
discerptibility => di,sə:ptə'biləti; -'zə:p-
discerptible => di'sә:ptibl
discerption => di'sә:pʃәn
discharge => dis'tʃɑ:dʒ
dischargeable => dis'tʃɑ:dʒәbl
discharged => dis'tʃɑ:dʒd
discharger => dis'tʃɑ:dʒә
discharges => disˈtʃɑ:dʒz
discharging => dis'tʃɑ:dʒiŋ
disciple => di'saipl
discipled => dɪ'saɪp(ə)l
disciples => dɪ'saɪplz
discipleship => dɪ'saɪplʃɪp
disciplinable => 'disiplinәbl
disciplinal => 'disiplinәl
disciplinarian => .disipli'nєәriәn
disciplinarians => ˌdɪsəpləˈneəri:ənz
disciplinary => 'disiplinәri
discipline => 'disiplin
disciplined => 'disiplind
discipling => dɪ'saɪp(ə)l
disciplining => ˈdisiplinɪŋ
discipular => di'sipjulә
disclaim => dis'kleim
disclaimed => dɪsˈkleɪmd
disclaimer => dis'kleimә
disclaimers => dɪsˈkleɪməz
disclaiming => dɪsˈkleɪmɪŋ
disclaims => dɪsˈkleɪmz
disclose => dis'klәuz
disclosed => disˈkləuzd
discloses => disˈkləuziz
disclosing => disˈkləuzɪŋ
disclosure => dis'klәuʒә
disclosures => dɪˈskləʊʒəz
disco => 'diskәu
discobolus => di'skɒbәlәs
discographer => dis'kɔ^rәfә(r)
discography => dis'kɔ^rәfi
discoid => 'diskɒid
discoidal => dis'kɔidәl
discolor => dis'kʌlә(r)
discoloration => dis,kʌlә'reiʃәn
discolored => dɪs'kʌlərd
discolour => dis'kʌlә
discolouration => diskʌlә'reiʃәn
discoloured => dɪsˈkʌləd
discolouring => dɪsˈkʌlərɪŋ
discolours => dɪsˈkʌləz
discombobulate => .diskәm'bɒbjuleit
discombobulated => ,dɪskəm'bɒbjʊleɪt
discombobulates => ,dɪskəm'bɒbjʊleɪt
discombobulating => ,dɪskəm'bɒbjʊleɪt
discomfit => dis'kʌmfit
discomfited => dis'kʌmfitid
discomfiting => dɪsˈkʌmfɪtɪŋ
discomfits => dɪsˈkʌmfɪts
discomfiture => -fitʃә
discomfort => dis'kʌmfәt
discomforting => dɪs'kʌmfətɪŋ
discomforts => dɪsˈkʌmfəts
discommode => .diskә'mәud
discommoded => ,dɪskə'məʊd
discommodes => ,dɪskə'məʊd
discommoding => ,dɪskə'məʊd
discommodious => ,diskә'mәudiәs
discommodity => diskә'mɔditi
discompose => .diskәm'pәuz
discomposed => dɪskəm'pəʊzd
discomposure => .diskәm'pәuʒә
disconcert => .diskәn'sә:t
disconcerted => .diskәn'sә:tid
disconcerting => ˌdɪskən'sɜ:rtɪŋ
disconcertingly => ,diskən'sə:tiŋli
disconcertion => ,diskən'sə:ʃən
disconcertment => dɪskən'sɜ:tmənt
disconcerts => ˌdɪskənˈsɜ:ts
disconfirm => ,diskәn'fә:m
disconfirmation => dis,kɔnfə'meiʃən
disconfirming => ,diskən'fə:m
disconformity => ,diskәn'fɔ:miti
disconnect => .diskә'nekt
disconnected => .diskә'nektid
disconnectedly => ˊdiskәˊeˊnektidli
disconnecting => ,diskә'nektiŋ
disconnection => ,diskә'nekʃәn
disconnects => ˌdɪskəˈnekts
disconsolate => dis'kɒnsәlit
disconsolately => dɪs'kɒnsələtlɪ
disconsolateness => dɪskɒnsə'lətnes
disconsolation => dɪskɒnsə'leɪʃn
discontent => .diskәn'tent
discontented => .diskәn'tentid
discontentedly => ˌdɪskən'tentɪdlɪ
discontentedness => dɪskənten'tɪdnəs
discontentment => .diskәn'tentmәnt
discontents => ˌdɪskənˈtents
discontinuance => .diskәn'tinjuәns
discontinuation => 'diskәn,tinju'eiʃә n
discontinue => .diskәn'tinju:
discontinued => ˌdɪskən'tɪnju:d
discontinues => ˌdɪskənˈtɪnju:z
discontinuing => ˌdɪskənˈtɪnju:ɪŋ
discontinuities => ˈdisˌkɔntiˈnju(:)itiz
discontinuity => .diskәnti'nju:iti
discontinuous => .diskәn'tinjuәs
discontinuously => diskәnˊtigjuәsli
discord => 'diskɒ:d
discordance => dis'kɒ:dәns
discordancy => dɪs'kɔ:dənsɪ
discordant => dis'kɒ:dәnt
discordantly => dɪs'kɔ:dəntlɪ
discotheque => 'diskәjtek
discotheques => ˌdɪskəˈteks
discount => 'diskaunt
discountable => 'diskauntәbl
discounted => ˈdiskauntid
discountenance => dis'kauntinәns
discountenanced => dɪs'kaʊntɪnəns
discountenances => dɪs'kaʊntɪnəns
discountenancing => dɪs'kaʊntɪnəns
discourage => dis'kʌridʒ
discouraged => dis'kʌridʒd
discouragement => dis'kʌridʒmәnt
discouragements => dɪˈskɜ:rɪdʒmənts
discourages => disˈkʌridʒz
discouraging => dis'kʌridʒiŋ
discouragingly => dɪs'kʌrɪdʒɪŋlɪ
discourse => 'diskɒ:s
discourse marker => ˈdiskɔ:s ˈmɑ:kə
discourses => ˈdiskɔ:siz
discourteous => dis'kә:tjәs
discourteously => dɪs'kɜ:ti:əslɪ
discourteousness => disˊkәːtjәsnis
discourtesy => dis'kә:tisi
discover => dis'kʌvә
discoverable => dɪs'kʌvərəbl
discoverer => dis'kʌvәrә
discoverers => dis'kʌvərə
discoveries => disˈkʌvəriz
discovering => dɪs'kʌvərɪŋ
discovers => disˈkʌvəz
discovery => dis'kʌvәri
discredit => dis'kredit
discreditable => dis'kreditәbl
discreditably => dis'kreditәbli
discrediting => dɪsˈkredɪtɪŋ
discredits => dɪsˈkredɪts
discreet => dis'kri:t
discreetly => dɪ'skri:tlɪ
discreetness => dɪ'skri:tnɪs
discrepancies => disˈkrepənsiz
discrepancy => dis'krepәnsi
discrepant => dis'krepәnt
discrete => dis'kri:t
discretely => dɪ'skri:tlɪ
discretion => dis'kreʃәn
discretionary => dis'kreʃәnәri
discretization => dis,kri:ti'zeiʃәn
discretize => 'diskri:taiz
discriminability => dis,kriminә'biliti
discriminable => dis'kriminәbl
discriminably => dɪsk'rɪmɪnəblɪ
discriminant => dis'kriminәnt
discriminate => dis'krimineit
discriminated => disˈkrimineitid
discriminates => disˈkrimineits
discriminating => dis'krimineitiŋ
discriminatingly => dɪsk'rɪmɪneɪtɪŋlɪ
discrimination => dis.krimi'neiʃәn
discriminative => dis'kriminәtiv
discriminator => dis'krimineitә
discriminatory => di'skriminәtәri; (?@) -tɔ:ri
discursive => dis'kә:siv
discursively => dɪs'kɜ:sɪvlɪ
discursiveness => disˊkәːsivnis
discus => 'diskәs
discuss => dis'kʌs
discussant => dis'kʌsәnt
discusser => dɪs'kʌsər
discusses => dɪ'skʌs
discussing => disˈkʌsɪŋ
discussion => dis'kʌʃәn
discussions => dɪs'kʌʃnz
disdain => dis'dein
disdained => disˈdeind
disdainful => dis'deinful
disdainfully => dis'deinfuli
disdainfulness => dɪs'deɪnfəlnəs
disdaining => disˈdeinɪŋ
disdains => disˈdeinz
disease => di'zi:z
diseased => di'zi:zd
diseconomy => 'disi(:)'kɔnәmi
disembark => .disim'bɑ:k
disembarkation => dis.embɑ:'keiʃәn
disembarked => ˌdɪsemˈbɑ:kt
disembarking => ˌdɪsemˈbɑ:kɪŋ
disembarks => ˌdɪsemˈbɑ:ks
disembarrass => .disim'bærәs
disembarrassed => dɪsɪm'bærəs; dɪsem-
disembarrasses => dɪsɪm'bærəs; dɪsem-
disembarrassing => dɪsɪm'bærəs; dɪsem-
disembarrassment => dɪsɪm'bærəsmənt
disembodied => disim'bɔdid
disembodies => dɪsɪm'bɒdɪz
disembodiment => .disim'bɒdimәnt
disembody => .disim'bɒdi
disembodying => ˌdɪsɪmˈbɔdɪdɪŋ
disembogue => .disim'bәug
disembowel => .disim'bauәl
disembowelled => disimˈbauəld
disembowelling => disimˈbauəlɪŋ
disembowelment => dɪsɪm'baʊelmənt
disembowels => disimˈbauəlz
disembroil => .disim'brɒil
disembroiled => ,dɪsɪm'brɒɪl
disembroiling => ,dɪsɪm'brɒɪl
disembroils => ,dɪsɪm'brɒɪl
disempower => dɪsɪm'paʊər
disempowerment => dɪsɪm'paʊɜ:mənt
disenchant => .disin'tʃɑ:nt
disenchantment => ˌdɪsɪn'tʃɑ:ntmənt
disencumber => .disin'kʌmbә
disencumbered => dɪsɪn'kʌmbə; dɪsen-
disencumbering => dɪsɪn'kʌmbə; dɪsen-
disencumbers => dɪsɪn'kʌmbə; dɪsen-
disendow => .disin'dau
disendowment => dɪ'sɪndaʊmənt
disenfranchise => .disin'fræntʃaiz
disenfranchised => ˌdɪsenˈfrænˌtʃaɪzd
disenfranchises => ˌdɪsenˈfrænˌtʃaɪziz
disenfranchising => ˌdɪsenˈfrænˌtʃaɪzɪŋ
disengage => .disin'geidʒ
disengaged => .disin'geidʒd
disengagement => .disin'geidʒmәnt
disengages => ˌdisinˈɡeidʒz
disengaging => 'disin'^eidʒiŋ
disentail => 'disin'teil
disentangle => .disin'tængl
disentangled => ˌdɪsenˈtæŋgəld
disentanglement => ˌdɪsɪn'tæŋgəlmənt
disentangles => ˌdɪsenˈtæŋgəlz
disentangling => ˌdɪsenˈtæŋgəlɪŋ
disenthral => .disin'θrɒ:l
disenthralment => .disin'θrɒ:lmәnt
disentitle => 'disin'taitl
disentomb => .disin'tu:m
disequilibrium => .disikwi'libriәm
disestablish => 'disis'tæbliʃ
disestablishment => ,disis'tæbliʃmənt
disesteem => .disi'sti:m
disesteemed => dɪsɪ'stiːm; dɪse-
disesteeming => dɪsɪ'stiːm; dɪse-
disesteems => dɪsɪ'stiːm; dɪse-
diseuse => di:'z\\\\:z
disfavor => dis'feivә
disfavored => dis'feivə
disfavour => 'dis'feivә
disfavours => dɪs'fevɚ
disfiguration => dis,fi:^jj'reiʃәn
disfigure => dis'fi^ә
disfigured => dɪs'fɪgəd
disfigurement => dis'fi^әmәnt
disfigurements => dɪs'fɪɡəmənts
disfigures => dɪsˈfɪgjəz
disfiguring => dɪsˈfɪgjərɪŋ
disforest => dis'fɒrist
disforestation => dɪsfɒ'rɪsteɪʃn
disforested => dɪs'fɒrɪst
disforesting => dɪs'fɒrɪstɪŋ
disforests => dɪs'fɒrɪst
disfranchise => dis'fræntʃaiz
disfranchised => dɪs'fræn(t)ʃaɪz
disfranchises => dɪs'fræn(t)ʃaɪz
disfranchising => dɪs'fræn(t)ʃaɪz
disfrock => dis'frɒk
disgorge => dis'gɒ:dʒ
disgorged => dɪsˈgɔ:dʒd
disgorgement => dɪs'gɔ:dʒˌmənt
disgorger => dɪs'ɡɔ:dʒər
disgorges => dɪsˈgɔ:dʒz
disgorging => dis'^ɔ:dʒiŋ
disgrace => dis'greis
disgraced => dɪs'greɪst
disgraceful => dis'greisful
disgracefully => dɪs'ɡreɪsfəlɪ
disgraces => disˈɡreisiz
disgruntle => dis'grʌntl
disgruntled => dis'^rʌnt(ә)ld
disguise => dis'gaiz
disguised => disˈɡaizd
disguises => disˈɡaiziz
disguising => disˈɡaizɪŋ
disgust => dis'gʌst
disgusted => dis'ɡʌstid
disgustedly => dis'gʌstidli
disgustful => dis'gʌstful
disgusting => dis'gʌstiŋ
disgustingly => dɪsˈgʌstɪŋli
disgusts => disˈɡʌsts
dish => diʃ
dish the dirt => diʃ ðə də:t
dish towel => diʃ ˈtauəl
dishabille => .disæ'bi:l
disharmonious => .dishɑ:'mәuniәs
disharmoniously => dishaːˊmounjәsli
disharmony => dis'ɑ:mәni
dishcloth => 'diʃklɒθ
dishcloth gourd => ˈdiʃklɔθ gɔ:d
dishcloths => ˈdiʃklɔθs
dishdasha => dɪʃ'dæʃə
dishearten => dis'hɑ:tn
disheartening => dɪs'hɑ:tnɪŋ
dishearteningly => dis'hɑ:tniŋli
disheartenment => dɪs'hɑ:tənmənt
disheartens => dɪsˈhɑ:tndz
dished => diʃd
dishevel => di'ʃevl
disheveled => di'ʃevәld
dishevelled => di'ʃev(ә)ld
dishevelment => dɪ'ʃevelmənt
dishful => 'diʃful
dishfuls => 'dɪʃfʊl
dishing => 'diʃiŋ
dishonest => dis'ɒnist
dishonestly => dɪs'ɒnɪstlɪ
dishonesty => dis'ɒnisti
dishonor => dis'ɒnә
dishonorably => dɪs'ɒnərəblɪ
dishonour => dis'ɔnә
dishonoured => dɪs'ɒnəd
dishonours => dɪsˈɔnəz
dishpan => 'diʃpæn
dishrag => 'diʃræ^
dishtowel => 'diʃ,tajәl
dishware => 'diʃwєә
dishwash => 'dɪʃwɒʃ
dishwasher => 'diʃwɒʃә
dishwashers => 'dɪʃwɒʃəz
dishwashing => 'dɪʃwɒʃɪŋ
dishwater => 'diʃwɔ:tә
dishy => 'diʃi
disillusion => .disi'lu:ʒәn
disillusioning => ˌdisiˈlu:ʒənɪŋ
disillusionment => ,disi'lju:ʒәnmәnt
disillusions => ˌdisiˈlu:ʒənz
disincentive => .disin'sentiv
disincentives => dɪsɪn'sentɪvz
disinclination => .disinkli'neʃәn
disincline => .disin'klain
disinclined => disin'klaind
disincorporate => .disin'kɒ:pәreit
disinfect => .disin'fekt
disinfectant => .disin'fektәnt
disinfectants => dɪsɪn'fektənts
disinfected => dɪsɪn'fektɪd
disinfecting => ˌdɪsɪnˈfektɪŋ
disinfection => .disin'fekʃәn
disinfects => ˌdɪsɪnˈfekts
disinfest => .disin'fest
disinfestation => ,disin,fes'teiʃәn
disinfested => dɪsɪn'fest
disinfesting => dɪsɪn'fest
disinfests => dɪsɪn'fest
disinflation => .disin'fleiʃәn
disinformation => .disinfә'meiʃәn
disingenuity => dɪs,ɪndʒɪ'njuːətɪ
disingenuous => .disin'dʒenjuәs
disingenuously => ˌdɪsɪn'dʒenjʊəslɪ
disinherit => 'disin'herit
disinheritance => .disin'heritәns
disinherited => ˈdisinˈheritid
disinheriting => ˈdisinˈheritɪŋ
disinherits => ˈdisinˈherits
disinhibition => ,disinhi'biʃәn
disintegrate => dis'intigreit
disintegrated => dɪsˈɪntɪˌgreɪtid
disintegrates => dɪsˈɪntɪˌgreɪts
disintegration => dis.inti'greiʃәn
disintegrative => dɪ'sɪntɪɡrətɪv
disintegrator => dis'intigreitә
disinter => .disin'tә:
disinterest => dis'intrist
disinterested => dis'intristid
disinterestedly => dis'intristidli
disinterestedness => dis'intrəstidnis
disintermediation => dis,intәmi:di'eiʃәn
disinterred => dɪsɪn'tɜ:d
disinterring => dɪ'sɪntɜ:rɪŋ
disinters => ˌdɪsɪnˈtɜ:z
disinvest => ˌdɪsɪnˈvest
disinvestment => disin'vestmәnt
disinvite => ,disin'vait
disjecta membra => dis'dʒektә'membrә
disjoin => dis'dʒɒin
disjoined => dɪs'dʒɒɪn
disjoining => dɪs'dʒɒɪn
disjoins => dɪs'dʒɒɪn
disjoint => dis'dʒɒint
disjointed => dis'dʒɔintid
disjointedly => dɪsˈdʒɒɪntədlɪ
disjunct => dis'dʒʌŋkt
disjunction => dis'dʒʌŋkʃәn
disjunctive => dis'dʒʌŋktiv
disjuncture => dis'dʒʌŋktʃә
disk => disk
diskette => 'diskit
diskettes => dɪs'kets
dislikable => dis'laikәbl
dislike => dis'laik
disliked => disˈlaikt
disliking => disˈlaikɪŋ
dislocate => 'dislәukeit
dislocated => 'dɪsləkeɪtɪd
dislocates => ˈdɪsləʊˌkeɪts
dislocating => ˈdɪsləʊˌkeɪtɪŋ
dislocation => dislou'keiʃәn
dislodge => dis'lɒdʒ
dislodged => dɪsˈlɔdʒd
dislodgement => disˊlɒdʒmәnt
dislodges => dɪsˈlɔdʒz
dislodging => dɪs'lɒdʒɪŋ
disloyal => dis'lɒiәl
disloyally => dɪs'lɔɪəlɪ
disloyalty => dis'lɒiәlti
dismal => 'dizmәl
dismantle => dis'mæntl
dismantled => disˈmæntld
dismantles => disˈmæntlz
dismantling => dis'mæntliŋ
dismast => dis'mɑ:st
dismasted => dɪs'mɑːst
dismasting => dɪs'mɑːst
dismay => dis'mei
dismayed => dɪsˈmeɪd
dismaying => disˈmeiŋ
dismayingly => dɪs'meɪɪŋlɪ
dismays => disˈmeiz
dismember => dis'membә
dismembered => dis'membəd
dismembering => dɪsˈmembərɪŋ
dismembers => dɪsˈmembəz
dismiss => dis'mis
dismissal => dis'misәl
dismissals => dɪsˈmɪsəlz
dismissed => dɪs'mɪst
dismisses => dɪs'mɪs
dismissible => dis'misәbl
dismissing => disˈmisɪŋ
dismissive => dis'misiv
dismount => dis'maunt
dismounted => dɪsˈmaʊntid
dismounting => dis'mauntiŋ
dismounts => dɪsˈmaʊnts
Disney => 'dizni
disneyland => 'diznilænd
disobedience => .disә'bi:djәns
disobedient => .disә'bi:djәnt
disobey => .disә'bei
disobeyed => ˌdɪsəˈbeɪd
disobeying => ˌdɪsəˈbeɪŋ
disobeys => ˌdɪsəˈbeɪz
disoblige => .disә'blaidʒ
disobliged => dɪsə'blaɪdʒ
disobliging => .disә'blaidʒiŋ
disomic => dai'sәumik
disomy => dai'sәumi
disorder => dis'ɒ:dә
disordered => dis'ɒ:dәd
disordering => dɪ'sɔ:dərɪŋ
disorderliness => dis'ɒ:dәlinis
disorderly => dis'ɒ:dәli
disorders => disˈɔ:dəz
disorganisation => dɪsɔ:ɡənaɪ'zeɪʃən
disorganize => dis'ɒ:gәnaiz
disorganized => dis'ɔ:ɡәnaizd
disorient => dis'ɒ:rient
disorientate => dis'ɒ:rienteit
disorientated => dɪsˈɔ:rɪənteɪtid
disorientates => dɪsˈɔ:rɪənteɪts
disorientating => dɪsˈɔ:rɪənteɪtɪŋ
disorientation => dis.ɒ:rien'teiʃәn
disoriented => dis'ɔ:rientid
disorienting => dɪsˈɔ:ri:ˌentɪŋ
disorients => dɪsˈɔ:ri:ˌents
disown => dis'әun
disowned => dɪsˈəʊnd
disowning => dɪsˈəʊnɪŋ
disowns => dɪsˈəʊnz
disparage => dis'pæridʒ
disparaged => dɪˈspærɪdʒd
disparagement => dis'pæridʒmәnt
disparages => dɪˈspærɪdʒz
disparaging => dis'pæridʒiŋ
disparagingly => dɪ'spærɪdʒɪŋlɪ
disparate => 'dispәrәt
disparities => dɪˈspærɪti:z
disparity => dis'pæriti
dispassion => dis'pæʃәn
dispassionate => dis'pæʃәnit
dispassionately => dɪs'pæʃənətlɪ
dispatch => dis'pætʃ
dispatch box => disˈpætʃ bɔks
dispatch rider => disˈpætʃ ˈraɪdə
dispatched => dɪs'pætʃt
dispatcher => dis'pætʃә
dispatchers => dɪs'pætʃəz
dispatches => disˈpætʃiz
dispel => dis'pel
dispelling => dɪˈspelɪŋ
dispels => dɪˈspelz
dispensability => dis.pensә'biliti
dispensable => dis'pensәbl
dispensaries => dɪˈspensəri:z
dispensary => dis'pensәri
dispensation => .dispen'seiʃәn
dispensationalism => ,dispen'seiʃənə,lizəm
dispensations => ˌdispenˈseiʃənz
dispense => dis'pens
dispensed => disˈpenst
dispenser => dis'pensә
dispensers => dɪˈspensəz
dispersal => dis'pә:sl
dispersant => dis'pә:sәnt
disperse => dis'pә:s
dispersed => dis'pә:st
disperser => dɪs'pɜ:sə
disperses => disˈpə:siz
dispersing => dɪ'spɜ:sɪŋ
dispersion => dis'pә:ʃәn
dispersive => dis'pә:siv
dispirit => dis'pirit
dispirited => dis'piritid
dispiritedly => dis'piritidli
dispiriting => dɪˈspɪrɪtɪŋ
dispirits => dɪˈspɪrɪtɪdz
displace => dis'pleis
displaced => dis'pleist
displaced person => dis'pleisid
displacement => dis'pleismәnt
displacement activity => dɪsˈpleɪsmənt ækˈtiviti
displacement ton => dɪsˈpleɪsmənt tʌn
displacements => dɪsp'leɪsmənts
displaces => disˈpleisiz
displacing => disˈpleisɪŋ
display => dis'plei
displayed => dis'pleid
displayer => dɪs'pleɪə
displease => dis'pli:z
displeases => dɪsˈpli:ziz
displeasing => dis'pli:ziŋ
displeasure => dis'pleʒә
disport => dis'pɒ:t
disported => dɪˈspɔ:tid
disporting => dɪˈspɔ:tɪŋ
disports => dɪˈspɔ:ts
disposability => dis,pəuzəɡ'biləti
disposable => dis'pәuzәbl
disposal => dis'pәuzәl
disposals => disˈpəuzəlz
dispose => dis'pәuz
disposed => di'spәjzd
disposer => dis'pәuzә
disposes => disˈpəuziz
disposing => disˈpəuzɪŋ
disposition => .dispә'ziʃәn
dispositions => dɪspə'zɪʃnz
dispositive => dis'pɔzәtiv
dispositor => dɪspə'zɪtər
dispossess => .dispә'zes
dispossessed => ,dispә'zest
dispossesses => ˌdɪspəˈzesiz
dispossessing => ˌdɪspəˈzesɪŋ
dispossession => .dispә'zeʃәn
dispraise => dis'preiz
disproof => dis'pru:f
disproportion => .disprә'pɒ:ʃәn
disproportional => .disprә'pɒ:ʃәnәl
disproportionality => dɪsprəpɔ:ʃə'nælɪtɪ
disproportionally => dɪsprə'pɔ:ʃənəlɪ
disproportionate => .disprә'pɒ:ʃәnit
disproportionation => , disprә ,pɔ:ʃә'neiʃәn
disprovable => dɪsp'ru:vəbl
disprove => .dis'pru:v
disproved => dɪsˈpru:vd
disproves => dɪsˈpru:vz
disproving => dɪsˈpru:vɪŋ
disputable => dis'pju:tәbl
disputably => disˊpjuːtәbli
disputant => dis'pju:tәnt
disputation => .dispju:'teiʃәn
disputations => ˌdispju:ˈteiʃənz
disputatious => ,dispju(:)'teiʃәs
disputative => dis'pju:tәtiv
dispute => dis'pju:t
disputer => dis'pju:tә(r)
disputes => disˈpju:ts
disputing => disˈpju:tɪŋ
disqualification => dis,kwɔlifi'keiʃәn
disqualifications => dis,kwɔlifi'keiʃən
disqualified => dɪsˈkwɔləˌfaɪd
disqualifies => dɪsˈkwɔləˌfaɪz
disqualify => dis'kwɒlifai
disqualifying => dɪsˈkwɔləˌfaɪŋ
disquiet => dis'kwaiәt
disquieted => dɪsˈkwaɪɪtid
disquieting => dis'kwaiәtiŋ
disquietingly => dɪsk'waɪətɪŋlɪ
disquiets => dɪsˈkwaɪɪts
disquietude => dis'kwaiitju:d
disquisition => .diskwi'ziʃәn
disquisitional => dis'kwizitiv
disquisitions => ˌdɪskwɪˈzɪʃənz
disraeli => diz'reili
disrate => dis'reit
disregard => .disri'gɑ:d
disregarded => ˌdisriˈɡɑ:did
disregarding => ˌdisriˈɡɑ:dɪŋ
disregards => ˌdisriˈɡɑ:dz
disrelish => dis'reliʃ
disremember => disri'membә
disrepair => .disri'pєә
disreputable => dis'repjutәbl
disreputably => dɪsrep'jʊtəblɪ
disrepute => .disri'pju:t
disrespect => .disri'spekt
disrespected => dɪsrɪ'spekt
disrespectful => .disri'spektful
disrespectfully => ,disri'spektfəli
disrespecting => dɪsrɪ'spekt
disrespects => dɪsrɪ'spekt
disrobe => dis'rәub
disrobed => ˈdisˈrəubd
disrobes => ˈdisˈrəubz
disrobing => ˈdisˈrəubɪŋ
disrupt => dis'rʌpt
disrupted => disˈrʌptid
disrupting => disˈrʌptɪŋ
disruption => dis'rʌpʃәn
disruptions => disˈrʌpʃənz
disruptive => dis'rʌptiv
disruptiveness => dɪs'rʌptɪvnɪs
disrupts => disˈrʌpts
Diss => dis
dissatisfaction => 'dis.sætis'fækʃәn
dissatisfies => dɪ'sætɪsfaɪz
dissatisfy => dis'sætisfai
dissaving => di'seiviŋ
dissect => di'sekt
dissected => di'sektid
dissecting => dɪ'sektɪŋ
dissection => di'sekʃәn
dissector => di'sektә
dissects => dɪˈsekts
dissemblance => di'semblәns
dissemble => di'sembl
dissembled => dɪˈsembəld
dissembler => di'semblә
dissembles => dɪˈsembəlz
dissembling => dɪˈsembəlɪŋ
disseminate => di'semineit
disseminated => dɪ'semɪneɪtɪd
disseminates => diˈsemineits
disseminating => diˈsemineitɪŋ
dissemination => di.semi'neiʃә
disseminule => di'semi,nju:l
dissension => di'senʃәn
dissensus => dɪ'sensəs
dissent => di'sent
dissented => diˈsentid
dissenter => di'sentә
dissenters => dɪ'sentəz
dissentient => di'senʃiәnt
dissenting => di'sentiŋ
dissention => dɪ'sentaɪən
dissents => diˈsents
dissepiment => di'sepimәnt
dissertation => .disә'teiʃәn
dissertations => dɪsə'teɪʃnz
disservice => dis'sә:vis
disservices => dɪ(s)'sɜːvɪs
disses => disiz
dissever => dis'sevә
dissevered => dɪ(s)'sevə
dissevering => dɪ(s)'sevə
dissevers => dɪ(s)'sevə
dissidence => 'disidәns
dissident => 'disidәnt
dissidents => 'dɪsɪdənts
dissimilar => di'similә
dissimilarities => ,dɪsɪmɪ'lærɪtɪ
dissimilarity => .disimi'læriti
dissimilarly => 'dɪsɪmələlɪ
dissimilate => di'simileit
dissimilated => dɪ'sɪmɪleɪt
dissimilating => dɪ'sɪmɪleɪt
dissimilation => .disimi'leiʃәn
dissimilatory => di'simi,leitәri
dissimilitude => .disi'militju:d
dissimulate => di'simjuleit
dissimulated => dɪˈsɪmjəˌleɪtid
dissimulates => dɪˈsɪmjəˌleɪts
dissimulating => dɪˈsɪmjəˌleɪtɪŋ
dissimulation => di.simju'leiʃәn
dissimulator => di'simjuleitә
dissing => disɪŋ
dissipate => 'disipeit
dissipated => 'disipeitid
dissipates => ˈdisipeits
dissipating => ˈdisipeitɪŋ
dissipation => .disi'peiʃәn
dissipative => 'disipeitiv
dissipator => 'disipeitә
dissociable => di'sәuʃiәbl
dissociate => di'sәuʃieit
dissociated => dɪ'səʊʃɪeɪtɪd
dissociates => dɪˈsəʊʃi:ˌeɪts
dissociating => dɪˈsəʊʃi:ˌeɪtɪŋ
dissociation => di.sәusi'eiʃәn
dissociative => di'sәuʃieitiv
dissolubility => di.sɒlju'biliti
dissoluble => di'sɒljubl
dissolute => 'disәljut
dissolutely => dɪsə'lu:tlɪ
dissolution => .disә'lu:ʃәn
dissolvable => di'zɒlvәbl
dissolve => di'zɒlv
dissolvent => di'zɒlvәnt
dissolves => diˈzɔlvz
dissolving => di'zɔlviŋ
dissonance => 'disәnәns
dissonant => 'disәnәnt
dissuade => di'sweid
dissuaded => dɪˈsweɪdid
dissuades => dɪˈsweɪdz
dissuading => dɪˈsweɪdɪŋ
dissuasion => di'sweiʒәn
dissuasive => di'sweisiv
dissyllabic => .disi'læbik
dissyllable => di'silәbl
dissymmetrical => 'dissi'metrikәl
dissymmetry => di'simitri
distaff => 'distɑ:f
distaffs => 'dɪstɑːf
distal => 'distәl
distance => 'distәns
distance learning => ˈdistəns ˈlə:niŋ
distances => ˈdistənsiz
distant => 'distәnt
distaste => .dis'teist
distasteful => dis'teistful
distemper => dis'tempә
distempered => dɪs'tempəd
distempering => dɪs'tempərɪŋ
distempers => dɪ'stempə
distend => di'stend
distended => dɪˈstendid
distending => dɪˈstendɪŋ
distends => dɪˈstendz
distensibility => dis,tensә'bilәti
distensible => dis'tensәbl
distension => dis'tenʃәn
distention => dis'tenʃәn
distich => 'distik
distichous => 'distikәs
distichously => 'dɪstɪtʃəslɪ
distill => dis'til
distillate => 'distilit, -leit
distillation => .disti'leiʃәn
distillatory => dis'tilәtәri
distilled => dis'tild
distiller => dis'tilә
distilleries => disˈtiləriz
distillers => disˈtiləz
distillery => dis'tilәri
distilling => dis'tiliŋ
distils => disˈtilz
distinct => dis'tiŋkt
distinction => dis'tiŋkʃәn
distinctions => dɪs'tɪŋkʃnz
distinctive => di'stiŋktiv
distinctively => dɪ'stɪŋktɪvlɪ
distinctiveness => dɪ'stɪŋktɪvnɪs
distinctly => dis'tiŋktli
distinctness => dis'tiŋktnis
distinguish => dis'tiŋgwiʃ
distinguishable => dis'tiŋ^wiʃәbl
distinguished => dis'tiŋgwiʃt
distinguishes => disˈtiŋɡwiʃiz
distinguishing => dis'tiŋgwiʃiŋ
distort => dis'tɒ:t
distorted => dis'tɔ:tid
distorting => disˈtɔ:tɪŋ
distortion => dis'tɒ:ʃәn
distortions => dɪˈstɔ:ʃənz
distorts => disˈtɔ:ts
distract => dis'trækt
distracted => dis'træktid
distractedly => dis'træktidli
distracter => dɪst'ræktər
distracting => dɪ'stræktɪŋ
distractingly => dis'træktiŋli
distraction => dis'trækʃәn
distractions => dɪˈstrækʃənz
distractive => dis'træktiv
distractor => dis'træktә
distracts => disˈtrækts
distrain => dis'trein
distrained => dɪ'streɪn
distrainer => dis'treinә(r)
distraining => dɪ'streɪn
distrainment => di'streinmәnt
distrains => dɪ'streɪn
distraint => di'streint
distrait => dis'trei
distraught => dis'trɒ:t
distress => di'stres
distressed => di'strest
distresses => disˈtresiz
distressful => di'stresful
distressing => di'stresiŋ
distributable => dis'tribjutәbl
distributary => di'stribjutәri
distribute => di'stribju:t
distributed => di'stribju:tid
distributes => disˈtribju:ts
distributing => dis'tribju:tiŋ
distribution => .distrә'bju:ʃәn
distributions => dɪstrɪb'ju:ʃnz
distributive => di'stribjutiv
distributively => dɪst'rɪbjʊtɪvlɪ
distributor => dis'tribjutә
distributors => dɪst'rɪbju:təz
distributorship => dɪst'rɪbju:təʃɪp
district => 'distrikt
district nurse => ˈdistrikt nə:s
districted => 'dɪstrɪkt
districts => ˈdistrikts
distrust => dis'trʌst
distrusted => dɪsˈtrʌstid
distrustful => dis'trʌstful
distrusting => dɪsˈtrʌstɪŋ
distrusts => dɪsˈtrʌsts
disturb => dis'tә:b
disturbance => dis'tә:bәns
disturbances => dɪs'tɜ:bənsɪz
disturbed => di'stә:bd
disturbing => dis'tә:biŋ
disturbingly => dis'tә:biŋli
disturbs => diˈstə:bz
disubstituted => dai'sʌbstitju:tid
disulfiram => dai'sʌlfiræm
disulphate => daɪ'sʌlfeɪt
disulphide => dai'sʌlfaid
disunion => dis'ju:njәn
disunite => .disju'nait
disunited => ˌdɪsju:'naɪtɪd
disunity => dis'ju:niti
disuse => dis'ju:s
disutility => disju:'tiliti
disyllabic => 'disi'læbik
disyllable => di'silәbl
dit => dit
ditch => ditʃ
ditcher => 'ditʃә
ditches => ditʃiz
ditching => 'ditʃiŋ
ditchwater => 'ditʃәwɒ:tә
ditheism => 'daiθi:izm
dither => 'diðә
dithered => 'dɪðərd
dithering => 'diðәriŋ
dithers => ˈdɪðəz
dithery => 'dɪðərɪ
dithionite => dai'θaiә,nait
dithizone => dai'θaizәun
dithyramb => 'diθiræmb
dithyrambic => .diθi'ræmbik
ditransitive => daɪˈtrænsətɪv
ditsy => ˈditsi
dittany => 'ditәni
ditties => ˈditiz
ditto => 'ditәu
dittoed => 'dɪtəʊ
dittography => di'tɔ^rәfi
dittoing => 'dɪtəʊ
ditty => 'diti
ditz => 'dɪtz
ditzy => ˈdɪtsi
diuresis => ,daijuә'ri:sis
diuretic => .daijuә'retik
diurnal => dai'ә:nl
diurnally => da'ɪɜ:nəlɪ
div => div
diva => 'di:vә
divagate => 'daivә^eit
divagated => 'daɪvəgeɪt
divagating => 'daɪvəgeɪt
divagation => ,daivә'^eiʃən
divalent => dai'veilәnt
Divali => di'vɑ:li:
divan => di'væn
divans => dɪˈvænz
divaricate => dai'værikeit
divaricated => daɪ'værɪkeɪt; dɪ-
divaricates => daɪ'værɪkeɪt; dɪ-
divaricating => daɪ'værɪkeɪt; dɪ-
divarication => dai.væri'keiʃәn
dive => daiv
dive-bomb => 'daivbɒm
dive-bombed => daiv bɔmd
dive-bomber => 'daɪvb'ɒmər
diver => 'daivә
diverge => dai'vә:dʒ
diverged => dɪˈvɜ:dʒd
divergence => dai'vә:dʒәns
divergences => daɪˈvɜ:dʒɵnsiz
divergency => daɪ'vɜ:dʒənsɪ
divergent => dai'vә:dʒәnt
diverges => dɪˈvɜ:dʒz
divers => 'daivәz
diverse => dai'vә:s
diversely => daɪ'vɜ:slɪ
diversification => daivә:sifi'keiʃәn
diversified => dai'vә:sifaid
diversifies => daiˈvə:sifaiz
diversify => dai'vә:sifai
diversion => dai'vә:ʒәn
diversionary => dai'vә:ʒәnәri
diversions => daɪ'vɜ:ʃnz
diversities => dɪˈvɜ:sɪti:z
diversity => dai'vә:siti
divert => dai'vә:t
diverticular => -lә(r)
diverticulitis => ,daivә,tikju'laitis
diverticulosis => daivә,tikju'lәusis
diverticulum => ,daivә:'tikjulәm
divertimento => di,veәti'mentәu
diverting => dai'vә:tiŋ
divertingly => daɪvɜ:'tɪŋlɪ
divertissement => dai'vә:tismәnt
diverts => daiˈvə:ts
Dives => 'daivi:z
divest => dai'vest
divested => dɪˈvestid
divesting => dɪˈvestɪŋ
divestiture => dai'vestitʃә
divestment => dai'vestmәnt,di-
divests => dɪˈvests
divi => 'divi
divide => di'vaid
divided => dә'vaidid
divided highway => dɪˈvaɪdɪd ˈhaiwei
dividend => 'dividend
dividends => 'dɪvɪdendz
divider => di'vaidә
divides => diˈvaidz
dividing => di'vaidiŋ
divination => .divi'neiʃәn
divinatory => di'vinәtәri
divine => di'vain
divine service => diˈvain ˈsɜːvɪs
divined => diˈvaind
divinely => di'vainli
diviner => di'vainә(r)
divines => diˈvainz
diving => 'daiviŋ
diving beetle => ˈdaɪvɪŋ ˈbi:tl
diving bell => ˈdaɪvɪŋ bel
diving board => ˈdaɪvɪŋ bɔ:d
diving duck => ˈdaɪvɪŋ dʌk
diving petrel => ˈdaɪvɪŋ ˈpetrəl
diving suit => ˈdaɪvɪŋ sju:t
divining rod => di'vainiŋ
divinities => diˈvinitiz
divinity => di'viniti
divinity school => diˈviniti sku:l
divinization => divinai'zeiʃәn
divinize => 'divinaiz
divisibility => di.vizi'biliti
divisible => di'vizәbl
division => di'viʒәn
division lobby => diˈviʒən ˈlɔbi
divisional => di'viʒәnәl
divisionalize => di'viʒәnәlaiz
divisions => dɪ'vɪʒnz
divisive => di'vaisiv
divisiveness => di'vaisivnis
divisor => di'vaizә
divorce => di'vɒ:s
divorcee => di'vɒ:si:
divorcees => diˈvɔ:si:z
divorcement => di'vɒ:smәnt
divorces => diˈvɔ:siz
divorcing => diˈvɔ:sɪŋ
divot => 'divәt
divots => ˈdivəts
divulgation => ,divʌl'geiʃən
divulge => di'vʌldʒ
divulged => dɪ'vʌldʒd
divulgence => daiˊvʌldʒәns
divulges => dɪˈvʌldʒz
divulging => dɪˈvʌldʒɪŋ
divvy => 'divi
dix => di:s
dixie => 'diksi
Dixiecrat => 'diksikræt
Dixieland => 'diksilænd
dixon => 'diksn
Diyarbakir => di'jɑ:bʌkiə
dizygotic => ,daizai'^ɔtik
dizygous => dai'zai^әs
dizzied => ˈdizid
dizzier => ˈdiziə
dizzies => ˈdiziz
dizzily => 'dizili
dizziness => 'dizinis
dizzy => 'dizi
dizzying => 'dizi:iŋ
djebel => 'dʒebәl
djellaba => 'dʒelәbә
Djerba => 'dʒebə
Djibouti => dʒi'bu:ti
djinn => dʒin
dkl => 'di:k'eɪ'el
dkm => 'di:k'eɪ'em
DMSO => ,di:emes'əu
DNase => 'di:'en'eis
dnestr => 'dnjestәr
Dnieper => d'ni:pә
Dniester => 'dnjestәr
do => du:
do good => du: ɡud
do-gooder => du:'^jdә(r)
do-it-yourself => 'du:itjɔ:'self
do-it-yourselfer => ,du:itjɔ:'selfә(r)
do-nothing => 'du:,nʌθiŋ
do-or-die => 'du:ә'dai
do-rag => 'du:ræɡ
doable => 'du:әbl
dobber => 'dɒbә
dobbin => 'dɔbin
dobby => 'dɔbi
dobe => 'dәubi
doberman => 'dəʊbəmən
dobra => 'dәubrә
Dobson => 'dɔbsәn
dobsonfly => 'dɒbsәnflai
Doc Martens => dɔk'mɑ:tənz
docent => 'dәusәnt
Docetism => dәu'si:tizәm
docile => 'dәusail
docilely => 'dɔsaili
docility => dәu'siliiti
dock => dɒk
dock-glass => 'dɔk^lɑ:s
dockage => 'dɔkidʒ
docked => dɔkt
docker => 'dɒkә
dockers => ˈdɔkəz
docket => 'dɒkit
docketed => 'dɒkɪt
docketing => 'dɒkɪt
dockets => ˈdɔkits
docking => 'dɒkiŋ
docking station => ˈdɔkɪŋ ˈsteiʃən
dockland => ˈdɒklænd
dockside => 'dɔksaid
dockworker => 'dɔk,w\\\\:kә(r)
dockworkers => 'dɒk,wɜːkə
dockyard => 'dɒkjɑ:d
dockyards => ˈdɔkjɑ:dz
doctor => 'dɒktә
doctoral => 'dɒktәrәl
doctorate => 'dɒktәrit
doctorates => ˈdɔktərits
doctored => 'dɒktəd
doctoring => 'dɔktәriŋ
doctrinaire => .dɒktri'nєә
doctrinairism => .dɒktri'nєәrizm
doctrinal => 'dɒktrinәl
doctrine => 'dɒktrin
doctrines => 'dɒktrɪnz
docudrama => 'dɔkjjdrɑ:mә
document => 'dɒkjumәnt
document case => ˈdɔkjumənt keis
documentable => 'dɒkjʊmentəbl
documental => ,dɔkju'mentәl
documentalist => ,dɔkjj'mentәlist
documentarian => ,dɔkjjmәn'teәriәn
documentarist => ,dɔkjj'mentәrist
documentary => .dɒkju'mentәri
documentation => .dɒkjumen'teiʃәn
docusoap => ˈdɒkjusəʊp
Dodd => dɔd
dodder => 'dɒdә
doddered => 'dɒdәd
doddering => 'dɔdәriŋ
dodders => 'dɒdəz
doddery => 'dɔdәri
dodeca- => dəʊ'dɪkə
dodecagon => dәu'dekәgәn
dodecahedral => .dәudekә'hi:drәl
dodecahedron => .dәudekә'hi:drәn
Dodecanese => dәj'dekәni:z
dodecaphonic => dәu,dekә'fɔnik
dodge => dɒdʒ
dodgeball => 'dɒdʒbɒ:l
dodged => dɔdʒd
dodgem => 'dɔdʒim
dodgems => dɒd'ʒəmz
dodger => 'dɔdʒә
dodgers => 'dɒdʒəz
dodges => dɔdʒz
dodging => 'dɔdʒiŋ
Dodgson => 'dɔdʒsәn
dodgy => 'dɒdʒi
dodo => 'dәudәu
Dodoma => 'dəudəmɑ:
dodos => ˈdəudəuz
doe => dәu
doe-eyed => 'dəʊ'aɪd
doek => djk
doer => 'du:ә
doers => ˈdu(:)əz
does => dʌz; dәz
doeskin => 'dәuskin
doesn't => ˈdʌznt
doest => 'du(:)ist
doeth => 'du(:)iθ
doff => dɒf
doffed => dɔ:ft
doffing => 'dɔfiŋ
doffs => dɔ:fs
dog => dɒg
dog biscuit => dɔɡ ˈbiskit
dog collar => dɔɡ ˈkɔlə
dog days => dɔɡ deɪz
dog paddle => dɔɡ ˈpædl
dog sled => dɔɡ sled
dog violet => dɔɡ ˈvaiəlit
dog-end => 'dɔ^end
dog-tired => 'dɔ^'taiәd
dogbane => 'dɒgbein
dogberry => 'dɒgbәri
dogbox => ˈdɒgbɒks
dogcart => 'dɒgkɑ:t
dogcarts => 'dɒɡkɑːt
dogcatcher => 'dɔ^,kætʃә(r)
dogdom => 'dɔ^dәm
doge => dәudʒ
dogface => 'dɒgfeis
dogfight => 'dɒgfait
dogfighter => 'dɒgfaɪt
dogfighting => 'dɒgfaɪt
dogfights => ˈdɔɡfaits
dogfish => 'dɒgfiʃ
dogged => 'dɒgid
doggedness => 'dɒɡɪdnəs
dogger => 'dɒgә
doggerel => 'dɒgәrәl
doggie => 'dɒgi
doggies => ˈdɔɡiz
dogginess => 'dɒginis
dogging => 'dɔɡiŋ
doggish => 'dɒgiʃ
doggo => 'dɔɡәu
doggone => 'dɒgɒn
doggy => 'dɔ^i
doggy bag => ˈdɔɡi bæɡ
doghouse => 'dɒghaus
dogie => 'dәu^i
dogleg => 'dɔ^le^
doglike => 'dɒglaik
dogma => 'dɒgmә
dogman => 'dɔɡmәn
dogmatic => dɒg'mætik
dogmatically => dɔg'mætikəli
dogmatics => dɒg'mætiks
dogmatise => 'dɔ^mәtaiz
dogmatism => 'dɒgmәtizm
dogmatist => 'dɒgmәtist
dogmatists => ˈdɔ:gməˌtɪzəmz
dogmatize => 'dɒgmәtaiz
dogmatized => 'dɔgmətaɪz
dogmatizing => 'dɔgmətaɪz
dognap => 'dɔ^næp
dogshore => 'dɒgʃɒ:
dogskin => 'dɒgskin
dogsled => ˈdɒgsled
dogtrot => 'dɔ^trɔt; (?@) 'dɔ:^-
dogwatch => 'dɒgwɒtʃ
dogwood => 'dɒgwud
DoH => dəu
Doha => 'dәuhә
doilies => ˈdɔiliz
doily => 'dɒili
doing => 'du:iŋ
doit => dɒit
dojo => 'dәudʒәu
dolby => dɔlbi
dolce => 'dɔltʃi
dolce far niente => ˈdɔltʃifɑ:ˈnjentei
dolce vita => 'dәultʃei 'vi:tә, 'dɔltʃә 'vi:tɑ:
doldrum => 'dɒldrəm
doldrums => 'dɒldrәmz
dole => dәul
doled => dəuld
doleful => 'dәulful
dolefully => 'dəʊlfəlɪ
dolefulness => ˊdoufulnis
dolerite => 'dɒlәrait
doles => dəulz
dolichocephalic => .dɒlikәuse'fælik
dolichocephaly => -'sefәli
doline => dә'li:nә
doling => dəulɪŋ
doll => dɒl
dollar => 'dɒlә
dollarbird => 'dɔlәb\\\\:d
dollarization => ˌdɒləraɪ'zeɪʃn
dollars-and-cents => 'dɔlәzәnd'sents
dolled => dɔld
dollhouse => 'dɔlhajs
dollies => ˈdɔliz
dolling => dɔlɪŋ
dollop => 'dɒlәp
dollops => ˈdɔləps
dolly => 'dɒli
dolly bird => ˈdɔli bə:d
dolma => 'dɒlmə
dolman => 'dɔlmәn
dolman sleeve => ˈdɔlmən sli:v
dolmen => 'dɔlmen
dolmus => 'dәjlmju:ʃ
dolomite => 'dɒlәmait
dolomites => 'dәulә,maitis
dolomitic => ,dɔlә'mitik
dolor => 'dәulә
dolores => dә'lәjris
dolorimetry => ,dәulә'rimәtri
dolorous => 'dɒlәrәs
dolostone => ,dәulә'stәun
dolour => 'dәulә
dolphin => 'dɒlfin
dolphinarium => ,dɔlfi'neәriәm
dolphins => 'dɔlfinz
dolt => dәult
doltish => 'dәultiʃ
dolts => dəʊlts
dom => dɔm
domain => dәu'mein
domaine => dәu'mein
domal => 'dəʊməl
domanial => dәu'meniәl
dome => dәum
domesday => 'du:mzdei
domestic => dәu'mestik
domestic partnership => dəˈmestik ˈpɑ:tnəʃip
domestic pigeon => dəˈmestik ˈpidʒin
domestically => dәu'mestikli
domesticate => dәu'mestikeit
domesticated => dəʊ'mestɪkeɪtɪd
domesticates => dəˈmestɪˌkeɪts
domesticating => dəˈmestɪˌkeɪtɪŋ
domestication => dәumesti'keiʃәn
domesticity => .dәumes'tisiti
domestics => də'mestɪks
domical => 'dәumikәl
domicile => 'dɒmisail
domiciled => 'dɔmisaild
domiciles => ˈdɔmisailz
domiciliary => .dɒmi'siliәri
dominance => 'dɔminәns
dominancy => 'dɒmɪnənsɪ
dominant => 'dɒminәnt
dominate => 'dɒmineit
dominates => ˈdɔmineits
dominating => 'dɒmineitiŋ
domination => .dɒmi'neiʃәn
dominator => 'dɒmineitә
dominatrix => ˌdɒmɪˈneɪtrɪks
domine => 'dɔmini
dominee => 'du:mini
domineer => .dɒmi'niә
domineering => ,dɔmi'niәriŋ
domingo => dәj'mi:ŋ^әj
dominic => 'dɔminik
Dominica => ,dɔmi'ni:kә
dominical => dә'minikәl
dominican => dә'minikәn
dominie => 'dɒmini
dominion => dә'minjәn
dominions => dəˈminjənz
Dominique => ,dɔmi'ni:k
dominium => dәj'miniәm
domino => 'dɒminәu
dominoes => 'dɒmɪnəʊz
Domitian => 'də'miʃən
don => dɒn
Don Juan => dɔn'hwɑ:n
Don Quixote => dɔn'kwiksәt
don't => dәunt
Dona => 'dәunjɑ:
donald => 'dɔnәld
donate => 'dәuneit
donated => dəuˈneitid
donates => dəuˈneits
donating => dəuˈneitɪŋ
donation => dәu'neiʃәn
Donatism => 'dәjnәtizәm
Donatist => 'dɔnәtist
donative => 'dәunәtiv
donator => 'dәuneitә
Donau => 'dәjnaj
Doncaster => 'dɔŋkəstə
done => dʌn
donee => dәu'ni:
Donegal => ,dɔni'ɡɔ:l
doneness => 'dʌnnis
doner kebab => ˌdɒnə kɪˈbæb
Donets => də'nets
Donetsk => dә'netsk
dong => dɔŋ
donga => 'dɒŋgә
donged => dɒŋ
donging => dɒŋ
dongle => ˈdɒŋgl
dongs => dɒŋ
donjon => 'dʌndʒәn
donkey => 'dɒŋki
donkey jacket => ˈdɔŋki ˈdʒækit
donkey work => ˈdɔŋki wə:k
donkeyman => 'dɔŋkimәn
donkeys => ˈdɔŋkiz
donkeywork => 'dɒŋkiwә:k
donna => 'dɔnә
donned => dɔnd
donnie => 'dɔni
donning => 'dɔniŋ
donnish => 'dɒniʃ
donnishness => 'dɔnizəm
donnybrook => 'dɔnibruk
donor => 'dәunә
donor card => ˈdəʊnə kɑ:d
donors => ˈdəʊnəz
donovan => 'dɔnәvәn
dons => dɔnz
donut => 'dәu,nʌt
donuts => ˈdəuˌnʌts
doo-doo => 'du:d'u:
doo-wop => 'du:,wɔp
doodad => 'du:dæd
doodah => 'du:dә
doodle => 'du:dl
doodlebug => 'du:dlbʌg
doodled => ˈdu:dld
doodles => ˈdu:dlz
doodling => 'du:dlɪŋ
doofus => ˈdu:fəs
doohickey => 'du:hiki
doolie => 'du:li
doom => du:m
dooming => du:mɪŋ
dooms => du:mz
doomsayer => 'du:m,seiә(r)
doomsday => 'du:mzdei
doomster => 'du:mstə(r)
doomwatcher => 'du:m,wɔtʃә(r)
doomy => ˈdu:mi
doon => du:n
Doona => 'du:nə
door => dɒ:
door furniture => dɔ: ˈfə:nitʃə
door prize => dɔ: praiz
doorbell => 'dɒ:bel
doorbells => ˈdɔ:ˌbelz
doored => 'dɔ:rd
doorframe => 'dɔ:freim
doorjamb => 'dɒ:dʒæm
doorkeeper => 'dɒ:ki:pә
doorknob => 'dɒ:nɒb
doorknobs => ˈdɔ:ˌnɔbz
doorknocker => 'dɔ:,nɔk
doorless => 'dɔ:rles
doorman => 'dɒ:mæn
doormat => 'dɒ:mæt
doormats => ˈdɔ:mæts
doormen => 'dɔːmən
doornail => 'dɒ:neil
doorplate => 'dɒ:pleit
doorpost => 'dɒ:pәust
doorsill => 'dɒ:sil
doorstep => 'dɒ:step
doorsteps => ˈdɔ:ˌsteps
doorstop => 'dɒ:stɒp
doorway => 'dɒ:wei
doorways => ˈdɔ:ˌweɪz
dooryard => 'dɒ:jɑ:d
doozy => ˈdu:zi
dopa => 'dәjpә
dopamine => 'dәupә,mi:n
dopaminergic => ,dәjpәmi'n\\\\:dʒik
dopant => 'dәupәnt
dope => dәup
doped => dәupt
doper => 'dәupә
dopes => dəʊps
dopester => 'dәupstә
dopey => 'dәupi
dopiness => 'dәupinis
doping => 'dәupiŋ
doppelganger => 'dɒpelɡɑ:nɡər
Dopper => 'dɔpә(r)
doppie => 'dɔpi
doppler => 'dɔplә
dopy => 'dәupi
dor => dɒ:
dora => 'dɔ:rә
dorado => dә'rɑ:dәu
Doran => 'dɔ:ræn
Dorchester => 'dɔ:tʃәstә(r)
Dordogne => dɔ:'dɔ:njə
Dordrecht => 'dɔ:drekt
dore => dɔ:'rei
Doreen => dɔ:'ri:n,'dɔ:ri:n
Dorian => 'dɔriәn
doric => 'dɔrik
doris => 'dɔris
dork => dɔ:k
Dorking => 'dɒ:kiŋ
dorks => dɔ:ks
dorky => 'dɔ:ki
dorm => dɒ:m
dormancy => 'dɒ:mәnsi
dormant => 'dɒ:mәnt
dormer => 'dɔ:mә
dormers => ˈdɔ:məz
dormice => 'dɔ:mais
dormitories => ˈdɔ:mitriz
dormitory => 'dɒ:mitәri
dormouse => 'dɒ:maus
dorms => dɔ:mz
dormy => 'dɒ:mi
doronicum => dә'rɔnikәm
Dorothea => ,dɔrә'θiә
dorothy => 'dɔrәθi
dorp => dɒ:p
dorsal => 'dɒ:sәl
dorsal fin => ˈdɔ:səl fin
dorset => 'dɔ:sit
dorsiflexion => ,dɔ:si'flekʃәn
dorsiflexor => 'dɔ:sifleksә
dorsiventral => 'dɔ:sɪventrəl
dorsiventrality => dɔ:sɪvent'rælɪtɪ
dorsolateral => ,dɔ:sәj'lætәrәl
dorsoventral => ,dɔ:sәu'ventrәl
dorsum => 'dɔ:sәm
dortmund => 'dɔ:tmәnd
dory => 'dɒ:ri
dos => du:z
dosa => ˈdəʊsə
dosage => 'dәusidʒ
dose => dәus
dosed => dɑs; dɔs
dosh => dɒʃ
dosimeter => dәu'simitә
dosimetry => dәu'simitri
dosing => 'dәusiŋ
doss => dɒs
doss-house => 'dɒsh'aʊs
dossal => 'dɒsәl
dossed => dɔst
dosser => 'dɔsә
dosseret => 'dɔsirit
dossers => ˈdɔsəz
dosses => dɔsiz
dossier => 'dɒsiei
dossiers => ˈdɔsi:ˌeɪz
dossing => dɔsɪŋ
dossy => 'dɔsi
dost => dʌst
Dostoevsky => ,dәstә'jefski
dot => dɒt