T => ti:
T-bar => 'ti:bɑ:
T-shirt => 'ti:,ʃә:t
ta => tɑ:
ta-ta => 'tæ'tɑ:
tab => tæb
tab stop => tæb stɔp
tabac => tɑ'bɑ
tabard => 'tæbәd
tabaret => 'tæbәrit
Tabasco => tә'bæskәu
tabbies => ˈtæbiz
tabbouleh => tә'bu:lә,-li:
tabby => 'tæbi
tabernacle => 'tæbәnækl
tabernacled => 'tæbə,næk(ə)l
tabernacles => ˈtæbə(:)næklz
tabes => 'teibi:z
tabes dorsalis => dɔ:ˈseɪlɪs, -ˈsælɪs
tabescent => tә'besnt
tabetic => tә'betik
tabi => 'tɑ:bi
TABITHA => 'tæbiθә
tabla => 'tɑ:blɑ:
tablature => 'tæblәtʃә
table => 'teibl
table napkin => ˈteibl ˈnæpkin
table wine => ˈteibl wain
tableau => 'tæblәu
tableau vivant => tɑ:'blәjvi:'vɔŋ
tableaux => 'tæblәj(z),tæ'blәj(z)
tablecloth => 'teiblklɒθ
tablecloths => ˈteɪbəlˌklɔ:θs
tabled => 'teɪb(ə)l
tableful => 'teiblfjl
tableland => 'teibllænd
tablemate => 'teiblmeit
tablespoon => 'teiblspu:n
tablespoonful => 'teib(ә)lspu:nfjl
tablespoonfuls => 'teɪbl,spuːnfʊl
tablespoons => ˈteɪbəlˌspu:nz
tablet => 'tæblit
tabletop => 'teibltɒp
tablets => 'tæblɪts
tableware => 'teiblwєә
tablier => ,tɑ:bli:'ei
tabling => 'teibliŋ
tabloid => 'tæblɒid
tabloids => ˈtæblɔidz
taboo => tә'bu:
tabor => 'teibә
tabouret => 'tæbәrit
Tabriz => tɑ:'bri:z
tabu => tә'bu:. tæ-
tabula rasa => ˌtæbjʊlə ˈrɑ:zə
tabular => 'tæbjulә
tabulate => 'tæbjuleit
tabulated => ˈtæbjəˌleɪtid
tabulates => ˈtæbjəˌleɪts
tabulation => .tæbju'leiʃәn
tabulator => 'tæbjuleitә
tabulators => ˈtæbjuleitəz
tabun => 'tɑ:bun
tacamahac => 'tækәmәhæk
tacet => 'teiset, 'tæ-
tach => tæk
tache => tɑ:ʃ
tachistoscope => tә'kistә,skәup
tachistoscopically => tə,kistəu'skɔpikəli; tæ-
tacho => tækəʊ
tachograph => 'tækә^rɑ:f
tachometer => tә'kɒmitә
tachycardia => .tæki'kɑ:diә
tachygraphic => ,tæki'ɡræfik
tachygraphy => tæ'kigrәfi
tachykinin => ,tæki'kinin
tachymeter => tæ'kimitә
tachyon => 'tæki:ɔn
tachyphylaxis => ,tækifai'læksis
tachypnoea => tækɪp'nɪəə
tacit => 'tæsit
tacitly => 'tæsɪtlɪ
taciturn => 'tæsitә:n
taciturnity => .tæsi'tә:nәti
taciturnly => 'tæsɪtɜ:nlɪ
Tacitus => tæsitəs
tack => tæk
tacked => tækt
tacker => 'tækә
tackier => ˈtæki:ə
tackily => 'tækili
tackiness => 'tækinis
tacking => 'tækiŋ
tackle => 'tækl
tackled => ˈtækld
tackler => 'tæklә
tackles => ˈtæklz
tackling => 'tækliŋ
tacks => tæks
tacky => 'tæki
taco => 'tɑ:kәu
taconite => 'tækәnait
tact => tækt
tactful => 'tæktful
tactfully => 'tæktfəlɪ
tactic => 'tæktik
tactical => 'tæktikl
tactical voting => ˈtæktɪkəl ˈvəʊtɪŋ
tactically => 'tæktɪklɪ
tactician => tæk'tiʃәn
tacticians => tæk'tɪʃnz
tacticity => tæk'tisiti
tactics => 'tæktiks
tactile => 'tæktail
tactility => tæk'tiliti
tactless => 'tæktlis
tactlessly => 'tæktlisli
tactlessness => 'tæktlisnis
tactual => 'tæktʃuәl
tad => tæd
tadpole => 'tædpәul
tadpoles => 'tæd,pol
Tadzhik => 'tɑ:dʒik
Tadzhikistan => tɑ: dʒiki'stɑ:n
tae kwon do => 'tai'kwɒn'dәu
taedium vitae => 'ti: diәm'vaiti: , 'taidijm'wi: tai
Taegu => 'tai^u:,tai'^u:
Taejon => 'taidʒɔn,tai'dʒɔn
tael => teil
taels => teɪl
taenia => 'ti:niә
taenioid => 'ti:niɔid
taff => tæf
taffeta => 'tæfitә
taffrail => 'tæfreil
taffy => 'tæfi
tafia => 'tæfiә
taft => tæft, tɑ:ft
tag => tæg
tag team => tæɡ ti:m
Tagalog => tɑ:'^ɑ:lɔ^, 'tæ^әlɔ^
Taganrog => 'tɑ:^әnrɔ^,,tɑ:^ɑ:n'rɔ:k
tagetes => tæ'dʒi:ti:z,'tædʒi-
tagger => 'tægә
tagging => 'tæ^iŋ
tagliatelle => ˌtæljəˈteli
tagma => 'tæ^mә
tagmeme => 'tægmi:m
tagmemics => tæ^'mi:miks
Tagore => tә'^ɔ:
Tagus => 'tei^әs
tahini => tɑ:'hi:ni,tә-
tahiti => tɑ:'hi:ti
Tahitian => tә'hi:ʃәn, tɑ:-; -hi:ʃiәn
tahr => tɑ:
tahsil => tә'si:l
tai => tai, 'tɑ:i:
tai chi => ˌtʌɪ ˈtʃiː
TAIF => 'tɑ:if
taiga => 'taigә
tail => teil
tail back => teil bæk
tail light => teil lait
tail rotor => teil ˈrəʊtə
tail-ender => 'teilendə
tail-light => 'teɪll'aɪt
tailback => ˈteɪlbæk
tailboard => 'teilbɒ:d
tailbone => ˈteɪlbəʊn
tailcoat => 'teilkәut
tailed => teild
tailgate => 'teilgeit
tailgated => ˈteilɡeitid
tailgates => ˈteilɡeits
tailgating => ˈteilɡeitiŋ
tailing => 'teiliŋ
tailings => 'teɪlɪŋz
taille => teil
tailless => 'teillis
tailleur => tɑ:'jә:
taillight => 'teillait
tailor => 'teilә
tailorbird => ˊteilәbәːd
tailored => 'teilәd
tailoring => 'teilәriŋ
tailors => ˈteiləz
tailpiece => 'teilpi:s
tailpipe => 'teilpaip
tailplane => ˈteɪlpleɪn
tailspin => 'teilspin
tailstock => 'teilstɔk
tailwater => 'teɪlwɔ:tə
tailwind => ˈteɪlwɪnd
taimen => 'taimen
Tainan => 'tai'næn,-'nɑ:n
Taino => 'tainәu
taint => teint
tainting => teɪntɪŋ
taintless => 'teintlis
taints => teɪnts
taipan => 'taipæn
taipei => 'tai'pei, -'bei
taiwan => 'tai'wɑ:n
taiwanese => ,taiwɑ:'ni:z, -'ni:s
Taiyuan => 'taiju:'ɑ:n
Taj => tɑ:dʒ
Tajik => 'tɑ:dʒik
Tajikistan => tɑ:dʒiki'stɑ:n
Tajo => 'tɑ:hɔ:,-hәj
taka => 'tɑ:kә. -kɑ:
takahe => 'tɑ:kәhi:, tә'kɑ:hi:
take => teik
take a dive => teik ə daiv
take a powder => teik ə ˈpaudə
take advantage of => teik ədˈvɑ:ntidʒ ɔv
take care => teik kɛə
take flight => teik flait
take hold => teik həuld
take issue with => teik ˈisju: wið
take it => teik it
take note => teik nəut
take part => teik pɑ:t
take the veil => teik ðə veil
take time by the forelock => teik taim bai ðə ˈfɔ:lɔk
take-off => teɪk ɒf
take-out => 'teɪkˌaʊt
take-up => 'teik'ʌp
takeaways => ˈteɪkəˌweɪz
taken => 'teikәn
takeoff => 'teikɒ:f
takeoffs => ˈteɪkˌɔ:fs
takeovers => ˈteɪkˌəʊvəz
taker => 'teikә
takin => 'tɑ:ki:n. -kin. 'tei-
taking => 'teikiŋ
takingly => ˊteikiŋli
Takoradi => ,tɑ:kә'rɑ:di
tala => 'teilә, -lɑ:
talapoin => 'tælәpɔin
talaria => tә'leәriә
Talbot => 'tɔ:lbәt
talc => tælk
talcose => 'tælkәus
talcs => tælk
talcum => 'tælkәm
tale => teil
tale-telling => 'teil,teliŋ
talebearer => 'teil.bєәrә
talebearing => 'teil.bєәriŋ
talent => 'tælәnt
talented => 'tælәntid
talentless => 'tælәntlis
tales => 'teili:z
talesman => 'teili:zmәn
taleteller => 'teil,telә(r)
tali => 'teilai
talik => 'tælik
talipes => 'tæli,pi:z
talipot => 'tælipɒt
talisman => 'tælizmәn
talismanic => ,tæliz'mænik, - lis-
talismans => ˈtælɪsmənz
talk => tɒ:k
talk dirty => tɔ:k ˈdə:ti
talk to => tɔ:k tu:
talkathon => 'tɒ:kәθɒn
talkative => 'tɒ:kәtiv
talkatively => 'tɔ:kətɪvlɪ
talkback => ˈtɔ:kbæk
talked => tɔːkt
talkee-talkee => 'tɒ:ki'tɒ:ki
talker => 'tɒ:kә
talkers => ˈtɔ:kəz
talkfest => 'tɒ:kfest
talkie => 'tɒ:ki
talkies => 'tɔ:kɪz
talking => 'tɒ:kiŋ
talking shop => ˈtɔ:kɪŋ ʃɔp
talky => 'tɒ:ki
tall => tɒ:l
tall ship => tɔ:l ʃip
tallage => 'tælidʒ
tallboy => 'tɒ:lbɒi
taller => 'tɔ:lə(r)
tallgrass => 'tɔ:l^rɑ:s
tallied => ˈtæli:d
tallies => ˈtæli:z
Tallinn => 'tælin
tallis => 'tɑ:lis
tallish => 'tɒ:liʃ
tallith => 'tɑ:liθ, -it, -is, 'tæ-,tɑ:'li:t
tallness => 'tɒ:lnis
tallow => 'tælәu
tallowy => 'tælәui
tally => 'tæli
tallyman => 'tælimәn
Talmud => 'tælmud
Talmudic => tæl'mudik
Talmudist => 'tælmudist
talon => 'tælәn
talons => 'tælənz
talus => 'teilәs
tam => tæm
tam-o'-shanter => tæmә'ʃæntә
tam-tam => 'tʌmtʌm
tamale => tә'mɑ:li
tamales => təˈmɑ:liz
tamandua => 'tɑ:mɑ:n'dwɑ:
Tamar => tә'mɑ:(r)
Tamara => tә'mærә
tamarack => 'tæmәræk
tamarau => ,tɑ:mә'rau
tamari => tɑ:'mɑ:ri
tamarillo => ,tæmә'rilәj
tamarin => 'tæmәrin
tamarind => 'tæmәrind
tamarinds => ˈtæməˌrɪndz
tamarisk => 'tæmәrisk
tamarisks => ˈtæmərisks
tamasha => tә'mɑ:ʃә
Tamaulipas => ,tɑ:mɑ:u'li:pɑ:s
tambala => tæmˊbaːlә
tambour => 'tæm.buә
tamboura => tæm'bjәrә, tɑ:m-
tamboured => ˈtæmbuəd
tambourin => 'tæmbuәrin
tambourine => .tæmbә'ri:n
tambourines => ˌtæmbəˈri:nz
Tambov => tɑ:m'bɔf
tambura => tæm'bjәrә,tɑ:m-
tamburitza => tæm'buritsә
tame => teim
tameable => ˈteiməbl
tamed => teimd
tamely => 'teimli
tameness => 'teimnis
tamer => 'teimә
tames => teimz
Tamil => 'tæmil
Tammany => 'tæmәni
Tammerfors => ,tɑ:mmәr'fɔ:rs
Tammuz => 'tæmu:z; -uz; 'tɑ:mmu:z
tammy => 'tæmi
tamoxifen => tә'mɔksifen
tamp => tæmp
tampa => 'tæmpә
Tampax => 'tæmpæks
tamped => tæmpt
tamper => 'tæmpә
tamper-proof => ˈtæmpə pru:f
tamper-resistant => ˈtæmpə rɪˈzɪstənt
Tampere => 'tɑ:mpere
tampered => ˈtæmpəd
tampers => ˈtæmpəz
Tampico => tæm'pi:kәu
tamping => 'tæmpiŋ
tampion => 'tæmpiәn
tampon => 'tæmpɒn
tamponade => ,tæmpә'neid
tamponed => ˈtæmpənd
tamponing => 'tæmpәniŋ
tampons => ˈtæmpənz
tamps => tæmps
Tamworth => 'tæmwә:θ
tan => tæn
tanager => 'tænәdʒә
Tanagra => 'tænəɡrə; tə'næ-
Tananarive => tananari:v
tanbark => 'tænbɑ:k
tancred => 'tæŋkrid
tandem => 'tændәm
tandems => 'tændəmz
tandoor => tæn'dɔ:r
tandoori => tæn'djәri
tang => tæŋ
Tanga => 'tæŋ^ә
Tanganyika => ,tæŋ^ә'nji:kә
tangelo => 'tændʒәlәu
tangency => 'tændʒәnsi
tangent => 'tændʒәnt
tangential => tæn'dʒenʃәl
tangentially => tæn'dʒenʃlɪ
tangents => ˈtændʒənts
tangerine => .tændʒә'ri:n
tangerines => tæn(d)ʒə'riːn
tangi => tæŋ'^i:
tangibility => .tændʒi'biliti
tangible => 'tændʒәbl
tangibly => 'tændʒәbli
Tangier => tæn'dʒiә
tangle => 'tæŋgl
tangle with => ˈtæŋɡl wið
tanglefoot => 'tæŋ^lfut
tangles => 'tæŋɡlz
tangling => ˈtæŋɡlɪŋ
tangly => 'tæŋgli
tango => 'tæŋgәu
tangoed => ˈtæŋgəʊd
tangoing => ˈtæŋgəʊɪŋ
tangos => ˈtæŋgəʊz
tangram => 'tæŋgrәm
Tangut => tæn'^u:t
tangy => 'tæŋi
Tania => 'tæniә,-njә
tanist => 'tænist
tank => tæŋk
tank engine => tæŋk ˈendʒin
tank town => tæŋk taun
tanka => 'tɑ:ŋkә
tankage => 'tæŋkidʒ
tankard => 'tæŋkәd
tankards => ˈtæŋkədz
tanker => 'tæŋkә
tankers => 'tæŋkəz
tankful => 'tæŋkful
tanking => 'tæŋkɪŋ
tannable => 'tænәbl
tannate => 'tænit
tanned => tænd
tanner => 'tænә
tanneries => ˈtænəri:z
tanners => ˈtænəz
tannery => 'tænәri
tannia => 'tæniә, -njә
tannic => 'tænik
tannie => 'tæni
tannin => 'tænin
tanning => 'tæniŋ
tannish => 'tæniʃ
tannoy => 'tænɒi
Tanoan => 'tɑ:nәuәn
tansy => 'tænzi
tant mieux => ,tɔŋ'mjə:
tant pis => ,tɔŋ'pi:
tantalic => tæn'tælik
tantalise => 'tæntәlaiz
tantalising => 'tæntәlaiziŋ
tantalite => 'tæntәlait
tantalization => .tæntәlai'zeiʃәn
tantalize => 'tæntәlaiz
tantalized => ˈtæntəˌlaɪzd
tantalizes => ˈtæntəˌlaɪziz
tantalizing => 'tæntәlaiziŋ
tantalizingly => 'tæntəlaɪzɪŋlɪ
tantalum => 'tæntәlәm
tantalus => 'tæntәlәs
tantamount => 'tæntәmaunt
tantivy => tæn'tivi
tanto => 'tæntәu
tantra => 'tæntrә, 'tʌn-, 'tɑ:n-
tantric => 'tæntrɪk
tantrum => 'tæntrәm
tantrums => ˈtæntrəmz
tanya => 'tænjә
Tanzania => .tænzә'ni:ә
Tanzanian => ,tænzə'niən
tanzanite => 'tænzәnait
Tao => tau
taoiseach => ˈti:ʃəx
Taoism => 'tauizm
Taoist => 'tɑ:әuist, 'tauist
Taoistic => ,tɑ:әu'istik, tau'istik
tap => 'tæp
tap dancing => tæp ˈdænsɪŋ
tap-in => 'tæpin
tapa => 'tɑ:pә
tapas => ˈtæpəs
tape => teip
tape machine => teip məˈʃi:n
tape recorder => 'teiprikɔ:dә(r)
tape recording => teip rɪˈkɔ:dɪŋ
tape-record => 'teipri'kɔ:d
taper => 'teipә
taperer => 'teɪpərər
tapering => 'teipәriŋ
tapers => ˈteɪpəz
tapestried => 'tæpistrid
tapestries => ˈtæpɪstri:z
tapestry => 'tæpistri
tapetum => tә'pi:tәm
tapeworm => 'teipwә:m
tapeworms => 'teɪpwɜ:mz
taphonomic => ,tæfə'nɔmik
taphonomy => tә'fɔnәmi
taping => 'teipiŋ
tapioca => .tæpi'әukә
tapir => 'teipә
tapirs => 'teɪpəz
tapis => 'tæpi(:)
tapotement => tә'pәutmәnt
tappable => 'tæpәbl
tapped => tæpt
tapper => 'tæpә
tappet => 'tæpit
tappets => 'tæpɪt
tapping => 'tæpiŋ
taproom => 'tæprum
taproot => 'tæpru:t
taps => tæps
tapster => 'tæpstә
tapu => tә'pu:
taqueria => ['tɑ:kəri:ə]
tar => tɑ:
tar sand => tɑ: sænd
tara => tә'rɑ:
taradiddle => 'tærәdidl
tarakihi => ,tærә'ki:hi
taramasalata => ˌtærəməsəˈlɑ:tə
tarantass => ,tærәn'tæs
tarantella => .tærәn'telә
tarantism => 'tærәntizm
Taranto => tә'ræntәu
tarantula => tә'ræntjulә
tarantulas => təˈræntjuləz
tarboosh => tɑ:'bu:ʃ
tarbrush => 'tɑ:brʌʃ
Tardenoisian => ,tɑ:dә'nɔiziәn
tardier => ˈtɑ:di:ə
tardigrade => 'tɑ:digreid
tardily => 'tɑ:dili
tardiness => 'tɑ:dinis
tardive dyskinesia => ˈtɑ:dɪv ˌdɪskɪˈni:zɪə
tardy => 'tɑ:di
tare => tєә
tared => teəd
targa => 'tɑ:ɡə
targe => tɑ:dʒ
target => 'tɑ:git
target cell => ˈtɑ:ɡit sel
target organ => ˈtɑ:ɡit ˈɔ:ɡən
targetable => 'tərɡɪtəbl
targeted => 'tɑːɡɪtɪd
targeting => 'tɑ:ɡitiŋ
Targum => 'tɑ:gәm
tariff => 'tærif
tariffed => 'tærɪf
tariffing => 'tærɪfɪŋ
tariffs => 'tærɪf
Tarim => 'tɑ:rim
taring => 'teәriŋ
tarlatan => 'tɑ:lәtn
tarmac => 'tɑ:mæk
tarmacadam => .tɑ:mә'kædәm
tarmacs => 'tɑ:mæk
tarn => tɑ:n
tarnation => tɑ:'neiʃәn
tarnish => 'tɑ:niʃ
tarnishable => tɑ:'nɪʃəbl
tarnishes => ˈtɑ:nɪʃiz
tarnishing => 'tɑ:niʃiŋ
tarns => tɑ:nz
taro => 'tɑ:rәu
tarot => 'tærәut
tarp => tɑ:p
tarpan => 'tɑ:pæn
tarpaper => 'tɑ:peipə
tarpaulin => tɑ:'pɒ:lin
tarpaulins => tɑ:ˈpɔ:lɪnz
Tarpeia => tɑ:'pi:ә
tarpon => 'tɑ:pɒn
Tarquin => 'tɑ:kwin
tarradiddle => ˊtærәdidl
tarragon => 'tærәgәn
Tarrasa => tɑ:r'rɑ:sɑ:
tarred => tɑ:d
tarried => ˈtæri:d
tarrier => 'tæriә
tarries => ˈtæri:z
tarriness => 'tɑ:rinis
tarry => 'tæri
tarrying => ˈtæri:ɪŋ
tars => tɑ:z
tarsal => 'tɑ:sl
tarsi => 'tɑ:sai, -si:
tarsier => 'tɑ:siә
tarsometatarsus => ,tɑ:sәu,metә'tɑ:sәs
tarsus => 'tɑ:sәs
tart => tɑ:t
tartan => 'tɑ:tn
tartans => ˈtɑ:tnz
tartar => 'tɑ:tә
tartare => tar'tar
tartare sauce => ˌtɑ:tə ˈsɔ:s
Tartarean => tɑ:'tєәriәn
Tartarian => tɑ:'teәriәn
tartars => ˈtɑ:təz
Tartarus => 'tɑ:tәrәs
Tartary => 'tɑ:tәri
tartily => 'tɑːti
tartlet => 'tɑ:tlit
tartly => 'tɑ:tli
tartness => 'tɑ:tnis
tartrate => 'tɑ:treit
tartrazine => 'tɑ:trә,zi:n
tarts => tɑ:ts
tarty => ˈtɑ:ti
tarweed => 'tɑ:wi:d
tarzan => 'tɑ:zæn
taser => 'teizə
tash => tæʃ
Tashkent => tæʃ'kent
task => tɑ:sk
taskbar => 'tæskbɑ:r
taskmaster => 'tɑ:sk.mɑ:stә
taskmasters => ˈtæskˌmæstəz
Tasman => 'tæzmәn
tasmania => tæz'meinjә
Tasmanian => tæz'meiniәn, -njәn
Tass => tæs, tɑ:s
tassel => 'tæsl
tasseled => ˈtæsəld
tasselled => ˈtæsld
taste => teist
tasted => teistid
tasteful => 'teistful
tasteless => 'teistlis
tastemaker => 'teist.meikә
taster => 'teistә
tasters => ˈteistəz
tastes => teists
tastily => 'teistili
tasting => 'teistiŋ
tasty => 'teisti
tat => tæt
tatami => tɑ:'tɑ:mi. tә-. tæ-
tatar => 'tɑ:tә
tate => teit
tater => 'teitә
Tatiana => ,tæti'ɑ:nә
tatler => 'tætlə
tatter => 'tætә
tatterdemalion => .tætәdә'meiljәn
tattered => 'tætәd
tattersall => 'tætә,sɔ:l
Tattersalls => 'tætəs(ə)l; -sɔːl
tattie => 'tæti
tatting => 'tætiŋ
tattle => 'tætl
tattled => ˈtætld
tattler => 'tæltә
tattletale => 'tætlteil
tattling => ˈtætlɪŋ
tattoo => tә'tu:
tattooed => tæˈtu:d
tattooer => tə'tu:ə
tattooing => tæ'tu:iŋ
tattooist => təˈtu:ɪst
tatty => 'tæti
Tatum => 'teitәm
tau => tɒ:
tau cross => tɔ: krɔs
taught => tɒ:t
taunt => tɒ:nt
taunted => tɔ:ntid
taunter => 'tɔ:ntə
taunting => tɔ:ntɪŋ
Taunton => 'tɔ:ntən; 'tɑ:n-
taunts => tɔ:nts
taupe => tәup
Tauranga => taj'ræŋә, -'rɑ:-
Taurean => 'tɔ:riәn
taurine => 'tɒ:rin
taurocholate => ,tɔ:rә'kәuleit
tauromachian => ,tɔːrə'meɪkɪən
tauromachy => tɔ:'rɔmәki
Taurus => 'tɒ:rәs
taut => tɒ:t
tauten => 'tɒ:tn
tautened => ˈtɔ:tnd
tautening => ˈtɔ:tnɪŋ
tautens => ˈtɔ:tnz
tauter => tɔ:tə
tautly => tɔ:tlɪ
tautog => tɔ:'tɔ^
tautological => ,tɔ:tә'lɔdʒikәl
tautologies => tɔ:'tɒlədʒɪz
tautologist => tɒ:'tɒlәdʒist
tautologize => tɒ:'tɒlәdʒaiz
tautologous => tɔː'tɒləɡəs
tautology => tɒ:'tɒlәdʒi
tautomer => 'tɔ:tәmә
tautomerism => tɒ:'tɒmәrizm
tautonym => 'tɔ:tәnim
tautonymy => -'tɔnimi
Tavel => tɑ:'vel
tavern => 'tævәn
taverna => 'tævənə
taverner => 'tævənər
taverns => ˈtævə:nz
taw => tɒ:
tawdrier => ˈtɔ:dri:ə
tawdrily => 'tɒ:drili
tawdriness => 'tɔ:drinis
tawdry => 'tɒ:dri
tawer => 'tɔ:ər
tawney => 'tɔ:ni
tawniest => 'tɔ:ni
tawny => 'tɒ:ni
tawse => tɔ:z
tax => tæks
tax break => tæks breik
tax disc => tæks disk
tax dodge => tæks dɔdʒ
tax exile => tæks ˈeksail
tax inspector => tæks ɪnˈspektə
tax relief => tæks riˈli:f
tax return => tæks riˈtə:n
taxa => 'tæksә
taxable => 'tæksәbl
taxation => tæk'seiʃәn
taxes => tæksi:z
taxi => 'tæksi
taxi dancer => ˈtæksi ˈdɑ:nsə
taxi rank => ˈtæksi ræŋk
taxicab => 'tæksikæb
taxicabs => ˈtæksikæbz
taxidermal => .tæksi'dә:ml
taxidermic => ,tæksi'də:mik
taxidermist => 'tæksidә:mist
taxidermists => ˈtæksidə:mists
taxidermy => 'tæsidә:mi
taxied => 'tæksɪ
taximeter => 'tæksi.mi:tә
taxing => 'tæksiŋ
taxis => 'tæksis
taxiway => 'tæksiwei
taxman => 'tæksmæn
taxol => 'tæksəul
taxon => 'tæksɔn. -sәn
taxonomic => tæksә'nɔmik
taxonomical => ,tæ-ksəu'nɔmikəl
taxonomically => ,tæksəu-'nɔmikəli
taxonomies => tækˈsɔnəmi:z
taxonomist => tæk'sɔnәmist
taxonomy => tæk'sɒnәmi
taxpayer => 'tækspeiә
taxpayers => 'tækspeɪəz
taxying => 'tæksiiŋ
tay => tei
tayberry => ˈteɪbəri
taylor => 'teilә
tayra => 'tairә
Tayside => 'teisaid
tazza => 'tɑ:tsә
Tbilisi => tә'bilisi,tbili:'si:
Tchaikovsky => tʃai'kɔfski
tchotchke => 'tʃɒtʃkə
Te => ti:
Te Deum => tei'deium, ti:'di:әm
tea => ti:
tea ball => ti: bɔ:l
tea bread => ti: bred
tea chest => ti: tʃest
tea cloth => ti: klɔθ
tea cosy => ti: ˈkəuzi
tea dance => ti: dɑ:ns
tea room => ti: ru:m
tea rose => ti: rəuz
tea service => ti: ˈsɜːvɪs
tea set => ti: set
tea shop => ti: ʃɔp
tea towel => ti: ˈtauəl
tea tree => ti: tri:
tea trolley => ti: ˈtrɔli
teacake => 'ti:keik
teach => ti:tʃ
teach-in => 'ti:tʃ,in
teachability => .ti:tʃә'biliti
teachable => 'ti:tʃәbl
teachableness => 'ti:tʃəblnəs
teacher => 'ti:tʃә
teacherage => 'ti:tʃәridʒ
teacherly => 'tiːtʃəlɪ
teaching => 'ti:tʃiŋ
teaching hospital => ˈti:tʃɪŋ ˈhɔspitəl
teacup => 'ti:kʌp
teacupful => 'ti:kʌp,fjl
teacups => ˈti:ˌkʌps
Teague => ti:^
teahouse => 'ti:haus
teak => ti:k
teakettle => 'ti:.ketl
teakwood => 'ti:kwjd
teal => ti:l
teals => ti:lz
team => ti:m
team player => ti:m ˈpleɪə
team spirit => ti:m ˈspirit
team-mate => 'ti:mm'eɪt
teamed => ti:md
teammate => 'ti:mmeit
teammates => 'tiːmmeɪt
teamster => 'ti:mstә
teamsters => 'ti:mstəz
teamwork => 'ti:mwә:k
teapot => 'ti:pɒt
teapots => 'ti:pɒts
teapoy => 'ti:pɒi
tear => tiә. tєә
tear sheet => tiə ʃi:t
tear-off => 'teәr,ɔf,-,ɔ:f
tearaway => 'tєәrә.wei
tearaways => ˈteərəweiz
teardown => 'tєәdaun
teardrop => 'tiәdrɒp
teardrops => ˈtɪəˌdrɔps
tearer => 'teərər
tearful => 'tiәful
tearfully => 'tɪəfəlɪ
tearing => 'tєәriŋ
tearjerker => 'tiә.dʒә:kә
tearless => 'tiәlis
tearoom => 'ti:ru:m
tears => tiәz
teary => 'tiәri
tease => ti:z
teased => ti:zd
teasel => 'ti:zl
teaser => 'ti:zә
teasers => ˈti:zəz
teases => ti:ziz
teashop => 'ti:ʃɒp
teasingly => 'ti:ziŋli
teaspoon => 'ti:spu:n
teaspoonfuls => 'tiːspuːn,fʊl
teaspoons => ˈti:ˌspu:nz
teat => ti:t
teatime => 'ti:taim
Tebet => tei'veit,tei'veiθ,'teives
tec => tek
tech => tek
techie => ˈteki
technetium => tek'ni:ʃiәm
technic => 'teknik
technical => 'teknikl
technical college => ˈteknikəl ˈkɔlidʒ
technical foul => ˈteknikəl faul
technical knockout => ˈteknikəl ˈnɔˈkaut
technical support => ˈteknikəl səˈpɔ:t
technicalities => ˌteknɪˈkælɪti:z
technicality => .tekni'kælәti
technically => 'teknikli
technician => tek'niʃәn
technicist => 'teknisist
technicolor => 'teknikʌlә(r)
technicolored => 'tekni,kʌlәd
technicolour => 'teknikʌlә
technics => 'tekniks
technique => tek'ni:k
techno- => ˈteknəʊ
technocracy => tek'nɒkrәsi
technocrat => 'teknәukræt
technocratic => ˌteknə'krætɪk
technocrats => 'teknəkræts
technofear => 'teknәjfiә(r)
technologic => ,teknә'lɔdʒik
technological => .teknә'lɒdʒikl
technologically => teknә'lɔdʒikәli
technologist => tek'nɒlәdʒist
technology => tek'nɒlәdʒi
technophile => 'teknәjfail
technophilia => ,teknəu'filiə
technophobe => ˈteknəʊfəʊb
technophobia => ,teknәj'fәjbiә
technostructure => teknә'strʌktʃә
techs => teks
techy => 'tetʃi
tectonic => tek'tɒnik
tectonics => tek'tɒniks
tectonophysics => ,tektәnәu'fiziks
tectorial => tek'tɒ:riәl
tectrices => tɛk'traɪsiz
tectum => 'tektәm
ted => ted
tedder => 'tedә
teddies => ˈtediz
Teddington => 'tediŋtәn
teddy => 'tedi
teddy bear => ˈtedi beə(r)
tedious => 'ti:diәs
tediously => 'ti:dɪəslɪ
tedium => 'ti:diәm
tee => ti:
tee-hee => 'ti:'hi:
teed => ti:d
teeing => ti:ɪŋ
teem => ti:m
teemed => ti:md
teeming => 'ti:miŋ
teems => ti:mz
teen => ti:n
teenage => 'ti:nidʒ
teenager => 'ti:nidʒә
teenier => ˈti:niə
teens => ti:ns
teensy => 'ti:nsi
teeny => 'ti:ni
teeny-bopper => 'ti:nibɔpә(r)
teeny-boppers => 'ti:ni,bɔpə
teenybopper => ti:nɪ'bɒpər
teepee => 'ti:pi:
tees => ti:z
teeter => 'ti:tә
teeter-totter => ˈti:təˌtɔtə
teetered => ˈti:təd
teetering => ˈti:tərɪŋ
teeters => ˈti:təz
teeth => ti:θ
teethe => ti:ð
teethed => ti:ðd
teething => 'ti:ðiŋ
teething ring => ˈti:ðiŋ riŋ
teething troubles => 'ti:θiŋ
teetotal => ti:'tәutl
teetotaler => ti:'tәutәlә
teetotalism => ti:'tәutәlizm
teetotum => ti:'tәutәm
teevee => 'ti:'vi:
teff => tef
tefillin => ti:'filin,tә-,tәfi:'li:n
TEFL => 'tef(ә)l
teflon => 'teflɔn
teg => te^
tegmen => 'te^mәn
tegmentum => te^'mentәm
Tegucigalpa => tә,^u:si'^ælpә
tegula => 'te^julә
tegument => 'tegjumәnt
Teheran => .tehә'rɑ:n
tehran => teә'ræn,-'rɑ:n
tehsil => tɑ:'si:l
Tejano => tei'hɑ:nəu
Tejo => 'teʒj,'teiʒu:
tektite => 'tek,tait
tel => tel
Tel Aviv => ,telә'vi:v
telamon => 'telәmәn
telangiectasia => te,lændʒiek'teiʒiә
telco => ˈtelkəʊ
tele => 'teli
telebanking => 'teli,bæŋkiŋ
telecast => 'telikɑ:st
telecasts => ˈtelikɑ:sts
telecentre => 'telɪsentərə
telecine => 'telisain
telecom => 'telәkɔm
telecommunication => 'telikәmju:ni'keiʃәn
telecommute => .telikә'mju:t
telecommuter => .telikә'mju:tә
telecomputing => 'telikәm,pju:tiŋ
telecoms => 'tɛləkə'mjʊnə'keʃənz
telecon => 'telikɔn
teleconference => 'telikɔnfәrәns
teleconferencing => teli'kɔnfәrәnsiŋ
teleconnection => 'telikә,nekʃәn
teleconverter => ,telikәn'v\\\\:tә(r)
telecottage => ˈtelikɒtɪdʒ
teledu => 'telidu:
telefacsimile => telifæk'simili
telefax => 'telә,fæks
teleferic => ,teli'ferik
telefilm => 'telifilm
telegenic => teli'dʒenik
telegram => 'teli^ræm
telegrams => ˈteliɡræmz
telegraph => 'teligrɑ:f
telegraph plant => ˈtelɪˌgræf plɑ:nt
telegraph post => ˈtelɪˌgræf pəust
telegraph wire => ˈtelɪˌgræf ˈwaiə
telegrapher => ti'legrәfә
telegraphese => .teligrɑ:'fi:z
telegraphic => .teli'græfik
telegraphically => ,teli'græfikli
telegraphist => ti'legrәfist
telegraphs => ˈtelɪˌgræfs
telegraphy => ti'legrәfi
telekinesis => .teliki'ni:sis
Telemachus => ti'lemәkәs,tә-
telemark => 'telimɑ:k
telemarketer => ,teli'mɑ:kitə
telemarketing => 'telimɑ:kitiŋ
telematic => -tik
telemedicine => 'teli,medisin
telemessage => 'teli:məsɪdʒ
telemeter => 'telimi:tә
telemetric => .teli'metrik
telemetry => ti'lemitri
telencephalon => ,telen'sefә,lɔn
telenovela => teli:'nɒvələ
teleologic => ,teliә'iɔdʒik,,ti:-
teleological => ˌti:lɪə'lɒdʒɪkl
teleologist => ,teli'ɔlәdʒist ,,ti:-
teleology => .teli'ɒlәdʒi
teleoperation => telepə'reɪʃn
teleoperator => ,telә'ɔpә,reitә
teleost => 'teli,ɔst, 'ti:li-
telepath => 'telipæθ
telepathic => .teli'pæθik
telepathically => ˌtelɪ'pæθɪklɪ
telepathist => ti'lepәθist
telepathize => ti'lepәθaiz
telepathized => tɪ'lepəθaɪz
telepathizes => tɪ'lepəθaɪz
telepathizing => tɪ'lepəθaɪz
telepathy => ti'lepәθi
telephone => 'telifәun
telephone banking => ˈtelifəun ˈbæŋkɪŋ
telephone book => ˈtelifəun buk
telephone kiosk => ˈtelifəun ˈki:ˌɔsk
telephone pole => ˈtelifəun pəul
telephoned => ˈtelifəund
telephoner => 'telɪfəʊnə
telephonic => .teli'fɒnik
telephonically => telɪ'fɒnɪklɪ
telephoning => 'telɪfəʊnɪŋ
telephonist => ti'lefәnist
telephonists => tiˈlefənists
telephony => ti'lefәni
telephoto => 'teli'fәutәu
teleplay => 'teliplei
teleport => 'telipɔ:t
teleportation => ,telɪpɔː'teɪʃən
teleported => ˈtelipɔ:tid
teleporting => ˈtelipɔ:tɪŋ
telepresence => ˈteliprezns
teleprinter => 'teli,printә
teleprinters => 'telɪprɪntə
teleprompter => 'teli.prɒmptә
telerecord => ,teliri'kɔ:d
telerecording => ,teliri'kɔ:diŋ
telesale => 'teliseil
telescope => 'teliskәup
telescoped => 'tɛlə,skop
telescopes => ˈteliskəups
telescopic => 'teliskәupik
telescopic sight => ˌtelɪˈskɔpɪk sait
telescopically => ˌtelɪ'skɒpɪklɪ
telescoping => 'teləˌskəʊpɪŋ
Telescopium => ,teli'skәupiәm
telescreen => 'teliskri:n
teleshop => 'telə,ʃɔp
teleshopping => 'teli,ʃɔpiŋ
telesoftware => ,teli'sɔftweә(r),-'sɔ:-
teletex => 'teliteks
teletext => 'telitekst
telethon => 'teliθɒn
teletype => 'telitaip
teletypewriter => 'teli'taipraitә
televangelism => ˌteliˈvændʒilizəm
televangelist => ˌtelɪˈvændʒəlɪst
televiewer => 'telivju:ә
televiewing => 'telɪvju:ɪŋ
televisable => 'teli,vaizәbl,,teli'v-
televise => 'telivaiz
televised => ˈteləˌvaɪzd
televises => ˈteləˌvaɪziz
televising => ˈteləˌvaɪzɪŋ
television => 'teli.viʒәn
television station => ˈteliˌviʒən ˈsteiʃən
televisionary => teliˊviʒәnәri
televisions => ˈteliˌviʒənz
televisual => ,teli'vizjuәl, -ʒuәl
telework => 'teli:wɜ:k
teleworker => 'telɪwɜ:kə(r)
telex => 'teleks
telexes => ˈtelˌeksiz
Telfer => 'telfә
Telford => 'telfәd
telic => 'ti:lik, 'telik
tell => tel
tell on => tel ɔn
tellable => 'telәbl
teller => 'telә
tellers => ˈteləz
tellies => 'teliz
tellin => 'telin
telling => 'teliŋ
telling-off => ˈtelɪŋ ɔf
tellingly => 'teliŋli
telltale => 'telteil
telltales => ˈtelˌteɪlz
tellurate => 'teljureit
tellurian => te'ljuәriәn
telluric => te'ljuәrik
telluride => 'teljuraid
tellurite => 'telju,rait
tellurium => te'ljuәriәm
telly => 'teli
telogen => tɪləʊd'ʒen
telolecithal => ,telәu'lesiθәl
telomerase => tə'lɒməreɪz
telomere => 'telәmiә
telomeric => tɪlɒ'merɪk
telophase => 'telәfeiz
telos => 'telɔs
telson => 'telsәn
temazepam => tә'meizәpæm
temblor => tem'blɒ:
temerarious => .temә'rєәriәs
temerity => ti'merәti
temp => temp
tempeh => 'tempә
temper => 'tempә
tempera => 'tempәrә
temperament => 'temprәmәnt
temperamental => .temprә'mentl
temperamentally => ˌtemprə'mentəlɪ
temperaments => ˈtempərəmənts
temperance => 'tempәrәns
temperate => 'tempәrәt
temperateness => 'temprɪtnɪs
temperature => 'temprәtʃә
temperatures => 'temprətʃəz
tempered => 'tempәd
tempering => 'tempәriŋ
tempest => 'tempist
tempests => ˈtempɪsts
tempestuous => tem'pestʃuәs
tempestuously => temˊpestjuәsli
tempestuousness => temˊpestjuәsnis
tempi => 'tempi:
temping => 'tempɪŋ
Templar => 'templә
templars => 'templə
template => 'templit
temple => templ
templet => 'templit
tempo => 'tempәu
temporal => 'tempәrәl
temporal lobe => ˈtempərəl ləʊb
temporalities => ˌtempəˈrælitiz
temporality => .temә'ræliti
temporarily => 'tempәrәrәli
temporariness => 'tempәrәrinis
temporary => 'tempәrәri
temporize => 'tempәraiz
temporized => ˈtempəˌraɪzd
temporizer => 'tempәraizә
temporizes => ˈtempəˌraɪziz
temporizing => ˈtempəˌraɪzɪŋ
temporomandibular => ,tempәrәjmæn'dibjjlә(r)
temporomandibular joint => ˌtempərəumænˈdibjulə dʒɔint
tempos => 'tempəʊz
temps => 'temps
tempt => tempt
temptability => ,temptә'biliti
temptable => 'temptәbl
temptation => temp'teiʃәn
temptations => tempˈteiʃənz
tempted => 'temptid
tempter => 'temptә(r)
tempting => 'temptiŋ
temptingly => 'temptɪŋlɪ
temptress => 'temptris
tempts => tempts
tempura => 'tempu,rɑ:, tem'purә
ten => ten
tenability => .tenә'biliti
tenable => 'tenәbl
tenace => 'teneis
tenacious => ti'neiʃәs
tenaciously => tə'neɪʃəslɪ
tenaciousness => tɪ'neɪʃəsnəs
tenacity => ti'næsiti
tenaculum => ti'nækjulәm
tenancies => ˈtenənsi:z
tenancy => 'tenәnsi
tenant => 'tenәnt
tenant farmer => ˈtenənt ˈfɑ:mə
tenantable => 'tenәntәbl
tenanted => 'tenənt
tenanting => 'tenənt
tenantless => 'tenәntlis
tenants => ˈtenənts
tenascin => te'næsɪn
tench => tenʃ
tend => tend
tendance => 'tendәns
tended => tendid
tendencies => ˈtendənsiz
tendency => 'tendәnsi
tendentious => ten'denʃәs
tendentiously => ten'denʃəslɪ
tender => 'tendә
tender-minded => 'tendә'maindid
tendered => ˈtendəd
tenderer => 'tendәrә(r)
tenderest => 'tendə
tenderfoot => 'tendәfut
tendering => ˈtendərɪŋ
tenderize => 'tendәraiz
tenderized => ˈtendəˌraizd
tenderizer => 'tendəraɪzə
tenderizes => ˈtendəˌraiziz
tenderizing => ˈtendəˌraizɪŋ
tenderloin => 'tendәlɒin
tenderness => 'tendәnis
tenders => ˈtendəz
tendinitis => ,tendi'naitis
tendinous => 'tendinәs
tendon => 'tendәn
tendonitis => ten'dəʊnaɪtɪs
tendons => ˈtendənz
tendresse => 'tɑ:ndres
tendril => 'tendril
tendrilled => 'tendrɪl
tendrils => 'tendrəlz
tends => tendz
tendu => ten'dʌ
Tenebrae => 'tenibri:
tenebrionid => ti'nebriәnid,'tenә-
tenebrism => 'tenibrizәm
tenebrist => 'tenəbrist
tenebrous => 'tenәbrәs
tenement => 'tenimәnt
tenements => 'tenəmənts
Tenerife => ,tenə'rif; -ri:f; ,tene'ri:fe
tenesmus => tә'nezmәs
tenet => 'tenit
tenets => 'tenɪts
tenfold => 'tenfәuld
tenia => 'ti:njә
tennantite => 'tenәn,tait
tenner => 'tenә
tenners => ˈtenəz
Tennessee => .teni'si:
tennies => 'teniz
tennis => 'tenis
tennis shoe => ˈtenɪs ʃu:
tennyson => 'tenisn
Tennysonian => ,teni'sәjniәn
tenon => 'tenәn
tenon saw => ˈtenən sɔ:
tenor => 'tenә
tenor clef => ˈtenə klef
tenorist => 'tenәrist
tenors => 'tenəz
tenosynovitis => ,tenәu,sinә'vaitis
tenotomy => ti'nɒtәmi
tenpence => 'tenpәns
tenpin => 'tenpin
tenpin bowling => ˈtenpin ˈbəuliŋ
tenpins => 'tenpinz
tenpounder => 'ten'paundә
tenrec => 'tenrek
tense => tens
tensegrity => ten'se^riti
tenseless => 'tenslis
tenseness => 'tensnis
tenses => tensiz
tensile => 'tensail
tensility => ten'siliti
tension => 'tenʃәn
tensional => 'tenʃәnl
tensioned => 'tenʃ(ə)n
tensioner => 'tenʃənə
tensionless => 'tenʃnles
tensions => ˈtenʃənz
tensity => 'tensәti
tensive => 'tensiv
tenson => 'tensən
tensor => 'tensә
tensors => 'tensə; -sɔː
tent => tent
tent caterpillar => tent ˈkætəpilə
tentacle => 'tentәkl
tentacled => 'tentəkld
tentacles => 'təntəkəlz
tentacular => ten'tækjulә
tentaculate => ten'tækjuleit
tentage => 'tentidʒ
tentative => 'tentәtiv
tentatively => 'tentətɪvlɪ
tentativeness => 'tentətɪvnəs
tented => 'tentid
tenter => 'tentә
tenterhook => 'tentәhuk
tenterhooks => ˈtentəhʊks
tentering => 'tentəɪŋ
tenth => tenθ
tenth-rate => 'tenθ'reit
tenthly => 'tenθli
tenths => tenθs
tenting => 'tentiŋ
tentorium => ten'tɔ:riәm
tenuity => te'nju:iti
tenuous => 'tenjuәs
tenuously => 'tenjʊəslɪ
tenuousness => 'tenjʊəsnəs
tenure => 'tenjuә
tenurial => te'njuәriәl
tenuto => te'nu:tәu
tenzon => 'tenzәn
teocalli => ,tiә'kæli:
teosinte => ,tiә'sinti
tepache => te'pætʃi:
tepal => 'ti:pəl,'te-
tepary bean => ˈtepəri:
tepee => 'ti:pi:
tepees => ˈti:pi:z
tephra => 'tefrә
tephrochronology => tefrәkrә'nɔlәdʒi
Tepic => tei'pi:k
tepid => 'tepid
tepidarium => ,tepi'deәriәm
tepidity => te'pidiiti
teppanyaki => tepənjeɪ'ki:
tequila => tә'ki:lә
ter => tә:. tεә
teraflops => te'rɑ:fləps
terai => tә'rai
teraphim => 'terəfɪm
teratocarcinoma => ,terәtәukɑ:si'nәumә
teratogen => 'terәtәdʒәn
teratogenesis => ,terәtәu'dʒenisis
teratogenic => .terәtә'dʒenik
teratogenicity => ,terәtәjdʒi'nisәti
teratology => .terә'tɒlәdʒi
teratoma => ,terә'tәumә
terawatt => 'terә,wɔt
terbium => 'tә:biәm
terce => tә:s
tercel => 'tә:sl
tercentenary => t\\\\:sen'ti:nәri
tercentennial => ,t\\\\:sen'tenjәl
tercet => 'tә:sit
terebinth => 'terәbinθ
terebratulid => ,terә'brætjulid
teredo => tә'ri:dәu
Terence => 'terəns
terephthalate => ,terəf'θæleit
teres => 'te,ri:z
teresa => tә'ri:zә
Teresina => ,terә'zi:nә,,tere'zi:nɑ:
terete => tә'ri:t, 'teri:t
tergal => 'tә:gәl
tergite => 'tә:dʒait
tergiversate => 'tә:dʒivә:seit
tergiversated => ˈtə:dʒivə:seitid
tergiversating => ˈtə:dʒivə:seitɪŋ
tergiversation => .tә:dʒivә:'seiʃәn
tergum => 'tә:gәm
teriyaki => ,teri'jɑ:ki
term => tә:m
termagant => 'tә:mә^әnt
termed => tɜːm
terminable => 'tә:minәbl
terminal => 'tә:minәl
terminally => 'tә:minәli
terminate => 'tә:mineit
terminated => 'tɜ:mɪneɪtɪd
terminates => ˈtə:mineits
terminating => 'tә:mi,neitiŋ
termination => .tә:mi'neiʃәn
terminational => tɜ:mɪ'neɪʃnəl
terminations => tɜ:mɪ'neɪʃnz
terminator => 'tә:mineitә
terminer => 'tә:minә
terming => tɜːm
termini => 'tә:minai
terminological => .tә:minә'lɒdʒikl
terminologies => ˌtɜ:məˈnɔlədʒi:z
terminology => .tә:mi'nɒlәdʒi
terminus => 'tә:minәs
terminus a quo => 'tә:minәs ei'kwәu
terminus ad quem => 'tә:minәs æd'kwem
termitarium => tә:mi'teәriәm
termitary => 't\\\\:mitəri
termite => 'tә:mait
termites => tɜ:maɪts
termly => 't\\\\:mli
tern => tә:n
ternary => 'tә:nәri
terne => tә:n
ternlet => 'tә:nlit
terns => tə:nz
terotechnology => ,terәtek'nɔlәdʒi
terpene => 'tә:pi:n
terpenoid => 'tә:pә,nɔid
terpolymer => tə:'pɔlimə
terpsichorean => ,tә:psikә'ri(:)әn
terra => 'terә
terra firma => terә 'f\\\\:mә
terra incognita => 'terәin'kɔ^nitә
terra rossa => 'terә'rɔsә
terra sigillata => 'terә,sidʒә'leitә
terrace => 'terәs
terracotta => terә'kɔtә
terrain => 'terein
terrane => tә'rein
terrapin => 'terәpin
terrapins => ˈterəpɪnz
terraqueous => te'reikwiәs
terrarium => te'rєәriәm
terrasse => təras
terrazzo => tә'ræzәu, tә'rɑ:tsәu
Terrence => tərrəns
terrene => te'ri:n
terreplein => 'teәplein
terrestrial => tә'restriәl
terret => 'terit
terrible => 'terәbl
terribleness => ˊterәblnis
terribly => 'terәbli
terricolous => tә'rikәlәs
terrier => 'teriә
terriers => ˈteri:əz
terrific => tә'rifik
terrifically => tә'rifikli
terrified => 'terifaid
terrifies => ˈterifaiz
terrify => 'terifai
terrifying => 'tәrifaiiŋ
terrigenous => te'ridʒinәs
terrine => te'ri:n
territorial => .teri'tɒ:riәl
territoriality => ,teri,tɔ:ri'æliti
territorially => ,teri'tɔ:riəli
territorials => ˌterɪˈtɔ:ri:əlz
territories => ˈteritəriz
territory => 'teritәri
terror => 'terә
terrorise => 'terәraiz
terrorism => 'terәrizm
terrorist => 'terәrist
terroristic => .terә'ristik
terrorize => 'terәraiz
terrorized => ˈterəˌraɪzd
terrorizer => 'terәraizә
terrorizes => ˈterəˌraɪziz
terrorizing => ˈterəˌraɪzɪŋ
terry => 'teri
terrycloth => teraɪk'lɒθ
terse => tә:s
tersely => tɜ:slɪ
terser => tɜ:sə
tertian => 'tә:ʃәn
tertiaries => ˈtɜ:ʃi:ˌeri:z
tertiary => 'tә:ʃiәri
tertiary education => ˈtɜ:ʃi:ˌeri: ˌedju:ˈkeiʃən
tertiary industry => 'tɜ:ʃi:ˌeri: 'ɪndəstrɪ
tertium quid => 'tә:ʃiәm 'kwid
Tertullian => tə:'tʌliən; -ljən
tervalent => tә:'veilәnt
terylene => 'terili:n
terza rima => 'teә:tsә'ri:mә
terzetto => tә:t'setәu
Tesco => teskəu
TESL => 'tesəl
Tesla => 'teslә
TESOL => 'tesɔl
tess => tes
Tessa => 'tesә
tessellate => 'tesileit
tessellated => 'tesileitid
tessellating => ˈtesəleitɪŋ
tessellation => .tesi'leiʃәn
tessera => 'tesirә
tesserae => 'tesəraɪ
tessitura => tesi'tu:rɑ:, -'tjuәrә
test => test
test drive => test draiv
test flight => test flait
test match => test mætʃ
test-fly => 'testflai
test-tube baby => ˈtestju:b ˈbeibi
testa => 'testә
testability => ,testә'bilәti
testaceous => te'steiʃәs
testament => 'testәmәnt
testamentary => .testә'mentәri
testaments => ˈtestəmənts
testate => 'testeit
testator => te'steitә. 'tes-
testatrix => te'steitriks
testee => te'sti:
tester => 'testә
testers => ˈtestəz
testicle => 'testikl
testicular => tes'tikjulә
testiculate => tes'tikjuleit
testified => ˈtestifaid
testifier => 'testifɑiә(r)
testifies => ˈtestifaiz
testify => 'testifai
testifying => ˈtestifaiŋ
testily => 'testili
testimonial => ,testi'mәunjәl, -niәl
testimonials => ˌtestəˈməʊni:əlz
testimonies => ˈtestiməniz
testimony => 'testimәni
testiness => 'testinis
testing => 'testiŋ
testing ground => ˈtestiŋ ɡraund
testis => 'testis
testosterone => te'stɒstәrәun
testudo => te'stju:dәu
testy => 'testi
tet => tet
tetanic => ti'tænik
tetanize => 'tetәnaiz
tetanoid => 'tetәnɔid
tetanus => 'tetәnәs
tetany => 'tetәni
tetched => tetʃt
tetchy => 'tetʃi
tether => 'teðә
tethered => ˈteðəd
tethering => ˈteðərɪŋ
tethers => ˈteðəz
Tethys => 'ti:θis
Teton => 'ti:tɔn
tetra => 'tetrә
tetrachloride => ,tetrә'klɔ:raid
tetrachloroethylene => ,tetrә,klɔ:rә'eθili:n
tetrachord => 'tetrәkɒ:d
tetracycline => .tetrә'saiklin
tetrad => 'tetræd
tetradactyl => ,tetrә'dæktil
tetrads => 'tetrædz
tetraethyl lead => .tetrә'i:θail'led
tetrafluoroethylene => ,tetrә'fluәrә'eθili:n
tetragonal => te'trægәnl
tetragram => 'tetrә^ræm
tetrahedral => .tetrә'hi:drәl
tetrahedrite => ,tetrә'hi:drait
tetrahedron => .tetrә'hi:drәn
tetrahydrocannabinol => ,tetrә,haidrәu'kænәbi,nɔl
tetrahydrofuran => 'tetrə,haidrəu'fjuəræn, -fju'ræn
tetralogy => te'trælәdʒi
tetramer => 'tetrәmә
tetramerous => te'træmәrәs
tetrameter => te'træmitә
tetraplegia => ,tetrә'pli:dʒjә
tetraploid => 'tetrәplɔid
tetraploidy => 'tetrә,plɔidi
tetrapod => 'tetrәpәd
tetrapterous => te'træptәrәs
tetrarch => 'ti:trɑ:k
tetrarchy => ti:'trɑ:ki
tetraspore => 'tetrәspɔ:
tetrastich => 'tetrәstik
tetrastyle => 'tetrә,stail
tetrasyllabic => .tetrәsi'læbik
tetrasyllable => 'tetrә.silәbl
tetrathlon => te'træθlәn,tә-
tetratomic => ,tetrә'tɔmik
tetravalent => .tetrә'veilәnt
tetrazole => 'tetrә,zәul
tetrazolium => ,tetrә'zәuliәm
tetrode => 'tetrәud
tetrodotoxin => ,tetrәu'tɔksin
tetrose => 'tetrәus
tetroxide => te'trɒksid
tetter => 'tetә
Teuton => 'tju:tn
Teutonic => tju:'tɒnik
Tevere => 'teiveirei,'tevere
Tew => tju:
Tewa => 'teiwә
Tewkesbury => 'tu:ks,beri
tex => teks
Tex-Mex => 'teks'meks
Texan => 'teksәn
Texas => 'teksәs
Texel => 'teksәl
text => tekst
textbook => 'tekstbuk
textbookish => 'tekstbʊkɪʃ
textbooks => 'teksbʊks
textile => 'tekstail
textual => 'tekstʃuәl
textual criticism => ˈtekstʃuəl ˈkritisizəm
textualism => 'tekstjjәlizəm,-tʃjә-
textualist => 'tekstjjәlist,-tʃjә-
textural => 'tekstʃuәrәl
texture => 'tekstʃә
textureless => 'tekstʃәlis
texturing => 'tekstʃərɪŋ
texturize => 'tekstʃәraiz
Thackeray => 'θækәri
Thaddaeus => θæ'di:әs,'θædi-
Thai => tai
Thailand => 'tailәnd
thais => ˈtɑ:i(:)z
thalamic => θә'læmik
thalamus => 'θælәmәs
thalassaemia => ˌθælə'si:mɪə
thalassic => θә'læsik
thaler => 'tɑ:lә
Thales => 'θeili:z
thali => 'tɑ:li
Thalia => θә'laiә
thalidomide => θә'lidәmaid
thalli => 'tælɪ
thallium => 'θæliәm
thalloid => 'θælɔid
thallophyte => 'θælәfait
thallus => 'θælәs
thalweg => 'tɑ: lveik
Thames => temz
thamin => 'θɑ:min
than => ðæn
thana => 'tɑ:nә
thanage => 'θeinidʒ
thanatological => ,θænətəʊ'lɒdʒɪkəl
thanatology => .θænә'tɒlәdʒi
thane => θein
thanedom => 'θeindәm
thank => θæŋk
thank you => θæŋk ju:
thank-you => 'θ,kjʊ
thanked => θæŋkt
thankful => 'θæŋkfәl
thankfully => 'θæŋkfulli
thanking => θæŋkɪŋ
thankless => 'θæŋklis
thanksgiving => 'θæŋks.giviŋ
thankyous => ˈθæŋkju:z
thar => ta:(r); ta:(r), tə:(r)
that => ðæt
that said => ðæt sed
thataway => 'ðætә,wei
thatch => θætʃ
thatcherism => 'θætʃərizəm
Thatcherite => 'θætʃәrait
thatchers => ˈθætʃəz
thatches => θætʃiz
thatching => 'θætʃiŋ
thaumatrope => 'θɒ:mәtrәup
thaumaturge => .θɒ:mә'tә:dʒ
thaumaturgic => .θɒ:mә'tә:dʒik
thaumaturgist => 'θɔ:mәt\\\\:dʒist,,θɔ:mә't\\\\:-
thaumaturgy => 'θɔ:mәtә:dʒi
thaw => θɒ:
thawed => θɔ:d
thawing => 'θɔ:iŋ
thaws => θɔ:z
the => ðә
the last => ðə lɑ:st
the like => ðə laik
the likes of => ðə laiks ɔv
the matter => ðə ˈmætə
the same => ðə seim
the world => ðə wɜː(r)ld
the- => ðə
thea => 'θi:ә,θiә
theanthropic => .θi:æn'θrɒpik
thearchy => 'θi:ɑ:ki
theater => 'θiәtә
theatergoer => θɪətə'ɡəʊər
theatre-in-the-round => 'θiәtәrinðә'rajnd,'θi:ә-
theatregoer => 'θiәtә.gәuә
theatregoers => θɪətə'ɡəʊəz
theatres => ˈθiətəz
theatric => θi'ætrik,θi:-
theatrical => θi'ætrikl
theatricalism => θi'ætrikəlizəm,θi:-
theatricality => θi.ætri'kælәti
theatricalization => θitrɪkəlaɪ'zeʃən
theatricalize => θi'ætriklaiz
theatrically => θɪ'ætrɪklɪ
theatricals => θiˈætrɪklz
theatrics => θi'ætriks
Theban => 'θi:bәn
thebe => 'θeibe,'te-
thebes => θi:bz
theca => 'θi:kә
thecate => 'θi:kit
thecodont => 'θi:kә,dɔnt
thee => ði:
theft => θeft
thefts => θefts
thegn => θein
theine => 'θi:in
their => ðєә
theirs => ðєәz
theirselves => ðeə'selvz
theism => 'θi:izm
theist => 'θi:ist
theistic => θi:'istik
thelma => 'θelmә
them => ðem
thematic => θi:'mætik
thematics => θɪ'mætɪk
thematization => ,θi:mətai'zeiʃən
thematize => 'θi:mətaiz
theme => θi:m
theme park => θi:m pɑ:k
themed => θi:md
Themis => 'θi:mis
Themistocles => θə'mistəkli:z
themselves => ðәm'selvz
then => ðen
thenar => 'θi:nɑ:
thenardite => θә'nɑ:dait
thence => ðens
thenceforth => .ðens'fɒ:θ
thenceforward => .ðens'fɒ:wәd
theo- => ˈθi:əʊ
Theobald => 'θiәbɔ:ld
theobromine => ,θi:ә'brәumin, -mi:n
theocentric => ,θiә'sentrik
theocracies => θi:ˈɔkrəsi:z
theocracy => θi'ɒkrәsi
theocrat => 'θi:әkræt
theocratic => .θi:ә'krætik
Theocritus => θi:'ɔkritəs
theodicean => θi,ɔdi'si:әn
theodicy => θi'ɒdisi
theodolite => θi'ɒdәlait
theodolites => θɪ'ɒdəlaɪt
theodolitic => θi,ɔdə'litik
theodore => 'θiәdɔ:
theogony => θi'ɒgәni
theologian => .θi:ә'lәudʒәn
theologians => θiəˈləudʒənz
theological => θiә'lɔdʒikәl
theologically => ˌθi:ə'lɒdʒɪklɪ
theologies => θi:ˈɔlədʒi:z
theologist => θi'ɔlәdʒist
theologize => θi'ɒlәdʒaiz
theology => θi'ɒlәdʒi
theomachy => θi'ɔmәki
theophany => θi'ɒfәni
theophoric => ,θi:ә'fɔ:rik, ,θiә-
theophylline => ,θiә'fili:n, -in
theorbo => θi'ɔ:bәu
theorem => 'θiәrәm
theorematic => .θiәrә'mætik
theorems => ˈθi:ərəmz
theoretic => .θi:ә'retik
theoretical => θiә'retikәl
theoretically => .θi:ә'retikli
theoretician => .θiәri'tiʃәn
theoreticians => θɪərətɪʃzn
theorise => 'θiәraiz, 'θi:ә-
theorising => 'θiəraiz, 'θi:ə-
theorist => 'θi:әrist
theorists => ˈθiərists
theorization => .θiәrai'zeiʃәn
theorize => 'θiәraiz
theorized => ˈθi:əˌraɪzd
theorizes => ˈθi:əˌraɪziz
theorizing => ˈθi:əˌraɪzɪŋ
theory => 'θiәri
theosopher => 'θɪəsɒf
theosophic => .θiә'sɒfik
theosophical => θi':əsɒfɪkl
theosophist => θi'ɒsәfist
theosophy => θi'ɒsәfi
therapeutic => .θerә'pju:tik
therapeutical => ,θerә'pju:tikәl
therapeutically => ,θerə'pju:tikli
therapeutics => .θerә'pju:tiks
therapeutist => .θerә'pju:tist
therapies => ˈθerəpiz
therapist => 'θerәpist
therapists => ˈθerəpɪsts
therapsid => θi'ræpsid
therapy => 'θerәpi
Theravada => ,θerә'vɑ:dә
there => ðєә
thereabouts => 'ðeәrәbauts
thereafter => .ðєәr'æftә
thereanent => ,ðeәrә'nent
thereat => ðeәr'æt
thereby => 'ðєәbai
therefor => ðeә'fɔ:
therefore => 'ðєәfɒ:
therefrom => .ðєә'frɒm
therein => .ðєәr'in
thereinafter => .ðєәrin'æftә
thereinbefore => .ðєәrinbi'fɒ:
thereinto => .ðєәr'intu
theremin => 'θerәmin
thereof => .ðєәr'ɒv
thereon => .ðєәr'ɒn
thereout => .ðєәr'aut
theresa => ti'ri:zә
therethrough => ðeə'θruː
thereto => .ðєә'tu:
theretofore => .ðєәtә'fɒ:
thereunder => .ðєәr'ʌndә
thereunto => .ðєәr'ʌntu:
thereupon => ,ðeәrә'pɔn
therewith => .ðєә'wið
therewithal => ,ðeәwi'ðɔ:l
theriac => 'θiәriæk
therian => 'θiәriәn
therianthropic => ,θiәriæn'θrɔpik
theriomorphic => ,θiәriә'mɔ:fik
therm => θә:m
therm- => θ\\\\:m-
thermae => 'θә:mi:
thermal => 'θә:ml
thermal imaging => ˈθə:məl iˈmædʒiŋ
thermal printer => ˈθə:məl ˈprɪntə
thermalization => ,θә:mәlai'zeiʃәn
thermalize => 'θ\\\\:mәlaiz
thermally => 'θɜ:məlɪ
thermals => 'θә:mәlz
thermic => 'θә:mik
Thermidor => 'θә:midɔ:
thermion => 'θә:miәn
thermionic => .θә:mi'ɒnik
thermionic valve => θə:miˈɔnik vælv
thermionics => .θә:mi'ɒniks
thermistor => θә'mistә
thermite => 'θә:mait
thermochemical => ,θә:mә'kemikl
thermochemistry => .θә:mәu'kemistri
thermocline => 'θә:mә,klain
thermocouple => 'θә:mәu.kʌpl
thermodynamic => .θә:mәudai'næmik
thermodynamical => θɜ:məʊdaɪ'næmɪkəl
thermodynamics => .θә:mәudai'næmiks
thermoelectric => .θә:mәui'lektrik
thermoelectricity => 'θә:mәui,lek'trisiti
thermoform => 'θә:mәu,fɔ:m
thermogenesis => .θә:mәu'dʒenisis
thermogram => 'θә:mә^ræm
thermograph => 'θә:mәgrɑ:f
thermographic => ,θɜːməʊ'ɡræfɪk
thermography => θә:'mɔ^rәfi
thermolabile => ,θә:mәu'leibail
thermoluminescence => ,θә:mәu,lu:mi'nesns
thermoluminescent => 'θə:məu,lju:mi'nesənt
thermolysis => θә'mɔlisis
thermomechanical => ,θ\\\\:mәjmi'kænikәl
thermometer => θә'mɒmitә
thermometers => θəˈmɔmitəz
thermometric => .θә:mәu'metrik
thermometrical => ,θә:mә'metrikәl
thermometry => θә'mɒmәtri
thermonuclear => .θә:mәu'nju:kliә
thermophile => 'θә:mәfail
thermophilic => ,θә:mә'filik
thermopile => 'θә:mәpail
thermoplastic => .θә:mәu'plæstik
thermoplastics => ,θә:mә'plæstiks
Thermopylae => θә'mɔpәli:
thermoregulate => ,θ\\\\:mәj're^jjleit
thermoregulation => ,θә:mәu,re^ju'leiʃәn
thermoregulatory => ,θ\\\\:mәj're^jjlәtәri
thermos => 'θә:mәs
thermoset => 'θә:mәset
thermosetting => .θә:mәu'setiŋ
thermosphere => 'θә:mәsfiә
thermostable => ,θә:mәu'steibәl
thermostat => 'θә:mәustæt
thermostatic => .θә:mәu'stætik
thermostatically => ˌθɜːmə'stætɪkli
thermostats => ˈθɜ:məˌstæts
thermotropic => ,θә:mә'trɔpik
thermotropism => θә(:)'mɔtrәpizәm
therms => θə:mz
theropod => 'θiәrәpɔd
thesaurus => θi'sɒ:rәs
these => ði:z
Theseus => 'θi:sju:s
thesis => 'θi:sis
thesp => θesp
Thespian => 'θespiәn
thespians => ˈθespi:ənz
Thespis => 'θespis
Thessalonians => ,θesә'lәjniәnz
Thessalonica => ,θesә'lɔnikә, -lәj'naikә
Thessaly => 'θesәli
theta => 'θeitә
thetas => 'θiːtə
Thetford => 'θetfәd
theurgic => θi:'ə:dʒik; θi-
theurgical => θi:'ə:dʒikəl; θi-
theurgist => 'θi:\\\\:dʒist
theurgy => 'θi:ә:dʒi
thew => ðju:
thews => θju:z
thewy => ðju:i
they => ðei
they'd => ðeid
they'll => ðeɪl
they're => ðeə(r)
they've => ðeɪv
thiabendazole => ,θaiә'bendәzәul
thiamin => 'θaiәmin
thiamine => 'θaiәmi:n
thiazide => 'θaiә,zaid
thiazine => 'θaiә,zi:n,-zin
thiazole => 'θaiә,zәul
thick => θik
thick-headed => 'θɪkh'edɪd
thick-knee => θik ni:
thick-skulled => 'θik'skʌld
thicken => 'θikәn
thickened => 'θɪkənd
thickener => 'θikәnә
thickeners => 'θɪkənərz
thickening => 'θikәniŋ
thickens => ˈθɪkənz
thicker => θɪkə
thicket => 'θikit
thickets => ˈθɪkɪts
thickhead => 'θikhed
thickheaded => 'θik'hedid
thickness => 'θiknis
thicknesser => 'θiknizә
thicknesses => ˈθɪknɪsiz
thicko => 'θikәj
thickset => 'θik'set
thief => θi:f
thieve => θi:v
thieved => θi:vd
thievery => 'θi:vәri
thieves => θi:vz
thieving => ˈθi:vɪŋ
thievish => 'θi:viʃ
thievishly => 'θi:vɪʃlɪ
thigh => θai
thigh-slapper => 'θai,slæpə
thighbone => 'θaibәun
thighed => θaɪd
thighs => θaiz
thigmotaxis => 'θi^mә'tæksis
thigmotropism => θi^'mɔtrәpizm
thill => θil
thiller => 'θilә
thimble => 'θimbl
thimbleberry => 'θimblbәri
thimbleful => 'θimblful
thimblerig => 'θimblrig
thimbles => 'θɪmblz
thimerosal => θai'merәsæl
Thimphu => 'θimfu:, -pu:, θim'pu:
thin => θin
thin air => θin eə(r)
thin-skinned => θin'skind
thine => ðain
thing => θiŋ
thingamabob => 'θiŋәmibɔb
thingamajig => 'θiŋәmidʒi^
thingies => ˈθiŋiz
thingummy => 'θiŋәmi
thingy => 'θiŋi
think => θiŋk
think again => θiŋk əˈɡen
think back => θiŋk bæk
think the world of => θiŋk ðə wɜː(r)ld ɔv
think-tank => 'θɪŋkt'æŋk
think-tanker => 'θiŋk'tæŋkə
think-tanks => 'θɪŋkt'æŋks
thinkable => 'θiŋkәbl
thinker => 'θiŋkә
thinkers => 'θɪŋkəz
thinking => 'θiŋkiŋ
thinkings => 'θɪŋkɪŋz
thinks => θiŋks
thinly => 'θinli
thinned => θind
thinner => 'θinә
thinness => 'θinis
thinnest => 'θɪnɪst
thinning => 'θiniŋ
thinnish => 'θiniʃ
thins => θinz
thiocyanate => ,θaɪə(ʊ)'saɪəneɪt
thiol => 'θaiәul,-ɔ:l
thiomersal => θaiәu'mә:sɔ:l
thionyl => 'θaiәnil
thiopental => ,θaiә'pentæl, -tɔ:l, -tl
thioridazine => ,θaiәuri'dæzi:n
thiosulphate => θi:əʊ'sʌlfeɪt
thiourea => ,θaiәujuә'riә
thir => ðiә(r), ð\\\\:(r)
thiram => 'θairæm
third => θә:d
third eye => θɜ:d ai
third party => θɜ:d ˈpɑ:ti
third person => θɜ:d ˈpə:sən
third rail => θɜ:d reil
third ventricle => θɜ:d ˈventrikl
third-degree => 'θ\\\\:ddi'^ri:
third-degree burn => ˈθə:ddiˈɡri: bə:n
third-rater => 'θ\\\\:d'reitә(r)
thirdhand => 'θɜ:dhænd
thirdly => 'θә:dli
thirst => θә:st
thirsted => θə:stid
thirstier => ˈθə:stiə
thirstily => 'θә:stili
thirsting => θə:stɪŋ
thirsts => θə:sts
thirsty => 'θә:sti
thirteen => 'θә:'ti:n
thirteenth => 'θә:ti:nθ
thirtieth => 'θә:tiiθ
thirty => 'θә:ti
thirty-eight => 'θə:ti'eit
thirty-second note => ˈθɜ:ti:ˈsekənd
thirtyfold => 'θ\\\\:tifәjld
thirtysomething => 'θɜ:ti:sʌmθɪŋ
this => θis
this-worldly => 'ðɪsw'ɜ:ldlɪ
thistle => 'θisl
thistledown => 'θisldaun
thistles => ˈθɪsəlz
thistly => 'θisli
thither => 'θiðә
thixotropic => ,θiksә'trɔpik
thixotropy => θik'sɔtrәpi
tho => ðәu
thole => θәul
tholeiite => 'θәuliait
tholeiitic => ,θəʊliː'ɪtɪk
tholos => 'θәulәs
Thomas => 'tɒmәs
Thomism => 'tәumizm
Thomist => 'tәjmist
Thomistic => təu'mistik
thompson => 'tɔmpsn
thomson => 'tɔmsn
thong => θɒ:ŋ
thonged => θɒŋ
Thor => θɒ:
thoracic => θɒ:'ræsik
thoracic duct => θɔ(:)ˈræsik dʌkt
thoracic vertebra => θɔ(:)ˈræsik ˈvɜ:təbrə
thoracolumbar => ,θɔ:rәkәu'lʌmbә
thoracotomy => ,θɔ:rә'kɔtәmi
thorax => 'θәuræks
Thoreau => 'θɔ:rәu
thoria => 'θɔ:riә
thorium => 'θәuriәm
thorn => θɒ:n
thornback => 'θɒ:nbæk
thornbill => 'θɔ:nbil
thornbush => 'θɔ:nbuʃ
Thorndike => 'θɔ:ndaik
thornier => ˈθɔ:ni:ə
thorntail => 'θɔ:nteil
thornton => 'θɔ:ntәn
thornveld => 'θɔ:nvelt, -felt
thorny => 'θɒ:ni
thorough => 'θʌrә
thoroughbred => 'θʌrәbred
thoroughbreds => ˈθɜ:rəʊˌbredz
thoroughfare => 'θʌrәfєә
thoroughfares => ˈθɜ:rəʊˌfeəz
thoroughgoing => 'θʌrә.gәuiŋ
thoroughly => 'θʌrәli
thoroughness => 'θʌrәnis. 'θә:rәu-
thoroughpin => 'θʌrәpin; 'θ\\\\:rәj-
Thorp => θɔ:p
thorpe => θɔ:p
Thorshavn => tɔ:s'hajn, 'tɔ:rshɑ:wәn
those => ðәuz
Thoth => θәuθ, tәut
thou => θau
though => ðәu
thought => θɒ:t
thought experiment => θɔ:t iksˈperimənt
thought-out => 'θɔ:t'ajt
thought-provoking => 'θɔ:tprә,vәjkiŋ
thought-reader => 'θɔ:tr'i:dər
thought-reading => 'θɔ:t,ri:diŋ
thoughtcrime => 'θɔ:tkraim
thoughtful => 'θɒ:tful
thoughtless => 'θɒ:tlis
thoughtlessly => 'θɔ:tləslɪ
thousand => 'θauznd
thousandfold => 'θauznd'fәuld
thousandth => 'θauzndθ
thousandths => ˈθauzənθs
Thrace => θreis
Thracian => 'θreiʃәn
thraldom => 'θrɔ:ldәm
thrall => θrɒ:l
thralldom => 'θrɒ:ldәm
thrash => θræʃ
thrashed => θræʃt
thrasher => 'θræʃә
thrashes => θræʃiz
thrashing => 'θræʃiŋ
thrawn => θrɔ:n
thread => θred
threadbare => 'θredbeә
threaded => θ'redid
threader => 'θredә
threadfin => 'θredfin
threading => 'θrediŋ
threadworm => 'θredwә:m
thready => 'θredi
threat => θret
threaten => 'θretn
threatened => 'θretənd
threatening => 'θretniŋ
threateningly => 'θretnɪŋlɪ
threatens => ˈθretənz
threats => θrets
three => θri:
three-D => 'θri:'di:
three-day event => θri: dei iˈvent
three-decker => θ'ri:d'ekər
three-dimensional => θri:'dimenʃәnәl
three-dimensionality => 'θri:di,menʃə'næləti; -dai-
three-handed => 'θri:'hændid
three-legged race => ˌθri: ˈlegɪd reɪs
three-line whip => θri: lain hwip
three-piece suit => ˈθri:ˌpi:s sju:t
three-point landing => ˈθri:ˌpɔɪnt
three-point turn => θri: pɔint tə:n
three-pronged => 'θri:prɔŋd
three-way => ˈθri:ˌweɪ
threefold => 'θri:fәuld
threepence => 'θripәns
threepenny => 'θripeni
threepenny bit => ˌθrepəni ˈbɪt
threescore => 'θri:'skɒ:
threesome => 'θri:sәm
threesomes => ˈθri:səmz
threnodic => θri'nɔdik
threnodist => 'θrenәdist, 'θri:-
threnody => 'θrenәdi
threonine => 'θri:әni:n
thresh => θreʃ
threshed => θreʃt
thresher => 'θreʃә
threshes => θreʃiz
threshing => 'θreʃiŋ
threshing machine => ˈθreʃɪŋ
threshold => 'θreʃәuld
thresholds => θ'reʃhəʊldz
threw => θru:
thrice => θrais
thrift => θrift
thrift shop => θrift ʃɔp
thriftier => ˈθrɪfti:ə
thriftily => 'θriftili
thriftiness => θrɪftɪnɪs
thriftless => 'θriftlis
thriftlessly => θ'rɪftləslɪ
thrifts => θrifts
thrifty => 'θrifti
thril => θ'rɪl
thrill => θril
thrilled => θrɪld
thriller => 'θrilә
thrillers => ˈθriləz
thrilling => 'θriliŋ
thrillingly => 'θrɪlɪŋlɪ
thrills => θrilz
thrip => θ'rɪp
thrips => θrips
thrive => θraiv
thrives => θraivz
thro => θ'rəʊ
throat => θrәut
throatily => 'θrәutili
throatiness => θrəʊ'ti:nəs
throatlatch => 'θrəʊtlætʃ
throats => θrəuts
throatwort => θ'rəʊtwɜ:t
throaty => 'θrәuti
throb => θrɒb
throbbed => θrɔbd
throbs => θrɔbz
throe => θrәu
thrombectomy => θrɔm'bektәmi
thrombi => 'θrɔmbai
thrombin => 'θrɒmbin
thrombocyte => 'θrɒmbәsait
thrombocytopenia => ,θrɔmbәusaitәu'pi:niә
thromboembolism => ,θrɔmbәu'embәlizm
thrombolytic => ,θrɔmbәj'litik
thrombophilia => ,θrɔmbәu'filiә
thrombophlebitis => ,θrɔmbәufli'baitis
thromboplastin => ,θrɔmbәu'plæstin
thrombose => θrɔm'bәjz , 'θrɔmb-
thromboses => θrɑ:mˈboʊsi:z
thrombosing => θrɔm'bəuz, 'θrɔmb-
thrombosis => θrɒm'bәusis
thrombotic => θrɔm'bɔtik
thromboxane => θrɔm'bɔksein
thrombus => 'θrɒmbәs
throne => 'θrәun
thrones => θrəunz
throng => θrɒ:ŋ
thronged => θrɔŋd
thronging => θrɔŋɪŋ
throngs => θrɔŋz
throstle => 'θrɒsl
throttle => 'θrɒtl
throttled => ˈθrɔtld
throttles => ˈθrɔtlz
through => θru:
through-composed => 'θru:kəm'pəuzd
throughflow => 'θru:flәj
throughother => 'θru:,ʌðә(r)
throughout => θru:'aut
throughput => 'θru:put
throughway => 'θru:wei
throve => θrәuv
throw => θrәu
throw-in => ˈθrəuin
throw-off => 'θrәjɔf, -ɔ:f
throwaway => 'θrouәwei
throwback => 'θrәubæk
throwbacks => ˈθrəubæks
thrower => 'θrәuә
throwers => 'θrəuə
throwing => 'θrәuiŋ
thrown => θrәun
throwster => 'θrәjstә(r)
thru => θru:
thrum => θrʌm
thrummed => θrʌmd
thrumming => θrʌmɪŋ
thrummy => 'θrʌmi
thrums => θrʌmz
thrush => θrʌʃ
thrush nightingale => θrʌʃ ˈnaɪtn:ˌɡel
thrushes => θrʌʃiz
thrust => θrʌst
thrust stage => θrʌst steidʒ
thruster => 'θrʌstә
thrusters => θ'rʌstəz
thrusting => 'θrʌstiŋ
thrusts => θrʌsts
thruway => 'θru:wei
Thucydides => θju:'sididi:z
thud => θʌd
thudded => θʌdid
thudding => θʌdɪŋ
thuds => θʌdz
thug => θʌg
thuggee => 'θʌgi:
thuggery => 'θʌ^әri
thuggish => 'θʌ^iʃ
thuggism => 'θʌ^izm
thugs => θʌgz
thuja => 'θju:dʒә
Thule => 'θju:li
thulium => 'θju:liәm
thumb => θʌm
thumb piano => θʌm piˈænəu
thumbnail => 'θʌmneil
thumbnails => ˈθʌmˌneɪlz
thumbprint => 'θʌmprint
thumbs => θʌmz
thumbscrew => 'θʌmskru:
thumbtack => 'θʌmtæk
thumbtacks => ˈθʌmˌtæks
Thummim => 'θʌmim
thump => θʌmp
thumped => θʌmpt
thumper => 'θʌmpә
thumping => 'θʌmpiŋ
thumps => θʌmps
thunder => 'θʌndә
thunderbird => 'θʌndәb\\\\:d
thunderbolt => 'θʌndәbәult
thunderbolts => ˈθʌndəˌbəʊlts
thunderclap => 'θʌndәklæp
thunderclaps => ˈθʌndəˌklæps
thundercloud => 'θʌndәklaud
thunderclouds => ˈθʌndəˌklaʊdz
thundered => ˈθʌndəd
thunderer => 'θʌndәrә
thunderflash => θʌndəf'læʃ
thunderhead => 'θʌndәhed
thundering => 'θʌndәriŋ
thunderous => 'θʌndәrәs
thunderously => 'θʌndərəsli
thunders => ˈθʌndəz
thundershower => 'θʌndәʃauә
thunderstorm => 'θʌndәstɒ:m
thunderstorms => 'θʌndɚ,stɔrm
thunderstruck => 'θʌndәstrʌk
thundery => 'θʌndәri
thunk => θʌŋk
Thurber => 'θә:bә
thurible => 'θjuәribl
thurifer => 'θjuәrifә
Thuringia => θjjә'rindʒiә
Thursday => 'θә:zdi
Thurston => 'θә:stәn
thus => ðʌs
thusly => 'ðʌsli
thuya => 'θu:jә
thwack => θwæk
thwacked => θwæk
thwacking => θwæk
thwacks => θwæks
thwaite => θweit
thwart => θwɒ:t
thwarted => θwɔ:tid
thwarting => 'θwɔ:tɪŋ
thwarts => θwɔ:ts
thy => ðai
Thyestean => θai'estiәn
Thyestes => θai'esti:z
thylacine => 'θailә,sain, -sin
thylakoid => 'θailә,kɔid
thyme => taim
thymectomy => θai'mektәmi
thymic => 'θaimik
thymidine => 'θaimi,di:n
thymine => 'θaimi:n
thymocyte => 'θaimә,sait
thymol => 'θaimәul
thymoma => θai'mәumә
thymus => 'θaimәs
thymy => 'taimi
thyristor => θai'ristә
thyroglobulin => ,θairәu'^lɔbjulin
thyroid => 'θairɒid
thyroidectomy => .θairɒi'dektәmi
thyroiditis => .θairɒi'daitis
thyrotoxicosis => ,θairәu,tɔksi'kәusis
thyrotropin => ,θairәj'trәjpin, θai'rɔtrәpin
thyrotropin-releasing hormone => ˌθaɪərəˈtrəʊpɪnrɪˌli:sɪŋ, θaɪˈrɔtrə-
thyroxine => θai'rɔksi:n
thyrsus => 'θә:sәs
thysanuran => ,θaisә'njurәn, θisә'nurәn
thyself => ðai'self
TI => ti:
tiara => ti'ɑ:rә
tiaras => tiˈɑ:rəz
tiber => 'taibә
Tiberius => tai'biәriәs
Tibet => ti'bet
Tibetan => ti'betn
tibia => 'tibiә
tibial => 'tibiәl
tibiotarsus => ,tibiәj'tɑ:sәs
tic => tik
tic douloureux => ˌdu:ləˈru:
Ticino => ti:'tʃi:nɔ:
tick => tik
tick-tack-toe => ˌtɪktæk'təʊ
tick-tock => ˌtɪk ˈtɒk
ticked => tikt
ticker => 'tikә
tickers => ˈtikəz
tickertape => 'tɪkəteɪp
ticket => 'tikit
ticket tout => ˈtikit taʊt
ticketed => ˈtɪkɪtɪd
ticketing => ˈtɪkɪtɪŋ
ticketless => 'tɪkɪtlɪs
tickey => 'tiki
ticking => 'tikiŋ
ticking off => ˈtikiŋ ɔf
tickle => 'tikl
tickled => ˈtikld
tickler => 'tiklә
tickles => ˈtiklz
tickling => 'tikliŋ
ticklish => 'tikliʃ
ticklishly => 'tɪklɪʃlɪ
tickseed => 'tik,si:d
ticky-tacky => ˌtɪki ˈtæki
tics => tɪks
tidal => 'taidl
tidal basin => ˈtaɪdl ˈbeisn
tidal bore => ˈtaɪdl bɔ:
tidbit => 'tidbit
tidbits => 'tɪbbɪts
tiddler => 'tidlә
tiddlers => ˈtɪdləz
tiddlier => 'tɪdlɪ
tiddliest => 'tɪdlɪ
tiddly => 'tidli
tiddlywink => 'tidliwiŋk
tiddlywinks => 'tidliwiŋks
tide => taid
tideland => 'taidlænd
tideless => 'taidlis
tidelines => 'taɪd,laɪn
tidemark => 'taidmɑ:k
tidemarks => 'taɪdmɑːk
tidepool => 'taidpu:l
tidewaiter => 'taidweitә
tidewater => 'taidwɒ:tә
tideway => 'taidwei
tidied => ˈtaidid
tidier => 'taidiә(r)
tidies => ˈtaidiz
tidiness => 'taidinis
tiding => 'taɪdɪŋ
tidings => 'taidiŋz
tidy => 'taidi
tidying => ˈtaidiŋ
tie => tai
tie clip => tai klip
tie-down => 'taɪd'aʊn
tie-dye => ˈtaɪˌdaɪ
tie-dyed => 'taɪd'aɪd
tie-dyeing => 'taɪd'aɪɪŋ
tie-pin => 'taɪp'ɪn
tiebreaker => ˈtaɪbreɪkə(r)
tied => taid
tieless => tailis
Tientsin => 'tjen'tsin
tiepin => 'taipin
tier => tiә
tierce => tiәs
tiercel => 'tiәsl
tiered => tɪəd
Tierra => ti'erә
Tierra del Fuego => ti'erә,delfu:'ei^әu
tiers => tɪəz
tiff => tif
tiffany => 'tifәni
tiffin => 'tifin
tiffs => tɪfs
Tiflis => 'tiflis, tif'li:s
tig => tiɡ
tiger => 'taigә
tiger beetle => ˈtaiɡə ˈbi:tl
tiger cat => ˈtaiɡə kæt
tiger lily => ˈtaiɡə ˈlili
tiger maple => ˈtaiɡə ˈmeipl
tiger moth => ˈtaiɡə mɔθ
tiger salamander => ˈtaiɡə ˈsæləmændə
tiger shark => ˈtaiɡə ʃɑ:k
tigerish => 'taigәriʃ
tight => tait
tight end => tait end
tight head => tait hed
tight-ass => 'taitæs
tight-assed => 'taitæst
tight-fitting => tait ˈfitiŋ
tight-knit => tait nit
tighten => 'taitn
tightened => ˈtaɪtnd
tightening => 'taitniŋ
tightens => ˈtaɪtnz
tighter => taitə
tightly => 'taitli
tightness => 'taitnis
tightrope => 'taitrәup
tightropes => ˈtait-rəups
tights => taits
tightwad => 'taitwɒd
tignon => ti'jɔ:n
tigon => ˊtaigәn
tigress => 'taigris
tigresses => ˈtaɪgrɪsiz
Tigrinya => ti'^ri:njә
tigris => 'tai^ris
tike => taik
tikka => ˈtɪkə
til => til
tilak => 'tilәk
tilapia => ti'leipiә
Tilburg => 'tilb\\\\:^, -b\\\\:rk
tilbury => 'tilbәri
Tilda => 'tildә
tilde => 'tildә
tile => tail
tiled => taid
tilefish => 'tail,fiʃ
tiler => 'tailә
tiling => 'tailiŋ
till => til
till doomsday => til ˈdu:mzdei
tillage => 'tilidʒ
tilled => tild
tiller => 'tilә
tillered => 'tɪlə
tillering => 'tɪlərɪŋ
tillers => ˈtɪləz
tilleul => ti'ljәl
Tilley => 'tili
tillite => 'tilait
tills => tilz
Tilly => 'tili
Tilsit => 'tilzit, -sit
tilt => tilt
tilter => 'tiltә
tilth => tilθ
tilting => 'tiltiŋ
tilts => tilts
tim => tim
Timaru => 'timәru:
timbal => 'timbәl
timbale => tæm'bɑ:l, 'timbәl
timbales => tim'bɑ:liz
timber => 'timbә
timber hitch => ˈtimbə hitʃ
timber wolf => ˈtimbə wulf
timbered => 'timbәd
timbering => 'timbәriŋ
timberland => 'timbәlænd
timberline => 'timbәlain
timberman => 'tɪmbəmæn
timbre => 'timbә
timbrel => 'timbrәl
time => taim
time capsule => taim ˈkæpsju:l
time line => taim lain
time off => taim ɔf
time out => taim aut
time signature => taim ˈsiɡnitʃə
time span => taim spæn
time trial => taim ˈtraiəl
time-and-motion study => taɪm ənd ˈmoʃən ˈstʌdi
time-consuming => 'taimkәn,sju:miŋ
time-lapse => 'taimlæps
time-limited => 'taɪml'ɪmɪtɪd
time-of-flight => 'taɪm'əvfl'aɪt
time-resolved => 'taɪmrɪz'ɒlvd
time-shift => 'taɪmʃ'ɪft
time-waster => 'taim,weistə
time-wasting => 'taim,weistiŋ
time-worn => taim wɔ:n
timebomb => taɪm'bɒm
timecard => table
timed => taimd
timeframe => taɪmfreɪm
timekeeper => 'taim.ki:pә
timekeepers => ˈtaɪmˌki:pəz
timeless => 'taimlis
timelessly => 'taɪmləslɪ
timelessness => 'taɪmləsnəs
timeline => ˈtaɪmlaɪn
timely => 'taili
timeous => 'taimәs
timepiece => 'taimpi:s
timepieces => 'taɪmpi:sɪz
timer => 'taimә
timers => ˈtaɪməz
times => taimz
timescale => ˈtaɪmskeɪl
timeserver => 'taimsә:vә
timetable => 'taimteibl
timetabled => 'taɪmteɪb(ə)l
timetables => ˈtaɪmˌteɪbəlz
timetabling => 'taɪm,teblɪŋ
timeworn => 'taimwɒ:n
timid => 'timid
timidity => ti'miditi
timidly => 'tɪmɪdlɪ
timidness => ˊtimidnis
timing => 'taimiŋ
Timisoara => ,ti:mi:'ʃwɑ:rɑ:
timocracy => tai'mɔkrәsi
timocratic => ,taimə'krætik
Timor => 'ti:mɔ:
Timorese => ,ti:mɔ:'ri:z; -'ri:s
timorous => 'timәrәs
timorously => 'timərəsli
timorousness => 'timərəsnis
timothy => 'timәθi
timpani => 'timpәni
timpanist => 'timpәnist
Timur => ti:'muə
tin => tin
tin hat => tin hæt
tin whistle => tin ˈhwisl
tin-opener => tin ˈəʊpənə
tin-pot => 'tinpɔt
tina => 'ti:nә
tinamou => 'tinәmu:
tinctorial => tiŋk'tɔ:riәl
tincture => 'tiŋktʃә
tinctured => 'tɪŋ(k)tʃə
tinctures => ˈtiŋktʃəz
tincturing => 'tɪŋ(k)tʃə
Tindal => 'tindәl
tinder => 'tindә
tinderbox => 'tindәbɒks
tindery => 'tindәri
tine => tain
tinea => 'tiniә
tined => taind
tines => tainz
tinfoil => 'tinfɒil
ting => tiŋ
tinge => tindʒ
tinges => tindʒz
tinging => 'tɪndʒɪŋ
tingle => 'tiŋgl
tingled => ˈtiŋɡld
tingles => ˈtiŋɡlz
tingly => 'tiŋɡli
tings => tiŋz
tinhorn => 'tinhɒ:n
tinier => ˈtainiə
tinily => 'tainili
tininess => 'taininis
tink => tiŋk
tinker => 'tiŋkә
tinkered => ˈtɪŋkəd
tinkerer => 'tɪŋkərər
tinkers => ˈtɪŋkəz
tinkle => 'tiŋkl
tinkled => ˈtɪŋkəld
tinkles => ˈtɪŋkəlz
tinkling => 'tiŋkliŋ
tinkly => 'tiŋkli
tinned => tind
tinner => 'tinә
tinnily => 'tinili
tinniness => 'tininis
tinning => 'tiniŋ
tinnitus => ti'naitәs
tinny => 'tini
tinplate => 'tinpleit
tinpot => 'tinpɒt
tinsel => 'tinsl
tinselled => 'tɪns(ə)l
tinselling => 'tɪns(ə)l
tinselly => 'tɪnsəlɪ
tinsels => ˈtinsəlz
Tinseltown => 'tinsəltaun
tinsmith => 'tinsmiθ
tinsnips => 'tɪnsnɪps
tinstone => 'tinstәjn
tint => tint
tintack => 'tintæk
tinting => 'tintiŋ
tintinnabulation => tintinæbjj'leiʃ(ә)n
Tinto => 'tintәu
tintype => 'tintaip
tinware => 'tinweә(r)
tiny => 'taini
tip => tip
tip-and-run => 'tipәn'rʌn
tip-in => ˈtɪpˌɪn
tip-top => tip tɔp
tip-up => tip ʌp
tipcat => 'tipkæt
tipi => 'ti:pi
tipper => 'tipә
Tipperary => 'tipə'rεəri
tippet => 'tipit
tippex => 'tɪpeks
tipping => 'tipiŋ
tipple => 'tipl
tippled => 'tɪp(ə)l
tippler => 'tiplә
tipples => ˈtiplz
tippling => 'tɪp(ə)l
tippy => 'tipi
tipsily => 'tipsili
tipsiness => 'tipsinis
tipstaff => 'tipstɑ:f
tipster => 'tipstә
tipsters => ˈtipstəz
tipsy => 'tipsi
tipsy cake => ˈtɪpsi: keik
tiptoe => 'tiptәu
tiptoed => ˈtɪpˌtəʊd
tiptoeing => ˈtɪpˌtəʊɪŋ
tiptoes => ˈtɪpˌtəʊz
tiptop => 'tiptɒp
tirade => 'taireid
tirades => ˈtaɪˌreɪdz
tirailleur => ,tirai'lә:
tiramisu => ˌtɪrəmɪ'sʊ
tire => taiә
tire iron => ˈtaiə ˈaiən
tired => taiәd
tiredly => ˈtaɪədlɪ
tiredness => 'taiәdnis
tireless => 'taiәlis
Tiresias => taiә'ri:siæs
tiresome => 'taiәsәm
tiresomely => 'taiəsəmli
tiring => 'taiәriŋ
tiro => 'taiәrәu
Tisa => 'ti:sә, -sɔ:
tisane => ti'zæn=
Tishri => tiʃ'ri:, 'tiʃri:
Tisiphone => ti'sifәni
tissue => 'tiʃu:
tissue paper => ˈtisju: ˈpeipə
tissuing => 'tɪʃuː; 'tɪsjuː
Tisza => 'ti:sә, -sɔ:
tit => tit
Titan => 'taitn
titanate => 'taitәneit
titania => tai'teiniә
Titanic => tai'tænik
titaniferous => ,taitә'nifәrәs
titanite => 'taitә,nait
titanium => tai'teiniәm
titanous => tai'tænәs, ti-, 'taitnәs
titbit => 'titbit
titbits => ˈtɪtˌbɪts
titchy => 'tɪtʃi
titer => 'taitә
titfer => 'tɪtfər
tithable => 'taiðәbl
tithe => taið
tithe barn => taið bɑ:n
tithed => taɪð
tithes => taiðz
tithing => 'taiðiŋ
Tithonus => ti'θәunәs
titi => ti'ti:
titian => 'tiʃiәn
Titicaca => ,ti:ti'kɑ:kɑ:
titillate => 'titileit
titillated => ˈtɪtlˌeɪtid
titillates => ˈtɪtlˌeɪts
titillating => ˈtitileitiŋ
titivate => 'titiveit
titivated => ˈtɪtəˌveɪtid
titivating => ˈtɪtəˌveɪtɪŋ
titivation => ,titi'veiʃən
titlark => 'titlɑ:k
title => 'taitl
title page => ˈtaitl peidʒ
titled => 'taitld
titling => 'taitliŋ
titlist => 'taitlist
titmouse => 'titmaus
tito => 'ti:tәj
Titograd => 'ti:tәj^ræd, -^rɑ:d
Titoism => 'ti:tәjizәm
titratable => 'taitreitәbl
titrate => 'titreit
titrated => ˈtaitreitid
titrating => ˈtaitreitɪŋ
titration => ti'treiʃәn
tits => 'tɪts
titter => 'titә
tittered => ˈtitəd
tittering => ˈtitərɪŋ
titters => ˈtitəz
titties => 'tɪtɪ
tittivate => 'titiveit
tittle => 'titl
tittle-tattle => 'tit(ә)ltæt(ә)l
tittup => 'titәp
tittupped => 'tɪtəp
tittupping => 'tɪtəp
titty => 'titi
titubation => .titju'beiʃәn
titular => 'titjulә
titularly => 'tɪtjʊləlɪ
Titus => 'taitәs
Tivoli => 'tivəli:
tizzy => 'tizi
Tlaxcala => tlɑ:s'kɑ:lɑ:
Tlemcen => tlem'sen
Tlingit => 'tliŋ^it
tmesis => 'tmi:sis
to => tu:
to distraction => tu: dɪˈstrækʃən
to order => tu: ˈɔ:də
to that effect => tu: ðæt iˈfekt
to-do => tә'du:, tu'du:
toad => tәud
toadfish => 'tәudfiʃ
toadflax => 'tәudflæks
toadied => ˈtəʊdi:d
toadies => ˈtəʊdi:z
toads => təudz
toadstone => 'tәudstәun
toadstool => 'tәudstu:l
toadstools => ˈtəʊdˌstu:lz
toady => 'tәudi
toadying => ˈtəʊdi:ɪŋ
toadyish => 'təʊdiːɪʃ
toast => tәust
toasted => təustid
toaster => 'tәjstә(r)
toasters => ˈtəustəz
toastie => ˈtəʊsti
toasting => təustɪŋ
toastmaster => 'tәjstmɑ:stә(r)
toastmasters => ˈtəustmɑ:stəz
toastmistress => 'tәjst,mistris
toasts => təusts
toasty => ˈtəʊsti
tobacco => tә'bækәu
tobacco plant => təˈbækəu plɑ:nt
tobacconist => tә'bækәnist
tobacconists => təˈbækənɪsts
tobago => tә'bei^әj
Tobagonian => ,tәjbә'^әjniәn
Tobin => 'tәubin
Tobit => 'tәubit
toboggan => tә'bɔ^әn
tobogganing => tə'bɒɡənɪŋ
toboggans => təˈbɔgənz
tobramycin => tәubrә'maisin
Tobruk => 'tәubruk
Toby => 'tәubi
toby jug => ˈtəubi dʒʌɡ
Toc H => 'tɔk'eitʃ
Tocantins => ,təukεn'ti:ns
toccata => tә'kɑ:tә
toccatas => təˈkɑ:təz
Tocharian => tɔ'kεəriən; təu-
Tock => tɔk
toco => 'tәukәu
tocopherol => tәu'kɔfәrәul
tocsin => 'tɒksin
tod => tɒd
today => tә'dei
today week => təˈdei wi:k
todays => tə'deɪ
todd => tɔd
toddies => ˈtɔdi:z
toddle => 'tɒdl
toddled => ˈtɔdld
toddler => 'tɔdlә
toddlers => 'tɒdləz
toddles => ˈtɔdlz
toddling => ˈtɔdlɪŋ
toddy => 'tɒdi
tody => 'tәudi
toe => tәu
toe-curling => təʊ ˈkə:liŋ
toea => 'tɪə
toecap => ˈtəʊkæp
toed => tәjd
toeholds => ˈtəʊˌhəʊldz
toeing => 'təʊɪŋ
toenail => 'tәuneil
toenails => ˈtəʊˌneɪlz
toepiece => 'tәjpi:s
toff => tɒf
toffee => 'tɒfi:
toffee apple => ˈtɔ:fi: ˈæpl
toffees => ˈtɔ:fi:z
toffs => tɔfs
Tofranil => 'tɔfrәnil
toft => tɔft
tofu => 'tәufu:
tog => tɒg
toga => 'tәugә
togas => ˈtəuɡəz
together => tә'geðә
togetherness => tә'^eðәnis
togged => tɔɡd
toggery => 'tɒgәri
togging => tɔɡɪŋ
toggle => 'tɒgl
toggles => ˈtɔɡlz
togo => 'tәu^әu
Togolese => ,təuɡəu'li:z
tohubohu => 'tәjhu:'bәjhu:
toil => tɒil
toile => twɑ:l
toiled => 'tɔɪld
toiler => 'tɒilә
toilet => 'tɒilit
toilet bag => ˈtɔilit bæɡ
toilet tissue => ˈtɔɪlɪt ˈtisju:
toileting => ˈtɔɪlɪt
toiletry => 'tɔilitri
toilets => 'tɔɪlɪts
toilette => twɑ:'let
toiling => 'tɔɪlɪŋ
toilsome => 'tɒilsәm
toilworn => 'tɒilwɒ:n
toing and froing => tu:iŋ әnd 'frәjiŋ
Tokai => 'tɔkei
tokay => təʊ'keɪ
toke => tәuk
token => 'tәukәn
tokens => ˈtəukənz
tokoloshe => ,tɔkɔ'lɔʃ,-'lɔʃi
tokonoma => ,tәjkә'nәjmә
Tokugawa => 'tәjku:'^ɑ:wɑ:
Tokyo => 'tәukjәu
tolar => tɔlɑ:
tolbooth => 'tәul,bu:θ
tolbutamide => tәl'bju:tәmaid
told => tәuld
tole => tәul
toledo => tә'li:dәu
tolerable => 'tɒlәrәbl
tolerably => 'tɒlәrәbli
tolerance => 'tɒlәrәns
tolerances => ˈtɔlərənsiz
tolerant => 'tɒlәrәnt
tolerantly => 'tɔlərəntli
tolerate => 'tɒlәreit
tolerated => ˈtɔləreitid
tolerates => ˈtɔləreits
tolerating => ˈtɔləreitɪŋ
toleration => .tɒlә'reiʃәn
toleware => 'tәulweә
toll => tәul
toll plaza => təul ˈplɑ:zə
toll-bridge => 'təʊlbr'ɪdʒ
tollbooth => 'tәulbu:θ
tollgate => 'tәulgeit
tolling => təulɪŋ
tolls => təulz
tollway => 'tәjlwei,'tɔl-
Tolstoy => 'tɔlstɔi
Toltec => 'tɒltek
Toltecan => 'tɔltekn 'tәu-
tolu => tәu'lu:
Toluca => tә'lu:kә,tɔ:'lu:kɑ:
toluene => 'tɔljui:n
tom => tɒm
tom-tom => 'tɔmtɔm
tomahawk => 'tɒmәhɒ:k
tomahawks => ˈtɔməhɔ:ks
tomalley => 'tɔmæli
tomatillo => ,tәumә'ti:lәu
tomatine => 'tɔmәti:n
tomato => tә'mɑ:tәu
tomatoey => tə'mɑ:təu; -'mei
tomb => tu:m
tombola => 'tɒmbәlә
tombolas => tɒm'bəʊlə
tombolo => 'tɔmbә,lәu
Tombouctou => ,tәjŋbu:k'tu:
tomboy => 'tɒmbɒi
tomboyish => 'tɔm,bɔiiʃ
tomboys => ˈtɔmˌbɔɪz
tombs => tu:mz
tombstone => 'tu:mstәun
tombstones => ˈtu:mˌstəʊnz
tomcat => 'tɒmkæt
tomcod => 'tɒmkɒd
tome => tәum
tomentose => tәu'mentәus
tomentum => tәu'mentәm
tomes => təumz
tomfool => 'tɒm'fu:l
tomfoolery => tɒm'fu:lәri
Tomlinson => 'tɔmlinsn
tommy => 'tɒmi
tommy gun => 'tɔmi^ʌn
tommyrot => 'tɒmirɒt
tomogram => 'tәumәgræm
tomographic => ,təumə'ɡræfik
tomography => tә'mɒgrәfi
tomorrow => tә'mɒ:rәu
tompion => 'tɔmpiәn
Tompkins => 'tɔmpkinz
Tomsk => tɔmsk
tomtit => 'tɒm'tit
ton => tʌn
ton-mile => 'tʌnmail
tonal => 'tәunl
tonalite => 'tәunәlait
tonality => tәu'næliti
tonally => 'tәunәli
tondo => 'tɔndәu
tone => tәun
tone group => təun ɡru:p
tone poem => təun ˈpəuim
toneburst => 'təʊnbɜ:st
toned => 'tәund
toneless => 'tәunlis
tonelessly => 'təʊnləslɪ
toneme => 'tәuni:m
tonemic => təʊ'niːmɪk
toner => 'tәunә
toners => ˈtəunəz
tong => tɒŋ
tonga => 'tɔŋ^ә
tongs => tɔŋz
tongue => tʌŋ
tongue tie => tʌŋ tai
tongue-lashing => 'tʌŋ,læʃiŋ
tongue-twister => tʌŋ 'twɪstə(r)
tongue-twisters => tʌŋ'twistə
tongue-twisting => 'tʌŋ,twistiŋ
tongued => tʌŋd
tonguefish => 'tʌŋfiʃ
tongueless => 'tʌŋlis
tongues => tʌŋz
tonguing => 'tɔŋiŋ
toni => 'tәuni
tonic => 'tɒnik
tonic sol-fa => ˈtɔnɪk sɔlˈfɑ:
tonic water => ˈtɔnɪk ˈwɔ:tə
tonically => 'tɔnik
tonicity => tәu'nisiti
tonier => ˈtəuniə
tonight => tә'nait
toning => 'tәuniŋ
tonk => tɔŋk
tonka bean => ˈtɔŋkə
Tonkin => 'tɔn'kin,'tɔŋ-
Tonks => tɔŋk
tonnage => 'tʌnidʒ
tonnages => ˈtʌnɪdʒz
tonne => tʌn
tonneau => 'tɒnәu
tonner => 'tʌnә
tonnes => tʌnz
tonometer => tәu'nɒmitә
tonoplast => 'tɔnә,plɑ:st
tonsil => 'tɒnsl
tonsillar => 'tɔnsilә
tonsillectomy => .tɒnsi'lektәmi
tonsillitis => .tɒnsi'laitis
tonsils => 'tɒnsɪlz
tonsorial => tɒn'sɒ:riәl
tonsure => 'tɒnʃә
tonsuring => ˈtɔnʃərɪŋ
tontine => tɔn'ti:n
tonus => 'tәunәs
tony => 'tәuni
too => tu:
too right => tu: rait
took => tuk
tool => tu:l
tool kit => tu:l kit
toolbox => 'tu:lbɒks
tooled => tu:ld
tooler => 'tu:lә
tooling => 'tu:liŋ
toolmaker => ˈtu:lmeɪkə(r)
toolmaking => 'tu:l.meikiŋ
tools => tu:lz
toolshed => 'tu:lʃed
tooltip => 'tuːltɪp
toon => tu:n
toot => tu:t
tooted => tu:tid
tooth => tu:θ
tooth fairy => tu:θ ˈfɛəri
tooth powder => tu:θ ˈpaudə
toothache => 'tu:θeik
toothbrush => 'tu:θbrʌʃ
toothbrushes => ˈtu:θˌbrʌʃiz
toothcomb => 'tu:θkәum
toothed => tu:θt
toothed whale => tu:θt hweil
toothing => 'tu:θiŋ
toothless => 'tu:θlis
toothpaste => 'tu:θpeist
toothpastes => ˈtu:θˌpeɪsts
toothpick => 'tu:θpik
toothpicks => ˈtu:θˌpɪks
toothsome => 'tu:θsәm
toothwort => 'tu:θwɜ:t
toothy => 'tu:θi
tootle => 'tu:tl
tootled => 'tu:tld
tootles => ˈtu:tlz
tootling => ˈtu:tlɪŋ
toots => tu:ts
top => tɒp
top boot => tɔp bu:t
top brass => tɔp brɑ:s
top dog => tɔp dɔɡ
top dollar => tɔp ˈdɔlə
top dressing => tɔp ˈdresiŋ
top gun => tɔp ɡʌn
top out => tɔp aut
top round => tɔp raund
top table => tɔp ˈteibl
top-down => 'tɔpdajn
top-drawer => 'tɔp'drɔ:(r)
top-end => tɔp end
top-heavy => tɔp'hevi
top-line => 'tɔplain
top-ranking => 'tɔp'ræŋkiŋ
top-shelf => tɔp ʃelf
top-up => ˈtɒpʌp
topaz => 'tәupæz
topazolite => tәu'pæzә lait
topcoat => 'tɔpkәjt
topcoats => ˈtɔpkəuts
topdress => 'tɒpdrəs
topdressing => 'tɒpdrəsɪŋ
tope => tәup
toped => təupt
toper => 'tәupә
topgallant => .tɒp'gælәnt
Tophet => 'tәufit
tophus => 'tәufәs
topi => 'tәupi
topiary => 'tәupiәri
topic => 'tɒpik
topical => 'tɒpikl
topicality => tɔpi'kæliti
topicalize => 'tɔpikə,laiz
toping => təupɪŋ
topknot => 'tɒpnɒt
topless => 'tɒplis
toplofty => 'tɒp.lɒfti
topman => 'tɔpmәn
topmast => 'tɒpmæst
topminnow => 'tɔp,minәu
topmost => 'tɒpmәust
topo => 'tɔpәu
topographer => tә'pɒgrәfә
topographic => .tɒpә'græfik
topographical => ,tɔpә'^ræfikәl
topographies => təˈpɔgrəfi:z
topography => tә'pɒgrәfi
topoi => 'tɔpɔi,'tәj-
topoisomer => 'tɒpɔɪzɒmər
topoisomerase => ˌtɒpɔɪ'sʌməreɪz
topological space => ˌtɔpəˈlɔdʒikəl speis
topology => tәu'pɒlәdʒi
toponym => 'tɒpәnim
toponymic => ,tɒpə'nɪmɪk
toponymy => tә'pɒnәmi
topos => 'tɔpɔs,-әs,'tәjpɔs
topper => 'tɔpә
toppers => 'tɒpə
topping => 'tɒpiŋ
topple => 'tɒpl
toppled => ˈtɔpld
topples => ˈtɔplz
toppling => ˈtɔplɪŋ
tops => tɔps
topsail => 'tɒpsәl
topside => 'tɒpsaid
topsoil => 'tɒpsɒil
topspin => ˈtɒpspɪn
topstitch => 'tɔpstitʃ
topsy-turvy => .tɒpsi'tә:vi
toque => tәuk
tor => tɒ:
torah => 'tәurә
torc => tɔ:k
torch => tɒ:tʃ
torchbearer => 'tɒ:tʃbєәrә
torched => tɔ:tʃt
torches => tɔ:tʃiz
torching => 'tɔ:tʃɪŋ
torchlight => 'tɒ:tʃlait
torchon => 'tɔ:ʃәn
tore => tɒ:
toreador => 'tɔriәdɔ:
toreador pants => ˈtɔriədɔ: pænts
torero => tәu'rєәrәu
toreutic => tәu'ru:tik
toreutics => tәj'ru:tiks
torgoch => 'tɔ:^әtʃ
tori => 'tɔ:rai
toric => 'tɔ:rik
torii => 'tɔri:
Torino => tɔ'ri:nɔ
torment => 'tɒ:ment
tormented => ˈtɔ:mentid
tormentil => 'tɒ:mentil
tormenting => tɔ: 'mentiŋ, 'tɔ: m-
tormentor => tɒ:'mentә
tormentors => tɔ:ˈmentəz
torments => ˈtɔ:ments
torn => tɒ:n
tornadic => tɔ:'nædik,-'nei-
tornado => tɒ:'neidәu
tornados => tɔ:ˈneidəuz
toro => 'tәurәu
toroid => 'tәurɔid
toroidal => tɔ:'rɔidәl
toronto => tә'rɔntәu
torpedo => tɒ:'pi:dәu
torpedo boat => tɔ:ˈpi:dəʊ bəut
torpedo tube => tɔ:ˈpi:dəʊ tju:b
torpedoing => tɔ:'pi:dəʊɪŋ
torpefy => 'tɔ:pifai
torpid => 'tɒ:pid
torpidity => tɒ:'piditi
torpidly => 'tɔ:pɪdlɪ
torpor => 'tɒ:pә
Torquay => 'tɔ:'ki:
torque => tɒ:k
torque wrench => tɔ:k rentʃ
torques => 'tɔ:kwiz
Torrance => 'tɔrәns,'tɔ:-
torrent => 'tɒ:rәnt
torrential => tɒ'renʃәl
torrentially => tɒːrenʃәli
Torricelli => ,tɔri'tʃeli
torrid => 'tɒ:rid
torridity => tɒ'riditi
torsade => 'tɔ:seid
torse => tɔ:s
torsel => 'tɔ:sәl
torsion => 'tɒ:ʃәn
torsional => 'tɒ:ʃәnl
torsk => tɔ:sk
torso => 'tɔ:sәu
torsos => ˈtɔ:səʊz
tort => tɒ:t
torte => tɔ:t
tortellini => ,tɔ:tә'li:ni
tortfeasor => 'tɔ:t'fi:zə, -zɔ:
torticollis => tɔ:ti'kɔlis
tortilla => tɔ:'tilә
tortillas => tɔː'tiːjəz
tortious => 'tɒ:ʃәs
tortoise => 'tɒ:tәs
tortoise beetle => ˈtɔ:tɪs ˈbi:tl
tortoises => ˈtɔ:tɪsiz
tortoiseshell => 'tɔ:tәʃel
tortoiseshell butterfly => ˈtɔ:tɪsˌʃel ˈbʌtəflai
tortoiseshells => ˈtɔ:tɪsˌʃelz
Tortola => 'tɔ:tәlә
tortricid => 'tɔ:trisid
tortrix => 'tɔ:triks
torts => 'tɔ:ts
tortuosity => .tɒ:tʃu'ɒsiti
tortuous => 'tɒ:tʃuәs
tortuously => 'tɔ:tjuəsli
tortuousness => 'tɔ:tjʊəsnɪs
torture => 'tɒ:tʃә
tortured => ˈtɔ:tʃəd
tortures => ˈtɔ:tʃəz
torturing => 'tɔ:tʃәriŋ
torturous => 'tɒ:tʃәrәs
torula => 'tɔ:rulә
torulosis => ,tɔ:rju'lәusis
torus => 'tɒ:rәs
Tory => 'tɒ:ri
Toryism => 'tɒ:riizm
tosca => 'tɔskә
Toscana => tәjs'kɑ:nә,tɔ:s'kɑ:nɑ:
tosh => tɒʃ
toss => tɒs
tossed => tɔst
tosser => ˈtɒsə(r)
tosses => tɔsiz
tossing => 'tɔsiŋ
tosspot => 'tɔspɔt,'tɔ:s-
tostada => tәjs'tɑ:dә,tɔ:s'tɑ:ðɑ:
tot => tɒt
total => 'tәutl
total depravity => ˈtəutəl dɪˈprævɪti:
total heat => ˈtəutəl hi:t
total recall => ˈtəutəl riˈkɔ:l
totaled => 'təʊt(ə)l
totalitarian => .tәutæli'tєәriәn
totalitarianism => ,tәjtæli'teәriәnizəm
totality => 'tәutæliti
totalization => təʊtəlaɪ'zeɪʃən
totalizator => 'tәutәlaizeitә
totalize => 'tәutәlaiz
totalized => ˈtəutəlaizd
totalizer => 'tәutәlaizә
totalizes => ˈtəutəlaiziz
totalled => 'tәutld
totally => 'tәutli
tote => tәut
tote bag => təut bæɡ
toted => təutid
totem => 'tәutәm
totemic => tәu'temik
totemism => 'tәutәmizm
totemist => 'tәutәmist
totemistic => .tәutә'mistik
totems => ˈtəʊtəmz
toter => 'tәutә
totes => 'təʊts
toting => təutɪŋ
totipotent => tәu'tipәtәnt
toto => 'tәutәu
tots => tɔts
totted => tɔtid
Tottenham => 'tɔtnəm
totter => 'tɒtә
tottered => ˈtɔtəd
totterer => 'tɒtərə
tottering => 'tɒtәriŋ
totters => ˈtɔtəz
tottery => 'tɒtәri
totting => ˈtɔtiŋ
totty => 'tɔti
toucan => 'tu:kәn
toucanet => 'tu:kәnit
toucans => ˈtu:kænz
touch => tʌtʃ
touch football => tʌtʃ ˈfutbɔ:l
touch judge => tʌtʃ dʒʌdʒ
touch pad => tʌtʃ pæd
touch-and-go => 'tʌtʃәn'^әu
touch-me-not => 'tʌtʃmi:,nɔt
touch-tone => 'tʌtʃtәjn
touch-type => 'tʌtʃtaip
touch-typing => tʌtʃ ˈtaɪpɪŋ
touchable => 'tʌtʃәbl
touchback => 'tʌtʃbæk
touchdown => 'tʌtʃdaun
touchdowns => ˈtʌtʃˌdaʊnz
touched => tʌtʃt
toucher => 'tʌtʃә
touches => 'tʌtʃis
touchier => ˈtʌtʃi:ə
touchily => 'tʌtʃili
touchiness => 'tʌtʃɪnəs
touching => 'tʌtʃiŋ
touchingly => 'tʌtʃɪŋlɪ
touchline => 'tʌtʃlain
touchpad => 'tʌtʃpæd
touchpaper => ˈtʌtʃpeɪpə(r)
touchscreen => tʌtʃɪzk'ri:n
touchstone => 'tʌtʃstәun
touchstones => ˈtʌtʃstəunz
touchwood => 'tʌtʃwud
touchy => 'tʌtʃi
touchy-feely => ˈtʌtʃi:ˈfi:li:
tough => tʌf
tough love => tʌf lʌv
tough-minded => 'tʌf'maindid
toughen => 'tʌfn
toughened => ˈtʌfnd
toughening => 'tʌfnɪŋ
toughens => ˈtʌfnz
toughie => 'tʌfi
toughly => 'tʌfli
toughness => 'tʌfnis
toughs => tʌfs
Toulon => tu:'lɔ:ŋ
toulouse => tu:'lu:z
toupee => 'tu:pei
toupees => tu:'peɪz
tour => tuә
tour de force => 'tuәdә'fɔ:s
tour operator => tuə ˈɔpəreitə
touraco => tu:rә'kәu
Tourane => tu:'rɑ:n,tj-
touring => 'tuәriŋ
touring car => ˈtuəriŋ kɑ:
tourism => 'tuәrizm
tourist => 'tuәrist
touristic => tuəˈristik
tourists => 'tʊərɪsts
touristy => 'tuәristi
tourmaline => 'tuәmәli:n
Tournai => 'tuə'nei
tournament => 'tә:nәmәnt
tournaments => 'tɔ:nəmənts
tournedos => tuәni'dәu
tourney => 'tuәni
tourneyed => ˈtuənid
tourneying => ˈtuəniŋ
tourneys => ˈtuəniz
tourniquet => 'tuәniket
tourniquets => ˈtʊənɪkɪts
tournois => tjә'nwɑ:,tu:r-
tours => tuәz
tousle => 'tauzl
tousled => ˈtaʊzəld
tousles => ˈtaʊzəlz
tousling => ˈtaʊzəlɪŋ
tout => taut
tout court => tu:'kuә
tout de suite => ,tu:də'swi:t
touted => taʊtid
touter => 'tajtә(r)
touting => taʊtɪŋ
touts => taʊts
tovarish => tә'vɑ:riʃ
tow => tәu
tow bar => təu bɑ:
tow rope => təu rəup
tow-headed => 'təʊh'edɪd
towable => 'tәjәbl
towage => 'tәuidʒ
toward => tә'wɒ:d
towards => tә'wɔ:dz
towboat => 'tәubәut
towed => təud
towel => 'tauәl
towel horse => ˈtauəl hɔ:s
towel rail => ˈtauəl reil
towelette => 'tәuәlit
toweling => 'tauәliŋ
towelling => 'tauәliŋ
towels => ˈtauəlz
tower => 'tauә
tower block => ˈtauə blɔk
towering => 'tauәriŋ
towery => 'tauәri
towhead => 'tәuhed
towhee => 'tauhi:
towing => 'tәjiŋ
towline => 'tәulain
town => taun
town car => taun kɑ:
town crier => taun ˈkraiə
town meeting => taun ˈmi:tiŋ
town planner => taun ˈplænə
townee => tau'ni:
Townes => taunz
townhome => 'taunhəum
townhouse => 'taʊnhaʊz
townie => 'tajni
townish => 'tajniʃ
townland => 'taʊnlənd
townlet => 'tajnlit
townscape => ˈtaʊnskeɪp
township => 'taunʃip
townships => ˈtaunʃips
townsite => taʊn'saɪt
townsman => 'taunzmәn
townsmen => 'taunzmən
townspeople => 'tajnzpi:p(ә)l
Townsville => 'tajnzvil
townswoman => 'tajnz,wjmәn
Townswomen => 'taunz,wimin
townward => 'tajnwәd
townwards => 'tajnwәdz
towpath => 'tәupæθ
towplane => təʊp'leɪn
towrope => 'tәurәup
tows => 'təʊz
towy => 'tәui
toxaemia => tɒk'si:miә
toxaemic => -mik
toxaphene => 'tɔksәfi:n
toxemia => tɔk'si:miә
toxi- => 'tɒksɪ
toxic => 'tɒksik
toxic shock syndrome => ˈtɔksik ʃɔk ˈsindrəum
toxicant => 'tɒksikәnt
toxicity => tɒk'sisiti
toxicological => .tɒksikә'lɒdʒikl
toxicologically => tɒksikәˊlɒdʒikәli
toxicologist => .tɒksi'kɒlәdʒist
toxicology => .tɒksi'kɒlәdʒi
toxigenic => ,tɔksi'dʒenik
toxigenicity => ,tɔksidʒi'nisiti
toxin => 'tɒksin
toxins => ˈtɔksɪnz
toxoid => 'tɒksɒid
toxophilite => tɒk'sɒfilait
toxophily => tɒk'sɒfili
toxoplasmosis => ,tɔksәuplæz'mәusis
toy => tɒi
toy boy => tɔi bɔi
toyboy => 'tɔɪbɔɪ
toying => tɒɪ
toymaker => 'tɔɪmeɪkə
toynbee => 'tɔinbi
toyon => 'tɒiɒn
toyshop => 'tɒiʃɒp
toytown => 'tɔɪtaʊn
tpa => t'pə
trabeated => 'treibi,eitid
trabeation => ,treibi'eiʃən
trabecula => trә'bekjulә
trabecular => trә'bekjulә
Trabzon => tra:b'zɔ:n
tracasserie => trә'kæsәri
trace => treis
trace fossil => treis ˈfɔsl
traceability => ,treisә'bilәti
traceable => 'treisәbl
traced => treist
traceless => 'treislis
tracer => 'treisә
traceries => ˈtreisəriz
tracery => 'treisәri
trachea => 'treikiә
tracheal => 'treikiәl
tracheate => 'treiki,eit
tracheid => 'treikiid
tracheitis => .treiki'aitis
tracheostomy => .treiki'ɒtәmi
tracheotomy => ,træki'ɔtәmi
trachoma => trә'kәumә
trachyte => 'treikait
trachytic => trә'kitik
tracing => 'treisiŋ
track => træk
trackage => 'trækidʒ
tracker => 'trækә
trackers => ˈtrækəz
tracking => 'trækiŋ
tracklayer => 'træk,leiә(r)
trackless => 'træklis
trackman => 'trækmәn
trackside => 'træksaid
tracksuits => ˈtræksu:ts
trackway => 'trækwei
tract => trækt
tract house => trækt haus
tractability => .træktә'biliti
tractable => 'træktәbl
tractably => ˊtræktәbli
Tractarian => træk'tєәriәn
Tractarianism => træk'teәriәnizəm
tractate => 'trækteit
traction => 'trækʃәn
tractive => 'træktiv
tractor => 'træktә
tractor trailer => ˈtræktə ˈtreɪlə
tractors => t'ræktəz
tractrix => 'træktriks
tracy => 'treisi
trad => træd
tradable => 'treidәbl
trade => treid
trade book => treid buk
trade unionist => treid ˈju:njənɪst
trade-last => 'treidlɑ:st;-læst
tradeable => t'reɪdeɪbl
tradecraft => 'tredkræft
trademark => 'treidmɑ:k
trademarked => 'treɪdmɑːk
trademarks => ˈtreidmɑ:ks
trader => 'treidә
trades => 'treidz
tradescantia => ,trædis'kænʃiә
tradesman => 'treidzmәn
trading => 'treidiŋ
trading card => ˈtreɪdɪŋ kɑ:d
trading estate => ˈtreɪdɪŋ isˈteit
tradition => trә'diʃәn
traditional => trә'diʃәnl
traditionalism => trә'diʃәnlizm
traditionalistic => .trәdiʃәnә'listik
traditionalists => trəˈdiʃənəlists
traditionary => trә'diʃәnәri
traditionist => trә'diʃənist
traditions => trə'dɪʃnz
traduce => trә'dju:s
traduced => trəˈdu:st
traduces => trəˈdu:siz
traducing => trəˈdu:sɪŋ
Trafalgar => trə'fælgə
traffic => 'træfik
traffic calming => 'træfik'kɑ:miŋ
traffic circle => ˈtræfik ˈsə:kl
traffic cone => ˈtræfik kəun
traffic cop => ˈtræfik kɔp
traffic pattern => ˈtræfik ˈpætən
traffic warden => ˈtræfik ˈwɔ:dn
trafficator => 'træfikeitә
trafficker => 'træfikә
traffickers => ˈtræfikəz
trafficking => ˈtræfikɪŋ
traffics => ˈtræfiks
tragacanth => 'trægәkænθ
tragedian => trә'dʒi:diәn
tragedienne => trә.dʒi:di'en
tragedies => 'trædʒədi
tragedy => 'trædʒidi
tragic => 'trædʒik
tragic flaw => ˈtrædʒik flɔ:
tragical => 'trædʒikәl
tragically => 'trædʒɪklɪ
tragicomedy => .trædʒi'kɒmәdi
tragicomic => ,trædʒi'kɔmik
tragopan => 'trægәpæn
tragus => 'trei^әs
trail => treil
trailblazer => 'treil.bleizә
trailblazing => 'treil,bleiziŋ
trailed => treild
trailer => 'treilә
trailer park => ˈtreɪlə pɑ:k
trailer trash => ˈtreɪlə træʃ
trailer truck => ˈtreɪlə trʌk
trailerable => 'treilәrәbl
trailhead => 'treilhed
trailing => 'treiliŋ
train => trein
train set => trein set
trainable => t'reɪnəbl
trainband => 'treinbænd
trained => treind
trainee => trei'ni:
trainees => treɪ'ni:z
traineeship => treɪ'ni:ʃɪp
trainer => 'treinә
training => 'treiniŋ
training college => ˈtreiniŋ ˈkɔlidʒ
trainload => 'treinlәud
trainsick => 'treinsik
trainspotter => ˈtreɪnspɒtə(r)
traipse => treips
traipsed => treipst
traipses => treipsiz
traipsing => treipsɪŋ
trait => treit
traitor => 'treitә
traitorous => 'treitәrәs
traitorously => 'treɪtərəslɪ
traitors => ˈtreɪtəz
Trajan => 'treidʒәn
trajectories => trəˈdʒektəri:z
trajectory => trә'dʒektri
Trakehner => trɑ:'keinə
tram => træm
tramcar => 'træmkɑ:
Traminer => 'træminә
tramline => 'træmlain
tramlines => 'træmlainz
trammel => 'træml
trammelled => ˈtræməld
trammelling => ˈtræməlɪŋ
trammels => t'ræməlz
tramontana => ,trɑ:mɔ:n'tɑ:nә
tramontane => trә'mɔntein
tramp => træmp
tramped => træmp
tramping => 'træmpiŋ
trample => 'træmpl
trampled => ˈtræmpld
tramples => ˈtræmplz
trampling => ˈtræmplɪŋ
trampoline => 'træmpә,li:n, -lin; ,træmpә'li:n
trampolines => træmpə'li:nz
trampolinist => 'træmpəlinɪst
tramps => træmps
trams => træmz
tramway => 'træmwei
Tramways => 'træmweɪ
trance => træns
trances => trænsiz
tranche => trɑ:nʃ
trank => træŋk
tranny => 'træni
tranquil => 'træŋkwil
tranquility => .træŋ'kwiliti
tranquilize => 'træŋ.kwilaiz. 'træn-
tranquilized => ˈtræŋkwilaizd
tranquilizer => 'træŋkwilaizә
tranquilizers => 'træŋkwɪlaɪzə
tranquilizes => ˈtræŋkwilaiziz
tranquilizing => 'træŋkwɪlaɪzɪŋ
tranquillity => træŋ'kwɪlətɪ
tranquillizers => ˈtræŋkwɪˌlaɪzə(r)
tranquillizing => 'træŋkwɪlaɪzɪŋ
tranquilly => 'træŋkwɪlɪ
trans- => træns-, trɑ:ns-, trænz-, trɑ:nz-
transact => træn'sækt
transacted => trænˈsæktid
transacting => trænˈsæktɪŋ
transaction => træn'sækʃәn
transactor => træn'sæktә
transacts => trænˈsækts
transalpine => .trænz'ælpain
transaminase => træn'sæmineis, -'zæmineiz
transaminate => træns'æmineit,trænz-,trɑ:n-
transamination => træn,sæmi'neiʃәn, -'zæmi-
transatlantic => .trænsәt'læntik
transaxle => træns'æksl,trænz-,trɑ:n-
transborder => trænz'bɔ:də
transboundary => træns'baʊndərɪ
Transcaucasia => ,trænsәkɔ:'keiziә
Transcaucasian => ,trænskɔ:'keiʒən
transceiver => træns'si:vә
transcend => træn'send
transcended => trænˈsendid
transcendence => træn'sendәns
transcendent => træn'sendәnt
transcendental => .trænsen'dentl
transcendentalist => ,trænsen'dentəlist
transcending => trænˈsendɪŋ
transcends => trænˈsendz
transcode => træns'kәud
transconductance => ,trænskәn'dʌktәns
transconjugant => ,træns'kɔndʒj^әnt,,trænz-,,trɑ:n-
transcontinental => 'trænzkɔnti'nentәl
transcortical => træns'kɔ:tikәl
transcribe => træn'skraib
transcribed => trænˈskraɪbd
transcriber => træns'kraibә
transcribes => trænˈskraɪbz
transcribing => trænˈskraɪbɪŋ
transcript => 'trænskript
transcriptase => træns'kripteis
transcription => træn'skripʃәn
transcriptionist => træn'skripʃәnist,trænz'k-,trɑ:n-
transcriptions => trænsk'rɪpʃnz
transcriptive => træns'kriptiv
transcriptome => trænsk'rɪptɒm
transcripts => 'træn,skrɪpt
transcultural => træns'kʌltʃәrәl,trænz-,trɑ:n-
transcutaneous => ,trænskju(:)'teinjәs
transdermal => t'rænzdɜ:məl
transdisciplinary => træns'disiplinәn,trænz-,trɑ:n-
transduce => trænz'dju:s
transduced => trænzˈdju:st
transducer => trænz'dju:zә
transducers => trænz'du:tʃeɪəz
transduces => trænzˈdju:siz
transducing => trænzˈdju:sɪŋ
transduction => træns'dʌkʃәn
transect => træn'sekt
transected => trænˈsektid
transecting => trænˈsektɪŋ
transection => træn'sekʃәn,-'zek-,trɑ:n-
transects => trænˈsekts
transept => 'trænsept
transepts => ˈtrænsepts
transexual => træn'seksjuәl. -ʃuәl. trɑ:n-
transfect => træns'fekt,trænz-,trɑ:n-
transfectant => træns'fektənt
transfection => træns'fekʃәn,trænz-,trɑ:n-
transfemoral => t'rænsfemərəl
transfer => træns'fә:
transferability => .trænsfәrә'biliti
transferable => træns'fә:rәbl
transferase => 'trænsfә,reis, -,reiz
transferee => .trænsfә'ri:
transference => træns'fә:rәns
transferor => træns'fә:rә
transferrer => træns'fә:rә
transferrin => træns'ferin
transferring => træns'fә:riŋ
transfiguration => ,trænsfi^ju'reiʃәn
transfigure => træns'figә
transfigured => trænsˈfɪgjəd
transfigures => trænsˈfɪgjəz
transfiguring => trænsˈfɪgjərɪŋ
transfinite => ,træns'fainait
transfix => træns'fiks
transfixed => trænsˈfikst
transfixes => trænsˈfiksiz
transfixing => trænsˈfiksɪŋ
transfixion => træns'fikʃәn
transform => træns'fɒ:m
transform fault => trænsˈfɔ:m fɔ:lt
transformable => træns'fɒ:mәbl
transformation => .trænsfә'meiʃәn
transformational => ,trænsfә'meiʃәnәl,,trænz-,,trɑ:n-
transformationally => ,trænsfә'meiʃәnәli,,trænz-,,trɑ:n-
transformative => træns'fɔ:mәtiv
transformed => trænsˈfɔ:md
transformer => træns'fɒ:mә
transforming => trænsˈfɔ:mɪŋ
transforms => trænsˈfɔ:mz
transfrontier => træns'frʌntjә
transfuse => træns'fju:z
transfused => trænsˈfju:zd
transfuses => trænsˈfju:ziz
transfusing => trænsˈfju:zɪŋ
transfusion => træns'fju:ʃәn
transfusions => trænsf'ju:ʒnz
transgender => trænzˈdʒendə(r)
transgendered => trænsˈdʒendəd
transgene => trænz'dʒi:n
transgenic => ˌtrænzˈdʒenɪk
transglobal => træns'^lәjbәl,trænz-,trɑ:n-
transgress => træns'gres
transgressed => trænsˈgrest
transgresses => trænsˈgresiz
transgressing => trænsˈgresɪŋ
transgression => træns'greʃәn
transgressions => trænzɡ'reʃnz
transgressor => træns'gresә
tranship => træn'ʃip
transhipment => træn'ʃipmәnt
transhistorical => ,trænshi'stɔrikәl,,trænz-,,trɑ:n-
transhumance => træns'hju:mәns
transience => 'trænziәns
transient => 'trænziәnt
transients => t'rænzɪənts
transilluminate => ,trænsi'lu:mineit, ,trænz-
transillumination => 'trænsi,lju:mi'neiʃәn
transire => træn'zaiәri
transistor => træn'zistә
transistorize => træn'zistәraiz
transit => 'trænsit
transit camp => ˈtrænsit kæmp
transition => træn'ziʃәn
transition metal => trænˈziʃən ˈmetl
transitional => træn'siʒәnl
transitionally => træn'sɪʃənəlɪ
transitionary => træn'sɪʃənərɪ
transitions => træn'zɪʃnz
transitive => 'trænzitiv
transitiveness => ,trænsi'tivəti; -zi-; 'trɑ:n-
transitivity => ,trænsi'tiviti
transitorily => 'trænsitәrili
transitoriness => 'trænsitәrinis
transitory => 'trænsitәri
Transjordan => træns'dʒɔ:dәn,trænz-,trɑ:n-
Transjordanian => ,trænsdʒɔ:'deiniən; ,trænz-; ,trɑ:n-
Transkei => træns'kei,-'kai
transketolase => træns'ki:tәjleis,trænz-,trɑ:n-
translatability => træns,leitә'bilәti,trænz-,trɑ:n-
translatable => træns'leitәbl
translate => træns'leit
translates => trænsˈleits
translation => træns'leiʃәn
translator => træn'leitә
translators => trænz'leɪtəz
transliterate => træns'litәreit
transliterated => trænzˈlitəreitid
transliterates => trænzˈlitəreits
transliterating => trænzˈlitəreitɪŋ
transliteration => .trænslitә'reiʃәn
transliterator => trænz'litәreitә(r),træns-,trɑ:n-
translocate => trænslәu'keit
translocated => trænsləuˈkeitid
translocates => trænsləuˈkeits
translocating => trænsləuˈkeitɪŋ
translocation => ,trænslәu'keiʃәn
translucence => træns'lu:sns
translucency => trænz'lju:sәns,træns-,trɑ:n-
translucent => træns'lu:snt
transmarine => ,trænzmә'ri:n
transmembrane => ,træns'membrein,,trænz-,,trɑ:n-
transmigrant => 'trænzmai^rәnt
transmigrate => 'trænzmaigreit
transmigrated => ˈtrænzmaiɡreitid
transmigrates => ˈtrænzmaiɡreits
transmigrating => ˈtrænzmaiɡreitɪŋ
transmigration => .trænzmaig'reiʃәn
transmigrator => ,trænzmai'^reitә(r),,træns-,,trɑ:n-,-'mai-,'trænz,m-
transmigratory => trænz'maiɡrətəri; træns-; trɑ:n-
transmissibility => .trænsmisә'biliti
transmissible => træns'misәbl
transmission => træns'miʃәn
transmissions => trænzˈmiʃənz
transmissive => træns'misiv
transmissivity => trænzmi'siviti
transmit => træns'mit
transmits => trænzˈmits
transmittal => trænz'mitәl
transmitter => træns'mitә
transmitters => trænz'mɪtəz
transmogrification => ,træzmɔ^rifi'keiʃәn
transmogrified => trænsˈmɔgrəˌfaɪd
transmogrifies => trænsˈmɔgrəˌfaɪz
transmogrify => træns'mɒgrifai
transmogrifying => trænsˈmɔgrəˌfaɪŋ
transmontane => trænz'mɔntein. træns-. trɑ:n-
transmural => træns'mju:rәl
transmutability => trænz,mju:tә'biliti
transmutable => træns'mju:tәbl
transmutation => .trænsmju:'teiʃәn
transmutationist => ,trænzmju:'teiʃәnist,,træns-,,trɑ:n-
transmutative => træns'mju:tәtiv
transmute => træns'mju:t
transmuted => trænsˈmju:tid
transmutes => trænsˈmju:ts
transmuting => trænsˈmju:tɪŋ
transnational => træns'næʃәnl
transoceanic => 'træns.әuʃi'ænik
transom => 'trænsәm
transom window => ˈtrænsəm ˈwindəu
transome => t'rænsəm
transomed => 'trænsәmd
transonic => træn'sɒnik
transparence => træns'pærәns
transparencies => trænsˈpeərənsi:z
transparency => træns'pærәnsi
transparent => træns'pærәnt
transpersonal => træns'pә:sәnl
transpicuous => træns'pikjuәs
transpierce => træns'piәs
transpiration => ,trænspi'reiʃәn
transpire => træn'spaiә
transpired => trænˈspaɪəd
transpires => trænˈspaɪəz
transpiring => trænˈspaɪərɪŋ
transplant => træns'plɑ:nt
transplantable => t'rænsplɑ:ntəbl
transplantation => trænsplɑ:n'teiʃәn
transplanter => træns'plɑ:ntә(r),trænz-,trɑ:n-;-'plæn-
transplants => 'træns,plænt
transpolar => træns'pәulә
transponder => træn'spɒndә
transponders => træn'spɒndə; trɑːn-
transpontine => træns'pɒntain
transport => træns'pɒ:t
transport cafe => trænsˈpɔ:t ˈkæfei
transportable => træns'pɒ:tәbl
transportation => .trænspә'teiʃәn
transported => trænsˈpɔ:tid
transporter => træns'pɒ:tә
transporters => træns'pɔ:təz
transposable => træns'pәuzәbl
transposal => træs'pәuzәl
transpose => træns'pәuz
transposer => træns'pәusә
transposes => trænsˈpəʊziz
transposing => træns'pәusiŋ
transposition => trænspә'ziʃәn
transpositional => trænspə'zɪʃənəl
transposon => træns'pәusɔn
transracial => træns'reiʃәl
transsexual => træn'sekjuәl
transubstantiate => ,træn,sәb'stænʃi,eit
transubstantiation => trænsәbstænʃi'eiʃ(ә)n, trɑ:-
transudate => 'trænsju,deit
transudation => ,trænsju'deiʃәn
transude => træn'sju:d
transuranic => .trænsju'rænik
transurethral => ,trænzjuә'ri:θrәl
Transvaal => 'trænzvɑ:l
transvaluation => 'træns,væljj'eiʃәn,'trænz-,'trɑ:n-
transvalue => trænz'vælju:
transversal => træns'vә:sl
transversality => ,trænzvә'sæliti
transverse => træns'vә:s
transverse colon => trænsˈvɜ:s ˈkəulən
transversed => trænz'vɜːs; trɑːnz-; -ns-
transversely => træns'vә:sli
transvestism => trænz'vestiz(ә)m, trɑ:-
transvestist => træns'vestist
transvestite => træns'vestait
transvestites => trænsˈvestaits
transworld => 'trænsw\\\\:ld,'trænz-,'trɑ:n-
transylvania => ,trænsil'veiniә,- njә
tranter => 'træntә
trap => træp
trapball => 'træpbɒ:l
trapdoor => 'træpdɒ:
trapes => treips
trapeze => trә'pi:z
trapezes => træˈpi:ziz
trapezium => trә'pi:ziәm
trapezius => trә'pi:ziәs,træ-
trapezohedron => ,træpizәu'hi:drәn
trapezoid => 'træpәzɒid
trapezoidal => ,træpi'zɔidәl
trapline => t'ræplaɪn
trapped => 'træpid
trapper => 'træpә
trappers => t'ræpəz
trapping => 'træpiŋ
trappings => 'træpiŋz
Trappist => 'træpist
traprock => 'træp,rɔk
trapshooting => 'træpʃu:tiŋ
trash => træʃ
trash talk => træʃ tɔ:k
trashcan => 'træʃkæn
trashcans => 'træʃkæn
trashes => træʃiz
trashier => ˈtræʃi:ə
trashiness => 'træʃinis
trashy => 'træʃi
trass => træs
trattoria => ,trɑ:tә'ri:ɑ:
trauma => 'trɒ:mә
traumatic => trɒ:'mætik
traumatically => trɔ:'mætik; trau-
traumatise => 'trɒmeˌtaɪz
traumatism => 'trɔ:mә,tizәm
traumatize => 'trɒ:mәtaiz
traumatized => 'traʊməˌtaɪzd
traumatizes => ˈtrɔ:mətaiziz
traumatizing => ˈtrɔ:mətaizɪŋ
travail => 'træveil
travailed => 'træveɪl
travailing => 'træveɪl
travails => trəˈveɪlz
travel => 'trævl
travel light => ˈtrævəl lait
traveled => 'træv(ә)ld
traveler => 'trævlә
traveling => 'trævliŋ
traveller => 'trævlә
travellers => ˈtrævələz
travelling => 'trævliŋ
travelogue => 'trævәlɒ:g
travelogues => ˈtrævəˌlɔ:gz
traversable => 'trævәsәbl
traversal => træ'vә:sl
traverse => 'trævә:s
traversed => ˈtrævəst
traverser => 'trævә:sә
traverses => ˈtrævəsiz
travertine => 'trævәtin
travestied => 'trævɪstɪ
travesties => ˈtrævɪsti:z
travesty => 'trævisti
travis => 'trævis
travois => trә'vɔiz
trawl => trɒ:l
trawl line => trɔ:l lain
trawled => trɔ:ld
trawler => 'trɒ:lә
trawlerman => 'trɔ:lәmæn,-mәn
trawlers => ˈtrɔ:ləz
trawling => trɔ:lɪŋ
trawls => trɔ:lz
tray => trei
trayful => 'treiful
trayfuls => 'treɪfʊl
trays => t'reɪz
treacheries => ˈtretʃəriz
treacherous => 'tretʃәrәs
treacherously => 'tretʃərəslɪ
treachery => 'tretʃәri
treacle => 'tri:kl
treacly => 'tri:kli
tread => tred
tread on => tred ɔn
treader => t'redə
treading => tredɪŋ
treadle => 'tredl
treadles => ˈtredlz
treadmill => 'tredmil
treadmills => ˈtredˌmɪlz
treads => tredz
treadwheel => 'tredhwi:l
treason => 'tri:zn
treasonable => 'tri:znәbl
treasure => 'treʒә
treasure hunt => ˈtreʒə hʌnt
treasured => ˈtreʒəd
treasurer => 'treʒәrә
treasurers => ˈtreʒəəz
treasures => ˈtreʒəz
treasuries => t'reʒərɪz
treasuring => ˈtreʒərɪŋ
treasury => 'treʒәri
treat => tri:t
treated => 'tri:tid
treater => 'tri:tә
treating => 'tri:tiŋ
treatise => 'tri:tis
treatises => 'tri:tɪzɪz
treatment => 'tri:tmәnt
treatments => 'tri:tmənts
treats => tri:ts
treaty => 'tri:ti
Trebizond => 'trebə,zɔnd
treble => 'trebl
treble clef => ˈtrebəl klef
trebled => ˈtrebəld
trebles => ˈtrebəlz
trebling => t'reblɪŋ
trebly => 'trebli
trebuchet => 'trebjuʃet
trecento => trei'tʃentәu
tree => tri:
tree fern => tri: fɜ:n
tree frog => tri: frɔɡ
tree heath => tri: hi:θ
tree house => tri: haus
tree kangaroo => tri: ˌkæŋgəˈru:
tree line => tri: lain
tree mallow => tri: ˈmæləu
tree of heaven => tri: ɔv ˈhevn
tree of knowledge => tri: ɔv ˈnɔlidʒ
tree shrew => tri: ʃru:
tree sparrow => tri: ˈspærəʊ
tree squirrel => tri: ˈskwirəl
tree surgeon => tri: ˈsə:dʒən
tree surgery => tri: ˈsə:dʒəri
tree toad => tri: təud
tree trunk => tri: trʌŋk
tree-like => t'ri:l'aɪk
tree-lined => 'tri:laɪnd
treecreeper => 'triːkriːpə
treed => tri:d
treehopper => 'tri:,hɔpә(r)
treehouse => tri:'haʊs
treeing => tri:ɪŋ
treeless => 'tri:lis
treeline => ˈtri:laɪn
treen => 'tri:n
treenail => 'tri:neil
treetop => 'tri:tɒp
treetops => ˈtri:ˌtɔps
trefa => 'treifә
trefoil => 'tri:fɒil
trefoiled => 'trefɔild
trehalose => 'tri:hә,lәus
trek => trek
trekked => trekt
trekker => 'trekə
trekking => trekɪŋ
treks => treks
Trelawney => tri'lɔ:ni
trellis => 'trelis
trellised => 'trelist
trellises => ˈtrelisiz
trem => trem
trematode => 'tremәtәud
tremble => 'trembl
trembled => ˈtrembld
trembler => 'tremblә
trembles => ˈtremblz
trembling => 'trembliŋ
tremblingly => ˊtrebliŋli
trembly => 'trembli
tremendous => tri'mendәs
tremendously => trə'mendəslɪ
tremendousness => triˊmendәsnis
tremolando => tremә'lændәu, treimәu'lɑ:ndәu
tremolite => 'tremәlait
tremolo => 'tremәlәu
tremolos => ˈtremələuz
tremor => 'tremә
tremors => 'treməz
tremulous => 'tremjulәs
tremulously => 'tremjələslɪ
tremulousness => ˊtremjulәsnis
trenail => 'tri:neil
trench => trentʃ
trench coat => trentʃ kəut
trenchancy => 'trentʃәnsi
trenchant => 'trentʃәnt
trenchantly => 'trentʃəntli
trenched => t'rentʃt
trencher => 'trentʃә
trenches => trentʃiz
trenching => 'trentʃiŋ
trend => trend
trended => trendid
trendier => ˈtrendi:ə
trendies => ˈtrendi:z
trendily => 'trendili
trendiness => 'trendinis
trending => trendɪŋ
trendoid => tren'dɔɪd
trendsetting => 'trend,setiŋ
trendy => 'trendi
Trengganu => treŋ'^ɑ:nu:
trent => trent
trente et quarante => ,trɔŋteikɑ:'rɔŋt
Trento => 'trentɔ:
trepan => tri'pæn
trepanation => ,trepә'neiʃәn
trepang => tri'pæŋ
trepanned => triˈpænd
trepanning => tri'pæniŋ
trepans => triˈpænz
trephination => ,trefi'neiʃәn
trephine => tri'fain
trephined => triˈfi:nd
trephines => triˈfi:nz
trepidation => .trepi'deiʃәn
treponemal => ,trɛpə'nɛmətəs
treponeme => 'trepәni:m
tres => tres
trespass => 'trespәs
trespasser => 'trespәsә
trespassers => 'trespəsəz
trespasses => ˈtrespəsiz
trespassing => ˈtrespəsɪŋ
tress => tres
tressed => trest
tressure => 'treʃә
tressy => 'tresi
trestle => 'tresl
trestle table => ˈtresl ˈteibl
trestles => ˈtreslz
tret => tret
trevally => tri'væli
Trevelyan => tri'viljәn, tri'veljәn
Trevira => tre'virә
Trevor => 'trevə
trews => tru:z
trey => trei
tri => trai
triable => 'traiәbl
triac => 'traiæk
triacetate => trai'æsi,teit
triad => 'traiәd
triads => ˈtraiədz
triage => tri'ɑ:ʒ
trial => 'traiәl
trial balloon => ˈtraiəl bəˈlu:n
trialist => 'traɪəlɪst
trialogue => 'traiәlɔ^; -lɔ:^
triangle => 'traiæŋgl
triangles => t'raɪæŋɡlz
triangular => trai'æŋgjulә
triangular number => traɪˈæŋgjələ ˈnʌmbə
triangularity => trai.æŋgju'læriti
triangularly => trai'æŋgjulәli
triangulate => trai'æŋgjuleit
triangulated => traɪ'æŋgjʊleɪt
triangulating => traɪ'æŋgjʊleɪt
triangulation => trai.æŋgju'leiʃәn
triangulation point => traiˌæŋɡjuˈleiʃən pɔint
Triangulum => trai'æŋ^julәm
Triassic => trai'æsik
triathlete => trai'æθli:t
triathlon => trai'æθlɔn
triatomic => traiә'tɔmik
triaxial => trai'æksiәl
triazine => 'traiә,zi:n, -zin; trai'æzi:n, -in
triazole => 'traiә,zәul
tribade => 'tribәd
tribadism => 'tribәdizəm
tribal => traibl
tribalism => 'traiblizm
tribasic => trai'beisik
tribe => traib
tribes => traibz
tribesman => 'traibzmәn
tribesmen => 'traɪbzmən
tribespeople => 'traibz,pi:pl
tribeswoman => 'traibz,wjmәn
triblet => 'triblit
tribo- => 'traibәj,'tri-
triboelectricity => ,traibәui,lek'trisiti
tribological => ,traibәj'lɔdʒikəl, ,tri-
tribology => trai'bɒlәdʒi
triboluminescence => ,traibәu,lumi'nesns
tribometer => trai'bɒmitә
tribrach => 'traibræk
tribrachic => trai'brækik; tri-
tribulation => .tribju'leiʃәn
tribulations => ˌtrɪbjəˈleɪʃənz
tribunal => trai'bju:nl
tribunals => traɪˈbju:nəlz
tribune => 'tribju:n
tribuneship => 'tribju:nʃip, tri'b-
tributaries => ˈtrɪbjəˌteri:z
tributary => 'tribjutәri
tribute => 'tribju:t
tributes => t'rɪbju:ts
tricar => 'traikɑ:
trice => trais
triced => traɪs
Tricel => 'traisel
tricentenary => ,traisen'tinәri
tricentennial => ,traisen'teniәl
triceps => 'traiseps
triceratops => trai'serәtɔps
trichiasis => tri'kaiәsis
trichina => tri'kainә
trichinosis => .triki'nәusis
trichloroethylene => trai,klɔ:rәu'eθi,li:n
trichlorophenol => traiklɔrә'fi:nɔ:l
trichocyst => 'trikәsist
trichologist => tri'kɒlәdʒist
trichology => tri'kɒlәdʒi
trichome => 'trikәum
trichomes => 'traikәumz
trichomonad => ,trikә'mɔnæd, -'mәunæd
trichomonal => ,trikәj'mɔnәl, -'mәj-,tri'kɔmәnәl
trichomoniasis => .trikәumә'naiәsis
trichopteran => tri'kɔptәrәn
trichotillomania => tri,kәtilә'meiniә
trichotomy => trai'kɒtәmi
trichroic => trai'krәjik
trichroism => 'traikrәuizm
trichromatic => .traikrәu'mætik
trichromatism => trai'krәumәtizm
trichrome => t'rɪkrəʊm
tricing => traɪs
trick => trik
trick or treat => trik ɔ: tri:t
trick-or-treater => t'rɪkɔ:rtr'i:tər
tricked => trikt
tricker => 'trikә(r)
trickery => 'trikәri
trickily => 'trikili
trickiness => 'trikinis
tricking => trikɪŋ
trickish => 'trikiʃ
trickle => 'trikl
trickle-down => ˈtrikl daun
trickled => ˈtrikld
trickles => ˈtriklz
trickling => 'trikliŋ
trickster => 'trikstә
tricksters => ˈtrikstəz
tricksy => 'triksi
tricky => 'triki
triclad => 'traiklæd
triclinic => trai'klinik
triclinium => trai'kliniәm
tricolor => 'trikәlә(r)
tricolour => 'traikәlә
tricolours => ˈtraikələz
tricorne => 'traikɔ:n
tricot => 'trikәu
tricuspid => trai'kʌspid
tricycle => 'traisikl
tricycles => t'raɪsɪklz
tricyclic => trai'saiklik, -'siklik
tridactyl => trai'dæktil
Trident => 'traidnt
Tridentine => trai'dentain
triduum => trɪd'jʊəm
tridymite => 'traidә,mait
tried => traid
triene => 'traii:n
triennial => trai'eniәl
triennially => tra'ɪenɪəlɪ
triennium => trai'eniәm
trier => 'traiә
triers => ˈtraiəz
Trieste => tri:'est,-'este
trifecta => trai'fektә
triffid => 'trifid
trifid => 'traifid
trifle => 'traifl
trifled => ˈtraifld
trifling => 'traifliŋ
trifluoperazine => 'trai,flu:әj'perәzi:n, -zin
trifocal => trai'fәukl
trifold => 'traifәjld
trifoliate => trai'fәuliәt
triforium => trai'fɔ:riәm
triform => 'traifɒ:m
trifurcate => trai'fә:kit
trifurcation => traɪfɜ:'keɪʃən
trig => trig
trig point => ˈtrɪg pɔɪnt
trigamist => 'trigәmist
trigamous => 'tri^әmәs
trigamy => 'trigәmi
trigeminal => trai'dʒeminl
trigeminal nerve => traiˈdʒeminl nə:v
trigeminal neuralgia => traiˈdʒeminl njuəˈrældʒə
trigeminus => trai'dʒeminәs
trigger => 'trigә
triggered => 'triɡәd
triggerfish => 'tri^әfiʃ
triggering => 'tri^әriŋ
triggerman => 'tri^әmæn, mәn
triglyceride => trai'^lisә,raid
triglycerides => trɪɡ'lɪsəraɪdz
triglyph => 'traiglif
triglyphic => trai'ɡlifikəl
trigon => 'traigɒn
trigonal => 'traigәnәl
trigone => 'trai^әun
trigonometric => .trigәnә'metrik
trigonometry => .trigә'nɒmitri
trigram => 'traigræm
trigraph => 'traigrɑ:f
trihedral => trai'hi:drәl
trihedron => trai'hi:drәn
trihydric => ,trai'haidrik
triiodomethane => traiaiәdәu'meθein
triiodothyronine => trai,aiәdәu'θairә,nin
trike => traik
trikes => traiks
trilateral => trai'lætәrәl
trilbies => ˈtrilbiz
trilby => 'trilbi
trilinear => trai'liniә
trilingual => .trai'liŋgwәl
trilithon => trai'liθɔn, 'trail-
trill => tril
triller => t'rɪlər
trilling => 'triliŋ
trillion => 'triljәn
trillions => ˈtrɪljənz
trillionth => 'triljәnθ
trillium => 'triliәm
trills => trilz
trilobite => 'trailәubait
trilogies => ˈtrɪlədʒi:z
trilogy => 'trilәdʒi
trim => trim
trim down => trim daun
trimaran => 'traimәræn
trimer => 'traimә
trimerous => 'trimәrәs
trimester => trai'mestә
trimestral => trai'mestrәl
trimestrial => trɪ'mestrɪəl
trimeter => 'trimitә
trimethoprim => ,trai'meθәprim
trimetric => tri'metrik
trimetrical => trɪ'metrɪkl
trimly => 'trimli
trimmed => trimd
trimmer => 'trimә
trimming => 'trimiŋ
trimness => 'trimnis
trims => trimz
Trimurti => tri'muәti
Trincomalee => ,triŋkәjmә'li:
trinidad => 'trinidæd, ,tri:ni:'ðɑ:ð
Trinidad and Tobago => 'trinidæd әnd tә'bei^әj
Trinidadian => ,trini'dædiən; -'dei-
Trinitarian => .trini'tєәriәn
Trinitarianism => ,trini'teәriәnizәm
trinitrotoluene => trainaitrә'tɔljji:n
trinity => 'triniti
trinket => 'triŋkit
trinketry => 'triŋkitri
trinkets => ˈtrɪŋkɪts
trinomial => trai'nәumjәl, -miәl
trio => 'tri:әu
triode => 'traiәud
triolet => 'traiәlit
trios => ˈtri:əʊz
triose => 'traiәus
trioxide => trai'ɒksaid
trip => trip
tripartite => .trai'pɑ:tait
tripartition => ,traipɑ:'tiʃәn
tripe => traip
triphosphate => trai'fɔsfeit
triphthong => 'trifθɒŋ
triphthongal => trif'θɔŋɡəl; trip-
triplane => 'traiplein
triple => 'tripl
triple jumper => ˈtripl ˈdʒʌmpə
triple play => ˈtripl plei
triple time => ˈtripl taim
tripled => ˈtripld
triples => ˈtriplz
triplet => 'triplit
triplet code => ˈtrɪplɪt kəud
triplex => 'tripleks
triplicate => 'triplikit
triplicated => ˈtrɪplɪkɪtid
triplicates => ˈtrɪplɪkɪts
triplicating => ˈtrɪplɪkɪtɪŋ
triplication => .tripli'keiʃәn
triplicity => tri'plisiti
tripling => 'tripliŋ
triploblastic => ,triplәu'blæstik
triploid => 'triplɒid
triply => 'tripli
tripmeter => 'trip,mi:tә(r)
tripod => 'traipɒd
tripodal => 'traipәdәl
tripods => t'raɪpɒdz
tripoli => 'tripәli
Tripolitania => ,tripәli'teiniә, ,tri:pɔ:li:'tɑ:njɑ:
Tripolitanian => tri,pɔli'teiniən; ,tripəli-
tripos => 'traipɒs
trippant => 'tripәnt
tripper => 'tripә
trippers => ˈtrɪpəz
Trippier => 'tripi
tripping => 'tripiŋ
trippy => 'tripi
triptych => 'triptik
triptychs => ˈtriptiks
triptyque => trip'ti:k
Tripura => 'tripjrә, -pә-
tripwire => 'trip,waiә
tripwires => ˈtripˌwaiəz
triquetra => trai'kwi:trә
triquetral => trai'kwetrәl,-'kwi:-
trireme => 'trairi:m
tris => tris
trisaccharide => trai'sækә,raid
Trisagion => tri'sæ^iɔn
trisect => trai'sekt
trisected => traɪ'sektɪd
trisection => trai'sekʃәn
trisector => trai'sektә
trishaw => 'traiʃɔ:
triskaidekaphobia => ,triskai,dekә'fәubiә
triskelion => tris'keliɔn
trismus => 'trizmәs
trisomy => 'traisәjmi
tristesse => tri:s'tes
trisyllabic => .traisi'læbik
trisyllable => trai'silәbl
tritagonist => trai'tæ^әunist
tritanope => 'traitә'nәup
tritanopia => ,traitә'nәjpiә, ,trit-
trite => trait
tritely => 'traitli
triteness => 'traitnis
triterpene => ,trai'tә:pi:n
triterpenoid => trai't\\\\:pinɔid
tritheism => 'traiθi:izm
tritheist => 'traiθi:ist
tritiated => 'triti,eitid
tritiation => triti'eiʃәn
triticale => 'traitikәl
tritium => 'tritiәm
tritocerebrum => ,traitәu'serәbrәm
Triton => 'traitn
tritone => 'trai,tәun
triturate => 'tritjureit
trituration => tritju'reiʃәn
triturator => 'tritjureitә
triumph => 'traiәmf
triumphal => trai'ʌmfәl
triumphalism => traɪˈʌmfəlɪzəm
triumphalist => trai'ʌmfәlist
triumphant => trai'ʌmfәnt
triumphantly => traɪ'ʌmfəntlɪ
triumphed => ˈtraiəmft
triumphing => ˈtraiəmfɪŋ
triumphs => ˈtraiəmfs
triumvir => trai'ʌmvә
triumviral => trai'ʌmvәrәl
triumvirate => trai'ʌmvireit
triune => 'traiju:n
triunity => trai'ju:nәti
trivalent => trai'veilәnt
Trivandrum => tri'vændrәm
trivet => 'trivit
trivia => 'triviә
trivial => 'tiviәl
trivialise => 'trɪvəlaɪz
trivialities => ˌtrɪvi:ˈælɪti:z
triviality => .trivi'æliti
trivialization => ˌtrɪvɪəlaɪ'zeɪʃn
trivialize => 'triviәlaiz
trivialized => ˈtrɪvɪəlaɪz,ˈtrɪvɪəˌlaɪzd
trivializes => ˈtrɪvɪəlaɪz,ˈtrɪvɪəˌlaɪziz
trivializing => ˈtrɪvɪəlaɪz,ˈtrɪvɪəˌlaɪzɪŋ
trivially => 'trɪvɪəlɪ
trivium => 'triviәm
trocar => 'trәukɑ:
trochaic => trәu'keiik
trochanter => trәu'kæntә
trochee => 'trәuki:
trochlea => 'trɒkliә
trochlear => 'trɒkliә
trochlear nerve => ˈtrɔkliə nə:v
trochoid => 'trәukɒid
trochoidal => t'rəʊkɔɪdl
trochophore => 'trɔkә,fɔ:
troctolite => 'trɔktә,lait
trod => trɔd
trodden => 'trɔdn
trog => trɔɡ
troglodyte => 'trɔ^lәdait
troglodytes => ˈtrɔgləˌdaɪts
troglodytic => ,trɒɡlə'dɪtɪk
trogon => 'trәu^ɔn
troika => 'trɒikә
troilism => 'trɔilizәm
Troilus => 'trɒilәs
Trojan => 'trәudʒәn
troll => trɒl
trolled => trəʊl; trɒl
troller => 'trəʊlə
trolley => 'trɒli
trolleys => ˈtrɔliz
trolling => 'trәuliŋ
trollop => 'trɒlәp
Trollope => 'trɔlәp
trollops => 'trɒləp
trolls => trəulz
trombone => 'trɒmbәun
trombones => trɔmˈbəʊnz
trombonist => 'trɒmbәunist
trommel => 'trɒml
tromp => trɔmp
trompe => 'trɒmp
trona => 'trәunә
Trondheim => 'trɔnheim
troop => tru:p
troop carrier => tru:p ˈkæriə
trooper => 'tru:pә
troopers => ˈtru:pəz
troopie => 'tru:pi
tropaeolum => trәu'pi:әlәm
trope => trәup
trophallaxis => ,trɔfә'læksis
trophectoderm => trɔ'fektәudә:m
trophic => 'trɒfik
trophies => ˈtrəufiz
trophoblast => 'trɔfә,blæst
trophozoite => trɔfә'zәuit
trophy => 'trәufi
trophy wife => ˈtrəufi waif
tropic => 'trɒpik
tropical => 'trɒpikl
tropical sprue => ˈtrɔpikəl spru:
tropical storm => ˈtrɔpikəl stɔ:m
tropically => 'trɔpikli
tropism => 'trәupizm
tropological => trɔpә'lɔdʒikl
tropology => trәu'pɒlәdʒi
tropolone => 'trәupәlәun
tropomyosin => ,trɔpәu'maiәsin
troponin => 'trɔpәnin
tropopause => 'trɒpәpɒ:z
troposphere => 'trɒpәsfiә
tropospheric => trɔpәu'sferik, -'sfiәr-
troppo => 'trɔpәu
trot => trɒt
troth => trәuθ
trotline => 'trɒtlain
trots => trɔts
trotsky => 'trɔtski
Trotskyism => 'trɔtskiizəm
Trotskyist => 'trɔtskiist
trotskyite => 'trɒtskɪaɪt
trotted => trɔtid
trotter => 'trɔtә
trotters => ˈtrɔtəz
trotting => trɔtɪŋ
troubadour => 'tru:bә.duә
troubadours => ˈtru:bəduəz
trouble => 'trʌbl
troubled => 'trʌbld
troublemaker => 'trʌbl.meikә
troublemakers => ˈtrʌbəlˌmeɪkəz
troublemaking => t'rʌblmeɪkɪŋ
troubles => ˈtrʌblz
troubleshooter => 'trʌb(ә)lʃu:tә(r)
troubleshooters => ˈtrʌb(ə)lʃu:təz
troubleshooting => 'trʌbl.ʃu:tiŋ
troublesome => 'trʌblsәm
troublesomely => ˊtrәblsәmli
troublesomeness => 'trʌbəlsəm,nis
troublous => 'trʌblәs
trough => trɒ:f
troughs => trɔ:fs
trounce => trauns
trounced => traʊnst
trounces => traʊnsiz
trouncing => traʊnsɪŋ
troupe => tru:p
trouper => 'tru:pә
troupers => ˈtru:pəz
troupes => tru:ps
troupial => 'tru:piәl
trouser => 'trauzә
trouser suit => ˈtrauzə sju:t
trousered => 'trauzәd
trousering => 'trauzәriŋ
trousers => 'trauzәz
trousseau => 'tru:sәu
trousseaus => 'truːsəʊ
trout => traut
trouts => traʊts
trouvaille => 'tru:vail
trove => trәuv
trover => 'trәuvә
trow => trәu
Trowbridge => 'trәjbridʒ
trowel => 'trauәl
trowelling => tra'ʊəllɪŋ
trowels => ˈtraʊəlz
troy => trɔi
troy weight => 'trɔi weit
Troyes => trwɑ:
truancy => 'tru:әnsi
truant => 'tru:әnt
truants => ˈtru:ənts
truce => tru:s
truces => tru:siz
truck => trʌk
truck stop => trʌk stɔp
truckage => 'trʌkidʒ
trucker => 'trʌkә(r)
truckers => ˈtrʌkəz
truckie => 'trʌki
trucking => 'trʌkiŋ
truckle => 'trʌkl
truckle bed => ˈtrʌkl bed
truckled => ˈtrʌkld
truckles => ˈtrʌklz
truckling => ˈtrʌklɪŋ
truckload => 'trʌklәjd
truckloads => ˈtrʌkləudz
truculence => 'trʌkjulәns
truculent => 'trʌkjulәnt
trudge => trʌdʒ
trudgen => 'trʌdʒәn
trudger => t'rʌdʒər
trudges => trʌdʒz
trudy => 'tru:di
true => tru:
true rib => tru: rib
true to => truː tu:
true-life => 'tru:'laif
trueness => 'tru:nis
truer => 'tru:ә
truffle => 'trʌfl
truffled => 'trʌfld,'tru:-
truffles => t'rʌflz
trug => trʌg
trugs => trʌɡz
truing => 'tru:iŋ
truism => 'tru:izm
truisms => ˈtru:ˌɪzəmz
truistic => 'tru:istik
TRUJILLO => tru:'hi:əu; -'hi:jɔ:
trull => trʌl
truly => 'tru:li
truman => 'tru:mәn
trumeau => trj'mәj, tru:-
trump => trʌmp
trumped => trʌmpt
trumped-up => 'trʌmpt'ʌp
trumpery => 'trʌmpәri
trumpet => 'trʌmpit
trumpet creeper => ˈtrʌmpit ˈkri:pə
trumpet vine => ˈtrʌmpit vaɪn
trumpeter => 'trʌmpitә
trumpeters => ˈtrʌmpitəz
trumpets => ˈtrʌmpits
trumping => trʌmpɪŋ
trumps => trʌmps
truncal => 'trʌŋkl
truncate => 'trʌŋkeit
truncated => 'trʌŋkeitid
truncates => ˈtrʌŋˌkeɪts
truncating => ˈtrʌŋˌkeɪtɪŋ
truncation => trʌŋ'keiʃәn
truncheon => 'trʌntʃәn
truncheons => ˈtrʌntʃənz
trundle => 'trʌndl
trundled => ˈtrʌndld
trundles => ˈtrʌndlz
trundling => ˈtrʌndlɪŋ
trunk => trʌŋk
trunkfish => 'trʌŋkfiʃ
trunkful => 'trʌŋkfjl
trunkfuls => 'trʌŋkfʊl
trunking => 'trʌŋkiŋ
trunkless => 'trʌŋklis
trunnel => 'trʌnl
trunnion => 'trʌnjәn
truss => trʌs
trussed => trʌst
trusses => trʌsiz
trussing => t'rʌsɪŋ
trust => trʌst
trust fund => trʌst fʌnd
trustable => t'rʌsteɪbl
trustbuster => 'trʌstbʌstә
trustee => .trʌs'ti:
trustees => trʌsˈti:z
trusteeship => trʌs'ti:ʃip
truster => 'trʌstə
trustful => 'trʌstful
trustfully => 'trʌstfəlɪ
trustfulness => ˊtrʌstfulnis
trustily => 'trʌstili
trustiness => 'trʌstinis
trusting => 'trʌstiŋ
trustingly => 'trʌstɪŋlɪ
trusts => trʌsts
trustworthily => 'trʌst.wә:ðili
trustworthiness => 'trʌst.wә:ðinis
trustworthy => 'trʌst.wә:ði
trusty => 'trʌsti
truth => tru:θ
truth drug => tru:θ drʌɡ
truthful => 'tru:θful
truthiness => t'rʌθɪnəs
try => trai
try-out => t'raɪ'aʊt
trying => 'traiiŋ
tryout => 'traiaut
tryouts => ˈtraɪˌaʊts
trypanosome => 'tripәnәsәum
trypanosomiasis => ,tripә,nәusәu'maiәsis
trypsin => 'tripsin
trypsinogen => trip'sinәdʒәn
tryptamine => 'triptә,mi:n
tryptic => 'triptik
tryptophan => 'triptәfæn
trysail => 'traiseil
tryst => trist
trysts => trɪsts
tsantsa => 'tsɑ:ntsә
tsar => zɑ:
tsardom => 'zɑːdəm
tsarina => zɑ:'rinә
tsarism => 'zɑ:rizәm, 'tsɑ:-
tsarist => 'zɑ:rist, 'tsɑ:-
Tsaritsyn => tsɑ: 'ritsin
tsars => zɑ:z
tsetse => 'tsetsi
tsimmes => 'tsimәs
Tsinan => 'tsi:'nɑ:n
Tsinghai => 'tʃiŋ'hai
tsotsi => 'tsɔtsi
tsunami => tsu'nɑ:mi
tsuris => 'tsɔ:res, 'tsu;ris
Tsushima => 'tsu:ʃimә, tsu(:)'ʃi:mә
Tswana => 'tswɑ:nә
tu-whit tu-whoo => təˌwɪt təˈwu:
tuan => tu:'ɑ:n,tj-
tuareg => 'twɑ:re^
tuatara => tu:ә'tɑ:rә
tub => tʌb
tub-thumping => 'tʌb,θʌmpiŋ
tuba => 'tju:bә
tubal => 'tju:bl
tubal ligation => ˈtju:bl laiˈɡeiʃən
tubas => ˈtju:bəz
tubbable => 'tʌbәbl
tubbed => tʌb
tubbier => ˈtʌbiə
tubbiness => 'tʌbinis
tubbing => 'tʌbiŋ
tubby => 'tʌbi
tube => tju:b
tube foot => tju:b fut
tube top => tju:b tɔp
tube well => tju:b wel
tubectomy => tju:'bektәmi
tubeless => t'ju:bləs
tuber => 'tju:bә
tubercle => 'tju:bәkl
tubercular => tju:'bә:kjulә
tuberculate => tju:'b\\\\:kjjlit,-leit
tuberculation => tju,bә:kju'leiʃәn
tuberculin => tju:'bә:kjulin
tuberculoid => tju,bә:kju'lɔid
tuberculosis => tju,bә:kju'lәusis
tuberculous => tju:'bә:kjulәs
tuberose => 'tju:bәrәus
tuberosities => ,tjuːbə'rɒsətɪ
tuberosity => .tju:bә'rɒsiti
tuberous => 'tju:bәrәs
tuberous root => ˈtju:bərəs ru:t
tubers => t'ju:bəz
tubful => 'tʌbfjl
tubicolous => tju:'bikәlәs
tubifex => 'tju:bә,feks, 'tu:-
tubing => 'tju:biŋ
tubocurarine => ,tju:bәjkjj'rɑ:ri:n,-rin
tubs => tʌbz
tubular => 'tju:bjulә
tubule => 'tju:bju:l
tubulin => 'tju:bjjlin
TUC => ,ti: ju: 'si:
tuck => tʌk
tuck-in => 'tʌk,in
tuck-point => 'tʌkpɔint
tuckahoe => 'tʌkәhәu
tucked => tʌkt
tucker => 'tʌkә
tuckered => ˈtʌkəd
tuckering => ˈtʌkərɪŋ
tuckers => ˈtʌkəz
tucket => 'tʌkit
tucking => 'tʌkiŋ
tucks => tʌks
tucson => tu:'sɔn
Tudor => 'tju:dә
Tudorbethan => 'tju:dәbәθәn
Tuesday => 'tju:zdi
Tuesdays => 'tju:zdiz, -deiz
tufa => 'tju:fә
tufaceous => tju:'feiʃәs
tuff => tʌf
tuffet => 'tʌfit
tuft => tʌft
tufted => 'tʌftid
tufteds => 'tʌftidz
tufting => 'tʌftiŋ
tufty => 'tʌfti
tug => tʌg
tug of war => tʌɡ ɔv wɔ:
tugboat => 'tʌgbәut
tugboats => 'tʌɡbəʊt
tugged => tʌɡd
tugger => 'tʌ^ә
tugging => 'tʌ^iŋ
tugrik => 'tu:^rik
tugs => tʌɡz
tui => 'tu:i
Tuinal => 'tu:inɔ:l
tuition => tju:'iʃәn
tuitional => tju:'iʃәnәl
tularaemia => tu:lә'ri:miә
tularemia => tu:lә'ri:miә
tule => 'tuːlɪ
tulip => 'tju:lip
tulip tree => ˈtju:lip tri:
tulips => t'ju:lɪps
tulipwood => 'tju:lipwjd
tulle => tju:l
tullibee => 'tʌli,bi:
Tully => 'tʌli
tulsa => 'tʌlsә
tum => tʌm
tumble => tʌmbl
tumble dryer => ˈtʌmbl ˈdraɪə
tumble-dryer => 'tʌmbldr'aɪər
tumblebug => 'tʌmblbʌg
tumbled => ˈtʌmbld
tumbledown => 'tʌmbldaun
tumblehome => 'tʌmblhəʊm
tumbler => 'tʌmblә
tumblerful => 'tʌmblәfjl
tumblerfuls => ˈtʌmbləfulz
tumblers => ˈtʌmbləz
tumbles => ˈtʌmblz
tumbleweed => 'tʌmblwi:d
tumbling => 'tʌmbliŋ
tumefaction => .tju:mi'fækʃәn
tumefied => t'ju:mɪfɪd
tumefy => 'tju:mifai
tumescence => tju'mesns, tu:-
tumescent => tju:'mesnt
tumid => 'tju:mid
tumidity => tju:'miditi
tumidly => ˊtjuːmidli
tummies => ˈtʌmi:z
tummler => 'tjmlә(r)
tummy => 'tʌmi
tumor => 'tju:mә
tumorigenesis => ,tu:mәri'dʒenisis
tumour => 'tju:mә
tumours => ˈtju:məz
tump => tʌmp
tumpline => 'tʌmplain
tumult => 'tju:mʌlt
tumults => ˈtu:ˌmʌlts
tumultuous => tju:'mʌltʃuәs
tumultuously => tju:'mʌltʃʊəslɪ
tumulus => 'tju:mjulәs
tun => tʌn
tuna => 'tju:nә
tunable => 'tju:nәbl
tundish => 'tændiʃ
tundra => 'tʌndrә
tundras => ˈtʌndrəz
tune => tju:n
tuned => tju:nd
tuneful => 'tju:nful
tunefully => 'tju:nfəlɪ
tunefulness => 'tju:nflnəs
tuneless => 'tju:nlis
tunelessly => 'tju:nlisli
tuner => 'tju:nә
tuners => ˈtju:nəz
tunes => tju:nz
tunesmith => 'tju:nsmiθ
tung => tʌŋ
tungstate => 'tʌŋsteit
tungsten => 'tʌŋstәn
tungstite => 'tʌŋstait
Tungus => tun'^uz
Tungusic => tun'^uzik
tunic => 'tju:nik
tunica => 'tju:nikә, 'tu:-
tunicate => 'tju:nikeit
tunicle => 'tju:nikl
tunics => ˈtju:nɪks
tuning => 'tju:niŋ
tuning fork => 'tju:niŋ
Tunis => 'tju:nis
Tunisia => tju:'nisiә
Tunisian => tju:'niziәn
tunned => tʌnd
tunnel => 'tʌnl
tunnelling => 'tʌnәliŋ
tunnels => ˈtʌnəlz
tunny => 'tʌni
tup => tʌp
Tupamaro => ,tju:pә'mɑ:rәj
tupelo => 'tju:pilәu
Tupi => tu:'pi:, 'tu:pi
Tupi-Guarani => 'tu:pi,ɡwa:rə'ni:; tu'pi:-
Tupian => 'tu:piәn, tu:'pi:-
tupik => 'tu:pik
tuple => 'tʌpl
tuppence => 'tʌpәns
tuppenny => 'tʌpәni
tupperware => 'tʌpәweә(r)
tuque => tju:k
turaco => 'tjәrәkәj, ,tjәrә'kәj
Turanian => tju'reiniәn
turban => 'tә:bәn
turbans => ˈtɜ:bənz
turbary => 'tә:bәri
turbellarian => ,tә:bi'leәriәn
turbid => 'tә:bid
turbidimeter => tә:bi'dimitә
turbidimetric => ,tә:bidi'metrik
turbidite => 'tә:bi,dait
turbidity => tә:'biditi
turbidly => tɜ:'bɪdlɪ
turbidness => 'tә:bidnis
turbinal => 'tә:binl
turbinate => 'tә:binit
turbine => 'tә:bain
turbines => 'tɜ:baɪnz
turbit => 'tә:bit
turbo => 'tә:bәu
turbocharge => 't\\\\:bәjtʃɑ:dʒ
turbocharged => 'tɜːbə(ʊ)tʃɑːdʒ
turbocharger => 'tә:bәu,tʃɑ:dʒә
turbofan => 'tә:bәu,fæn
turbogenerator => 'tә:bәu'dʒenәreitә
turbojet => 'tәbәjdʒet
turboprop => 'tә:bәuprɔp
turbos => ˈtə:bəuz
turboshaft => 't\\\\:bәjʃæft
turbosupercharger => ,t\\\\:bәj'sju:pә,tʃɑ:dʒә(r)
turbot => 'tә:bәt
turbulence => 'tә:bjulәns
turbulent => 'tә:bjulәnt
turbulently => 'tɜ:bjʊləntlɪ
Turco => 't\\\\:kәj
Turcoman => 'tә:kәmәn
turd => tә:d
turds => tə:dz
tureen => tju'ri:n
tureens => təˈri:nz
turf => tә:f
turf war => tɜ:f wɔ:
turfed => tɜːf
turfing => 'tɜ:fɪŋ
turfman => 'tә:fmәn
turfs => tɜ:fs
turfy => 'tә:fi
turgescence => tә:'dʒesns
turgescent => tә:'dʒesnt
turgid => 'tә:dʒid
turgidity => tә:'dʒiditi
turgidly => 'tɜ:dʒɪdlɪ
turgor => 'tә:^ә
turin => tju'rin
Turing => 'tjjәriŋ