turnbuckle => 'tә:n.bʌkl
turncoat => 'tә:nkәut
turncoats => ˈtə:nkəuts
turncock => 'tә:nkɒk
turndown => 'tә:ndaun
turner => 'tә:nә
turnery => 'tә:nәri
turning => 'tә:niŋ
turning circle => ˈtɜ:nɪŋ ˈsə:kl
turnings => ˈtɜ:nɪŋz
turnip => 'tә:nip
turnips => ˈtɜ:nɪps
turnkey => 'tә:nki:
turnkeys => ˈtə:nkiz
turnoff => 'tә:nɒf
turnout => 'tә:naut
turnouts => 'tɜ:naʊts
turnover => 'tә:n.әuvә
turnovers => 'tɜ:nəʊvəz
turnpiked => 'tɜːnpaɪk
turnpikes => ˈtɜ:nˌpaɪks
turnpiking => 'tɜːnpaɪk
turnround => 'tә:nraund
turnrounds => 'tɜːnraʊnd
turnsole => 'tә:nsәul
turnspit => 'tә:n,spit
turnstile => 'tә:nstail
turnstiles => ˈtɜ:nˌstaɪlz
turnstone => 'tә:nstәun
turntable => 'tә:nteibl
turntables => 'tɜ:nteɪblz
turpentine => 'tә:pәntain
turpitude => 'tә:pitju:d
turps => tә:ps
turquoise => 'tә:kwɒiz
turquoises => ˈtɜ:ˌkwɔɪziz
turret => 'tʌrit
turreted => 'tʌritid
turrets => ˈtɜ:rɪts
turtle => 'tә:tl
turtledove => 'tә:tldʌv
turtledoves => 'tə:tldʌv
turtleneck => 'tә:tlnek
turtles => 'tә:tlz
turves => tә:vz
Tuscan => 'tʌskәn
tuscany => 'tʌskәni
Tuscarora => .tʌskә'rɒ:rә
tush => tʌʃ
tushy => tʊʃɪ
tusk => tʌsk
tusker => 'tʌskә
tusks => tʌsks
tusky => 'tʌski
Tussaud => 'tu:sәu
tussive => 'tʌsiv
tussle => 'tʌsl
tussled => 'tʌs(ə)l
tussles => ˈtʌsəlz
tussling => 'tʌs(ə)l
tussock => 'tʌsәk
tussock grass => ˈtʌsək ɡrɑ:s
tussocks => ˈtʌsəks
tussocky => 'tʌsәki
tut => tʌt
tut-tut => 'tʌt'tʌt
Tutankhamen => ,tu:tən'kɑ:men; -mən
tutee => tju:'ti:, tu:-
tutelage => 'tju:tilidʒ
tutelary => 'tju:tilәri
tutor => 'tju:tә
tutorage => 'tju:tәridʒ
tutored => ˈtju:təd
tutorial => tju:'tɒ:riәl
tutorials => tu:ˈtɔ:ri:əlz
tutoring => ˈtju:tərɪŋ
tutorship => 'tju:tәʃip
tuts => tʌts
tutsan => 'tʌtsәn
Tutsi => 'tjtsi
tutted => tʌtid
tutti => 'tuti
tutti-frutti => 'tjti 'fru:ti
tutting => tʌtɪŋ
Tuttle => 'tʌtl
tutu => 'tu:tu:
tutus => 'tu:tu:z
Tuvalu => 'tu:vәlu
Tuvaluan => ,tu:vә'lu:әn,tu:'vɑ:l-
tux => tʌks
tuxedo => tʌk'si:dәu
tuxedoed => tʌk'siːdəʊd
tuxedos => tʌkˈsi:dəʊz
TV => 'ti:'vi:
TWA => twɑ:
twaddle => 'twɒdl
twaddled => ˈtwɔdld
twaddles => ˈtwɔdlz
twaddling => ˈtwɔdlɪŋ
twain => 'twein
twang => twæŋ
twangs => twæŋz
twangy => t'wænɡɪ
twat => twæt. twɔt
twayblade => 'twei,bleid
tweak => twi:k
tweaks => twi:ks
twee => 'twi:
tweed => twi:d
Tweeddale => 'twi:ddeil
tweediness => t'wi:dɪnəs
tweeds => twi:dz
tween => twi:n
tweener => twi:nə(r)
tweeny => 'twi:ni
tweer => 'twi:ә
tweet => twi:t
tweeted => twiːt
tweeter => 'twi:tә
tweets => twi:ts
tweeze => twi:z
tweezed => twi:zd
tweezers => 'twi:zәz
tweezes => twi:ziz
tweezing => twi:zɪŋ
twelfth => twelfθ
twelfthly => 'twelfθli
twelfths => twelfθs
twelve => twelv
twelve-month => 'twelvmʌnθ
twelve-note => 'twelvnәjt
twelvefold => 'twelvfәuld
twelvemo => -mәu
twentieth => 'twentiiθ
twenty => 'twenti
twenty-eight => t'wenti:'eɪt
twenty-first => ˈtwenti: fə:st
twenty-twenty => 'twenti'twenti
twenty-twenty vision => ˈtwentiˈtwenti ˈviʒən
twenty-two => ˌtwentɪ'tu:
twentyfold => 'twentifәjld
twentysomething => 'twentisʌmθiŋ
twerp => twә:p
twerps => twə:ps
Twi => tʃwi:
twice => twais
twice-born => 'twais'bɔ:n
twiddle => 'twidl
twiddled => ˈtwɪdld
twiddles => ˈtwɪdlz
twiddling => ˈtwɪdlɪŋ
twiddly => ˈtwɪdli
twig => twig
twigged => twi^d
twigging => twɪg
twiggy => 'twi^i
twigs => twiɡz
twilight => 'twailait
twilight zone => ˈtwailait zəun
twilit => 'twailit
twill => twil
twilling => twilɪŋ
twills => t'wɪlz
twin => twin
twin bed => twin bed
twin town => twin taun
twin-lens => 'twinlens
twin-screw => 'twin'skru:
twine => twain
twined => twaind
twiner => 'twainә
twines => twaɪnz
twinflower => 'twinflauә
twinge => twindʒ
twinged => twɪn(d)ʒ
twinges => twɪndʒz
twining => 'twiniŋ
twinkie => 'twiŋki
twinkle => 'twiŋkl
twinkled => ˈtwɪŋkəld
twinkles => ˈtwɪŋkəlz
twinkling => 'twiŋkliŋ
twinkly => 'twɪŋklɪ
twinned => twind
twinning => 'twiniŋ
twinset => ˈtwɪnset
twirl => twә:l
twirled => twɜ:ld
twirler => 'twә:lә
twirling => 'twә:liŋ
twirls => twɜ:lz
twirly => 'twə:li
twirp => twә:p
twist => twist
twisted => 'twistid
twister => 'twistә
twisters => ˈtwɪstəz
twisting => 'twistiŋ
twistor => 'twistә
twists => twists
twisty => 'twisti
twit => twit
twitch => twitʃ
twitcher => twɪtʃə(r)
twitches => twitʃiz
twitching => 'twitʃiŋ
twitchy => ˈtwɪtʃi
twite => twait
twits => twɪts
twitted => twɪt
twitter => 'twitә
twittered => 'twɪtə
twittering => 'twitәriŋ
twitters => ˈtwɪtəz
twittery => t'wɪtərɪ
twitting => twɪt
twizzle => 'twizl
two => tu:
two-by-four => 'tu:bai,fɔ:(r)
two-cycle => 'tu:s'aɪkl
two-dimensionality => 'tu:di,menʃə'næləti; -dai-
two-faced => 'tu:feist
two-fisted => 'tu:'fistid
two-handed => tu:'hændid
two-horse => 'tu:h'ɔ:s
two-man => 'tu:'mən
two-pieces => 'tu:p'i:sɪz
two-seater => ˈtu:ˈsi:tə
two-sided => 'tu:'saidid
two-state => 'tu:st'eɪt
two-stroke => tu: strəuk
two-time => 'tu:taim
two-tone => 'tu:tju:n
two-toned => 'tu:təund
two-up => 'tu:'ʌp
two-way => 'tu:'wei
two-way mirror => ˈtu:ˈweɪ ˈmirə
two-wheeler => 'tu:w'i:lə
twofer => 'tu:fә(r)
twofold => 'tu:'fәuld
twoness => 'tu:nis
twopence => 'tʌpәns
twopenny => 'tʌpәni
twosome => 'tu:sәm
Tyburn => 'taibә:n
tychism => 'taikizәm
tycoon => tai'ku:n
tycoons => taɪˈku:nz
Tye => tai
tying => 'taiiŋ
tyke => taik
tykes => taɪks
tyler => 'tailә
tylopod => 'tailәpɔd
tympan => 'timpәn
tympana => 'timpәnә, -nә
tympani => 'timpәnai
tympanic => tim'pænik
tympanic membrane => timˈpænik ˈmemˌbreɪn
tympanites => .timpә'naiti:z
tympanoplasty => 'timpәnәj,plæsti
tympanum => 'timpәnәm
tympany => 'timpәni
Tyndale => 'tindl
tyndall => 'tindl
Tyne => tain
TYNEMOUTH => 'tainmauθ
Tynwald => 'tinwɔld
typal => 'taipl
type => taip
type species => taip ˈspi:ʃi:z
type specimen => taip ˈspesimən
typecast => 'taipkɑ:st
typecasting => 'taip.kɑ:stiŋ
typeface => 'taipfeis
typefaces => ˈtaipfeisiz
typescript => 'taipskript
typeset => 'taipset
typesets => ˈtaipsets
typesetter => 'taipsetә
typesetting => 'taip,setiŋ
typewrite => 'taiprait
typewriter => 'taip.raitә
typewriters => 'taɪpraɪtəz
typewriting => 'taip,raitiŋ
typewritten => 'taipritn
typhlitic => tif'litik
typhlitis => tif'laitis
typhoid => 'taifɔid
typhoidal => tai'fɔidәl
typhonic => tai'fɒnik
typhoon => tai'fu:n
typhoons => taɪ'fu:nz
typhous => 'taifәs
typhus => 'taifәs
typical => 'tipikl
typicality => ,tipi'kæliti
typically => 'tipikәli
typification => .tipifi'keiʃәn
typified => ˈtɪpəˌfaɪd
typifies => ˈtɪpəˌfaɪz
typify => 'tipifai
typifying => ˈtɪpəˌfaɪŋ
typing => 'taipiŋ
typing pool => ˈtaɪpɪŋ pu:l
typist => 'taipist
typists => ˈtaipists
typo => 'taipәu
typographer => tai'pɒgrәfә
typographic => .taipә'græfik
typographical => ,taipә'^ræfikәl
typographically => ,taipə'græfikəli
typography => tai'pɒgrәfi
typologist => tai'pɔlәdʒist
typology => tai'pɒlәdʒi
typos => 'taipәus
Tyr => tiә
tyramine => 'tairә,mi:n, -min
tyrannical => tai'rænikl
tyrannically => tiˊrænikәli
tyrannicide => tai'rænisaid
tyrannies => ˈtirəniz
tyrannize => 'tirәnaiz
tyrannized => ˈtirənaizd
tyrannizes => ˈtirənaiziz
tyrannizing => ˈtirənaizɪŋ
tyrannosaur => ti'rænә,sɔ:, tai-
tyrannosaurus => ti.rænә'sɒ:rәs
tyrannous => 'tirәnәs
tyrannously => ˊtirәnәsli
tyranny => 'tirәni
tyrant => 'taiәrәnt
tyrant flycatcher => ˈtaɪərənt ˈflaiˌkætʃə
tyrants => ˈtaɪərənts
tyre => 'taiә
tyres => taɪəz
Tyrian => 'tiriәn
tyro => 'tairәu
tyrol => ti'rәjl,'tirәjl, ti:'rәjl
Tyrolean => ti'rəuliən
Tyrolese => tirә'li:z
Tyron => 'tairәn
Tyrone => ti'rәun
tyros => 'taɪərəʊz
tyrosinase => 'tairәsineis, tai'rɔsi,neis
tyrosine => 'tirәsi:n
Tyrrhene => 'tiri:n, ti'r-
Tyrrhenian => ti'ri:niәn
Tyumen => tju:'men
tyuyamunite => ,tjujә'mu:nait
tzar => zɑ:(r), tsɑ:(r)
tzarina => zɑ:'ri:nә,tsɑ:-
tzarism => 'zɑːrɪzəm
tzatziki => tsæt'sɪkɪ
tzetze fly => ˈtsetsi flai
tzimmes => ˈtsimis