R => ɑ:(r)
RA => rɑ:
rabat => rә'bæt
Rabaul => rә'bajl,rɑ:-
rabbet => 'ræbit
rabbeted => ˈræbitid
rabbeting => ˈræbitɪŋ
rabbets => ˈræbits
rabbi => 'ræbai
rabbinate => 'ræbinit
rabbinic => ræ'binik,rә-
rabbinical => 'ræbinikәl
rabbis => ˈræbaɪz
rabbit => 'ræbit
rabbit food => ˈræbit fu:d
rabbit punch => ˈræbit pʌntʃ
rabbitbrush => 'ræbitbrʌʃ
rabbitfish => 'ræbitfiʃ
rabbity => 'ræbiti
rabble => 'ræbl
Rabelais => 'ræbә,lei
Rabelaisian => ræbә'leiziәn
Rabia => rә'biә
rabid => 'ræbid
rabidity => 'ræbiditi
rabidness => ræ'bɪdnəs
rabies => 'reibi:z
raccoon => ræ'ku:n
raccoon dog => ræˈku:n dɔɡ
raccoons => rə'ku:nz
race => reis
race meeting => reis ˈmi:tiŋ
race relations => reis riˈleiʃənz
racecar => 'reis,kɑ:
racecard => 'reiskɑ:d
racecourse => 'reiskɔ:s
racecourses => ˈreɪsˌkɔ:siz
racehorse => 'reishɒ:s
racehorses => ˈreishɔ:siz
racemate => 'reisimeit, rә-
raceme => rә'si:m
racemic => rә'si:mik
racemize => 'ræsimaiz, rei'si:-
racemose => 'ræsimәus
racer => 'reisә
racers => ˈreɪsəz
racerunner => 'reisrʌnә
racetrack => 'reistræk
racetracks => ˈreɪsˌtræks
raceway => 'reiswei
rachel => 'reitʃәl
rachis => 'reikiz
rachitic => rә'kitik
rachitis => rә'kaitis
Rachmanism => 'rækmәnizәm, 'rɑ:-
racial => 'reiʃәl
racialism => 'reiʃәlizm
racialist => 'reiʃәlist
racialists => 'reiʃəlist
racialize => ˈreiʃəlaiz
racially => 'reiʃәli
racier => ˈreɪsi:ə
racily => 'reisili
racine => rә'si:n
raciness => 'reisinis
racing => 'reisiŋ
racism => 'reisizm
racist => 'reisist
racists => ˈreisists
rack => ræk
rack railway => ræk ˈreilwei
rack rate => ræk reit
rack-and-pinion => 'ræk'ændp'ɪnɪən
rack-mounted => 'rækm'aʊntɪd
racked => 'rækt
racket => 'rækit
racketeer => .ræki'tiә
racketeering => ,ræki'tiәriŋ
racketeers => ˌrækɪˈtɪəz
rackets => ˈrækits
rackety => 'rækiti
racking => 'rækiŋ
raclette => rɑ:'klet; ræ-
racon => 'reikәn
raconteur => rækɔn'tә:
raconteurs => ˌrækɔnˈtɜ:z
raconteuse => ,rækɔn't\\\\:z
racoon => rә'ku:n
racquet => 'rækit
racquetball => 'rækitbɔ:l
racy => 'reisi
RAD => ræd
radar => 'reidә
radar trap => ˈreidə træp
radars => ˈreidəz
Radcliffe => 'rædklif
raddle => 'rædl
raddled => 'rædld
raddles => 'ræd(ə)l
raddling => 'ræd(ə)l
radial => 'reidiәl
radial keratotomy => ˈreɪdi:əl ˌkerəˈtɔtəmi
radial symmetry => ˈreɪdi:əl ˈsimitri
radial tyre => ˈreɪdi:əl ˈtaiə
radials => 'reidiәlz
radian => 'reidiәn
radiance => 'reidiәns
radiancy => 'reidiәnsi
radiant => 'reidiәnt
radiantly => 'reɪdɪəntlɪ
radiate => 'reidieit
radiated => 'reidieitid
radiates => ˈreidieits
radiation => .reidi'eiʃәn
radiation therapy => ˌreidiˈeiʃən ˈθerəpi
radiative => 'reidieitiv
radiator => 'reidieitә
radiator grille => ˈreɪdi:ˌeɪtə grɪl
radiators => 'reɪdɪeɪtəz
radical => 'rædikl
radicalism => 'rædikәlizm
radicalization => ,rædikәlai'zeiʃәn
radicalize => 'rædiklaiz
radicalized => ˈrædikəlɑizd
radicalizes => ˈrædikəlɑiziz
radicalizing => ˈrædikəlɑizɪŋ
radically => 'rædikәli
radicalness => 'rædɪklnəs
radicals => 'rædɪklz
radicchio => ræˈdi:kiəʊ
radices => 'rædisi:z
radicle => 'rædikl
radicular => ræ'dikjjlә(r), rә-
radii => 'reidiai
radio => 'reidiәu
radio astronomy => ˈreidiəu əsˈtrɔnəmi
radio car => ˈreidiəu kɑ:
radio galaxy => ˈreidiəu ˈɡæləksi
radio- => 'reidiәj-
radio-controlled => 'reidiәukәn'trәuld
radioactive => .reidiәu'æktiv
radioactivity => .reidiәuæk'tiviti
radiobiologically => 'reidiəu,baiəu'lɔdʒikəli
radiobiologist => 'reidiәubai'ɔlәdʒist
radiobiology => 'reidiәubai'ɔlәdʒi
radiocarbon => .reidiәu'kɑ:bәn
radiochemical => -'kemikәl
radiochemist => -'kemist
radiochemistry => .reidiәu'kemistri
radioed => 'reidiәud
radiogenic => .reidiәu'dʒenik
radiogram => 'reidiәu^ræm
radiograms => 'reɪdɪə(ʊ)græm
radiograph => 'reidiәugrɑ:f
radiographer => .reidi'ɒgrәfә
radiographic => .reidiәu'græfik
radiographs => ˈreidiəuɡrɑ:fs
radiography => .reidi'ɒgrәfi
radioimmunoassay => 'reidiәu,imjunәu'æsei
radioimmunological => 'reidiәj,imjjnә'lɔdʒikәl
radioing => 'reɪdɪəʊ
radioisotope => .reidiәu'aisәtәup
radioisotopic => reɪdi:əʊaɪ'səʊtɒpɪk
radiolarian => .reidiәu'lєәriәn
radiologic => ,reidiәu'lɔdʒik
radiological => 'reidiou'lɒdʒikl
radiologist => .reidi'ɒlәdʒist
radiology => .reidi'ɒlәdʒi
radiolucency => ,reidiәj'lju:sәnsi
radiolucent => 'reidiәu'lu:snt
radioman => 'reidiәumæn
radiomete => 'reɪdɪɒmɪt
radiometer => .reidi'ɒmitә
radiometric => ˌreɪdiəʊˈmetrɪk
radionics => ,reidi'ɔniks
radionuclide => ,reidiәu'nju:klaid, -'nu:-
radiopacity => -'pæsәti
radiopaque => 'reidiәupeik
radioscopic => ,reidiәj'skɔpik
radioscopy => .reidi'ɒskәpi
radiosonde => 'reidiәusɔnd
radiotherapeutic => 'reidiәuθerә'pju:tik
radiotherapist => .reidiәu'θerәpist
radiotherapists => ,reidiəu'θerəpist
radiotherapy => .reidiәu'θerәpi
radish => 'rædiʃ
radishes => ˈrædɪʃiz
radium => 'reidiәm
radius => 'reidiәs
radix => 'reidiks
Radnor => 'rædnә(r)(ʃiә(r))
Radnorshire => 'rædnəʃiə
Radom => 'rɑ:dɔ:m
radome => 'reidәum
radon => 'reidɒn
radula => 'rædʒulә
radular => - lә( r)
radwaste => 'ræd,weist
rae => rei
raff => ræf
RAFFERTY => 'ræfәti
raffia => 'ræfiә
raffinate => 'ræfineit
raffinose => 'ræfinәus
raffish => 'ræfiʃ
raffle => 'ræfl
raffled => ˈræfld
raffles => ˈræflz
raffling => ˈræflɪŋ
raft => ræft
rafted => rɑːft
rafter => 'ræftә
raftered => 'rɑ:ftәd
rafting => 'rɑ:ftiŋ
rafts => rɑ:fts
raftsman => 'ræftsmәn
raftsmen => 'rɑ:ftsmən
rag => ræg
rag doll => ræɡ dɔl
rag on => ræɡ ɔn
rag paper => ræɡ ˈpeipə
rag rug => ræɡ rʌɡ
rag-and-bone man => ræɡ ænd bəun mæn
raga => 'rɑ:ɡә
ragamuffin => 'rægә.mʌfin
ragamuffins => ˈræɡəˌmʌfinz
ragbag => 'rægbæg
ragbags => 'rægbæg
rage => reidʒ
rages => reidʒz
ragga => ˈrægə
ragged => 'rægid
ragged robin => ˈræɡid ˈrɔbɪn
raggedly => 'ræɡɪdlɪ
raggedness => ˊrægidnis
raggedy => 'ræ^idi
ragging => 'ræ^iŋ
raggle-taggle => 'rægl'tægl
raggy => 'ræ^i
ragi => 'rægi
raging => 'reidʒiŋ
raglan => 'ræglәn
ragman => 'rægmæn
ragout => ræ'gu:
ragpicker => 'rægpikә
rags => ræɡz
ragstone => 'ræ^stәun
ragtag => 'rægtæg
ragtime => 'rægtaim
ragtop => 'ræ^tɔp
raguly => 'ræ^jjli
Ragusa => rɑ:'ɡu:zɑ:
ragweed => 'ræ^wi:d
ragworm => 'ræ^w\\\\:m
ragwort => 'rægwә:t
rah => rɑ:
rah-rah => 'rɑ: 'rɑ:
raid => reid
raider => 'reidә
raiders => ˈreidəz
rail => reil
railage => 'reilidʒ
railbus => 'reilbʌs
railcar => 'reilkɑ:
railcard => ˈreɪlkɑ:d
railcards => 'reilkɑ:d
railcars => 'reɪlkɑː
railer => 'reilә
railhead => 'reilhed
railing => 'reiliŋ
raillery => 'reilәri
railroad => 'reilrәud
railroading => 'reil,rәjdiŋ
railroads => ˈreilrəudz
railway => 'reilwei
railway line => ˈreilwei lain
railwayman => 'reilweimæn
railways => 'reɪlweɪz
raiment => 'reimәnt
rain => rein
rain dance => rein dɑ:ns
rain gauge => 'rein^eidʒ
rain shadow => rein ˈʃædəu
rain tree => rein tri:
rainbird => 'reinb\\\\:d
rainbow => 'reinbәu
rainbow trout => ˈreinbəu traʊt
rainbows => ˈreinbəuz
raincoat => 'reinkәut
raincoats => ˈreinkəuts
raindrop => 'reindrɒp
raindrops => 'reɪndrɒps
rainer => 'reinә
rainfall => 'reinfɒ:l
rainforest => 'rein'fɔrist
rainforests => ˈreinfɔrists
raininess => 'reininis
rainless => 'reinlis
rainmaker => 'rein.meikә
rainmaking => 'rein,meikiŋ
rainout => 'rein,aut
rainproof => 'rein'pru:f
rainstorm => 'reinstɒ:m
rainstorms => ˈreɪnˌstɔ:mz
rainwater => 'reinwɒ:tә
rainworm => 'reinwɒ:m
rainy => 'reini
raisable => 'reɪzəbl
raise => reiz
raised => reizd
raiser => 'reizә
raisin => 'reizn
raising => 'reiziŋ
raisins => 'reɪzɪnz
raita => ˈraɪtə
raj => rɑ:dʒ
raja => 'rɑ:dʒә
rajah => 'rɑ:dʒә
Rajasthan => ,rɑ:dʒә'stɑ:n
Rajasthani => ,rɑ:dʒәs'tɑ:ni
Rajput => 'rɑ:dʒpjt
Rajputana => ,rɑ:dʒpj'tɑ:nә
rake => reik
rake-off => 'reikɔf
raked => reɪkt
raker => 'reikә
rakes => reiks
raki => rɑ:'ki:,'ræki
raking => 'reikiŋ
rakish => 'reikiʃ
rakishly => 'reikiʃli
rallentando => rælen'tændәu
rallied => ˈrælid
rallies => ˈræliz
rally => 'ræli
rallycross => ˈrælikrɒs
rallying => ˈræliɪŋ
rallyist => 'ræliist
Ralph => reif, rælf
ram => ræm
rama => 'rɑ:mә
Ramadan => ,ræmә'dɑ:n
raman => 'rɑ:mәn
Ramapithecus => ,rɑ:mәpә'ti:kәs
Ramayana => rә'maiәnә, rә'mɑ:jәnә
ramble => 'ræmbl
rambled => ˈræmbəld
rambler => 'ræmblә
ramblers => ˈræmbləz
rambles => ˈræmbəlz
rambling => 'ræmbliŋ
Rambo => 'ræmbəu
Rambouillet => 'ræmbә,lei
rambunctious => ræm'bʌŋkʃәs
rambunctiously => ræm'bʌŋkʃəslɪ
rambutan => ræm'bu:tn
ramekin => 'ræmikin
ramen => 'rɑːmen
Rameses => 'ræmisi:z
ramie => 'ræmi, 'rei-
ramification => .ræmifi'keiʃәn
ramifications => ˌræməfɪˈkeɪʃənz
ramified => 'ræmifaid
ramifies => ˈræməˌfaɪz
ramify => 'ræmifai
ramifying => ræmɪ'faɪɪŋ
ramin => ræ'miːn
ramjet => 'ræmdʒet
rammed => 'ræmd
rammer => 'ræmә
ramming => 'ræmiŋ
Ramon => rә'mәun, 'reimәn
ramp => ræmp
rampage => 'ræmpeidʒ
rampaged => ˈræmˌpeɪdʒd
rampageous => ræm'peidʒәs
rampages => ˈræmˌpeɪdʒz
rampaging => ˈræmˌpeɪdʒɪŋ
rampancy => 'ræmpәnsi
rampant => 'ræmpәnt
rampantly => 'ræmpəntlɪ
rampart => 'ræmpɑ:t
ramparts => ˈræmˌpɑ:ts
ramped => ræmpt
ramping => ræmpɪŋ
rampion => 'ræmpiәn
ramps => ræmps
ramrod => 'ræmrɒd
ramrods => ˈræmrɔdz
Ramsay => 'ræmzi
Ramsden => 'ræmzdәn
Ramsey => 'ræmzi
Ramsgate => 'ræmz,ɡit
ramshackle => 'ræmʃækl
ramson => 'ræmzәn
ramus => 'reimәs
ran => ræn
rance => rɑ:ns
ranch => ræntʃ. rɑ:ntʃ
ranch house => rɑ:ntʃ haus
rancher => 'ræntʃә
ranchera => 'rɑ:ntʃərə
rancheria => ,ræntʃә'ri:ә
ranchero => ræn'tʃeәrәu
ranchers => ˈræntʃəz
ranches => rɑ:ntʃiz
ranchette => ,ræn'tʃet
Ranchi => 'rɑ:ntʃi, 'ræn-
ranching => ˈrɑ:ntʃɪŋ
rancho => 'ræntʃәu
rancid => 'rænsid
rancidity => ræn'siditi
rancidly => 'rænsɪdlɪ
rancor => 'ræŋkә
rancorous => 'ræŋkәrәs
rancour => 'ræŋkә
rand => rænd
randall => 'rændl
randier => ˈrændi:ə
randolph => 'rændɔlf
random => 'rændәm
randomise => 'rændəmaiz
randomization => ,rændәmai'zeiʃәn; -mi'z-
randomize => 'rændәmaiz
randomizes => ˈrændəmaiziz
randy => 'rændi
ranee => rɑ:'ni:
rang => ræŋ
rangatira => ,ræŋ^ә'tiәrә
range => 'reindʒ
rangefinder => 'reindʒ,faindә
rangeland => 'reindʒlænd
ranger => 'reinʒә
rangers => ˈreindʒəz
ranging => 'reindʒiŋ
ranging pole => ˈreindʒiŋ pəul
rangoon => ræŋ'^u:n
rangy => 'reindʒi
rani => 'rɑ:ni
rank => ræŋk
rank and file => ræŋk ænd fail
ranker => 'ræŋkә
ranking => 'ræŋkiŋ
rankle => 'ræŋkl
rankled => ˈræŋkəld
rankles => ˈræŋkəlz
rankling => ˈræŋkəlɪŋ
rankly => 'ræŋklɪ
rankness => 'ræŋknɪs
ransack => 'rænsæk
ransacked => ˈrænˌsækt
ransacking => ˈrænˌsækɪŋ
ransacks => ˈrænˌsæks
ransom => 'rænsәm
ransomed => ˈrænsəmd
ransoming => ˈrænsəmɪŋ
ransoms => ˈrænsəmz
rant => rænt
ranted => ræntid
ranter => 'ræntә
ranting => ræntɪŋ
rants => rænts
ranula => 'rænjulә
ranunculaceous => rә,nʌŋkjj'leiʃәs
ranunculus => rә'nʌŋkjælәs
rap => ræp
rap sheet => ræp ʃi:t
rapacious => rә'peiʃәs
rapaciously => rə'peɪʃəslɪ
rapaciousness => rәˊpeiʃәsnis
rapacity => rә'pæsiti
rape => reip
rapes => reips
rapeseed => 'reipsi:d
raphael => 'reifl, 'ræfeil
raphe => 'reifi
raphide => 'reifid, 'ræfid
rapid => 'ræpid
rapid-fire => 'ræpid'faiә(r)
rapidity => rә'piditi
rapidly => 'ræpidli
rapids => ræpidz
rapier => 'reipjә
rapiers => 'reɪpɪəz
rapine => 'ræpain
raping => reipɪŋ
rapist => 'reipist
rapists => ˈreɪpɪsts
rapparee => ,ræpә'ri:
rapped => ræpt
rappee => ræ'pi:
rappel => ræ'pel
rappelled => ræˈpeld
rappelling => ræˈpelɪŋ
rappels => ræˈpelz
rappen => 'rɑ:pәn
rapper => 'ræpә
rappers => ˈræpəz
rapping => 'ræpiŋ
rapport => ræ'pɒ:
rapporteur => .ræpɒ:'tә:
rapprochement => ræ'prɔʃmә:ŋ
raps => ræps
rapscallion => ræp'skæljәn
rapt => ræpt
raptor => 'ræptә(r)
raptorial => ræp'tɒ:riәl
raptors => ˈræptəz
rapture => 'ræptʃә
raptured => 'ræptʃәd
raptures => ˈræptʃəz
rapturous => 'ræptʃәrәs
rapturously => 'ræptʃərəslɪ
rapturousness => 'ræptʃərəsnəs
rara avis => reәrә'ævis
rare => rєә
rare bird => rɛə bə:d
rarebit => 'reәbit
raree-show => 'reәri: ʃәu
rarefaction => .rєәri'fækʃәn
rarefied => 'rєәrifaid
rarefies => 'reərɪfaɪz
rarefy => 'rєәrifai
rarefying => 'reərɪfaɪɪŋ
rarely => 'rєәli
rareness => 'rєәnis
rarified => 'reәrifaid
rarify => 'rεərifai
raring => 'rєәriŋ
rarities => ˈreərɪti:z
rarity => 'rєәrәti
Rarotonga => ,rærә'tɔŋ^ә
rasa => 'rʌsɜː
Rasbora => ræz'bɔ:rә,'ræzbәrә
rascal => 'ræskl
rascality => ræs'kæliti
rascally => 'ræskli
rascals => ˈræskəlz
rase => reiz
rased => reizd
rases => reiziz
rash => ræʃ
rasher => 'ræʃә
rashers => ˈræʃəz
rashes => ræʃiz
rashly => 'ræʃli
rashness => 'ræʃnis
rasing => reizɪŋ
rasp => ræsp
raspberries => ˈræzˌberi:z
raspberry => 'ræzbәri
rasped => rɑ:spt;ræspt
rasping => 'ræspiŋ
raspingly => 'rɑ:spɪŋlɪ
rasps => ræsps
raspy => 'ræspi
rassle => ræsl
rasta => 'ræstә,'rɑ:-
Rastafarian => 'ræstə'fεəriən
Rastafarianism => ,ræstə'fɑ:riə,nizəm
raster => 'ræstә
rasterize => ˈræstəraɪz
rat => ræt
rat fink => 'rætfɪŋk
rat pack => ræt pæk
rat run => ræt rʌn
rat-a-tat => 'rætә'tæt
rat-bite fever => ræt bait ˈfi:və
rat-tail => 'rætt'eɪl
rat-tat => ræt'tæt
ratable => 'reitәbl
rataplan => .rætә'plæn
ratatouille => ˌrætə'tu:ɪ
ratbag => ˈrætbæg
ratchet => 'rætʃit
ratcheted => ˈrætʃitid
ratcheting => 'rætʃitiŋ
ratchets => ˈrætʃits
rate => reit
rateable => 'reitәbl
rated => 'reitid
ratel => 'reitәl
ratepayer => 'reit.peiә
rater => 'reitә
ratfish => 'ræt,fiʃ
rath => rɑ:θ
rathe => reið,ræθ
rather => 'ræðә
rathole => 'ræthәul
rathskeller => 'rɑ:t.skelә
ratification => .rætifi'keiʃәn
ratifier => 'rætifaiә
ratifies => ˈrætifaiz
ratify => 'rætifai
ratifying => ˈrætifaiŋ
rating => 'reitiŋ
ratio => 'reiʃәu
ratiocinate => .ræti'ɒsineit
ratiocinated => ˌrætiˈɔsineitid
ratiocinating => ˌrætiˈɔsineitɪŋ
ratiocination => .rætiɒsi'neiʃәn
ratiocinative => .ræti'ɒsineitiv
ration => 'ræʃәn
rational => 'ræʃәnl
rationale => .ræʃә'nɑ:li
rationalisation => ,ræʃәnәlai'zeiʃәn;-li'z-
rationalise => 'ræʃәnәlaiz
rationalised => 'ræʃənəlaiz
rationalism => 'ræʃәnәlizm
rationalist => 'ræʃәnәlist
rationalistic => .ræʃәn'listik
rationalists => 'ræʃnəlɪsts
rationality => .ræʃә'næliti
rationalization => ,ræʃәnәlai'zeiʃәn
rationalize => 'ræʃәnәlaiz
rationalized => ˈræʃənəˌlaɪzd
rationalizes => ˈræʃənəˌlaɪziz
rationed => ˈræʃənd
rationing => 'ræʃәniŋ
ratios => ˈreiʃiəuz
ratite => 'rætait
ratline => 'rætlin
ratlines => 'rætlɪn
ratoon => ræ'tu:n
rats => ræts
ratsbane => 'rætsbein
rattan => ræ'tæn
ratted => ˈrætid
ratter => 'rætә
ratters => 'rætə
rattily => 'rætili
rattiness => 'rætinis
rattle => 'rætl
rattled => 'rætld
rattler => 'rætlә
rattlers => ˈrætləz
rattles => ˈrætlz
rattlesnake => 'rætlsneik
rattlesnakes => 'rætlsneɪks
rattletrap => 'rætltræp
rattling => 'rætliŋ
rattly => 'rætli
ratty => 'ræti
raucous => 'rɒ:kәs
raucously => 'rɔ:kəslɪ
raucousness => ˊrɒːkәsnis
raunch => rɔ:ntʃ
raunchier => ˈrɔ:ntʃiə
raunchiness => 'rɔ:ntʃɪnəs
raunchy => 'rɒ:ntʃi
rauwolfia => rɔ:'wulfiә
ravage => 'rævidʒ
ravaged => ˈrævɪdʒd
ravaging => ˈrævɪdʒɪŋ
rave => reiv
rave-up => 'reivʌp
raved => reivd
ravel => 'rævәl
raveled => ˈrævəld
ravelin => 'rævlin
ravelled => ˈrævəld
ravelling => ræ'vəlɪŋ
raven => 'reivn
raven-haired => 'rævnh'eərd
ravening => 'rævniŋ
Ravenna => rә'venә,rɑ:'vennɑ:
ravenous => 'rævinәs
ravenously => 'rævənəslɪ
ravens => 'rævәnz
raver => 'reivә(r)
ravers => ˈreivəz
raves => reivz
ravigote => ravi'^ɔ:t
ravin => 'rævin
ravine => rә'vi:n
ravined => rә'vi:nd
ravines => rəˈvi:nz
raving => 'reiviŋ
ravioli => rɑvi'әjli
ravish => 'ræviʃ
ravished => ˈrævɪʃt
ravishes => ˈrævɪʃiz
ravishing => 'ræviʃiŋ
ravishingly => 'ræviʃiŋli
raw => rɒ:
raw sienna => rɔ: siˈenə
raw umber => rɔ: ˈʌmbə
raw-boned => 'rɔ:b'əʊnd
Rawalpindi => ,rɑ:vәl'pindi:
rawboned => 'rɒ:bәund
rawhide => 'rɒ:haid
rawish => 'rɒ:iʃ
Rawlinson => 'rɔ:linsn
rawness => 'rɒ:nis
ray => rei
ray floret => rei ˈflɔ:rit
ray gun => rei ɡʌn
rayed => 'reɪd
raying => 'reɪɪŋ
rayleigh => 'reili
rayless => 'reilis
raymond => 'reimɔnd
rayon => 'reiɒn
rayonnant => 'reiәnәnt
rayons => 'reɪɒn
Raytheon => 'reiθiɔn
raze => reiz
razed => reɪzd
razes => reɪziz
razing => reɪzɪŋ
razoo => rəˈzu:
razor => 'reizә
razor blade => ˈreizə bleid
razor clam => ˈreizə klæm
razor shell => ˈreizə ʃel
razor wire => ˈreizə ˈwaiə
razor-sharp => 'reizәʃɑ:p
razor-thin => 'reizәθin
razorback => 'reizәbæk
razorbill => 'reizәbil
razored => 'reɪzə
razorfish => 'reizə,fiʃ
razors => 'reɪzəz
razz => ræz
razzed => ræzd
razzes => ræziz
razzia => 'ræziә
razzing => 'ræzɪŋ
razzle => ræzl
razzle-dazzle => 'ræzldæzl
razzmatazz => 'ræzmәtæz
RBI => ,ɑ:bi:'ai,'ribi
RDX => 'ɑ:di:'eks
re => ri:
re-cover => ri:'kʌvә(r)
re-dress => 'ri:'dres
re-echo => ri:'ekәj
re-educate => ri:ˈedjukeit
re-elect => 'ri:i'lekt
re-elected => 'reɪel'ektɪd
re-embark => 'ri:em'bɑ:k
re-emerge => reɪ iˈmə:dʒ
re-emphasize => 'ri:'emfәsaiz
re-enact => 'ri:i'nækt
re-enactment => reɪ enˈæktmənt
re-enlist => 'reɪenl'ɪst
re-enter => ri:ˈentə
re-entered => 'reɪ'entəd
re-entering => 'reɪ'entərɪŋ
re-entrant => ri:'entrәnt
re-entry => ri:ˈentrɪ
re-equipping => 'reɪɪkw'ɪpɪŋ
re-erect => ,ri:i'rekt
re-evaluate => ˈri:ɪˈvæljʊeɪt
re-evaluation => reɪ ɪˌvæljʊˈeɪʃən
re-examination => reɪ ɪɡˌzæmɪˈneɪʃn
re-examine => ˌri:ɪgˈzæmɪn
re-form => ri'fɔ:m
re-formation => 'reɪfɔ:m'eɪʃn
re-formed => reɪ fɔːmd
re-present => ˌri: prɪˈzent
re-presentation => ,reprɪzen'teɪʃ(ə)n
re-release => 'reɪrɪl'i:s
re-route => reɪ ru:t
re-routing => 'reɪr'aʊtɪŋ
re-sort => .ri:'sɒ:t
reabsorption => ,ri:әb'sɔ:pʃәn
reach => ri:tʃ
reached => ri:tʃt
reaches => 'riːtʃiz
reaching => ri:tʃɪŋ
reacquaint => ˌri:əˈkweɪnt
reacquire => ˌrɪə'kwaɪə
react => ri'ækt
reactance => ri'æktәns
reactant => ri'æktәnt
reacted => riˈæktid
reaction => ri'ækʃәn
reactionary => ri'ækʃәnәri
reactionist => ri'ækʃәnist
reactivate => ri'æktiveit
reactivated => ri:ˈæktəˌveɪtid
reactivates => ri:ˈæktəˌveɪts
reactivating => ri:ˈæktəˌveɪtɪŋ
reactivation => ri,ækti'veiʃәn
reactive => ri'æktiv
reactivities => ,riæk'tivəti, ri:-
reactivity => ,ri(:)æk'tiviti
reactor => ri'æktә
reactors => r'ɪæktəz
reacts => riˈækts
read => ri:d
read-in => 'ri:din
read-through => 'ri:dθru:
readability => .ri:dә'biliti
readable => 'ri:dәbl
readably => 'ri:dəblɪ
readdress => .ri:ә'dres
reader => 'ri:dә
readership => 'ri:dәʃip
readerships => ˈri:dəˌʃɪps
readied => ˈredid
readies => ˈrediz
readily => 'redili
readiness => 'redinis
reading => 'ri:diŋ
reading age => ˈri:diŋ eidʒ
reading frame => ˈri:diŋ freim
readjust => .ri:ә'dʒʌst
readjusted => ˌri:əˈdʒʌstid
readjusting => ˌri:əˈdʒʌstɪŋ
readjustment => ri:ә'dʒʌstmәnt
readjusts => ˌri:əˈdʒʌsts
readmission => ,ri:әd'miʃәn
readmit => .ri:әd'mit
readopt => ri:ә'dɔpt
readout => 'ri:daut
reads => ri:dz
ready => 'redi
ready for => ˈredi fɔ:
ready meal => ˈredi mi:l
ready-mix => 'redi'miks
readying => ˈrediŋ
reaffirm => .ri:ә'fә:m
reaffirmation => 'ri:.æfә'meiʃәn
reaffirmed => ˌri:əˈfɜ:md
reaffirming => ˌri:əˈfɜ:mɪŋ
reaffirms => ˌri:əˈfɜ:mz
reafforest => 'ri:æ'fɔrist
reafforestation => ˌri:əˌfɒrɪˈsteɪʃn
Reaganism => 'rei^әnizәm
Reaganite => 'reiɡənait
reagent => ri:'eidʒәnt
reagents => ri':eɪdʒənts
reagin => ri'eidʒin
real => 'riәl
real ale => riəl eɪl
real tennis => riəl ˈtenis
realgar => ri'ælgә
realia => ri:'eiliә
realign => ,riә'lain
realigned => ˌriəˈlaind
realignment => ,ri:ә'lainmәnt
realigns => ˌriəˈlainz
realisable => 'riәlaizәbl,'ri:-
realisation => .riәlai'zeiʃәn. ri:-. -li'z-
realise => 'riәlaiz,'ri:-
realised => 'riəlaizd
realism => 'riәlizm
realist => 'riәlist
realistic => riә'listik
realistically => riә'listikli
realists => 'rɪəlɪsts
realities => riˈælitiz
reality => ri'æliti
reality check => riˈæliti tʃek
realizability => rɪəlaɪzəbɪ'lɪtɪ
realizable => 'riәlaizәbl
realization => .riәlai'zeiʃәn
realize => 'riәlaiz
realizes => ˈriəlaiziz
realizing => 'riәlaiziŋ. 'ri:-
reallocate => ri:'ælәkeit
reallocated => ri:ˈæləkeitid
reallocates => ri:ˈæləkeits
reallocating => ri':æləkeɪtɪŋ
really => 'riәli
realm => relm
realpolitik => rei'ɑ:lpәuli'ti:k
realtor => 'riәltә
realty => 'ri:lti
ream => ri:m
reamed => ri:md
reamer => 'ri:mә
reaming => 'ri:miŋ
reams => ri:mz
reanalysis => 'ri:nələsɪs
reanimate => ri:'ænimeit
reanimated => ri:ˈænimeitid
reanimating => ri:ˈænimeitɪŋ
reanimation => .ri:æni'meiʃәn
reap => ri:p
reaped => ri:pt
reaper => 'ri:pә
reapers => ˈri:pəz
reappear => .ri:ә'piә
reappearance => .ri:ә'piәrәns
reappeared => ˌri:əˈpiəd
reappearing => ˌri:əˈpiərɪŋ
reappears => ri:ə'pɪəz
reapplication => ri:æplɪ'keɪʃən
reapply => ,ri:ә'plai
reappoint => .ri:ә'pɒint
reappointment => ˌri:ə'pɔɪnmənt
reapportion => .ri:ә'pɒ:ʃәn
reappraisal => .ri:ә'preizl
reappraisals => ˌri:əˈpreɪzəlz
reappraise => .ri:ә'preiz
reappraised => ˈri:əˈpreizd
reappraises => ˈri:əˈpreiziz
reappraising => ˈri:əˈpreizɪŋ
reappropriation => ,ri:ә,prәupri'eiʃәn
reaps => ri:ps
rear => riә
rear echelon => riə ˈeʃəˌlɔn
rear light => riə lait
rear-view mirror => riə vju: ˈmirə
rear-wheel drive => riə hwi:l draiv
reared => riəd
rearer => 'rɪərər
rearguard => ˈrɪəgɑ:d
rearguard action => ˈrɪəˌgɑ:d ˈækʃən
rearm => ri:'ɑ:m
rearmament => .ri:'ɑ:mәmәnt
rearmed => ri:ˈɑ:md
rearming => ri:r'mɪŋ
rearmost => 'riәmәust
rearms => ri:ˈɑ:mz
rearrange => .ri:ә'reindʒ
rearranged => ˌri:əˈreɪndʒd
rearrangement => ,ri:ә'reindʒmәnt
rearrangements => ˌri:əˈreindʒmənts
rearranges => ˌri:əˈreɪndʒz
rearranging => ˌri:ə'reɪndʒɪŋ
rearrest => ri:ә'rest
rearticulate => ,ri:ɑ:'tikjuleit
rearview => 'riәvju:
rearward => 'riәwәd
reascend => ,ri:ә'send
reascension => -'senʃәn
reason => 'ri:zn
reasonable => 'ri:znәbl
reasonably => 'ri:znәbli
reasoned => 'ri:z(ә)nd
reasoning => 'ri:zniŋ
reasonless => 'ri:znlis
reassemble => .ri:ә'sembl
reassembled => ˌri:əˈsembəld
reassembles => ˌri:əˈsembəlz
reassert => .ri:ә'sә:t
reasserted => ˈri:əˈsə:tid
reasserting => ˈri:əˈsə:tɪŋ
reassertion => .ri:ә'sә:ʃәn
reasserts => ˈri:əˈsə:ts
reassess => .ri:ә'ses
reassessed => ˈri:əˈsest
reassesses => ˈri:əˈsesiz
reassessing => ˈri:əˈsesɪŋ
reassessments => ˌri:əˈsesmənts
reassign => .ri:ә'sain
reassigns => riːə'saɪn
reassume => .ri:ә'sju:m
reassumption => .ri:ә'sʌmpʃәn
reassurance => .ri:ә'ʃurәns
reassurances => ˌri:əˈʃʊərɵnsiz
reassure => .ri:ә'ʃuә
reassured => ,ri:ə'ʃuəd
reassures => ˌri:əˈʃuəz
reassuring => .ri:ә'ʃuriŋ
reassuringly => ˌri:ə'ʃʊərɪŋlɪ
reattach => rɪə'tætʃ
reattachment => ,ri:ә'tætʃmәnt
reattain => ,riːə'teɪn
reattempt => ,ri:ә'tempt
reave => ri:v
reaves => ri:vz
reaving => ri:vɪŋ
reawaken => ri:ә'weikәn
rebab => ri'bɑ:b,rә-
rebadge => 'rebædʒ
rebalance => re'bæləns
rebar => ri'bɑ:
rebarbative => ri'bɑ:bәtiv
rebase => ri'beis
rebate => ri'beit
rebbe => ˈrebə
rebec => 'ri:bek
rebecca => ri'bekә
Rebekah => ri'bekә
rebel => 'rebl
rebelling => ˈrebəlɪŋ
rebellion => ri'beljәn
rebellions => riˈbeliənz
rebellious => ri'beljәs
rebelliously => rɪ'beljəslɪ
rebelliousness => rɪ'beljəsnəs
rebid => 'rebɪd
rebind => .ri:'baind
rebinding => rɪ'baɪndɪŋ
rebirth => .ri:'bә:θ
rebirther => riː'bɜːθ
reboot => ri:'bu:t
rebore => 'ri:'bɔ:
reborn => .ri:'bɒ:n
rebound => ri'baund
rebounded => ˈri:ˈbaʊndid
rebounder => 'ri:bajndә(r),ri'b-
rebounding => riˈbaundiŋ
rebounds => 'ri:'bɑʊndz
rebozo => ri'bәuzәu
rebrand => ˌri:ˈbrænd
rebreathe => ri:'bri:ð
rebroadcast => .ri:'brɒ:dkɑ:st
rebroadcasting => reb'rɔ:dkɑ:stɪŋ
rebuff => ri'bʌf
rebuffed => rɪˈbʌft
rebuffing => rɪˈbʌfɪŋ
rebuffs => rɪˈbʌfs
rebuild => ri'bild
rebuilder => ri:'bildә
rebuilds => ri:ˈbɪldz
rebuke => ri'bju:k
rebuked => riˈbju:kt
rebukes => riˈbju:ks
rebuking => riˈbju:kɪŋ
rebury => ri'beri
rebus => 'ri:bәs
rebut => ri'bʌt
rebuts => rɪˈbʌts
rebuttal => ri'bʌtәl
rebuttals => rɪˈbʌtlz
rebutted => rɪ'bʌtɪd
rebutter => ri'bʌtә
rebutting => rɪ'bʌtɪŋ
rec room => 'rekrum
recalcitrance => ri'kælsitrәns
recalcitrant => ri'kælsitrәnt
recalculate => ri:'kælkjuleit
recalculated => riː'kælkjʊleɪt
recalculates => riː'kælkjʊleɪt
recalculating => riː'kælkjʊleɪt
recalculation => ri:'kælkjuleiʃәn
recalescence => ,rikә'lesns
recall => ri'kɒ:l
recalled => riˈkɔ:ld
recalling => riˈkɔ:lɪŋ
recalls => riˈkɔ:lz
recant => ri'kænt
recantation => .ri:kæn'teiʃәn
recanted => rɪˈkæntid
recanting => rɪˈkæntɪŋ
recants => rɪˈkænts
recap => ri:'kæp
recapitalization => ri:,kæpitәlai'zeiʃәn;-li'z-
recapitalize => ri:'kæpitәlaiz
recapitulate => .ri:kә'pitjuleit
recapitulated => ˌri:kəˈpɪtʃəˌleɪtid
recapitulates => ˌri:kəˈpɪtʃəˌleɪts
recapitulating => ˌri:kəˈpɪtʃəˌleɪtɪŋ
recapitulation => ri:kәpitjj'leiʃ(ә)n
recapitulatory => ri:kə'pɪtjʊlətərɪ
recapped => ri:ˈkæpt
recapping => ri:ˈkæpɪŋ
recaps => ri:ˈkæps
recaption => ri:'kæpʃәn
recapture => .ri:'kæptʃә
recaptured => ri:ˈkæptʃəd
recaptures => ri:ˈkæptʃəz
recapturing => ri:ˈkæptʃərɪŋ
recast => .ri:'kɑ:st
recasts => ri:ˈkæsts
recce => 'reki
recd => 'rekd
recede => ri'si:d
receded => riˈsi:did
recedes => riˈsi:dz
receding => riˈsi:dɪŋ
receipt => ri'si:t
receipting => rɪ'siːt
receivable => ri'si:vәbl
receive => ri'si:v
received => ri'si:vd
receiver => ri'si:vә
receivers => rɪ'si:vəz
receivership => ri'si:vәʃip
receiving => ri'si:viŋ
recency => 'ri:snsi
recension => ri'senʃәn
recent => 'ri:snt
recently => 'ri:sntli
recentness => 'ri:sntnes
receptacle => ri'septәkl
receptacles => rɪ'septəklz
reception => ri'sepʃәn
receptionist => ri'sepʃәnist
receptionists => rɪˈsepʃənɪsts
receptive => ri'septiv
receptiveness => rɪ'septɪvnəs
receptivity => .ri:sep'tiviti
receptor => ri'septә
receptors => rɪˈseptəz
recertification => 'ri:,s\\\\:tifi'keiʃәn
recess => ri'ses
recesses => rɪ'sesɪz
recessing => rɪ'sesɪŋ
recession => ri'seʃәn
recessional => ri'seʃәnl
recessionary => ri'seʃәnәri
recessions => riˈseʃənz
recessive => ri'sesiv
Rechabite => 'rekәbait
recharge => ri:'tʃɑ:dʒ
recharged => ri:ˈtʃɑ:dʒd
recharges => ri:ˈtʃɑ:dʒz
recharging => rɪ'tʃa:dʒɪŋ
recheck => 'ri:'tʃek
rechristen => ri:'krisn
recidivism => ri'sidivizm
recidivist => ri'sidivist
recidivists => riˈsidivists
recipe => 'resipi
recipes => 'resəpɪz
recipiency => rɪ'sɪpɪənsɪ
recipient => ri'sipiәnt
reciprocal => ri'siprәkl
reciprocal cross => riˈsiprəkəl krɔs
reciprocate => ri'siprәkeit
reciprocated => rɪˈsɪprəˌkeɪtid
reciprocates => rɪˈsɪprəˌkeɪts
reciprocating => ri'siprәkeitiŋ
reciprocation => ri.siprә'keiʃәn
reciprocator => ri'siprәkeitә
reciprocity => .resi'prɒsiti
recirculate => ri'sә:kjuleit
recirculating => rɪ'sɜ:kjʊleɪtɪŋ
recirculation => ,ri:'s\\\\:kjj'leiʃәn
recision => ri'siʒәn
recital => ri'saitl
recitalist => ri'saitəlist
recitals => rɪˈsaɪtlz
recitation => .resi'teiʃәn
recitations => resɪ'teɪʃnz
recitative => 'resiteitiv
recitativo => ,resitә'ti:vәj
recite => ri'sait
recited => riˈsaitid
reciter => ri'saitә
recites => riˈsaits
reciting => riˈsaitɪŋ
reck => rek
reckless => 'reklis
reckon => 'rekәn
reckoned => ˈrekənd
reckoner => 'rekәnә
reckoning => 'rekәniŋ
reckons => ˈrekənz
reclaim => ri'kleim
reclaimable => ri'kleimәbl
reclaimer => ri'kleimә
reclaiming => rɪ'kleɪmɪŋ
reclaims => riˈkleimz
reclamation => .reklә'meiʃәn
reclassification => ri:.klæsifi'keiʃәn
reclassified => ri:ˈklæsifaid
reclassify => 'ri:'klæsifai
reclassifying => ri:ˈklæsifaiŋ
recline => ri'klain
reclined => rɪˈklaɪnd
recliner => ri'klainә
reclines => rɪˈklaɪnz
reclining => rɪˈklaɪnɪŋ
reclothe => ri:'klәuð
recluse => ri'klu:s
recluses => ˈrekˌlu:siz
reclusion => ri'klu:ʒәn
reclusive => ri'klu:siv
recode => 'ri:'kәud
recognise => 'rekә^naiz
recognition => .rekәg'niʃәn
recognitory => rekəɡ'nɪtərɪ
recognizability => rekəɡnaɪzə'bɪlɪtɪ
recognizable => 'rekәgnaizәbl
recognizably => ˌrekəɡ'naɪzəblɪ
recognizance => ri'kɒgnizәns
recognizant => ri'kɒgnizәnt
recognize => 'rekәgnaiz
recognizer => 'rekә^,naizә
recognizes => ˈrekəɡnaiziz
recoil => ri'kɒil
recoiled => rɪˈkɔɪld
recoilless => ri'kɔillis
recoils => rɪˈkɔɪlz
recollect => .rekә'lekt
recollected => ,rekә'lektid
recollecting => ˌrekəˈlektɪŋ
recollection => .rekә'lekʃәn
recollections => ˌrekəˈlekʃənz
recollects => ˌrekəˈlekts
recolonization => ,ri:kɔlәnai'zeiʃәn; -ni'z-
recolonize => ri:'kɔlәnaiz
recombinant => ri'kɔmbinәnt
recombination => 'ri:kɔmbi'neiʃәn
recombine => .ri:kәm'bain
recommence => .ri:kә'mens
recommenced => ˈri:kəˈmenst
recommencement => ri:kə'mensmənt
recommences => ˈri:kəˈmensiz
recommencing => ˈri:kəˈmensɪŋ
recommend => .rekә'mend
recommendable => ,rekә'mendәbl
recommendation => .rekәmen'deiʃәn
recommendations => ˌrekəmenˈdeiʃənz
recommendatory => .rekә'mendәtәri
recommending => ˌrekəˈmendɪŋ
recommends => ˌrekəˈmendz
recommission => 'ri:kә'miʃәn
recommit => .ri:kә'mit
recommittal => .ri:kә'mitl
recommitted => ˈri:kəˈmitid
recommitting => ˈri:kəˈmitɪŋ
recompense => 'rekәmpens
recompensed => ˈrekəmˌpenst
recompenses => ˈrekəmˌpensiz
recompensing => ˈrekəmˌpensɪŋ
recompose => .ri:kәm'pәuz
recomposed => ri:kəmˈpəuzd
recomposing => ri:kəmˈpəuzɪŋ
recomposition => .ri:kɒmpә'ziʃәn
recon => 'ri:kɒn
reconceptualization => rekənseptjʊəlaɪzeɪnʃ
reconcilability => ,rekәnsailә'bilәti
reconcilable => 'rekәnsailәbl
reconcile => 'rekәnsail
reconciled => 'rekənsaɪld
reconciler => 'rekənsaɪlə
reconciles => ˈrekənsailz
reconciliation => ,rekәnsili'eiʃәn
reconciliations => ˌrekənsiliˈeiʃənz
reconciliatory => .rekәn'siliәtәri
reconciling => ˈrekənsailɪŋ
recondite => 'rekәndait
recondition => .ri:kәn'diʃәn
reconditioned => ˌri:kənˈdɪʃənd
reconditioning => 'ri:kәn'diʃәniŋ
reconditions => ˌri:kənˈdɪʃənz
reconfiguration => 'ri:kәnfi^ju'reiʃәn
reconfigure => .ri:kәn'fiɡә. -ɡjuә
reconfigured => riːkən'fɪgə
reconfirm => .ri:kәn'fә:n
reconfirmation => ,ri:kɔnfә'meiʃәn
reconfirmed => ˌri:kənˈfɜ:md
reconfirming => ˌri:kənˈfɜ:mɪŋ
reconfirms => ˌri:kənˈfɜ:mz
reconnaissance => ri'kɒnisәns
reconnect => .ri:kә'nekt
reconnection => 'ri:kә'nekʃәn
reconnoiter => .rekә'nɔitә. .ri:-
reconnoitered => ˌri:kəˈnɔɪtəd
reconnoitering => ˌri:kəˈnɔɪtərɪŋ
reconnoiters => ˌri:kəˈnɔɪtəz
reconnoitre => .rekә'nɒitә
reconnoitred => ˌrekəˈnɔitəd
reconnoitres => ˌrekəˈnɔitəz
reconnoitring => 'rekənɔɪtərɪŋ
reconquer => 'ri:'kɔŋkә
reconquest => ri:'kɒŋkwest
reconsider => .ri:kәn'sidә
reconsidered => ˌri:kənˈsɪdəd
reconsidering => ˌri:kənˈsɪdərɪŋ
reconsiders => ˌri:kənˈsɪdəz
reconsignment => ,rikәn'sainmәnt
reconsolidate => .ri:kәn'sɒlideit
reconsolidation => ri:kən,sɔli'deiʃən
reconstitute => .ri:'kɒnstitju:t
reconstituted => ,ri:'kɔnstitju:tid
reconstitutes => ri:ˈkɔnstɪˌtu:ts
reconstituting => ri:ˈkɔnstɪˌtu:tɪŋ
reconstitution => ˌri:ˌkɒnstɪ'tju:ʃn
reconstruct => .ri:kәns'trʌkt
reconstructed => ,ri:kәn'strʌktid
reconstructing => ˌri:kənˈstrʌktɪŋ
reconstruction => .ri:kәn'strʌkʃәn
reconstructions => ˌri:kənˈstrʌkʃənz
reconstructive => .ri:kәn'strʌktiv
reconstructs => ˌri:kənˈstrʌkts
reconvene => .ri:kәn'vi:n
reconvened => ˈri:kənˈvi:nd
reconvenes => ˈri:kənˈvi:nz
reconvening => ˈri:kənˈvi:nɪŋ
reconversion => .ri:kәn'vә:ʃәn
reconvert => .ri:kәn'vә:t
reconverted => ˈri:kənˈvə:tid
reconverting => ˈri:kənˈvə:tɪŋ
reconvict => 'ri:kәn'vikt
reconviction => ,ri:kәn'vikʃәn
recopy => ri:kɔpi
record => ri'kɒ:d
record-breaker => riˈkɔ:d ˈbreikə
record-holder => 'rekɔ:dˌhəʊldə
record-player => re'kɔ:dpl'eɪər
recordable => ri'kɔ:dәbl
recorder => ri'kɒ:dә
recorders => riˈkɔ:dəz
recordership => ri'kɔ:dәʃip
recording => ri'kɒ:diŋ
recordist => ri'kɒ:dist
recount => ri'kaunt
recounted => rɪˈkaʊntid
recounting => rɪˈkaʊntɪŋ
recounts => rɪˈkaʊnts
recoup => ri'ku:p
recouped => rɪˈku:pt
recouping => rɪˈku:pɪŋ
recoups => rɪˈku:ps
recourse => ri'kɒ:s
recover => ri'kʌvә
recoverability => ri,kʌvәrә'biliti
recoverable => ri'kʌvәrәbl
recoveries => rɪ'kʌvərɪz
recovers => riˈkʌvəz
recovery => ri'kʌvәri
recreancy => 'rekriәnsi
recreant => 'rekriәnt
recreate => 'rekrieit
recreated => ˈrekri:ˌeɪtid
recreates => ˈrekri:ˌeɪts
recreating => ˈrekri:ˌeɪtɪŋ
recreation => .rekri'eiʃәn
recreational => .rekri'eiʃәnәl
recreational vehicle => ˌrekriˈeiʃənəl ˈvi:ɪkl
recreations => ˌrekriˈeiʃnz
recreative => 'rekrieitiv
recriminate => ri'krimәneit
recriminated => rɪˈkrɪməˌneɪtid
recriminating => rɪˈkrɪməˌneɪtɪŋ
recrimination => ri.krimi'neiʃәn
recriminations => rɪˌkrɪməˈneɪʃənz
recriminatory => ri'kriminәtәri
recross => 'ri:krɔ(:)s
recrudesce => .ri:kru:'des
recrudesced => ˌri:kru:ˈdest
recrudescence => .ri:kru:'desns
recrudescent => .ri:kru:'desnt
recrudescing => ˌri:kru:ˈdesɪŋ
recruit => ri'kru:t
recruited => riˈkru:tid
recruiter => ri'kru:tә
recruiters => rɪ'kruːtə
recruiting => riˈkru:tɪŋ
recruitment => ri'kru:tmәnt
recruits => riˈkru:ts
recrystallize => ri:'kristәlaiz
recta => 'rektә
rectal => 'rektl
rectangle => 'rektæŋgl
rectangles => ˈrektæŋɡlz
rectangular => rek'tæŋgjulә
rectangularity => ,rektæn^ju'læriti
recti => 'rektai
rectifiable => 'rektifaiәbl
rectification => .rektifi'keiʃәn
rectified => ˈrektifaid
rectifier => 'rektifaiә
rectifies => ˈrektifaiz
rectify => 'rektifai
rectilinearity => rektɪlɪ'nərɪtɪ
rectitude => 'rektitju:d
recto => 'rektәu
rectocele => 'rektәsi:l
rector => 'rektә
rectorate => 'rektәrit
rectorial => rek'tɒ:riәl
rectories => ˈrektəri:z
rectors => ˈrektəz
rectorship => 'rektәʃip
rectory => 'rektәri
rectrices => 'rektraɪsɪz
rectum => 'rektәm
rectums => ˈrektəmz
rectus => 'rektәs
recumbency => ri'kʌmbәnsi
recumbent => ri'kʌmbәnt
recumbently => riˊkʌmbәntli
recuperate => ri'kju:pәreit
recuperated => rɪˈku:pəˌreɪtid
recuperates => rɪˈku:pəˌreɪts
recuperating => rɪˈku:pəˌreɪtɪŋ
recuperation => ri.kju:pә'reiʃәn
recuperative => ri'kju:pәreitiv
recuperator => ri'kju:pәreitә
recur => ri'kә:
recurred => riˈkə:d
recurrence => ri'kʌrәns
recurrences => riˈkʌrənsiz
recurrent => ri'kʌrәnt
recurrently => rɪ'kʌrəntlɪ
recurs => riˈkə:z
recursion => ri'kә:ʃәn
recursive => ri'kә:siv
recurvature => ri'k\\\\:vәtʃә(r)
recurve => ri:'kә:v
recurved => ,ri:'k\\\\:vd, ri-
recusal => ri'kju:zәl
recusancy => 'rekjuznsi
recusant => 'rekjuznt
recuse => ri'kju:z
recused => riˈkju:zd
recuses => riˈkju:ziz
recusing => riˈkju:zɪŋ
recut => reɪ'kʌt
recyclable => ˌri:ˈsaɪkləbl
recycle => .ri:'saikl
recycled => ˌri:ˈsaikld
recycles => ˌri:ˈsaiklz
red => red
red admiral => red ˈædmərəl
red box => red bɔks
red card => red kɑ:d
red coral => red ˈkɔrəl
red dog => red dɔɡ
red dwarf => red dwɔ:f
red fox => red fɔks
red giant => red ˈdʒaiənt
red mullet => red ˈmʌlit
red pepper => red ˈpepə
red pine => red pain
red ribbon => red ˈribən
red setter => red ˈsetə
red squirrel => red ˈskwirəl
red star => red stɑ:
red top => red tɔp
red zone => red zəun
red-bait => 'redbeit
red-baiter => 'red,beitә(r)
red-faced => ˈredˈfeɪst
red-handed => 'red'hændid
red-headed => red ˈhedid
red-hot poker => ˈredˈhɔt ˈpəʊkə
red-letter day => ˈredˈletə dei
redact => ri'dækt
redacting => rɪ'dækt
redaction => ri'dækʃәn
redactor => ri'dæktә
redacts => rɪ'dækt
redan => ri'dæn
redback => 'redbæk
redbone => 'redbәjn
redbreast => 'redbrest
redbrick => 'redbrik
Redbridge => 'redbridʒ
redbud => 'redbʌd
redcap => 'redkæp
redcoat => 'redkәut
redcoats => 'redkəʊt
redcurrants => ,red'kʌrənt
redd => red
redden => 'redn
reddened => ˈrednd
reddening => 'rednɪŋ
reddens => ˈrednz
reddish => 'rediʃ
reddle => 'redl
rede => ri:d
redecorate => 'ri:'dekәreit
redecorated => ri:ˈdekəˌreɪtid
redecorates => ri:ˈdekəˌreɪts
redecorating => ri:ˈdekəˌreɪtɪŋ
redecoration => ˌri:ˌdekə'reɪʃn
reded => riːd
redeem => ri'di:m
redeemable => ri'di:mәbl
redeemer => ri'di:mә
redeemers => ri'di:mə
redeeming => ri'di:miŋ
redeems => riˈdi:mz
redefine => .ri:di'fain
redefined => 'ri:dɪ'faɪnd
redefines => ˈri:diˈfainz
redefinition => .ri:defi'niʃәn
redemption => ri'dempʃәn
redemptions => rɪˈdempʃənz
redemptive => ri'demptiv
redeploy => .ri:di'plɒi
redeployed => ˌri:diˈplɔid
redeploying => ˌri:diˈplɔiŋ
redeployment => ˌri:dɪ'plɔɪmənt
redeploys => ˌri:diˈplɔiz
redeposit => 'ri:di'pɔzit
redeposition => 'ri:depә'ziʃәn
redes => riːd
redescription => ,ri:di'skripʃәn
redesign => ,ri:di'zain
redesignate => ri:'dezi^neit
redesigned => ˌri:diˈzaind
redesigning => ˌri:diˈzainɪŋ
redesigns => ˌri:diˈzainz
redetermination => 'ri:di,tə:mi'neiʃən
redetermine => 'ri:di'tә:min
redevelop => ,ri:di'velәp
redeveloped => ˌri:diˈveləpt
redeveloper => ri:dɪ'veləpər
redeveloping => ˌri:diˈveləpɪŋ
redevelopments => ,ridɪ'vɛləpmənt
redevelops => ˌri:diˈveləps
redfish => 'redfiʃ
redhead => 'redhed
redheads => ˈredˌhedz
redial => ˈri:daɪəl
redid => ri:'did
rediffusion => .ri:di'fju:ʒәn
redingote => 'rediŋ^әut
redintegrate => re'dintigreit
redintegration => re.dinti'greiʃәn
redirect => .ri:di'rekt
redirected => ˌri:dɪˈrektid
redirecting => ˌri:dɪˈrektɪŋ
redirection => .ri:di'rekʃәn
redirects => ˌri:dɪˈrekts
rediscount => ri:'diskaunt
rediscover => .ri:dis'kʌvә
rediscovered => ri:dɪs'kʌvəd
rediscovers => ri:diˈskʌvəz
rediscovery => .ri:dis'kʌvәri
redissolve => 'ri:di'zɔlv
redistribute => .ri:di'stribjut
redistributed => ˌri:dɪˈstrɪbju:tid
redistributes => ˌri:dɪˈstrɪbju:ts
redistributing => ˌri:dɪˈstrɪbju:tɪŋ
redistribution => 'ri:distri'bju:ʃәn
redistributionist => ,ri:distri'bju:ʃәnist
redistributive => ˌri:dɪ'strɪbjətɪv
redistrict => ri:'distrikt
redistricting => 'ri:'distriktiŋ
redivide => .ri:di'vaid
redivision => dj:,riːdɪ'vɪʒən
redivivus => .redi'vaivәs
redline => 'redlain
redly => 'redlɪ
redmond => 'redmәnd
redneck => 'rednek
rednecked => 'rednek
rednecks => ˈredˌneks
redness => 'rednis
redo => .ri:'du:
redoes => ˌri:ˈdʌz
redoing => ri:ˈdu:ɪŋ
redolence => 'redәjlәns
redolent => 'redәulәnt
redone => .ri:'dʌn
redouble => ri'dʌbl
redoubled => ri:ˈdʌbəld
redoubles => ri:ˈdʌbəlz
redoubling => rɪ'dʌblɪŋ
redoubt => ri'daut
redoubtable => ri'dautәbl
redoubts => riˈdauts
redound => ri'daund
redounded => rɪˈdaʊndid
redounding => rɪˈdaʊndɪŋ
redounds => rɪˈdaʊndz
redox => ri'dɒks
redpoll => 'redpәul
redraft => .ri:'dræft
redraw => .ri:'drɒ:
redress => ri'dres
redressal => ri'dresәl
redressed => rɪˈdrest
redresser => 'rɪdresɜ:
redresses => rɪˈdresiz
redressing => rɪˈdresɪŋ
redshank => 'redʃæŋk
redshift => 'redʃɪft
redshifted => 'red,ʃift
redshirt => red'ʃɜ:t
redskin => 'redski:n
redstart => 'redstɑ:t
reduce => ri'dju:s
reduced => ri'dju:st
reducer => ri'dju:sә
reducibility => ri,dju:sә'biliti
reducible => ri'dju:sәbl
reducing => ri'dju:siŋ
reductant => ri'dʌktәnt
reductase => ri'dʌkteis
reductio ad absurdum => ri'dʌkʃiәu æd әb'sә:dәm
reduction => ri'dʌkʃәn
reductionism => ri'dʌkʃәnizm
reductionist => rɪ'dʌkʃənɪst
reductions => riˈdʌkʃənz
reductive => ri'dʌktiv
reductivism => ri'dʌktivizәm
reductivist => ri'dʌktivist
redundancies => rɪˈdʌndənsi:z
redundancy => ri'dʌndәnsi
redundant => ri'dʌndәnt
redundantly => rɪ'dʌndəntlɪ
reduplicate => ri'dju:plikeit
reduplicates => rɪ'djuːplɪkeɪt
reduplicating => rɪ'djuːplɪkeɪt
reduplication => ri,dju:pli'keiʃәn
reduplicative => ri'dju:plikeitiv
redux => ri:'dʌks
redware => 'redweә(r)
redwing => 'redwiŋ
redwood => 'redwud
redwoods => ˈredˌwʊdz
redworm => 'redwə:m
Reebok => 'ri:bɔk
reed => ri:d
reed bunting => riːd ˈbʌntɪŋ
reed mace => ri:d meɪs
reed organ => ri:d ˈɔ:ɡən
reed pipe => ri:d paip
reedbuck => 'ri:dbʌk
reeded => 'ri:did
reeding => 'ri:diŋ
reedling => 'ri:dliŋ
reedy => 'ri:di
reef => ri:f
reefer => 'ri:fә(r)
reefer jacket => ˈri:fə ˈdʒækit
reefers => ˈri:fəz
reefs => ri:fs
reek => ri:k
reeked => ri:kt
reeking => 'rɪkɪŋ
reeks => ri:ks
reeky => 'ri:ki
reel => ri:l
reelection => .ri:i'lekʃәn
reeled => ri:ld
reeling => 'ri:liŋ
reels => ri:lz
reengineering => rɪ'endʒɪnɪərɪŋ
reenter => .ri:'entә
reentering => ri:ˈentərɪŋ
reestablish => .ri:is'tæbliʃ
reevaluate => ,ri:i'væljjeit
reeve => ri:v
reeving => ri:vɪŋ
reexamine => .ri:ig'zæmin
reexamined => ˌri:ɪɡˈzæmind
reexamining => ˌri:ɪɡˈzæminɪŋ
ref => ref
reface => .ri:'feis
refaced => ˈri:ˈfeist
refaces => ˈri:ˈfeisiz
refacing => ri:'feɪsɪŋ
refashion => .ri:'fæʃәn
refashioned => ˈri:fæʃənd
refashioning => ˈri:fæʃənɪŋ
refasten => ri:'fɑ:sәn;-'fæ-
refection => ri'fekʃәn
refectories => rɪˈfektəri:z
refectory => ri'fektәri
refer => ri'fә:
referable => ri'fә:rәbl
referee => .refә'ri:
referees => ˌrefəˈri:z
reference => 'refәrәns
referendum => .refә'rendәm
referendums => refə'rendəmz
referent => 'refәrәnt
referential => .refә'renʃәl
referral => ri'fә:rәl
referrals => riˈfə:rəlz
referred pain => rɪˈfɜ:d
referrer => rɪ'fɜːrə
refers => riˈfə:z
reffo => 'refәu
refill => ri:'fil
refillable => ˌri:'fɪləbl
refilled => ri:ˈfɪld
refills => ri:ˈfɪlz
refinance => .ri:fai'næns
refinanced => ˈrifiˈnænst
refinances => ˈrifiˈnænsiz
refinancing => rifi'nænsiŋ
refine => ri'fain
refined => ri'faind
refinement => ri'fainmәnt
refinements => rɪ'faɪnmənts
refiner => ri'fainә
refineries => rɪˈfaɪnəri:z
refiners => riˈfainəz
refinery => ri'fainәri
refines => riˈfainz
refining => ri'fainiŋ
refinish => ri:'finiʃ
refinished => ˈri:ˈfiniʃt
refinishing => ˈri:ˈfiniʃɪŋ
refit => .ri:'fit
refits => ˌri:ˈfits
refitted => ˌri:ˈfitid
refitting => ri:'fɪtɪŋ
refix => ri:'fiks
reflag => ref'læɡ
reflate => .ri:'fleit
reflated => riˈfleitid
reflates => riˈfleits
reflating => riˈfleitɪŋ
reflation => .ri:'fleiʃәn
reflationary => ˌri:'fleɪʃnrɪ
reflect => ri'flekt
reflectance => ri'flektәns
reflected => ri'flektid
reflecting => ri'flektiŋ
reflecting telescope => rɪˈflektɪŋ ˈteliskəup
reflection => ri'flekʃәn
reflective => ri'flektiv
reflectively => rɪˈflektɪvlɪ
reflectivity => .ri:flek'tiviti
reflectometer => ,ri:flek'tɔmitә
reflectometry => -tri
reflector => ri'flektә
reflectors => rɪf'lektəz
reflects => riˈflekts
reflet => rә'fle
reflex => 'ri:fleks
reflex camera => ˈri:ˌfleks ˈkæmərə
reflexes => ˈri:ˌfleksiz
reflexible => ri'fleksәbl
reflexion => ri'flekʃәn
reflexive => ri'fleksiv
reflexivity => rɪflek'sɪvɪtɪ
reflexology => ,ri:flek'sɔlәdʒi
refloat => .ri:'flәut
refloated => ,ri:'fləut
refloating => ,ri:'fləut
refloats => ,ri:'fləut
reflow => ri:'flәu
refluence => 'refluәns
refluent => 'refluәnt
reflux => 'ri:flʌks
refocus => ri:'fәukәs
refocusing => ri:'fəʊkəsɪŋ
refold => ri:'fәuld
reforest => ri:'fɒ:rist
reforestation => .ri:fɒ:ris'teiʃәn
reforge => ri:'fɔ:dʒ
reform => ri'fɒ:m
reformable => ri'fɒ:mәbl
reformat => ri'fɔ:mæt
reformation => .refә'meiʃәn
reformational => refәˊmeiʃәnl
reformative => ri'fɒ:mәtiv
reformatory => ri'fɔ:mәtәri
reformed => ri'fɒ:md
reformer => ri'fɒ:mә
reformers => rɪ'fɔ:məz
reforming => ri'fɔ:miŋ
reformism => ri'fɒ:mizm
reformist => ri'fɒ:mist
reformists => riˈfɔ:mists
reforms => riˈfɔ:mz
reformulate => ri'fɒ:mjuleit
reformulated => ri:ˈfɔ:mjuleitid
reformulating => ri:ˈfɔ:mjuleitɪŋ
reformulation => .ri:fɔ:mju'leiʃәn
refract => ri'frækt
refracted => rɪˈfræktid
refracting => rɪf'ræktɪŋ
refracting telescope => rɪˈfræktɪŋ
refraction => ri'frækʃәn
refractive => ri'fræktiv
refractometer => .ri:fræk'tɒmitә
refractor => ri'fræktә
refractory => ri'fræktәri
refracts => rɪˈfrækts
refrain => ri'frein
refrained => riˈfreind
refraining => rɪ'freɪn
refrains => riˈfreinz
reframe => 'ri:'freim
reframing => ri:f'reɪmɪŋ
refrangibility => ri.frændʒi'biliti
refrangible => ri'frændʒәbl
refreeze => 'ri:'fri:z
refresh => ri'freʃ
refresher => 'ri'freʃә
refreshes => riˈfreʃiz
refreshing => ri'freʃiŋ
refreshingly => rɪ'freʃɪŋlɪ
refreshment => ri'freʃmәnt
refrigerant => ri'fridʒәrәnt
refrigerate => ri'fridʒәreit
refrigerated => rɪf'rɪdʒəreɪtɪd
refrigerates => rɪˈfrɪdʒəˌreɪts
refrigerating => rɪˈfrɪdʒəˌreɪtɪŋ
refrigeration => ri.fridʒә'reiʃәn
refrigerator => ri'fridʒәreitә
refrigerators => rɪf'rɪdʒəreɪtəz
refrigeratory => ri'fridʒәreitәri
refringent => ri'frindʒәnt
refs => refs
reft => reft
refuel => ri:'fju:әl
refuelled => ri:ˈfju:əld
refuelling => ri:f'ju:əlɪŋ
refuels => ri:ˈfju:əlz
refuge => 'refju:dʒ
refugee => .refju'dʒi:
refugees => 'refjʊdʒi:z
refuges => ˈrefju:dʒz
refugium => ri'fju:dʒiәm , ri:-
refulgence => ri'fʌldʒәns
refulgent => ri'fʌldʒәnt
refund => 'ri:fʌnd
refundable => ri'fʌndәbl
refunded => ˈri:fʌndid
refunding => ri:'fʌndiŋ
refunds => ˈri:fʌndz
refurbish => .ri:'fә:biʃ
refurbished => ri:ˈfɜ:bɪʃt
refurbishes => ri:ˈfɜ:bɪʃiz
refurbishing => ri:ˈfɜ:bɪʃɪŋ
refurnish => .ri:'fә:niʃ
refurnished => ˈri:ˈfə:niʃt
refurnishing => ˈri:ˈfə:niʃɪŋ
refusal => ri'fju:zl
refusals => rɪf'ju:zlz
refuse => ri'fju:z
refusenik => rɪˈfju:znɪk
refuses => riˈfju:ziz
refusing => riˈfju:zɪŋ
refutable => 'refjutәbl
refutal => ri'fju:tl
refutation => .refju'teiʃәn
refute => ri'fju:t. ri:-
refuted => riˈfju:tid
refutes => riˈfju:ts
refuting => riˈfju:tɪŋ
REG => redʒ
regain => ri'gein
regained => ri:ˈgeɪnd
regaining => ri:ˈgeɪnɪŋ
regains => ri:ˈgeɪnz
regal => 'ri:gl
regale => ri'geil
regaled => rɪ'geɪl
regalement => rɪ'ɡeɪlmənt
regalia => ri'geiljә
regaling => rɪ'geɪl
regalism => 'ri:gәlizm
regalist => 'ri:^әlist
regality => ri:'gæliti
regally => 'ri:gli
regan => 'ri:^әn
regard => ri'gɑ:d
regardant => ri'gɑ:dәnt
regarded => riˈɡɑ:did
regardful => ri'gɑ:dful
regarding => ri'gɑ:diŋ
regardless => ri'gɑ:dlis
regardlessly => rɪ'ɡɑ:dləslɪ
regardlessness => rɪ'ɡɑ:dləsnəs
regather => ri:'^æðә(r)
regatta => ri'gætә
regattas => rɪ'ɡætəz
regelate => 'ri:dʒileit
regelation => .ri:dʒә'leiʃәn
regencies => ˈri:dʒənsiz
regency => 'ri:dʒәnsi
regenerate => ri'dʒenәreit
regenerated => rɪˈdʒenəˌreɪtid
regenerates => rɪˈdʒenəˌreɪts
regenerating => rɪˈdʒenəˌreɪtɪŋ
regeneration => ri.dʒenә'reiʃәn
regenerative => ri'dʒenәreitiv
regenerator => ri'dʒenәreitә
Regensburg => 'rei^әnsbjrk,-b\\\\:^
regent => 'ri:dʒәnt
Regents => 'riːdʒ(ə)nt
reggae => 're,^ei
regicidal => .redʒi'saidl
regicide => 'redʒisaid
regicides => ˈredʒisaidz
regime => rei'ʒi:m
regimen => 'redʒimen
regimens => ˈredʒəmənz
regiment => 'redʒimәnt
regimental => .redʒi'mentl
regimentals => redʒɪ'mentlz
regimentation => .redʒimen'teiʃәn
regimented => ˈredʒɪmentɪd
regimenting => 'redʒɪm(ə)nt
regiments => ˈredʒimənts
regimes => reɪ'ʒi:mz
Regina => ri'dʒainә
reginald => 'redʒinәld
region => 'ri:dʒәn
regional => 'ri:dʒәnәl
regionalism => 'ri:dʒәnә,lizәm
regionalist => 'ri:dʒәnәlist
regionalization => .ri:dʒәnәlai'zeiʃәn
regionalize => 'ri:dʒәnәlaiz
regionally => 'ri:dʒәnәli
regis => 'ri:dʒis
regisseur => ,reiʒi'sә:
register => 'redʒistә
registered => 'redʒistәd
registering => 'redʒistәriŋ
registrable => 'redʒistrәbl
registrant => 'redʒistrәnt
registrants => 'redʒɪstr(ə)nt
registrar => 'redʒistrɑ:
registrars => ˈredʒɪˌstrɑ:z
registrary => 'redʒistrәri
registration => .redʒi'streiʃәn
registration number => ˌredʒɪˈstreɪʃən ˈnʌmbə
registrations => ˌredʒɪˈstreɪʃənz
registries => ˈredʒɪstri:z
registry => 'redʒistri
regius => 'ri:dʒiәs
reglaze => ri:'^leiz
reglazing => ri:'^leiziŋ
reglet => 're^let
regnal => 'regnәl
regnant => 'regnәnt
regolith => 're^әliθ
regorge => ri:'gɒ:dʒ
regorged => riˈɡɔ:dʒd
regorges => riˈɡɔ:dʒz
regorging => riˈɡɔ:dʒɪŋ
regrade => ri'^rɑ:d, ri:'^reid
regrading => rɪɡ'reɪdɪŋ
regress => 'ri:^res
regressed => rɪˈɡrest
regresses => rɪˈɡresiz
regressing => rɪˈɡresɪŋ
regression => ri'greʃәn
regressive => ri'gresiv
regret => ri'gret
regretful => ri'gretful
regretfully => rɪˈgretfəli
regretfulness => ri'ɡretful
regrets => riˈɡrets
regrettable => ri'gretәbl
regrettably => ri'^retәbli
regretted => rɪɡ'retɪd
regroup => 'ri:'^ru:p
regrouped => ri:ˈgru:pt
regrouping => ri:ˈgru:pɪŋ
regroupment => ˊriːgruːpmәnt
regroups => ri:ˈgru:ps
regrow => ri:'ɡrәu
regrowing => ri:ɡreuɪŋ
regrowth => 'reɡrəʊθ
regs => reɡs
regulable => 're^julәbl
regular => 'regjulә
regularise => 're^jjlәraiz
regularities => reɡjʊ'lærɪtɪz
regularity => .regju'læriti
regularization => ,re^julәrai'zeiʃәn
regularize => 'regjulәraiz
regularized => ˈreɡjuləraizd
regularizes => ˈreɡjuləraiziz
regularizing => ˈreɡjuləraizɪŋ
regularly => 'regjulәli
regulars => ˈreɡjuləz
regulate => 'regjuleit
regulates => ˈreɡjuleits
regulating => 're^juleitiŋ
regulation => .regju'leiʃәn
regulative => 'regjuleitiv
regulator => 'regjuleitә
regulators => 'regjʊleɪtəz
regulatory => 'regjulәtәri
reguline => 'reɡjʊlɪn
regulo => 'reɡjʊləʊ
regulus => 'regjulәs
regurgitate => ri'gә:dʒiteit
regurgitated => ri:ˈgɜ:dʒɪˌteɪtid
regurgitates => ri:ˈgɜ:dʒɪˌteɪts
regurgitating => rɪ'gɜːdʒɪteɪt
regurgitation => ri.gә:dʒi'teiʃәn
rehab => 'ri:hæb
rehabilitate => .ri:hә'biliteit
rehabilitated => ˌri:həˈbiliteitid
rehabilitates => ˌri:həˈbiliteits
rehabilitating => ˌri:həˈbiliteitɪŋ
rehabilitation => 'ri:(h)ә,bili'teiʃәn
rehabilitative => .ri:hә'biliteitiv
rehang => ri:'hæŋ
rehash => .ri:'hæʃ
rehashed => riː'hæʃ
rehashes => riː'hæʃ
rehear => .ri:'hiә
reheard => ˌri:ˈhɜ:d
rehearsal => ri'hә:sl
rehearsals => riˈhə:səlz
rehearse => ri'hә:s
rehearsed => rɪˈhɜ:st
rehearses => rɪˈhɜ:siz
rehearsing => rɪˈhɜ:sɪŋ
reheat => ri:'hi:t
reheated => ˌri:ˈhi:tid
reheater => 'ri:'hi:tә
reheating => ri:'hi:tiŋ
reheats => ˌri:ˈhi:ts
rehire => ri:'haiә
rehoboam => ˌri:əˈbəʊəm
rehome => ˌri:'həʊm
rehouse => 'ri:'hauz
rehousing => ri'haʊz
rehydrate => ri'hai,dreit
rehydrated => riˈhaiˌdreitid
rehydration => ,ri:hai'dreiʃәn
reich => raik
Reichsmark => 'raiksmɑ:k
Reichstag => 'raikstɑ:^
reid => ri:d
reification => .ri:ifi'keiʃәn
reified => ˈri:iˌfaid
reify => 'ri:ifai
reifying => ˈri:iˌfaiŋ
reign => rein
reign of terror => rein ɔv ˈterə
reigning => 'reiniŋ
reignite => ,ri:i^'nait
reignited => ˌri:iɡˈnaitid
reigniting => ˌri:iɡˈnaitɪŋ
reigns => reinz
reimburse => .ri:im'bә:s
reimbursed => ˌri:ɪmˈbɜ:st
reimbursement => .ri:im'bә:smәnt
reimbursements => ˌri:ɪmˈbɜ:smənts
reimburses => ˌri:ɪmˈbɜ:siz
reimbursing => ˌri:ɪmˈbɜ:sɪŋ
reimport => 'ri:im'pɔ:t
reimportation => ,ri:impɔ:'teiʃәn
reimpose => .ri:im'pәuz
reimposition => ri:ɪmpə'zɪʃn
REIMS => ri:mz,ræŋs
rein => rein
reincarnate => .ri:in'kɑ:neit
reincarnated => ˌri:ɪnˈkɑ:neɪtid
reincarnates => ˌri:ɪnˈkɑ:neɪts
reincarnating => ˌri:ɪnˈkɑ:neɪtɪŋ
reincarnation => .ri:inkɑ:'neiʃәn
reincarnations => ˌri:ɪnkɑ:ˈneɪʃənz
reincorporate => .ri:in'kɔ:pәreit
reincorporation => ri:ɪnkɔ:pə'reɪʃn
reindeer => 'rein.diә
reined => reind
reinfect => .ri:in'fekt
reinfection => .ri:in'fekʃәn
reinflate => ,ri:in'fleit
reinflation => -'fleiʃәn
reinforce => .ri:in'fɒ:s
reinforcement => .ri:in'fɒ:smәnt
reinforcer => ,ri:in'fɔ:sә(r)
reinforces => ˌri:ɪnˈfɔ:siz
reinhabit => ,ri:in'hæbit
reinhold => 'rainhәuld
reining => reinɪŋ
reins => reinz
reinsert => .ri:in'sә:t
reinsertion => 'ri:in'sә:ʃәn
reinstall => .ri:in'stɔ:l
reinstallation => ri:ɪnstə'leɪʃn
reinstalled => ˌri:inˈstɔ:ld
reinstalling => ˌri:ɪn'stɔ:lɪŋ
reinstate => .ri:in'steit
reinstated => 'ri:ɪn'steɪtɪd
reinstates => ˌri:ɪnˈsteɪts
reinstating => ˌri:ɪnˈsteɪtɪŋ
reinstitution => 'ri:insti'tju:ʃәn
reinsurance => .ri:in'ʃurәns
reinsure => .ri:in'ʃuә
reinsured => ri:ɪn'ʃʊəd
reinsures => ˈri:inˈʃuəz
reinsuring => ˈri:inˈʃuərɪŋ
reintegrate => ri'intigreit
reintegrated => ˈri:ˈintiɡreitid
reintegrating => ˈri:ˈintiɡreitɪŋ
reinter => .ri:in'tә:
reinterpret => .ri:in'tә:prit
reinterpretation => ˌri:ɪnˌtɜ:prɪ'teɪʃn
reinterpreted => ˌriinˈtə:pritid
reinterpreting => ˌriinˈtə:pritɪŋ
reintroduce => ri:intrә'dju:s
reintroduced => ˈri:ˌintrəˈdju:st
reintroduces => ˈri:ˌintrəˈdju:siz
reintroducing => ˈri:ˌintrəˈdju:sɪŋ
reintroduction => .ri:intrә-'dʌkʃәn
reinvade => ,ri:in'veid
reinvent => .ri:in'vent
reinvented => ˌri:inˈventid
reinventing => ˌri:inˈventɪŋ
reinvention => ri:ɪn'venʃn
reinvents => ˌri:inˈvents
reinvest => .ri:in'vest
reinvested => ˈri:inˈvestid
reinvestigate => ,ri:in'vesti^eit
reinvestment => ,ri:in'vestmәnt
reinvigorate => .ri:in'vigәreit
reinvigorated => ˈri:inˈviɡəreitid
reinvigorating => ˈri:inˈviɡəreitɪŋ
reinvigoration => 'ri:in,viɡə'reiʃən
reissue => .ri:'isju:
reissued => ˌri:ˈisju:d
reissues => ˌri:ˈisju:z
reissuing => ˌri:ˈisju:ɪŋ
reiterate => ri:'itәreit
reiterated => ri:'ɪtəreɪt
reiterates => ri:ˈɪtəˌreɪts
reiterating => ri:ˈɪtəˌreɪtɪŋ
reiteration => .ri:itә'reiʃәn
reiterations => ri:,itə'reiʃən
reiterative => .ri:'itәreitiv
reive => 'ri:v
reiver => 'ri:vә
reject => ri'dʒekt
rejected => riˈdʒektid
rejecter => ri'dʒektә
rejecting => riˈdʒektɪŋ
rejection => ri'dʒekʃәn
rejection slip => ri'dʒekʃ(ә)n
rejectionist => ri'dʒekʃənist
rejections => rɪd'ʒekʃnz
rejective => ri'dʒektiv
rejector => ri'dʒektә
rejig => ˌri:ˈdʒɪg
rejigged => ri:d'ʒɪɡd
rejigger => 'ri:'dʒi^ә
rejigging => ri:d'ʒɪɡɪŋ
rejigs => ri:ˈdʒɪgz
rejoice => ri'dʒɒis
rejoiced => riˈdʒɔist
rejoices => riˈdʒɔisiz
rejoicing => ri'dʒɒisiŋ
rejoin => ri'dʒɒin
rejoinder => ri'dʒɒindә
rejoinders => rɪˈdʒɔɪndəz
rejoined => rɪˈdʒɔɪnd
rejoins => rɪˈdʒɔɪnz
rejuvenate => ri'dʒu:vineit
rejuvenates => rɪˈdʒu:vəˌneɪts
rejuvenating => rɪˈdʒu:vəˌneɪtɪŋ
rejuvenator => ri'dʒu:vineitә
rejuvenescence => .ri:dʒu:vi'nesns
rejuvenescent => .ri:dʒu:vә'nesnt
rekindle => .ri:'kindl
rekindled => ri:ˈkɪndld
rekindles => ri:ˈkɪndlz
rekindling => ri:'kɪndlɪŋ
relabel => .ri:'leibәl
relaid => ,ri:'leid
relapse => ri'læps
relapsed => rɪˈlæpst
relapses => rɪˈlæpsiz
relate => ri'leit
related => ri'leitid
relatedness => rɪ'leɪtɪdnəs
relater => ri'leitә(r)
relation => ri'leiʃәn
relational => ri'leiʃәnәl
relationally => ri'leiʃənəl
relationship => ri'leiʃәnʃip
relationships => rɪ'leɪʃnʃɪps
relatival => .relә'taivәl
relative => 'relәtiv
relative clause => ˈrelətiv klɔ:z
relative pronoun => ˈrelətiv ˈprəunaun
relatively => 'relәtivli
relativism => 'relәtivizm
relativist => 'relәtivist
relativistic => .relәti'vistik
relativity => .relә'tiviti
relativize => 'relәti,vaiz
relativized => 'relətɪvaɪz
relativizing => 'relətɪvaɪz
relator => ri'leitә
relaunch => ˌri:ˈlɔ:ntʃ
relax => ri'læks
relaxant => ri'læksәnt
relaxation => .ri:læk'seiʃәn
relaxations => ˌri:lækˈseɪʃənz
relaxed => ri'lækst
relaxedly => ri'læksidli
relaxes => riˈlæksiz
relaxin => ri'læksin
relay => 'ri:lei
relayed => rɪ'le
relays => ˈri:leiz
relearn => ri:'l\\\\:n
relearned => ri:ˈlə:nd
relearning => rɪ'lɜ:nɪŋ
releasable => ri'li:sәbl
release => ri'li:s
releasee => ri.li:'si:
releaser => ri'li:sә
releasor => ri'li:sә
relegate => 'religeit
relegated => ˈreliɡeitid
relegates => ˈreliɡeits
relegating => ˈreliɡeitɪŋ
relegation => .reli'geiʃәn
relent => ri'lent
relented => rɪˈlentid
relenting => ri'lentiŋ
relentless => ri'lentlis
relents => rɪˈlents
relet => .ri:'let
relevance => 'relivәns
relevancy => 'relәvәnsi
relevant => 'relivәnt
reliability => ri.laiә'biliti
reliable => ri'laiәbl
reliableness => riˊlaiәblnis
reliably => ri'laiәbli
reliance => ri'laiәns
reliant => ri'laiәnt
relic => 'relik
relict => 'relikt
relied => riˈlaid
relief => ri'li:f
relief road => riˈli:f roʊd
reliefs => riˈli:fs
relies => riˈlaiz
relievable => ri'li:vәbl
relieve => ri'li:v
relieved => ri'li:vd
relievedly => rɪ'li:vɪdlɪ
reliever => ri'li:vә
relievers => rɪ'livɚ
relieves => riˈli:vz
relieving => ri'li:viŋ
relievo => ri'li:vәu
relight => ri:'lait. 'ri:lait
religion => ri'lidʒәn
religionism => ri'lidʒәnizәm
religionist => ri'lidʒәnist
religiose => ri'lidʒiәus
religiosity => ri.lidʒi'ɒsiti
religious => ri'lidʒәs
reline => .ri:'lain
relined => ˈri:ˈlaind
relinquish => ri'liŋkwiʃ
relinquished => rɪˈlɪŋkwɪʃt
relinquishes => rɪˈlɪŋkwɪʃiz
relinquishing => rɪˈlɪŋkwɪʃɪŋ
reliquaries => ˈrelikwəriz
reliquary => 'relikwәri
reliquiae => ri'likwii:
relish => 'reliʃ
relished => ˈreliʃt
relishes => ˈreliʃiz
relishing => ˈreliʃɪŋ
relive => ri:'liv
relived => ri:ˈlɪvd
relives => ri:ˈlɪvz
reliving => ri:ˈlɪvɪŋ
reload => ri:'lәud
reloaded => ri:ˈləʊdid
reloads => ri:ˈləʊdz
relocate => ri:'lәukeit
relocated => ri:ˈləʊkeɪtid
relocates => riːlə(ʊ)'keɪt
relocation => .ri:lәu'keiʃәn
reluctance => ri'lʌktәns
reluctant => ri'lʌktәnt
reluctantly => rɪ'lʌktəntlɪ
relume => ri'lju:m
rely => ri'lai
relying => riˈlaiŋ
REM => rem
remain => ri'mein
remainder => ri'meindә
remaindered => rɪ'meɪndə
remainders => riˈmeindəz
remained => riˈmeind
remains => ri'meins
remake => ri'meik
remakes => ri:ˈmeɪks
remaking => ri:ˈmeɪkɪŋ
reman => ri:'mæn
remand => ri'mɑ:nd
remand centre => rɪˈmænd ˈsentə
remanded => rɪˈmændid
remanding => rɪˈmændɪŋ
remands => rɪˈmændz
remanence => 'remәnәns
remanent => 'remәnәnt
remanufacture => ri:,mænjj'fæktʃә(r)
remanufactured => ri:,mænju'fæktʃə
remap => 'ri:,mæp
remapping => rɪ'mæpɪŋ
remark => ri'mɑ:k
remarkable => ri'mɑ:kәbl
remarkableness => riˊmaːkәblnis
remarkably => ri'mɑ:kәbli
remarked => riˈmɑ:kt
remarking => riˈmɑ:kɪŋ
remarriage => .ri:'mæridʒ
remarried => ˌri:ˈmærɪd
remarries => ˌri:ˈmærɪz
remarry => .ri:'mæri
remarrying => ˌri:ˈmærɪŋ
remaster => ri:'mɑ:stә(r);-'mæs-
remastered => ri:ˈmɑ:stəd
rematch => 'ri:'mætʃ
Rembrandt => 'rembrænt
remeasure => ri:'meʒә. -'mei-
remediable => ri'mi:djәbl
remedial => ri'mi:diәl
remedially => rɪ'mi:dɪəlɪ
remediate => rɪ'mi:dɪeɪt
remediation => ,ri,midi'eiʃәn
remedied => ˈremidid
remedy => 'remidi
remedying => ˈremidiŋ
remember => ri'membә
remember oneself => riˈmembə wʌnˈself
remembered => riˈmembəd
remembers => riˈmembəz
remembrance => ri'membrәns
remembrancer => ri'membrәnsә
remembrances => rɪ'membrənsɪz
remex => 'ri:meks
remiges => 'remi,dʒi:z
remilitarization => ,ri:militәrai'zeiʃәn;-ri'z-
remilitarize => .ri:'militәraiz
remind => ri'maind
reminded => riˈmaindid
reminder => ri'maindә
reminders => rɪ'maɪndəz
remindful => ri'maindful
reminding => riˈmaindɪŋ
reminds => riˈmaindz
remineralize => riː'mɪnərəlaɪz
remington => 'remiŋtәn
reminisce => .remi'nis
reminisced => ˌreməˈnɪst
reminiscence => .remi'nisns
reminiscences => remɪ'nɪsnsɪz
reminiscent => .remi'nisnt
reminiscential => ,remini'senʃәl
reminiscently => ˌremə'nɪsntlɪ
reminisces => ˌreməˈnɪsiz
reminiscing => ˌreməˈnɪsɪŋ
remise => ri'mais
remiss => ri'mis
remissible => ri'misibl
remission => ri'miʃәn
remissly => rɪ'mɪslɪ
remit => ri'mit
remits => rɪˈmɪts
remittal => ri'mitl
remittance => ri'mitns
remittances => rɪˈmɪtnsiz
remitted => rɪˈmɪtid
remittent => ri'mitәnt
remitter => ri'mitә
remitting => rɪˈmɪtɪŋ
remix => ri:'miks
remixer => ˌri:'mɪksə(r)
remnant => 'remnәnt
remnants => 'remnənts
remodel => ri:'mɒdl
remodeled => ri:'mɔdld
remodelled => ri:ˈmɔdld
remodelling => ri:ˈmɔdlɪŋ
remodels => ri:ˈmɔdlz
remodification => ,ri:mɔdifi'keiʃәn
remodify => 'ri:'mɔdifai
remold => ri'mәuld
remonetization => ri:,mʌnitai'zeiʃən; -,mɔ-; -ti'z-
remonetize => ri:'mɒnitaiz
remonstrance => ri'mɒnstrәns
remonstrate => ri'mɒnstreit
remonstrated => rɪˈmɔnˌstreɪtid
remonstrates => rɪˈmɔnˌstreɪts
remonstrating => rɪˈmɔnˌstreɪtɪŋ
remonstration => .ri:mɒn'streiʃәn
remonstrative => ri'mɒnstrәtiv
remonstrator => ri'mɒnstreitә
remontant => ri'mɔntәnt
remora => 'remәrә
remorse => ri'mɒ:s
remorseful => ri'mɒ:sful
remorsefully => rɪ'mɔ:sfəlɪ
remorseless => ri'mɒ:slis
remorselessly => rɪ'mɔ:sləslɪ
remortgage => ri:'mɔ:^idʒ
remote => ri'mәut
remote-controlled => riˈməut kənˈtrəuld
remoteness => ri'mәutnis
remoter => riˈməutə
remoulade => ,reimә'lɑ:d
remould => 'ri:'mәuld
remoulded => ˈri:ˈməuldid
remoulding => ˈri:ˈməuldɪŋ
remoulds => ˈri:ˈməuldz
remount => ri:'maunt
remounted => ˈri:ˈmauntid
remounting => ˈri:ˈmauntɪŋ
remounts => ˈri:ˈmaunts
removability => ri.mu:vә'biliti
removable => ri'mu:vәbl
removal => ri'mu:vl
removal van => riˈmu:vəl væn
removalist => ri'mu:vәlist
removals => riˈmu:vəlz
remove => ri'mu:v
removed => ri'mu:vd
remover => ri'mu:vә
removers => riˈmu:vəz
removing => ri'mu:viŋ
remuda => ri'mu:dә
remunerate => ri'mju:nәreit
remunerated => rɪˈmju:nəˌreɪtid
remunerates => rɪˈmju:nəˌreɪts
remunerating => rɪˈmju:nəˌreɪtɪŋ
remuneration => ri.mju:nә'reiʃәn
remunerations => rɪ,mjuːnə'reɪʃ(ə)n
remunerative => ri'mju:nәreitiv
remus => 'ri:mәs
renaissance => ri'neisәns
renal => 'ri:nl
rename => .ri:'neim
renamed => ˌri:ˈneɪmd
renames => ˌri:ˈneɪmz
renascence => ri'næsns
renascent => ri'næsnt
Renata => rә'nɑ:tә
renationalise => riː'næʃənəlaɪz
renault => rә'nәu
rencontre => ren'kɔntә
rencounter => ren'kauntә
rend => rend
render => 'rendә
render-set => 'rendəset
rendering => 'rendәriŋ
renders => ˈrendəz
rendezvous => 'rɒndivu:
rendezvoused => ˈrɑ:ndeɪˌvu:d
rendezvouses => ˈrɑ:ndeɪˌvu:z
rendezvousing => 'rɒndɪvu:zɪŋ
rending => rendɪŋ
rendition => ren'diʃәn
renditions => renˈdɪʃənz
rends => rendz
rendzina => ren'dʒi:nә
rene => 'renei
renegade => 'renigeid
renegades => ˈrenɪˌgeɪdz
renegado => ,reni'^eidәu, -'^ɑ:-
renege => ri'ni:g
reneged => rɪˈnɪgd
reneges => rɪˈnɪgz
reneging => rɪˈnɪgɪŋ
renegotiable => ,ri:ni'^әjʃiәbl
renegotiate => .ri:ni'gәuʃieit
renegotiated => ˈri:niˈɡəuʃi:ˌeitid
renegotiating => ˈri:niˈɡəuʃi:ˌeitɪŋ
renew => ri'nju:
renewable => ri'nju(:)әbl
renewables => rɪ'nuəblz
renewal => ri'nju:әl
renewals => rɪn'ju:əlz
renewed => ri'nju:d
renews => riˈnju:z
Renfrew => 'renfru:
Renfrewshire => 'renfru:ʃiә(r)
reniform => 'renifɒ:m
renin => 'ri:nin
Rennes => ren
rennet => 'renit
rennin => 'renin
reno => 'ri:nәu
renominate => ri:'nɒmineit
renomination => .ri:nɒmi'neiʃәn
renormalization => 'ri:nɔ:mәlai'zeiʃәn
renounce => ri'nauns
renounced => riˈnaunst
renouncement => rɪ'naʊnsmənt
renounces => riˈnaunsiz
renouncing => riˈnaunsɪŋ
renovate => 'renәuveit
renovated => ˈrenəveitid
renovates => ˈrenəveits
renovating => 'renəveɪtɪŋ
renovation => .renәu'veiʃәn
renovator => 'renәuveitә
renown => ri'naun
renowned => ri'naund
rent => rent
rent boy => rent bɔi
rental => 'rentl
rental library => ˈrentl ˈlaibrəri
renter => 'rentә
rentier => 'rɔntiei
renumber => ri:'nʌmbә
renunciant => ri'nʌnsiәnt
renunciation => ri.nʌnsi'eiʃәn
renvoi => ren'vɒi
reoccupation => ri:ɒkjʊ'peɪʃən
reoccupy => .ri:'ɒkjupai
reopen => .ri:'әupәn
reopened => ri:ˈəʊpənd
reopening => ri:ˈəʊpənɪŋ
reopens => ri:ˈəʊpənz
reorder => .ri:'ɒ:dә
reordered => ˈri:ˈɔ:dəd
reordering => ri':ɔ:dərɪŋ
reorders => ˈri:ˈɔ:dəz
reorganisation => 'ri:,ɔ:gənai'zeiʃən
reorganization => 'ri:,ɔ:^әnai'zeiʃәn
reorganizations => ri:ˌɔ:gənɪˈzeɪʃənz
reorganize => .ri:'ɒ:gәnaiz
reorganized => ri:ˈɔ:gəˌnaɪzd
reorganizes => ri:ˈɔ:gəˌnaɪziz
reorganizing => ri:ˈɔ:gəˌnaɪzɪŋ
reorient => .ri:'ɒ:rient
reorientate => .ri:'ɒ:rienteit
reorientated => ,ri:'ɔ:rienteit, -'əu-
reorientates => ,ri:'ɔ:rienteit, -'əu-
reorientating => ,ri:'ɔ:rienteit, -'əu-
reorientation => 'ri:,ɔrien'teiʃәn
reoriented => ˈri:ˈɔ:rientid
reorienting => ˈri:ˈɔ:rientɪŋ
reorients => ˈri:ˈɔ:rients
reovirus => ,ri:әu'vaiәrәs
rep => rep
repack => re'pæk
repackage => ri:'pækidʒ
repackaged => riˈpækidʒd
repackaging => riˈpækidʒɪŋ
repaid => ri:'peid
repaint => ri:'peint
repainted => ri:ˈpeɪntid
repainting => ri:'peɪntɪŋ
repair => ri'pєә
repairable => ri'pєәrәbl
repaired => riˈpɛəd
repairman => ri'pєәmæn
repairmen => men
repaper => 'ri:'peipә
reparable => 'repәrәbl
reparation => .repә'reiʃәn
reparative => 'repәrәtiv
repartee => ,repɑ:'ti:
repartition => .ri:pɑ:'tiʃәn
repass => .ri:'pɑ:s
repast => ri'pɑ:st
repasts => riˈpɑ:sts
repat => ri:'pæt
repatriate => ri:'pætrieit
repatriated => ri:ˈpeɪtri:ˌeɪtid
repatriates => ri:ˈpeɪtri:ˌeɪts
repatriating => ri:ˈpeɪtri:ˌeɪtɪŋ
repatriation => .ri:pætri'eiʃәn
repay => ri'pei
repayable => ri'peiәbl
repaying => ri:ˈpeiŋ
repayment => ri'peimәnt
repayments => ri:ˈpeimənts
repays => ri:ˈpeiz
repeal => ri'pi:l
repealed => riˈpi:ld
repealing => riˈpi:lɪŋ
repeals => riˈpi:lz
repeat => ri'pi:t
repeatable => ri'pi: tәbl
repeated => ri'pi:tid
repeatedly => ri'pi:tidli
repeater => ri'pi:tә
repeating => ri'pi:tiŋ
repeats => riˈpi:ts
repel => ri'pel
repellant => ri'pelәnt
repellence => ri'pelәns
repellency => ri'pelәnsi
repellent => ri'pelәnt
repellently => ri'pelənt
repellents => rɪˈpelənts
repelling => riˈpelɪŋ
repels => riˈpelz
repent => ri'pent
repentance => ri'pentәns
repentant => ri'pentәnt
repented => rɪˈpentid
repenting => rɪˈpentɪŋ
repents => rɪˈpents
repeople => ri:'pi:pl
repercussion => .ri:pә'kʌʃәn
repercussions => ri:pə(:)'kʌʃəns
reperfusion => ri:pərf'ju:ʒn
repertoire => 'repәtwɑ:
repertory => 'repәtәri
repertory company => ˈrepəˌtɔ:ri: ˈkʌmpəni
repetend => 'repitend
repetition => .repi'tiʃәn
repetitional => repɪ'tɪʃənl
repetitions => repɪ'tɪʃnz
repetitious => .repi'tiʃәs
repetitiously => ,repi'tiʃəsli
repetitiousness => repiˊtiʃәnsnis
repetitive => ri'petitiv
repetitively => ri'pitətivli
repetitiveness => rɪ'petətɪvnəs
rephrase => ri:'freiz
rephrased => ri:ˈfreizd
rephrases => ri:ˈfreiziz
rephrasing => ri:ˈfreizɪŋ
repine => ri'pain
repined => rɪˈpaɪnd
repines => rɪˈpaɪnz
repining => rɪˈpaɪnɪŋ
repique => ,ri:'pi:k
replace => ri'pleis
replaceable => ri'pleisәbl
replacement => ri'pleismәnt
replacement therapy => riˈpleismənt ˈθerəpi
replacer => ri'pleisә
replan => ri:'plæn
replant => .ri:'plɑ:nt
replanted => ˈri:ˈplɑ:ntid
replanting => ri:p'lɑ:ntɪŋ
replants => ˈri:ˈplɑ:nts
replay => .ri:'plei
replayed => ri:ˈpleɪd
replaying => ri:ˈpleɪŋ
replays => ri:ˈpleɪz
replenish => ri'pleniʃ
replenished => rɪ'plenɪʃt
replenisher => ri'pleniʃә(r)
replenishes => rɪˈplenɪʃiz
replenishing => rɪ'plɛnɪʃ
replenishment => rɪ'plenɪʃmənt
replete => ri'pli:t
repletion => ri'pli:ʃәn
replevin => ri'plevin
replevy => ri'plevi
replica => 'replikә
replicability => ,replikә'bilәti
replicable => 'replikәbl
replicas => ˈreplɪkəz
replicase => 'replikeis
replicate => 'replikeit
replicated => ˈreplɪˌkeɪtid
replicates => ˈreplɪˌkeɪts
replicating => ˈreplɪˌkeɪtɪŋ
replication => .repli'keiʃәn
replicative => 'replikeitiv
replicon => 'replikɔn
replier => ri'plaiә(r)
reply => ri'plai
reply-paid => rɪp'laɪp'eɪd
replying => riˈplaiŋ
repo => 'ri:pәu
repoint => .ri:'pɒint
repointed => ,ri:'pɔint
repointing => ri:'pɔɪntɪŋ
repoints => ,ri:'pɔint
repolish => ri:'pɔliʃ
repopulate => .ri:'pɒpjuleit
repopulation => ri:pɒpjʊ'leɪʃn
report => ri'pɒ:t
report to => riˈpɔ:t tu:
reportable => ri'pɒ:tәbl
reportage => .repɒ:'tɑ:ʒ
reported => ri'pɔ:tid
reported speech => riˈpɔ:tid spi:tʃ
reportedly => ri'pɒ:tidli
reporter => ri'pɒ:tә
reporters => riˈpɔ:təz
reporting => ri'pɒ:tiŋ
reportorial => .repә'tɒ:riәl
reposal => ri'pәuzl
repose => ri'pәuz
reposed => rɪˈpəʊzd
reposeful => ri'pәuzful
reposefully => riˊpouzfuli
reposes => rɪˈpəʊziz
reposing => rɪˈpəʊzɪŋ
reposition => .ripә'ziʃәn
repositioned => rɪpɒ'zɪtaɪənd
repositioning => rɪpə'zɪʃənɪŋ
repositions => ˌri:pəˈziʃənz
repositories => rɪˈpɔzɪˌtɔ:ri:z
repository => ri'pɔzitәri
repossess => .ri:pә'zes
repossessed => ,ri:pә'zest
repossesses => ˌri:pəˈzesiz
repossessing => ˌri:pəˈzesɪŋ
repossession => .ri:pә'zeʃәn
repot => ri:'pɒt
repots => ˈri:ˈpɔts
repotted => ˈri:ˈpɔtid
repotting => 'ri:pɒtɪŋ
repp => rep
reprehend => .repri'hend
reprehended => ˌreprɪˈhendid
reprehending => ˌreprɪˈhendɪŋ
reprehends => ˌreprɪˈhendz
reprehensible => .repri'hensәbl
reprehensibly => reprɪ'hensəblɪ
reprehension => .repri'henʃәn
represent => .repri'zent
representability => 'repri,zentә'bilәti
representable => ,repri'zentәbl
representation => .reprizen'teiʃәn
representational => .reprizen'teiʃәnl
representationalism => ,reprizen'teiʃәnәlizәm
representationalist => - list
representations => reprɪzen'teɪʃnz
representative => .repri'zentәtiv
representativeness => 'reprɪzentətɪvnəs
representatives => reprɪ'zentətɪvz
represented => ˌrepriˈzentid
representing => ˌrepriˈzentɪŋ
represents => ˌrepriˈzents
repress => ri'pres
repressed => ri'prest
represser => ri'presə
represses => rɪˈpresiz
repressible => ri'presәbl
repression => ri'preʃәn
repressions => riˈpreʃənz
repressive => ri'presiv
repressor => ri'presә
reprieve => ri'pri:v
reprieved => rɪˈpri:vd
reprieves => rɪˈpri:vz
reprieving => rɪˈpri:vɪŋ
reprimand => 'reprimɑ:nd
reprimanded => ˈreprəˌmændid
reprimanding => ˈreprəˌmændɪŋ
reprimands => ˈreprəˌmændz
reprint => 'ri:print
reprinted => ˈri:ˌprɪntid
reprinting => ˈri:ˌprɪntɪŋ
reprints => ˈri:ˌprɪnts
reprisal => ri'praizl
reprisals => riˈpraizəlz
reprise => ri'praiz
reprised => riˈpraizd
reprises => riˈpraiziz
reprising => riˈpraizɪŋ
repro => 'ri:prәu
reproach => ri'prәutʃ
reproachable => ri'prәutʃәbl
reproached => riˈprəutʃt
reproacher => rɪp'rəʊtʃər
reproaches => riˈprəutʃiz
reproachful => ri'prәutʃful
reproachfully => rɪ'prəʊtʃfəlɪ
reproaching => riˈprəutʃɪŋ
reproachingly => ri'prәutʃiŋli
reprobate => 'reprәubeit
reprobated => 'reprəbeɪt
reprobates => ˈreprəˌbeɪts
reprobating => 'reprəbeɪt
reprobation => .reprә'beiʃәn
reprocess => 'ri:'prәuses
reprocessed => ri:'prәjsest;-'prɔ-
reprocessing => 'ri:'prәusesiŋ
reproduce => .ri:prә'dju:s
reproduced => ˌri:prəˈdju:st
reproducer => ,ri:prә'dju:sә
reproduces => ˌri:prəˈdju:siz
reproducibility => riprә,dju:sә'biliti
reproducible => .ri:prә'dju:sәbl
reproduction => .ri:prә'dʌkʃәn
reproductions => ˌri:prəˈdʌkʃənz
reproductive => .ri:prә'dʌktiv
reprogram => 'ri:prәu^ræm
reprogrammed => ˈri:prəuɡræmd
reprographic => ,reprә'^ræfik,,ri:-
reprography => ri:'prɔ^ræfi
reproof => ri'pru:f
reproofs => rɪˈpru:fs
reprovable => ri'pru:vәbl
reprove => ri'pru:v
reproved => rɪˈpru:vd
reproves => rɪˈpru:vz
reprovingly => ri'pru:viŋli
reps => reps
reptile => 'reptail
reptilian => rep'tiliәn
republic => ri'pʌblik
republican => ri'pʌblikәn
republicanism => ri'pʌblikәnizm
republication => 'ri:.pʌbli'keiʃәn
republics => riˈpʌbliks
republish => ri:'pʌbliʃ
republished => ri:ˈpʌbliʃt
republishing => ri:ˈpʌbliʃɪŋ
repudiate => ri'pju:dieit
repudiated => rɪˈpju:di:ˌeɪtid
repudiates => rɪˈpju:di:ˌeɪts
repudiating => rɪˈpju:di:ˌeɪtɪŋ
repudiation => ri.pju:di'eiʃәn
repudiator => ri'pju:dieitә
repugnance => ri'pʌgnәns
repugnancy => ri'pʌ^nәnsi
repugnant => ri'pʌgnәnt
repulse => ri'pʌls
repulsed => rɪˈpʌlst
repulses => rɪˈpʌlsiz
repulsing => rɪˈpʌlsɪŋ
repulsion => ri'pʌlʃәn
repulsive => ri'pʌlsiv
repulsively => rɪ'pʌlsɪvlɪ
repulsiveness => ri'pʌlsivnis
repurchase => ri:'pә:tʃәs
repurchased => ri:ˈpə:tʃist
repurchasing => ri:ˈpə:tʃisɪŋ
repurpose => ˌri:ˈpɜ:pəs
reputable => 'repjutәbl
reputably => 'repjutәbli
reputation => .repju'teiʃәn
reputational => ,repju'teiʃən
reputations => repjʊ'teɪʃnz
repute => ri'pju:t
reputed => ri'pju:tid
reputedly => ri'pju:tidli
reputing => rɪˈpju:tɪŋ
request => ri'kwest
requests => riˈkwests
requiem => 'ri:kwiәm
requiems => ˈrekwi:əmz
requiescat => ,rekwi'eskæt,-kɑ:t,,rei-
require => ri'kwaiә
required => ri'kwaiәd
requirement => ri'kwaiәmәnt
requiring => riˈkwaiərɪŋ
requisite => 'rekwizit
requisites => 'rekwɪzɪts
requisition => .rekwi'ziʃәn
requisitioned => ˌrekwɪˈzɪʃənd
requisitioner => rekwɪ'zɪʃnər
requisitions => ˌrekwɪˈzɪʃənz
requital => ri'kwaitl
requite => ri'kwait
requited => rɪˈkwaɪtid
requiting => rɪˈkwaɪtɪŋ
reran => ˌri:ˈræn
reread => .ri:'ri:d
reredos => 'riәdɒs
rerun => ri:'rʌn
RES => ri:z
res publica => ˈreisˈpʌblikə
resale => ri:'seil
resaleable => ri:'seilәbl
resales => riː'seɪl
rescale => ri:'skeil
rescaling => ri:'skeiliŋ
reschedule => ri:ʃedju:l
rescheduled => riˈskedʒuld
reschedules => riˈskedʒulz
rescheduling => ˌri:'ʃedju:lɪŋ
rescind => ri'sind
rescinded => rɪˈsɪndid
rescinding => rɪˈsɪndɪŋ
rescinds => rɪˈsɪndz
rescission => ri'siʒәn
rescript => 'ri:skript
rescuable => ri:sk'jʊəbl
rescue => 'reskju:
rescued => ˈreskju:d
rescuer => 'reskjuә
rescues => ˈreskju:z
rescuing => ˈreskju:ɪŋ
reseal => ri'si:l
research => ri'sә:tʃ
researched => riˈsə:tʃt
researcher => ri:'sә:tʃә
researchers => 'rɪsɜ:tʃəz
researching => riˈsə:tʃɪŋ
reseat => .ri:'si:t
reseated => ri:ˈsi:tid
reseating => ri:'si:tɪŋ
resect => ri'sekt
resected => ri(:)ˈsektid
resecting => ri(:)ˈsektɪŋ
resection => ri'sekʃәn
reseda => ri'si:dә
reseed => ri:'si:d
resegregation => 'ri:se^ri'^eiʃәn
reselect => riːsɪ'lekt
resell => ri:'sel
reseller => 'ri:selə
reselling => ri:'selɪŋ
resells => ˈri:ˈselz
resemblance => ri'zemblәns
resemblant => ri'zemblәnt
resemble => ri'zembl
resembled => riˈzembld
resembles => riˈzemblz
resent => ri'zent
resented => riˈzentid
resentful => ri'zentful
resenting => riˈzentɪŋ
resentment => ri'zentmәnt
resentments => rɪˈzentmənts
resents => riˈzents
reserpine => ri'sә:pin
reservation => .rezә'veiʃәn
reservationist => rezə'veiʃənist
reserve => ri'zә:v
reserved => ri'zә:vd
reservedly => rɪ'zɜ:vɪdlɪ
reservist => ri'zә:vist
reservists => riˈzə:vists
reservoir => 'rezәvwɑ:
reservoirs => 'rezəvwɑ:z
reset => .ri:'set
resets => ˌri:ˈsets
resettle => ri:'setl
resettled => 'ri:'setld
resettles => ˌri:ˈsetlz
resettling => ri:'setlɪŋ
reshape => ri:'ʃeip
reshaped => ˌri:ˈʃeipt
reshapes => ˌri:ˈʃeips
resharpen => 'ri:'ʃɑ:p(ә)n
reshuffle => ri:'ʃʌfl
reshuffled => ri:ˈʃʌfəld
reshuffles => ri:ˈʃʌfəlz
reshuffling => ri:ˈʃʌfəlɪŋ
reside => ri'zaid
resided => riˈzaidid
residence => 'rezidәns
residences => 'rezɪdənsɪz
residency => 'rezidәnsi
resident => 'rezidәnt
residential => .rezi'denʃәl
residentiary => ,rezi'denʃәri
resides => riˈzaidz
residing => riˈzaidɪŋ
residua => ri'zidjjә, - dʒjә
residual => 'rezidju:l
residually => rɪ'zɪdʊəlɪ
residuals => rɪ'zɪdʒʊəlz
residuary => 'rezidjuri
residue => 'rezidju:
residues => 'rezɪdjʊ
residuum => ri'zidjuәm
resign => ri'zain
resignation => .rezig'neiʃәn
resignations => ˌrezɪgˈneɪʃənz
resigned => ri'zaind
resignedly => ri'zaindli
resigning => riˈzainɪŋ
resigns => riˈzainz
resile => ri'zail
resiled => riˈzaild
resilience => ri'ziliәns
resiliency => ri'ziliәnsi. -jәnsi
resilient => ri'ziliәnt
resiliently => ri'ziliəntli
resilin => 'rezilin
resiling => riˈzailɪŋ
resin => 'rezin
resinate => 'rezineit
resinated => ˈrezineitid
resinates => 'rezɪneɪts
resinating => ˈrezineitɪŋ
resinous => 'rezinәs
resins => 'rezɪnz
resist => ri'zist
resistance => ri'zistәns
resistances => rɪ'zɪstənsɪz
resistant => ri'zistәnt
resister => ri'zistә
resistibility => ri.zistә'biliti
resistible => ri'zistәbl
resistive => ri'zistiv
resistivity => ri.zis'tiviti
resistless => ri'zistlis
resistor => ri'zistә
resistors => rɪ'zɪstəz
resists => riˈzists
resit => 'ri:sit
resizing => ri'saiziŋ
reskill => ˌri:ˈskɪl
resold => ˌri:ˈsəʊld
resole => .ri:'sәul
resoled => ˈri:ˈsəuld
resoling => ˈri:ˈsəulɪŋ
resoluble => ri'zɒljubl
resolute => 'rezәlu:t
resoluteness => 'rezə,lutnis
resolution => .rezә'lu:ʃәn
resolutive => 'rezәlju:tiv
resolvability => ri.zɒlvә'biliti
resolvable => ri'zɒlvәbl
resolve => ri'zɒlv
resolved => ri'zɒlvd
resolvedly => ri'zɒlvidli
resolvent => ri'zɒlvәnt
resolver => ri'zɔlvә
resolves => riˈzɔlvz
resolving => ri'zɔlviŋ
resonance => 'rezәnәns
resonances => 'rezənənsɪs
resonant => 'rezәnәnt
resonantly => 'rezənəntlɪ
resonate => 'rezәneit
resonated => ˈrezəneitid
resonates => ˈrezəneits
resonating => ˈrezəneitɪŋ
resonator => 'rezәneitә
resorb => ri'sɒ:b
resorbed => riˈsɔ:bd
resorbing => riˈsɔ:bɪŋ
resorbs => riˈsɔ:bz
resorcinol => ri'zɔ:sinәul, -nɔ:l
resorption => ri'sɔ:pʃәn
resorptive => -tiv
resort => ri'zɒ:t
resorted => riˈzɔ:tid
resorting => riˈzɔ:tɪŋ
resound => ri'zaund
resounded => rɪˈzaʊndid
resounding => ri'zaundiŋ
resoundingly => rɪ'zaʊndɪŋlɪ
resounds => rɪˈzaʊndz
resource => ri'sɒ:s
resourced => rɪ'sɔ:st
resourceful => ri'sɒ:sful
resourceless => rɪ'zɔ:slɪs
respect => ri'spekt
respectability => rispektә'bilәti
respectable => ri'spektәbl
respectably => ri'spektәbli
respecter => ri'spektә
respecters => rɪˈspektəz
respectful => ri'spektful
respectfully => ri'spektfuli
respecting => ri'spektiŋ
respective => ri'spektiv
respectively => ri'spektivli
respell => ri:'spel
respirable => 'respirәbl
respirate => 'respәreit
respiration => .respә'reiʃәn
respirator => 'respәreitә
respirators => 'respəreɪtəz
respiratory => ri'spaiәrәtәri
respiratory distress syndrome => ˈrespərəˌtɔ:ri: disˈtres ˈsindrəum
respire => ri'spaiә
respired => rɪˈspaɪəd
respiring => rɪˈspaɪərɪŋ
respirometer => ,respi'rɔmitә
respite => 'respait
resplendence => ri'splendәns
resplendent => ri'splendәnt
resplendently => rɪ'splendəntlɪ
respond => ri'spɒnd
responded => riˈspɔndid
respondence => ri'spɔndәns
respondent => ri'spɒndәnt
respondents => rɪs'pɒndənts
responder => ri'spɔndә(r)
responds => riˈspɔndz
responsa => ri'spɔnsә
response => ri'spɒns
responsibility => ri.spɒnsә'biliti
responsible => ri'spɒnsәbl
responsive => ri'spɒnsiv
responsively => ri'spɔnsivli
responsorial => rispɔnˈsɔ:riəl
responsory => ri'spɒnsәri
responsum => ri'spɔnsәm
respray => ˌri:ˈspreɪ
ressentiment => rә,sәti'mә
rest => rest
rest area => rest ˈɛəriə
rest house => rest haus
restage => ri:'steidʒ
restart => .ri:'stɑ:t
restarted => ri:ˈstɑ:tid
restarts => ri:ˈstɑ:ts
restate => .ri:'steit
restated => ri:ˈsteɪtid
restatement => .ri:'steitmәnt
restatements => ri:s'teɪtmənts
restates => ri:ˈsteɪts
restating => ri:ˈsteɪtɪŋ
restaurant => 'restәrɒŋ
restaurant car => ˈrestərənt kɑ:
restaurants => ˈrestərənts
restaurateur => restәrә'tә(r)
restaurateurs => restərəˈtəz
restenosis => ,ri:sti'nәjsis
restful => 'restful
restfulness => 'restfulnis
restharrow => 'resthærәu
resting => 'restiŋ
resting place => ˈrestiŋ pleis
restitution => .resti'tju:ʃәn
restive => 'restiv
restively => 'restɪvlɪ
restless => 'restlis
resto => 'restәu
restock => .ri:'stɒk
restocked => ˈri:ˈstɔkt
restocks => ˈri:ˈstɔks
restorable => ri'stɒ:rәbl
restoration => .restә'reiʃәn
restorationism => restə'reɪʃnɪzəm
restorationist => ,restə'reiʃənist
restorative => ri'stɒrәtiv
restore => ri'stɒ:
restorer => ris'tɔ:rә
restorers => risˈtɔ:rəz
restores => riˈstɔ:z
restrain => ri'strein
restrained => ri'streind
restrainedly => ri'streinidli
restraining => ri'streiniŋ
restrains => risˈtreinz
restraint => ri'streint
restraints => rɪst'reɪnts
restrict => ri'strikt
restricted => ri'striktid
restrictedly => ri'striktidli
restriction => ri'strikʃәn
restriction enzyme => rɪˈstrɪkʃən ˈenzaɪm
restriction fragment => rɪˈstrɪkʃən ˈfræɡmənt
restrictionism => ri'strikʃәnizm
restrictionist => ri'strikʃənist
restrictive => ri'striktiv
restrictively => rɪ'strɪktɪvli
restricts => risˈtrikts
restring => ri:'striŋ
restringing => rɪst'rɪnɡɪŋ
restroom => 'restru:m
restructure => ri:'strʌktʃә
restructured => ˌri:ˈstrʌktʃəd
restructures => ˌri:ˈstrʌktʃəz
restudy => ri:'stʌdi
restyle => ri:'stail
resubmit => rɪzəb'mɪt
result => ri'zʌlt
resultant => ri'zʌltәnt
resultative => ri'zʌltәtiv
resulted => riˈzʌltid
resulting => ri'zʌltiŋ
resumable => ri'zju:mәbl
resume => ri'zju:m
resumed => riˈzju:md
resuming => riˈzju:mɪŋ
resumption => ri'zʌmpʃәn
resumptive => ri'zʌmptiv
resupinate => ri'sju:pineit
resupply => ,ri:sә'plai
resurface => ri:'sә:fis
resurfaced => ˌri:ˈsə:fist
resurfaces => ˌri:ˈsə:fisiz
resurfacing => ri:'sә:fisiŋ
resurgence => ri'sә:dʒәns
resurgent => ri'sә:dʒәnt
resurrect => .rezә'rekt
resurrected => ˌrezəˈrektid
resurrecting => rezə'rekt
resurrection => .rezә'rekʃәn
resurrection plant => ˌrezəˈrekʃən plɑ:nt
resurrects => ˌrezəˈrekts
resurvey => 'ri:sә(:)'vei
resuscitate => ri'sʌsiteit
resuscitated => rɪˈsʌsɪˌteɪtid
resuscitates => rɪˈsʌsɪˌteɪts
resuscitating => rɪˈsʌsɪˌteɪtɪŋ
resuscitation => ri.sʌsi'teiʃәn
resuscitative => ri'sʌsiteitiv
resuscitator => ri'sʌsiteitә
resuspended => ri:zəs'pendɪd
resuspension => ri:zəs'penʃn
resveratrol => rez'vɪərɪˌtrɔ:l
ret => ret
retable => ri'teibl
retail => 'ri:teil
retail park => ˈri:teil pɑ:k
retail therapy => ˈri:teil ˈθerəpi
retailer => 'ri:teilә
retailers => 'ri:teɪləz
retailing => 'ri:teiliŋ
retain => ri'tein
retained => riˈteind
retainer => ri'teinә
retainers => rɪ'teɪnəz
retaining => rɪˈteɪnɪŋ
retaining wall => rɪˈteɪnɪŋ
retains => riˈteinz
retake => ri:'teik
retaken => ˌri:ˈteɪkən
retakes => ri:ˈteɪks
retaking => ri:ˈteɪkɪŋ
retaliate => ri'tælieit
retaliated => riˈtælieitid
retaliates => riˈtælieits
retaliating => riˈtælieitɪŋ
retaliation => ri.tæli'eiʃәn
retaliative => ri'tælieitiv
retaliatory => ri'tæliәtәri
retard => ri'tɑ:d
retardancy => ri'tɑ:dənsi
retardant => ri'tɑ:dәnt
retardate => ri'tɑ:deit
retardation => .ri:tɑ:'deiʃәn
retarded => ri'tɑ:did
retarder => ri'tɑ:dә
retardment => ri'tɑ:dmәnt
retards => rɪˈtɑ:dz
retarget => ri'tɑ:ɡit
retch => retʃ
retched => retʃt
retches => retʃiz
retd => 'rɪtd
rete => 'ri:ti:
retell => ri:'tel
retelling => ri:ˈtelɪŋ
retells => ri:ˈtelz
retention => ri'tenʃәn
retentive => ri'tentiv
retentively => rɪ'tentɪvlɪ
retentiveness => rɪ'tentɪvnɪs
retentivity => .ri:ten'tiviti
retest => ri:'test
retexture => ri:'tekstʃә
rethink => ri:'θiŋk
rethinking => ri:ˈθɪŋkɪŋ
rethinks => ri:ˈθɪŋks
rethought => ˌri:ˈθɔ:t
retia => 'ri:ʃiә
retiarius => ri:ʃi'eәriәs
reticence => 'retisns
reticent => 'retisnt
reticently => 'retɪsntlɪ
reticle => 'retikl
reticula => ri'tikjulә
reticular => ri'tikjulә
reticular formation => riˈtikjulə fɔ:ˈmeiʃən
reticulate => ri'tikjulit
reticulates => rɪ'tɪkjʊleɪt
reticulating => rɪ'tɪkjʊleɪt
reticulation => ri.tikju'leiʃәn
reticule => 'retikju:l
reticules => 'retɪkjuːl
reticulocyte => ri'tikjulәu,sait
reticuloendothelial => ri,tikjulәu,endәu'θi:liәl
reticulum => ri'tikjulәm
retie => rɪ'tɑɪ
retiform => 'ri:tifɒ:m
retighten => rɪ'taɪtn
retina => 'retinә
retinal => 'rentinl
retinitis => .reti'naitis
retinoblastoma => ,retinәublæs'tәumә
retinoid => 'retinɔid
retinol => 'retinɔl
retinopathy => reti'nɔpәθi
retinue => 'retinju:
retinues => ˈretnˌu:z
retiral => ri'taiәrәl
retire => ri'taiә
retired => ri'taiәd
retiredness => riˊtaiәdnis
retiree => ri.taiә'ri:
retirees => rɪˌtaɪərˈi:z
retirement => ri'taiәmәnt
retirement home => rɪˈtaɪəmənt həum
retirement plan => rɪˈtaɪəmənt plæn
retirements => rɪˈtaɪəmənts
retires => riˈtaiəz
retiring => ri'tairiŋ
retold => ri:'tәuld
retook => 'ri:'tuk
retool => 'ri:'tu:l
retooled => ˌri:ˈtu:ld
retools => ˌri:ˈtu:lz
retort => ri'tɒ:t
retorted => riˈtɔ:tid
retorting => ri'tɔ:tiŋ
retorts => riˈtɔ:ts
retouch => .ri:'tʌtʃ
retouched => ˌri:ˈtʌtʃt
retouches => ˌri:ˈtʌtʃiz
retrace => ri'treis
retraced => ri:ˈtreɪst
retraces => ri:ˈtreɪsiz
retracing => ri:ˈtreɪsɪŋ
retract => ri'trækt
retractable => ri'træktәbl
retractile => ri'træktail
retractility => .ri:træk'tiliti
retraction => ri'trækʃәn
retractions => rɪ'trækʃən
retractive => ri'træktiv
retractor => ri'træktә
retracts => rɪˈtrækts
retrain => ri:'trein
retrained => ri:ˈtreind
retrains => ri:ˈtreinz
retranslate => 'ri:trænsleit
retranslation => ,ri:træns'leiʃən,-trænz-
retransmission => ,ri:trænz'miʃәn
retransmit => ,ri:trænz'mit
retread => .ri:'tred
retreaded => ˈri:ˈtredid
retreads => ˈri:ˈtredz
retreat => ri'tri:t
retreated => riˈtri:tid
retreats => riˈtri:ts
retrench => ri'trentʃ
retrenched => rɪˈtrentʃt
retrenches => rɪˈtrentʃiz
retrenching => rɪˈtrentʃɪŋ
retrenchment => ri'trentʃmәnt,ri:-
retrial => ri:'traiәl
retrials => ri:ˈtraɪəlz
retribution => .retri'bju:ʃәn
retributive => ri'tribjutiv
retributory => ri'tribjutәri
retried => ri:ˈtraid
retrievable => ri'tri:vәbl
retrieval => ri'tri:vl
retrieve => ri'tri:v
retriever => ri'tri:vә
retrievers => riˈtri:vəz
retrieves => riˈtri:vz
retro => 'retrәu
retroaction => .retrәu'ækʃәn
retroactive => .retrәu'æktiv
retroactively => ˌretrəʊ'æktɪvlɪ
retroactivity => .retrәuæk'tiviti
retrobulbar => ,retrәj'bʌlbә(r)
retrocede => ,retrәu'si:d
retrocession => .retrәu'seʃәn
retrochoir => 'retrәukwaiә
retrodden => 'ri:'trɔdn
retrofit => 'retrә,fit
retrofits => ˈretrəˌfits
retrofitted => 'retrəʊfɪtɪd
retroflex => 'retrәufleks
retroflexion => .retrә'flekʃәn
retrogradation => .retrәgrә'deiʃәn
retrograde => 'retrәgreid
retrograded => ˈretrəˌgreɪdid
retrogradely => retrəɡ'reɪdlɪ
retrograding => ˈretrəˌgreɪdɪŋ
retrogress => .retrә'gres
retrogressed => ˈretrəˌgrest
retrogressing => ˈretrəˌgresɪŋ
retrogression => .retrә'greʃәn
retrogressive => .retrә'gresiv
retroject => 'retrәdʒekt
retroperitoneal => ,retrәu,peritә'ni:әl
retroreflective => ,retrәjri'flektiv
retroreflector => ,retrәjri'flektә(r)
retrorocket => 'retrәjrɔkit
retrorse => ri'trɒ:s
retrospect => 'retrәspekt
retrospected => ˈretrəspektid
retrospecting => ˈretrəspektɪŋ
retrospection => .retrә'spekʃәn
retrospective => .retrә'spektiv
retrospectively => ˌretrə'spektɪvlɪ
retrospectives => ˌretrəˈspektɪvz
retrospects => ˈretrəspekts
retrosternal => ,retrәj'st\\\\:nәl
retroversion => .retrә'vә:ʃәn
retroverted => 'retrәv\\\\:tid
retrovirus => ,retrәu'vaiәrәs
retry => .ri:'trai
retsina => 'retsinә
retted => retid
retting => 'retiŋ
retune => ri:'thu:n
returf => ,ri:'t\\\\:f
return => ri'tә:n
returnable => ri'tә:nәbl
returned => ri'tә:nd
returnee => ri.tә:'ni:
returner => ri'tә:nә
retype => ri:'taip
reunification => ,ri:ju:nifi'keiʃәn,ri:,ju:-
reunified => riː'juːnɪfaɪ
reunifies => riː'juːnɪfaɪ
reunify => ri:'ju:nifai
reunifying => riː'juːnɪfaɪ
reunion => ri:'ju:njәn
reunions => ˌri:ˈju:niənz
reunite => .ri:ju:'nait
reunites => ˌri:ju:ˈnaɪts
reuniting => ˌri:ju:ˈnaɪtɪŋ
reupholster => ri:ʌp'hәjlstә(r)
reuptake => ,ri:'ʌpteik
reusable => ri:'ju:zәbl
reuse => ri:'ju:z
reused => 'ri:ju:zd
reuses => ri:ˈju:ziz
reusing => ri:ˈju:zɪŋ
Reuter => 'rɔitә
Reuters => 'rɒitә
reutilization => ri,ju:tilai'zeiʃәn
rev => rev
revaccinate => ri:'væksineit
revaccination => ,ri:væksi'neiʃən
revaluation => .ri:vælju'eiʃәn
revalue => ri:'vælju:
revalued => ri:ˈvælju:d
revalues => ri:ˈvælju:z
revaluing => ri:ˈvælju:ɪŋ
revamp => ri:'væmp
revamped => ri:ˈvæmpt
revamps => ri:ˈvæmps
revanche => rә'vә:nʃ
revanchism => rә'vɒŋʃizm
revanchist => rә'vɔŋʃist,ri'væntʃ-
reveal => ri'vi:l
revealed religion => rɪˈvi:ld
revealing => ri'vi:liŋ
revealingly => ri'vi:liŋli
reveals => riˈvi:lz
revegetate => ri:'vedʒiteit
revegetation => ,ri:vedʒi-'teiʃən
reveille => ri'væli
revel => 'revl
revelation => .revi'leiʃәn
revelationist => ,revә'leiʃənist
revelations => ˌrevəˈleiʃənz
revelatory => 'revәlәtәri
reveler => 'revlә
revelled => ˈrevəld
reveller => 'revlә
revellers => ˈrevləz
revelling => ˈrevəlɪŋ
revelries => ˈrevəlri:z
revelry => 'revәlri
revels => ˈrevəlz
revenant => 'revәnә:ŋ
revenge => ri'vendʒ
revenged => riˈvendʒd
revengeful => ri'vendʒful
revengefully => rɪ'vendʒfəlɪ
revenges => riˈvendʒz
revenging => riˈvendʒɪŋ
revenue => 'revinju:
revenues => 'revənju:z
reverb => ri'vә:b. 'ri:vә:b
reverberant => ri'vә:bәrәnt
reverberantly => rɪ'vɜ:bərəntlɪ
reverberate => ri'vә:bәreit
reverberated => rɪˈvɜ:bəˌreɪtid
reverberates => rɪˈvɜ:bəˌreɪts
reverberating => rɪ'vɜ:bəreɪtɪŋ
reverberation => ri.vә:bә'reiʃәn
reverberations => riˌvə:bəˈreiʃənz
reverberative => ri'v\\\\:bəreitiv,-rә-
reverberator => ri'vә:bәreitә
reverberatory => ri'vә:bәrәtәri
revere => ri'viә
revered => rɪ'vɪəd
reverence => 'revәrәns
reverenced => ˈrevərənst
reverences => ˈrevərənsiz
reverencing => ˈrevərənsɪŋ
reverend => 'revәrәnd
reverent => 'revәrәnt
reverential => .revә'renʃәl
reverentially => ˌrevə'renʃəlɪ
reveres => 'rɪvɪəz
reverie => 'revәri
reveries => ˈrevəriz
revering => 'rɪvɪərɪŋ
revers => ri'viә, ri'veә
reversal => ri'vә:sl
reversals => rɪ'vɜ:slz
reverse => ri'vә:s
reverse discrimination => riˈvə:s dɪˌskrimiˈneiʃən
reverse transcriptase => riˈvə:s trænsˈkripteis
reversed => ri'vә:sd
reversely => ri'v\\\\:sli
reverser => ri'vә:sә
reverses => riˈvə:siz
reversibility => ri,vә:sә'biliti
reversible => ri'vә:sәbl
reversing => ri'vә:siŋ
reversing light => riˈvə:siŋ lait
reversion => ri'vә:ʃәn
reversionary => ri'v\\\\:ʃənәri;-ʒən-
reversioner => ri'v\\\\:ʃənә(r);-ʒən-
reversions => rɪˈvɜ:ʒənz
revert => ri'vә:t
revertant => ri'vә:tәnt
reverted => rɪˈvɜ:tid
revertible => ri'vә:tәbl
reverting => rɪˈvɜ:tɪŋ
reverts => rɪˈvɜ:ts
revery => 'revәri
revet => ri'vet
revetment => ri'vetmәnt
revetted => rɪ'vetted
revetting => riˈvetɪŋ
review => ri'vju:
reviewable => ri'vju:әbl
reviewal => ri'vju:әl
reviewer => ri'vju:ә(r)
reviewers => rɪv'ju:əz
reviewing => riˈvju:ɪŋ
revile => ri'vail
reviled => rɪˈvaɪld
revilement => rɪ'vaɪlmənt
reviles => rɪˈvaɪlz
reviling => rɪˈvaɪlɪŋ
revisal => ri'vaizl
revise => ri'vaiz
reviser => ri'vaizә(r)
revising => riˈvaizɪŋ
revision => ri'viʒәn
revisionism => ri'viʒәnizm
revisionist => ri'viʒәnist
revisionists => ri'viʒənist
revisit => ri:'vizit
revisited => ˌri:ˈvizitid
revisiting => ˌri:ˈvizitɪŋ
revisits => ˌri:ˈvizits
revisory => ri'vaizәri
revitalization => ri:,vaitəlai'zeiʃən;-li'z-
revitalize => .ri:'vaitәlaiz
revitalized => ri:ˈvaɪtlˌaɪzd
revitalizes => ri:ˈvaɪtlˌaɪziz
revitalizing => ri:ˈvaɪtlˌaɪzɪŋ
revivable => ri'vaivәbl
revival => ri'vaivl
revivalism => rɪˈvaɪvəlɪzəm
revivalist => ri'vaivəlist
revivals => rɪˈvaɪvəlz
revive => ri'vaiv
reviver => ri'vaivә
revives => riˈvaivz
revivification => ri:.vivifi'keiʃәn
revivified => ri(:)ˈvivifaid
revivifies => ri(:)ˈvivifaiz
revivify => ri:'vivifai
revivifying => ri:vɪvɪ'faɪɪŋ
revocability => revəkə'bɪlɪtɪ
revocable => 'revәkәbl
revocation => .revә'keiʃәn
revocatory => 'revәkәtәri
revoke => ri'vәuk
revoked => riˈvəukt
revokes => riˈvəuks
revoking => riˈvəukɪŋ
revolt => ri'vәult
revolted => ri'vәjltid,-'vɔ:-
revolting => ri'vәultiŋ
revoltingly => rɪ'vəʊltɪŋlɪ
revolts => riˈvəults
revolute => 'revәl(j)u:t
revolution => .revә'lu:ʃәn
revolutionaries => ˌrevəˈlu:ʃənəriz
revolutionary => .revә'lu:ʃәnәri
revolutionise => ,revә'lju:ʃənaiz
revolutionism => ,revә'lju:ʃənizəm
revolutionist => .revә'lu:ʃәnist
revolutionize => .revә'lu:ʃәnaiz
revolutionizes => revəˈluʃ(ə)nˌaɪziz
revolutionizing => revəˈluʃ(ə)nˌaɪzɪŋ
revolve => ri'vɒlv
revolve around => riˈvɔlv əˈraund
revolved => riˈvɔlvd
revolver => ri'vɒlvә
revolvers => rɪˈvɔlvəz
revolves => riˈvɔlvz
revolving => ri'vɒlviŋ
revolving door => rɪˈvɔlvɪŋ dɔ:
revs => revz
revue => ri'vju:
revues => riˈvju:z
revulsion => ri'vʌlʃәn
revved => revd
revving => revɪŋ
reward => ri'wɒ:d
rewarded => riˈwɔ:did
rewarding => ri'wɒ:diŋ
rewardless => ri'wɔ:dlis
rewash => ri:'wɒʃ
rewind => ri:'waind
rewinder => ri:'waindә(r)
rewinding => ri:'waɪndɪŋ
rewinds => ri:ˈwaɪndz
rewire => ri:'waiә
rewired => ri:ˈwaiəd
rewires => ri:ˈwaiəz
rewiring => ri:'waɪərɪŋ
reword => ri:'wә:d
reworded => ˈri:ˈwə:did
rewording => ˈri:ˈwə:dɪŋ
rewords => ˈri:ˈwə:dz
rework => ri:'wә:k
reworked => ri:ˈwɜ:kt
reworks => ri:ˈwɜ:ks
rewound => ˌri:ˈwaʊnd
rewritable => ˌri:ˈraɪtəbl
rewrite => ri:'rait
rewrites => ri:ˈraɪts
rewrote => ˌri:ˈrəʊt
rex => reks
reykjavik => 'reikjә,vi:k
Reynard => 'renәd
reynolds => 'renәldz
rezoning => re'zəʊnɪŋ
RGN => ,ar: dʒi: 'en
rhabdom => 'ræb,dɔm
rhabdomancy => 'ræbdә.mænsi
rhabdomyolysis => ,ræbdәjmai'әjlisis
rhabdomyosarcoma => 'ræbdәj,maiә?sɑ:'kәjmә
rhamnose => 'ræmnәus
rhapsode => 'ræpsәjd
rhapsodic => ræp'sɔdik
rhapsodies => ˈræpsədi:z
rhapsodist => 'ræpsәdist
rhapsodize => 'ræpsәdaiz
rhapsodized => ˈræpsəˌdaɪzd
rhapsodizes => ˈræpsəˌdaɪziz
rhapsodizing => ˈræpsəˌdaɪzɪŋ
rhapsody => 'ræpsәdi
rhatany => 'rætәni
rhea => riә. 'ri:ә
rhebok => 'ri:bɔk,-bʌk
Rheims => ri:mz,ræŋs
Rheinland => 'rainlɑ:nt
Rheinland-Pfalz => 'rainlɑ:nt'pfɑ:lts
rheme => ri:m
Rhenish => 'ri:niʃ
rhenium => 'ri:niәm
rheological => ,ri:ə'lɔdʒikəl
rheologist => ri:'ɔlәdʒist,ri-
rheology => ri:'ɒlәdʒi
rheometer => ri:'ɒmitә
rheostat => 'ri:әstæt
rhesus => 'ri:sәs
rhesus factor => ˈri:səs fæktə(r)
rhetor => 'ri:tә
rhetoric => 'retәrik
rhetorical => ri'tɒ:rikl
rhetorically => rɪ'tɒrɪklɪ
rhetorician => .retә'riʃәn
rheum => ru:m
rheumatic => ru:'mætik
rheumatically => ru(ː)ˊmætikәli
rheumaticky => ru:'mætiki
rheumatics => ru:'mætɪks
rheumatism => 'ru:mәtizm
rheumatoid => ru:'mætɒid
rheumatoid arthritis => ˌru:mətɔɪd ɑ:ˈθraɪtɪs
rheumatoid factor => ˈru:məˌtɔɪd ˈfæktə
rheumatology => .ru:mә'tɒlәdʒi
rheumy => 'ru:mi
rhinal => 'rainl
Rhine => rain
Rhineland => 'rainlænd; -lənd
rhinestone => 'rainstәjn
rhinestones => ˈraɪnˌstəʊnz
rhinitis => rai'naitis
rhino => 'rainәu
rhinoceros => rai'nɒsәrәs
rhinocerotic => raɪnɒsə'rɒtɪk
rhinoplastic => .rainә'plæstik
rhinoplasty => 'rainәplæsti
rhinorrhea => 'rainәriә
rhinovirus => ,rainәu'vaiәrәs
rhizobium => rai'zәubiәm
rhizoctonia => ,raizɔk'tәuniә
rhizoid => 'raizɒid
rhizomatous => rai'zɔmәtәs,-'zәj-
rhizome => 'raizәjm
rhizomorph => 'raizәmɒ:f
rhizopod => 'raizәpɒd
rhizosphere => 'raizә,sfiә
rho => rәu
rhoda => 'rәudә
rhodamine => 'rәudәmi:n
Rhode Island => rәud'ailәnd
Rhodesia => rәu'di:zjә
rhodesian => rəu'di:ziən
rhodium => 'rәudiәm
rhodochrosite => ,rәudә'krәusait
rhododendron => .rәudә'dendrәn
rhodonite => 'rәudәnait
rhodophyte => 'rәjdәfait
rhodopsin => rәu'dɒpsin
rhodora => rәu'dәurә
rhomb => rɔm
rhombencephalon => ,rɔmben'sefәlәn
rhombi => 'rɔmbai
rhombic => 'rɒmbik
rhombohedral => ,rɔmbә?'hi:drәl,-'he-
rhombohedron => .rɒmbә'hi:drәn
rhomboid => 'rɒmbɒid
rhomboidal => rɔm'bɔidəl
rhomboideus => rɔm'bɔidiәs
rhombus => 'rɒmbәs
Rhondda => 'rɔndә
Rhone => rәun
rhotic => 'rәjtik
rhubarb => 'ru:bɑ:b
rhumb => rʌm
rhumba => 'rʌmbә,'rjm-
rhyme => raim
rhyme scheme => raim ski:m
rhymer => 'raimә(r)
rhyming => 'raimiŋ
rhyming slang => ˈraɪmɪŋ
rhymist => 'raimist
rhynchosaur => ,riŋkə'sɔ:
rhyolite => 'raiәlait
rhythm => 'riðәm
rhythm method => ˈriðəm ˈmeθəd
rhythm section => ˈriðəm ˈsekʃən
rhythmic => 'riðmik
rhythmical => 'riðmikəl,'riθ-
rhythmicity => rið'misiti
rhythmics => 'riðmiks
rhythmless => 'riðәmlis
rhythms => ˈriðəmz
rhyton => 'raitɔn
RIA => 'riә
rial => 'raiәl
Rialto => ri'æltәu
rib => rib
rib cage => rib keidʒ
rib-tickler => rib ˈtɪklə
rib-tickling => 'rib,tikliŋ
ribald => 'ribɒ:ld
ribaldry => 'ribәldri
riband => 'ribәnd
ribands => 'rɪb(ə)nd
ribavirin => ,raibә'vaiərin
ribbed => ribd
ribber => 'rɪbə
ribbing => 'ribiŋ
ribbon => 'ribәn
ribbon worm => ˈribən wə:m
ribboned => 'rɪbən
ribbonfish => 'ribәnfiʃ
ribboning => 'ribәniŋ
ribbons => ˈribənz
ribby => 'ribi
ribitol => 'raibitɔl
ribless => 'rɪbles
riboflavin => .raibәu'fleivin
ribonuclease => ,raibәu'nju:klieis, -'nu:-
ribonucleic acid => raibәnju:'kli:ik
ribose => 'raibәus
ribosomal => ,raibә'sәumәl
ribosome => 'raibәsәum
ribozyme => 'raɪbəˌzaɪm
ribwort => 'ribwә:t
Ricard => 'rikɑ:(r)
Ricardo => ri'kɑ:dәu
rice => rais
rice paddy => rais ˈpædi
rice pudding => rais ˈpudiŋ
rice rat => rais ræt
ricer => 'raisә
ricercar => 'raɪsəkɑ:
rices => raisiz
rich => ri:tʃ
richard => 'ritʃәd
richards => 'ritʃәdz
richardson => 'ritʃәdsn
Richelieu => 'riʃәlu:
richen => 'ritʃәn
riches => 'ritʃiz
richly => 'ritʃli
richness => 'ritʃnis
richter => 'riktә
ricin => 'raisin
ricing => 'raisiŋ
rick => rik
ricked => rikt
ricketiness => 'rɪkɪtɪnəs
rickets => 'rikits
rickettsia => rik'etsiә
rickettsial => ri'ketsiәl
rickety => 'rikәti
rickey => 'riki
ricking => rikɪŋ
rickle => 'rikl
rickrack => 'rikræk
ricks => riks
rickshaw => 'rikʃɔ:
rickshaws => ˈrɪkʃɔ:z
ricky => 'riki
ricochet => .rikә'ʃei
ricocheted => ˈrɪkəʃeɪd
ricocheting => ˈrɪkəʃeɪɪŋ
ricochets => ˌrɪkəˈʃeɪz
ricotta => rɪ'kɒtə
rictal => 'riktәl
rictus => 'riktәs
rid => rid
riddance => 'ridns
ridden => 'ridn
ridding => ridɪŋ
riddle => 'ridl
riddled => 'rɪdld
riddling => 'rɪdlɪŋ
ride => raid
ride herd on => raid hə:d ɔn
ride shotgun => raid ˈʃɔtˌgʌn
rideable => 'raidәbl
rider => 'raidә
riderless => 'raɪdələs
riders => ˈraɪdəz
ridership => 'raidәʃip
ridge => ridʒ
ridge tile => ridʒ tail
ridgeback => 'ridʒbæk
ridged => rɪdʒd
ridgepole => 'ridʒpәul
ridgeway => 'ridʒwei
ridging => 'rɪdʒɪŋ
ridgy => 'ridʒi
ridicule => 'ridikju:l
ridiculed => ˈrɪdɪˌkju:ld
ridicules => ˈrɪdɪˌkju:lz
ridiculing => ˈrɪdɪˌkju:lɪŋ
ridiculous => ri'dikjulәs
ridiculousness => rɪ'dɪkjələsnəs
riding => 'raidiŋ
riding crop => ˈraɪdɪŋ krɔp
riding light => ˈraɪdɪŋ lait
ridley => 'ridli
rids => ridz
riebeckite => 'ri:bekait
riel => ri'el
Riemannian geometry => 'ri:mɑ:niən
Riesling => 'ri:zliŋ
rifampicin => ,rifæm'paisin
rifampin => rai'fæmpin,'rif-
rife => raif
riff => rif
riff-raff => ˈrɪf ræf
riffle => 'rifl
riffled => ˈrifld
riffler => 'riflә
riffles => 'rɪflz
riffling => 'rifliŋ
riffraff => 'rifræf
riffs => rifs
rifle => 'raifl
rifle range => ˈraifl reindʒ
rifle shot => ˈraifl ʃɔt
rifled => 'raɪf(ə)l
rifleman => 'raiflmәn
riflemen => mən
riflery => 'raiflri
riflescope => 'raiflskәup
rifling => 'raifliŋ
rift => rift
rifted => rɪft
rifting => 'rɪftɪŋ
rifts => rɪfts
rig => rig
rig-out => 'ri^'aut
riga => 'ri:^ә
rigadoon => .rigә'du:n
rigamarole => 'ri^әmә,rәul
rigatoni => ,ri^ә'tәuni
rigged => rigd
rigger => 'ri^ә
rigging => 'rigiŋ
right => rait
right ascension => rait əˈsenʃən
right back => rait bæk
right field => rait fi:ld
right triangle => rait ˈtraiæŋɡl
right whale => rait hweil
right-hand drive => ˈraɪtˈhænd draiv
right-hand man => ˈraɪtˈhænd mæn
right-handed => rait'hændid
right-of-centre => rait ɔv ˈsentə
right-on => 'rait'ɔn,-'ɔ:n
right-thinking => rait ˈθiŋkiŋ
right-to-lifer => 'raittə'laifə
right-to-work => 'raittə'wə:k
rightable => 'raitәbl
righted => 'raɪtɪd
righten => 'raitn
righteous => 'raitʃәs
righteousness => 'raitʃәsnis
rightful => 'raitful
rightfulness => 'raɪtfəlnɪs
rightish => 'raitiʃ
rightism => 'raitiz(ә)m
rightist => 'raitist
rightists => 'raɪtɪsts
rightly => 'raitli
rightness => 'raitnis
righto => 'raitәu
rightsize => ˈraɪtsaɪz
rightward => 'raitwәd
rightwards => 'raitwәdz
righty => 'raiti
rigid => 'ridʒid
rigidified => rɪ'dʒɪdɪfaɪ
rigidifies => rɪ'dʒɪdɪfaɪ
rigidify => ri'dʒidifai
rigidifying => rɪ'dʒɪdɪfaɪ
rigidity => ri'dʒiditi
rigidness => 'rɪdʒɪdnɪs
rigmarole => 'rigmәrәul
rigmaroles => ˈrɪgməˌrəʊlz
rigor => 'rigә
rigor mortis => ri^ә 'mɔ:tis
rigorism => 'ri^әrizm
rigorist => 'ri^әrist
rigorous => 'rigәrәs
rigorousness => ˊrigәrәsnis
rigors => ˈrɪgəz
rigour => 'rigә
rigours => ˈrɪgəz
rigs => riɡz
Rijeka => ri:'jekә
rijsttafel => 'rais,tɑ:fәl
rile => rail
riled => raɪld
riles => raɪlz
riley => 'raili
rilievo => rili'eivәu
riling => raɪlɪŋ
rill => ril
rille => ril
rillettes => ri'lets,ri:'jet
rim => rim
rime => raim
rimfire => 'rim,faiә
riming => raimiŋ
Rimini => 'rimini,'ri:mi:ni:
rimland => 'rimlænd
rimless => 'rimlis
rimmed => rimd
rimming => 'rimiŋ
Rimmon => 'rimәn
rimrock => 'rimrɒk
rimu => 'ri:mu:
rimy => 'raimi
rind => raind
rinded => 'raindid
rinderpest => 'rindәpest
rindless => 'raɪndles
rinds => raɪndz
ring => riŋ
ring bearer => riŋ ˈbeərə
ring binder => riŋ ˈbaɪndə
ring road => riŋ roʊd
ring-necked => 'riŋnekt
ring-pull => 'rɪŋp'ʊl
ring-tailed => 'riŋteild
ringbark => 'riŋbɑ:k
ringbolt => 'riŋbәult
ringbone => 'riŋbәjn
ringdove => 'riŋdʌv
ringed => riŋd
ringer => 'riŋә
ringers => ˈriŋəz
ringgit => 'riŋ^it
ringhals => 'riŋhæls
ringing => 'riŋiŋ
ringingly => 'rɪŋɪŋlɪ
ringleader => 'riŋli:dә
ringleaders => ˈrɪŋˌli:dəz
ringless => 'rɪŋles
ringlet => 'riŋlit
ringlets => ˈrɪŋlɪts
ringmaster => 'riŋmɑ:stә
ringmasters => ˈrɪŋˌmæstəz
ringneck => 'riŋnek
ringside seat => ˈrɪŋˌsaɪd si:t
ringsider => 'riŋ,saidә(r)
ringster => 'riŋstә
ringtail => 'riŋteil
ringworm => 'riŋw\\\\:m
rink => riŋk
rinking => rɪŋk
rinks => rɪŋks
rinky-dink => 'riŋki'diŋk
rinse => rins
rinsed => rinst
rinser => 'rinsә
rinses => rinsiz
rinsing => 'riŋsiŋ
Rio de Janeiro => 'ri(:)әu dә dʒә'niәrәu
Rio Grande => 'ri:әu'^rændi
Rioja => ri'әjhɑ:
riot => 'raiәt
riot gear => ˈraiət ɡiə
rioted => ˈraiətid
rioter => 'raiәtә
rioters => 'raiətə
rioting => ˈraɪətɪŋ
riotous => 'raiәtәs
riotously => ˈraɪətəsli
riots => ˈraiəts
rip => rip
Rip Van Winkle => 'ripvæn'wiŋkl
rip-roaring => 'riprɔ:riŋ
riparian => ri'pєәriәn
ripcord => 'ripkɒ:d
ripcords => ˈripkɔ:dz
ripe => raip
ripely => 'raipli
ripen => 'raipәn
ripened => ˈraɪpənd
ripeness => 'raipnis
ripening => 'raɪpənɪŋ
ripens => ˈraɪpənz
riper => raipə
ripieno => rɪ'pɪeɪnəʊ
riposte => ri'pәust
riposted => riˈpəustid
ripostes => riˈpəusts
riposting => riˈpəustɪŋ
ripped => ript
ripper => 'ripә
rippers => 'rɪpə
ripping => 'ripiŋ
ripple => 'ripl
ripplet => 'riplit
rippling => 'ripliŋ
ripply => 'ripli
riprap => 'ripræp
rips => rips
ripsaw => 'ripsɒ:
ripsnorter => 'rip'snɒ:tә
ripsnorting => 'rip'snɒ:tiŋ
ripstop => 'ripstɔp
riptide => 'riptaid
rise => raiz
rise to => raiz tu:
risen => 'rizәn
riser => 'raizә
risers => ˈraizəz
rishi => 'riʃi,'ri:-
risibility => .rizi'biliti
risible => 'rizibl
rising => 'raiziŋ
rising damp => ˈraɪzɪŋ dæmp
rising main => ˈraɪzɪŋ mein
risk => risk
riskily => 'riskili
riskiness => 'riskinis
risky => 'riski
Risorgimento => 'risɔ:dʒi'mentәu
risotto => ri'sɒtәu
rissole => 'risәul
rita => 'ri:tә
ritardando => ,ri:tɑ:'dændәu
ritchie => 'ritʃi
rite => rait
rite of passage => raɪt ɔv ˈpæsidʒ
ritenuto => ,ritә'nu:tәj
ritornello => .ritә'nelәu
Ritter => 'ritə
ritual => 'ritʃuәl
ritualised => 'ritjuəlaiz, -tʃu-
ritualism => 'rɪtʃʊəlɪzəm
ritualist => 'ritjjәlist,-tʃj-
ritualistic => .ritʃuә'listik
ritualization => ,ritjjәlai'zeiʃәn,-tʃj-;-li'z-
ritualize => 'ritjuәlaiz
ritualized => ˈritjuəˌlaizd
ritualizing => ˈritjuəˌlaizɪŋ
rituals => 'rɪtʃʊəlz
ritz => rits
ritzy => 'ritsi
rival => 'raivl
rivalries => ˈraivəlriz
rivalrous => 'raivәlrәs
rivalry => 'raivlri
rivals => 'raivəlz
rive => raiv
riven => 'rivәn
river => 'rivә
river bed => ˈrivə bed
river blindness => ˈrivə ˈblaɪndnɪs
riverbank => 'rivәbæŋk
riverbed => 'rivәbed
riverboat => 'rivәbәjt
rivered => 'rivəd
riverfront => 'rivәfrʌnt
riverine => 'rivәrain
riverscape => 'rvəskeɪp
riverside => 'rivәsaid
riverway => 'rivәwei
rives => raivz
rivet => 'rivit
riveted => 'rɪvɪtɪd
riveter => 'rivitә
riveting => 'rivitiŋ
rivets => ˈrɪvɪts
riviera => ,rivi'eәrә
riving => 'raɪvɪŋ
rivulet => 'rivjulit
rivulets => rɪvjʊ'lɪts
riyadh => ri:'jɑ:d
riyal => ri'jɒl
RNase => ,ɑ:'ren,eis,-,eiz
roach => rәutʃ
roaches => rəʊtʃiz
road => rәud
road hog => roʊd hɔ:g
road rage => roʊd reidʒ
road sign => roʊd sain
road tax => roʊd tæks
road train => roʊd trein
road warrior => roʊd ˈwɔriə
roadbed => 'rәudbed
roadblock => 'rәudblɒk
roadblocks => ˈrəʊdˌblɔks
roadholding => 'rәudhәuldiŋ
roadhouse => 'rәjdhajs
roadhouses => ˈrəudhausiz
roadie => 'rәudi
roadkill => ˈrəʊdkɪl
roadless => 'rәjdlis
roadman => 'rәjdmәn
roadmap => 'rod,mæp
roadrunner => 'rәjd,rʌnә(r)
roadshow => ˈrəʊdʃəʊ
roadside => 'rәudsaid
roadsides => ˈrəʊdˌsaɪdz
roadster => 'rәudstә
roadsters => ˈrəudstəz
roadway => 'rәudwei
roadways => 'rəʊdweɪz
roadwork => 'rәjdw\\\\:k
roadworthiness => 'rəʊdwɜ:ðɪnəs
roadworthy => 'rәudwә:ði
roam => rәum
roamed => rəumd
roams => rəumz
roan => rәun
roans => rəʊnz
roar => rɒ:
roared => rɔ:d
roarer => 'rɒ:rә
roaring => 'rɒ:riŋ
roaringly => 'rɔ:riŋli
roast => rәust
roaster => 'rәustә
roasting => 'rәustiŋ
roasts => rəusts
rob => rɒb
robbed => rɔbd
robber => 'rɒbә
robber baron => ˈrɔbə ˈbærən
robber fly => ˈrɔbə flai
robberies => ˈrɔbəri:z
robbery => 'rɒbәri
robbing => 'rɔbiŋ
Robbins => 'rɔbinz
robe => rәub
robed => rəʊb
Robert => 'rɔbәt
roberta => rәu'bә:tә
roberts => 'rɔbәts
robertson => 'rɔbәtsn
Robertsonian => ,rɔbәt'sәjniәn
Robeson => 'rәubsn
robin => 'rɒbin
Robin Goodfellow => 'ɡud,feləu
robins => 'rәubinz, 'rɔbinz
robinson => 'rɔbinsn
Robinson Crusoe => 'kru:sәj
robot => 'rәubәt
robotic => rәu'bɔtik
robotics => rәu'bɔtiks
robotization => ,rәjbәtai'zeiʃәn,,rɔ-;-ti'z-
robotize => 'rәubɒtaiz
robs => rɔbz
robust => rәu'bʌst
robustly => rəʊ'bʌstlɪ
roc => rɒk
rocaille => rɔ'kai,rɔ'kɑ:j
rocambole => 'rɔkәm,bәul
Rochdale => 'rɔtʃdeil
Rochelle => rәu'ʃel
Rochester => 'rɔtʃistə; -tʃes-
rochet => 'rɒtʃit
rock => rɒk
rock bass => rɔk beɪs
rock cake => rɔk keik
rock climber => rɔk ˈklaɪmə
rock cod => rɔk kɔd
rock face => rɔk feis
rock hyrax => rɔk ˈhaiəræks
rock lobster => rɔk ˈlɔbstə
Rock of Gibraltar => ˌrɒk əv dʒɪ'brɔ:ltə(r)
rock pigeon => rɔk ˈpidʒin
rock plant => rɔk plɑ:nt
rock pool => rɔk pu:l
rock rabbit => rɔk ˈræbit
rock rose => rɔk rəuz
rock salmon => rɔk ˈsæmən
rock'n'roll => rɔkn'rәul
rock-bottom => 'rɔk'bɔtәm
rock-bound => 'rɔkbajnd
rock-hard => rɔk hɑrd
rock-like => 'rɒkl'aɪk
rock-ribbed => 'rɔkribd
rock-solid => 'rɒks'ɒlɪd
rockabilly => 'rɔkәbili
rocked => rɔkt
Rockefeller => 'rɔkifelә
rocker => 'rɒkә
rocker panel => ˈrɔkə ˈpænəl
rocker switch => ˈrɔkə switʃ
rockeries => ˈrɔkəriz
rockery => 'rɒkәri
rocket => 'rɒkit
rocket scientist => ˈrɔkit ˈsaiəntist
rocketeer => ,rɔki'tiә
rocketry => 'rɒkәtri
rocketship => 'rɒkɪtʃɪp
rockface => 'rɔkfeis
rockfall => 'rɒkfɒ:l
rockfish => 'rɒkfiʃ
rockhounding => 'rɔk,haundiŋ
rockier => ˈrɔki:ə
rockily => 'rɔkili
rockiness => 'rɔkinis
rocking => 'rɒkiŋ
rocking chair => 'rɔkiŋ
rocking horse => ˈrɔkiŋ hɔ:s
Rockingham => 'rɔkiŋәm
rockless => 'rɒkles
rockling => 'rɔkliŋ
rockslide => 'rɔkslaid
rocksteady => 'rɔk,stedi
rockumentary => rɒ'kəmentrɪ
Rockwell => 'rɒk,wel
rocky => 'rɒki
rococo => rә'kәukәu
rod => rɒd
rodding => 'rɔdiŋ
rode => rәud
rodent => 'rәudәnt
rodent ulcer => ˈrəʊdnt ˈʌlsə
rodenticide => rәu'dentisaid
rodeo => rәu'deiәu
rodeos => ˈrəʊdi:ˌəʊz
Roderick => 'rɔdәrik
Rodger => 'rɔdʒә
rodgers => 'rɔdʒәz
rodham => 'rɔdhæm
rodless => 'rɒdles
rodlet => 'rɔdlit
rodney => 'rɔdni
rodomontade => .rɒdәmɒn'teid
Rodrigues => rәj'dri:^әs,rɔ-
roe => rәu
roe deer => rəʊ diə
roebuck => 'rәubʌk
roentgen => 'rɔntjәn
roentgenium => ˌrɒnt'gi:niəm
roentgenogram => 'rɔnt^әnә^ræm,-tjә-,'rent-
roentgenography => .rentgә'nɒgrәfi
roentgenology => .rentgә'nɒlәdʒi
rogation => rәu'geiʃәn
roger => 'rɔdʒә
rogers => 'rɔdʒәz, 'rәudʒәz
Roget => 'rɔʒei
rogue => rәug
rogue state => rəʊg steit
roguery => 'rәugәri
rogues => rəʊgz
roguish => 'rәugiʃ
roguishly => 'rəugiʃli
roi => rwɑ:
roil => rɒil
roiled => rɔɪld
roiling => rɔɪlɪŋ
roils => rɔɪlz
roily => 'rɒili
roister => 'rɔistә
roistered => ˈrɔistəd
roistering => ˈrɔɪstərɪŋ
roisterous => 'rɒistәrәs
Roker => 'rәukә
roko => 'rәukәu
roland => 'rәulәnd
role => rәul
role model => rəul ˈmɔdəl
role-play => ˈrəʊlˌpleɪ
rolf => rɔlf
roll => rәul
roll bar => rəul bɑːr
roll cage => rəul keidʒ
roll off => rəul ɔf
roll-call => rəul kɔ:l
roll-neck => rəul nek
roll-on => ˈrəʊlˌɔn, -ˌɔ:n
roll-on roll-off => rəul ɔn rəul ɔf
roll-top desk => ˈrəʊlˌtɔp
roll-up => rəul ʌp
Rolland => rɔ:'læŋ
rollaway => 'rәjlә,wei
rollback => 'rәulbæk
rolled => rәuld
rolled oats => rəuld əuts
roller => 'rәulә
roller blind => ˈrəulə blaind
roller coaster => ˈrəulə ˈkəʊstə
roller skating => ˈrəulə ˈskeɪtɪŋ
roller towel => ˈrəulə ˈtauəl
roller-skate => 'rәjlәskeit
roller-skating => 'rəʊləskeɪtɪŋ
rollered => 'rәjlәd
rollick => 'rɒlik
rollicking => 'rɔlikiŋ
rolling => 'rәuliŋ
rolling hitch => ˈrəʊlɪŋ hitʃ
rolling pin => ˈrəʊlɪŋ pin
rollmop => ˈrəʊlmɒp
rollmops => 'rәulmɔps
Rollo => 'rɔlәu
rollout => 'rәulaut
rollover => 'rәul,әuvә
rolls => rәulz
Rolls-Royce => 'rәjlz'rɔis
Rolodex => 'rəulə,deks
roly-poly => 'rәuli'pәuli
ROM => rɔm,rәjm
roma => 'rɔmә. 'rәu-
Romaic => rәu'meiik
romaine => rәu'mein
romaji => 'rәjmɑ:dʒi,-mә-
Roman => 'rәumәn
roman-fleuve => rɔ,mɔŋ'fl\\\\:v
romance => rәu'mæns
romanced => rə(ʊ)'mæns; 'rəʊmæns
romancer => rәu'mænsә
romances => rəuˈmænsiz
Romanesque => ,rәumә'nesk
Romania => rәu'meinjә
Romanian => ru:'meiniәn
Romanic => rәu'mænik
Romanism => 'rәumәnizәm
Romanist => 'rәumәnist
romanization => roumәnaiˊzeiʃәn
romano => rәj'mɑ:nәj
Romanov => 'rəumənɔf; rɔ'mɑ:nɔf
romans => 'rәjmәnz
romantic => rәu'mæntik
romantically => rәu'mæntikli
romanticise => rәj'mæntisaiz
romanticised => rəu'mæntisaiz
romanticism => rәu'mæntisizm
romanticist => rәu'mæntisist
romanticization => rəu,məntisai'zeiʃən
romanticize => rәu'mæntisaiz
romanticized => rəʊˈmæntɪˌsaɪzd
romanticizes => rəʊˈmæntɪˌsaɪziz
romanticizing => rəʊˈmæntɪˌsaɪzɪŋ
romantics => rə'mæntɪks
Romany => 'rɔmәni
Rome => rәum
romeo => 'rәumiәu
romeos => 'rәumiәu
Romford => 'rʌmfəd
Romish => 'rәumiʃ
Rommel => 'rɔmәl
Romney => 'rɔmni
romp => rɒmp
romped => rɔmpt
romper => 'rɒmpә
romping => 'rɔmpiŋ
romps => rɔmps
romulus => 'rɔmjulәs
ronald => 'rɔnәld
rondavel => ,rɔndә'vel
rondeau => 'rɔndәu
rondel => 'rɒndl
rondo => 'rɔndәu
rone => 'rəʊn
ronin => 'rɔnin
ronnie => 'rɔni
ronquil => 'rɔŋkil
roo => ru:
rood => ru:d
rood screen => ˈru:d skri:n
roof => ru:f
roof of the mouth => ru:f ɔv ðə mauθ
roof rack => ru:f ræk
roof rat => ru:f ræt
roof-rack => 'ru:fr'æk
roof-tree => 'ru:ftr'i:
roofed => ru:ft
roofer => 'ru:fә
roofie => 'ru:faɪ
roofing => 'ru:fiŋ
roofless => 'ru:flis
roofline => 'ru:flain,'rj-
roofs => ru:fs
roofscape => 'ru:fskeip,'rj-
rooftop => 'ru:ftɒp
rooftops => ˈru:fˌtɔps
rooinek => 'rәjinek,'rɔi-
rook => rʌk
rooked => rukt
rookeries => ˈrukəriz
rookery => 'rukәri
rookie => 'ruki
rooking => rukɪŋ
rooks => ruks
room => ru:m
room-mate => 'rjmmeit
roomed => ru(:)md
roomer => 'ru:mә
roomette => ru:m'et
roomful => 'ru:mful
roomie => 'ru:mi
roomier => ˈru:mi:ə
roomily => 'ru:mili
roominess => 'ru:minis
rooming => 'ru:miŋ,'rj-
rooming house => ˈru:miŋ haus
roommates => 'ru:mmeɪts
roomy => 'ru:mi
Roosevelt => 'rәuzәvelt, 'ru:svelt
roost => ru:st
roosted => ru:stid
rooster => 'ru:stә
roosters => 'ru:stəz
roosting => ru:stɪŋ
roosts => ru:sts
root => ru:t
root beer => ru:t biə
root crop => ru:t krɔp
root vegetable => ru:t ˈvedʒitəbl
root-knot => 'ru:tn'ɒt
rooted => 'ru:tid
rootedness => 'ru:tɪdnəs
rooter => 'ru:tә
rooting => 'ru:tiŋ
rootkit => rʊkɪt
rootle => 'ru:tl
rootled => 'ru:tl, 'ru-
rootles => 'ru:tl, 'ru-
rootless => 'ru:tlis
rootlessness => 'ru:tlisnis
rootlet => 'ru:tlit
rootling => 'ru:tl, 'ru-
rootstock => 'ru:tstɒk
rootworm => 'ru:twә:m
rooty => 'ru:ti
rope => rәup
ropeable => 'rәupәbl
ropemanship => 'rәjpmәnʃip
roper => 'rәjpә(r)
ropeway => 'rәupwei
ropey => 'rәjpi
ropiness => 'rәupinis
roping => 'rәupiŋ
ropy => 'rәupi
roque => rәuk
roquet => rәu'kei
roquette => rәj'ket
rorqual => 'rɔ:kwәl
Rorschach test => 'rɔ:ʃɑ:k
rort => rɔ:t
rorty => 'rɒ:ti
Rory => 'rɔ:ri,'rәjri
rosa => 'rәuzә
rosace => 'rәuzeis
rosacea => rәu'zeiʃiә
rosaceous => rәu'zeiʃәs
rosalie => 'rɔzәli
Rosalind => 'rɔzәlind
Rosamund => 'rәjzәmәnd,'rɔ-
rosaniline => rәu'zænili:n
rosarian => rәu'zєәriәn
rosaries => ˈrəʊzəri:z
Rosario => rәu'sɑ:rjәu
rosarium => rәu'zeәriәm
rosary => 'rәuzәri
Roscoe => 'rɔskәu
Roscommon => rɔs'kɔmən
rose => rәuz
rose hip => rəuz hip
rose mallow => rəuz ˈmæləu
rose quartz => rəuz kwɔ:ts
rose-cut => 'rəuzkʌt
rose-like => 'rəuzlaik
rose-tinted => 'rəuz,tintid
roseate => 'rәuziәt
Roseau => rәj'zәj
rosebay => 'rәuzbei
Rosebery => 'rәuzbәri
rosebud => 'rәuzbʌd
rosebuds => ˈrəuzbʌdz
rosebush => 'rәuzbuʃ
rosefish => 'rәjzfiʃ
rosella => rәu'zelә
rosemaled => 'rәjzәmɑ:ld, -sә-
rosemaling => 'rәjzә,mɑ:liŋ, -sә-
rosemary => 'rәuzmәri
Rosenberg => 'rəuzənbə:ɡ
Rosenthal => 'rәjzәntɑ:l
roseola => rәu'zi:әlә
roseroot => 'rәjzru:t
roset => 'rɔzit
rosetta => rәu'zetә
rosette => rәu'zet
rosettes => rəʊˈzets
rosewater => 'rәuswɒ:tә
rosewood => 'rәuzwud
Rosh Hashana => 'rɔʃhә'ʃɑ:nә
Rosicrucian => ,rәuzikru'ʃәn
Rosicrucianism => 'rəuzi'kru:ʃə,nizəm
ROSIE => 'rəuzi:
rosier => ˈrəʊzi:ə
rosily => 'rәuzili
rosin => 'rɒzin
Rosina => rәj'zi:nә
rosined => ˈrɔzind
rosiness => 'rәuzinis
rosining => ˈrɔzinɪŋ
rosins => ˈrɔzinz
rosiny => 'rɔzini, 'rɔ:-
rosolio => rәu'zәuliәu
ross => rɔs
Rosser => 'rɔsә
Rossetti => rɔ'seti
rossite => 'rɔsait
roster => 'rɒstә
rostering => 'rәustәriŋ
rosters => ˈrɔstəz
Rostock => 'rɔstɔk
Rostov => 'rɔstɔv
rostra => 'rɔstrә
rostral => 'rɒstrәl
rostrate => 'rɒstreit
rostrum => 'rɒstrәm
rosy => 'rәuzi
rot => rɒt
rota => 'rәutә
rotamer => 'rәjtәmә(r)
rotary => 'rәutәri
rotary press => ˈrəutəri pres
rotary wing => ˈrəutəri wiŋ
rotas => ˈrəutəz
rotatable => 'rәuteitәbl
rotate => 'rәuteit
rotated => rəuˈteitid
rotates => rəuˈteits
rotation => rәu'teiʃәn
rotational => rәu'teiʃәnәl
rotations => rəʊ'teɪʃnz
rotative => 'rәutәtiv
rotator => 'rәuteitә
rotator cuff => rəuˈteitə kʌf
rotatory => 'rәutәtәri
rotavate => 'rəʊtəveɪt
rotavirus => 'rәjtә,vaiәrәs
rote => rәut
rotenone => 'rәutnәun
rotgut => 'rɒtgʌt
Rotherham => 'rɔðərəm
Rothschild => 'rɔθtʃaild, 'rəuʃilt
roti => 'rәjti, 'rj-
rotifer => 'rәutifә
rotisserie => rәu'tisәri:
rotogravure => .rәutәugrә'vjuә
rotor => 'rәutә
rotorcraft => 'rәjtәkrɑ:ft; -kræft
rotors => 'rəʊtəz
rotoscope => rɒ'təskəʊp
rototill => 'rәutәtil
rototiller => 'rәutә,tilә
rotovator => 'rәjtәveitә(r)
rots => rɔts
rotted => rɔtid
rotten => 'rɒtn
rotten borough => ˈrɔtən ˈbʌrə
rottenly => 'rɔtənli
rottenness => 'rɑtnnɪs
rottenstone => 'rɒtnstәun
rotter => 'rɒtә
Rotterdam => 'rɔtәdæm
rotters => ˈrɔtəz
rotting => 'rɔtiŋ
rottweiler => 'rɔtwailә
rotund => rәu'tʌnd
rotunda => rәu'tʌndә
rotundas => rəuˈtʌndəz
rotundity => rәu'tʌnditi
rouble => 'ru:bl
roubles => ˈru:blz
roucou => ru:'ku:
Rouen => 'ru:әŋ
rouge => ru:ʒ
rouged => ru:ʒd
rouges => ru:ʒz
rough => rʌf
rough cut => rʌf kʌt
rough-dry => 'rʌfdr'aɪ
rough-hew => 'rʌfhj'u:
rough-hewn => ˌrʌfˈhju:n
roughage => 'rʌfidʒ
roughcast => 'rʌfkɑ:st
roughcasting => ˈrʌfkɑ:stɪŋ
roughcasts => ˈrʌfkɑ:sts
roughed => rʌft
roughen => 'rʌfәn
roughened => 'rʌfənd
roughening => 'rʌfәniŋ
roughens => ˈrʌfənz
rougher => 'rʌfә
roughhouse => 'rʌfhaus
roughhoused => ˈrʌfhaust
roughhouses => ˈrʌfhausiz
roughhousing => ˈrʌfhausɪŋ
roughing => 'rʌfiŋ
roughish => 'rʌfiʃ
roughly => 'rʌfli
roughneck => 'rʌfnek
roughnecks => ˈrʌfˌneks
roughness => 'rʌfnis
roughs => rʌfs
roughshod => 'rʌfʃɒd
roughy => 'rʌfi
rouging => ru:ʒɪŋ
rouille => 'ru:i:, 'ru:jә
roulade => ru:'lɑ:d
rouleau => ru:'lәu
roulette => ru:'let
Roumania => ru:'meiniә, rәj-
Roumanian => ru:'meiniәn, rәj-
round => raund
round dance => raund dɑ:ns
round trip => raund trip
round-arm => 'rajnd,ɑ:m
round-trip => 'rajnd'trip
roundabout => 'raundә.baut
roundabouts => ˈraundəbauts
rounded => 'raundid
roundel => 'raundl
roundelay => 'raundilei
rounder => 'raundә
roundhead => 'rajndhed
roundheel => 'rajndhi:l
roundhouse => 'raundhaus
rounding => 'raundiŋ
roundish => 'raundiʃ
roundly => 'raundli
roundness => 'raundnis
roundsman => 'raundzmәn
roundup => 'raundʌp
roundups => ˈraʊndˌʌps
roundwood => 'rajndwjd
roundworm => 'raundwә:m
roup => ru:p
roupy => 'ru:pi
rouse => rauz
rouseabout => 'rauzә.baut
roused => rauzd
rouser => 'rauzә
rouses => rauziz
rousing => 'rauziŋ
Rousseau => 'ru:sәu
Roussillon => ,ru:si:'jjŋ
roust => raust
roustabout => 'raustә.baut
rout => raut
route => ru:t
route man => ru:t mæn
route march => ru:t mɑ:tʃ
router => 'ru:tә(r), 'raj-
routine => ru:'ti:n
routing => 'ru:tiŋ
routinism => ru:'ti:nizm
routinist => ru:'ti:nist
routinization => ru:,ti:nai'zeiʃәn; -ni'z-
routinize => ru:'ti:naiz
routinized => ru:ˈtinaizd
routs => raʊts
roux => ru:
rove => rәuv
rove beetle => rəʊv ˈbi:tl
roved => rəʊvd
rover => 'rәuvә
roves => rəʊvz
roving => 'rәuviŋ
row => rәu. rau
row house => ˈrəʊ haʊs
rowan => 'rәuәn
rowboat => 'rәubәut
rowboats => ˈrəʊˌbəʊts
rowdier => ˈraʊdi:ə
rowdily => 'raudili
rowdy => 'raudi
rowdyism => 'rajdiizәm
rowe => rәu
rowed => rəud
rowel => 'rauәl
rowelled => 'raʊ(ə)l
rowelling => 'raʊ(ə)l
rowen => 'rәuәn
Rowena => rәu'i:nә
rower => 'rәuә
rowers => 'rəʊəz
rowing => 'rәuiŋ
rowing boat => ˈrəʊɪŋ bəut
rowing machine => ˈrəʊɪŋ məˈʃi:n
rowland => 'rәulәnd
rowley => 'rәuli
rowlock => 'rɔlәk
Roxanne => rɔk'sæn
Roxburgh => 'rɔksbәrә
ROXY => 'rɔksi
roy => rɔi
royal => 'rɒiәl
royal flush => ˈrɔiəl flʌʃ
royal icing => ˈrɔiəl ˈaɪsɪŋ
royal palm => ˈrɔiəl pɑ:m
royal stag => ˈrɔiəl stæg
royale => rɔi'æl
royalism => 'rɒiәlizm
royalist => 'rɒiәlist
royalists => ˈrɔɪəlɪsts
royally => 'rɒiәli
royals => ˈrɔiəlz
royalty => 'rɒiәlti
royce => rɔis
Royston => 'rɔistәn
Roz => rɔz
rozzer => 'rɔzә
rpi => ˌɑ:pi:'aɪ
RRP => ,a:(r) a: 'pi:
rspca => ˌɑ:r es pi: si: ˈeɪ
RTA => ,a: ti: 'ei
rub => rʌb
rub-down => ˈrʌbˌdaʊn
rubato => ru:'bɑ:tәu
rubber => 'rʌbә
rubber boot => ˈrʌbə bu:t
rubber bullet => ˈrʌbə ˈbulit
rubber tree => ˈrʌbə tri:
rubber-stamped => ,rʌbə'stæmp
rubber-stamps => ,rʌbə'stæmp
rubberize => 'rʌbәraiz
rubberized => ˈrʌbəraɪzd
rubberneck => 'rʌbәnek
rubbery => 'rʌbәri
rubbing => 'rʌbiŋ
rubbing alcohol => ˈrʌbɪŋ ˈælkəˌhɔl
rubbish => 'rʌbiʃ
rubbished => ˈrʌbiʃt
rubbishes => ˈrʌbiʃiz
rubbishy => 'rʌbiʃi
rubble => 'rʌbl
rubbly => 'rʌbli
rubdown => 'rʌbdaun
rube => ru:b
rubella => ru:'belә
rubellite => 'ru:bәlait
ruben => 'ru:bin
Rubens => 'ru:binz
rubeola => ru:'bi:әlә
rubescent => ru:'besnt
rubicon => 'ru:bikәn
rubicund => 'ru:bikәnd
rubicundity => .ru:bi'kʌnditi
rubidium => ru:'bidiәm
rubies => ˈru:biz
rubiginous => ru:'bidʒinәs
ruble => 'ru:bl
rubredoxin => ,ru:brә'dɔksin
rubric => 'ru:brik
rubrical => 'ru:brikәl
rubricate => 'ru:brikeit
rubricated => ˈru:brikeitid
rubricates => ˈru:brikeits
rubricating => ˈru:brikeitɪŋ
rubrication => .ru:bri'keiʃәn
rubricator => 'ru:brɪkeɪtə
rubrics => 'ru:brɪks
rubs => rʌbz
ruby => 'ru:bi
ruby wedding => ˈru:bi ˈwediŋ
rubythroat => 'ru:biθrəut
RUC => ,a: ju: 'si:
ruche => ru:ʃ
ruched => ru:ʃt
ruching => 'ru:ʃiŋ
ruck => rʌk
rucked => rʌkt
rucking => rʌkɪŋ
ruckle => 'rʌkl
rucks => rʌks
rucksack => 'rʌksæk
rucksacks => ˈrʌkˌsæks
ruckus => 'rʌkәs
ruction => 'rʌkʃәn
ructions => ˈrʌkʃnz
rudaceous => 'ru:deiʃәs
rudbeckia => rʌd'bekiә
rudd => rʌd
rudder => 'rʌdә
rudderless => 'rʌdәlis
rudders => ˈrʌdəz
ruddied => 'rʌdɪ
ruddier => ˈrʌdi:ə
ruddily => 'rʌdili
ruddiness => 'rʌdinis
ruddle => 'rʌdl
ruddled => ˈrʌdld
ruddles => ˈrʌdlz
ruddling => ˈrʌdlɪŋ
ruddock => 'rʌdәk
ruddy => 'rʌdi
rude => ru:d
rudely => 'ru:dli
ruderal => 'ru:dәrәl
rudest => 'ru:dɪst
rudiment => 'ru:dimәnt
rudimentary => ru:di'mentәri
Rudolph => 'ru:dɔlf
rudy => 'ru:di
rue => ru:
rued => ru:d
rueful => 'ru:ful
ruefulness => ˊruːfulnis
rues => ru:z
ruff => rʌf
ruffe => rʌf
ruffed => rʌft
ruffed grouse => rʌft graʊs
ruffian => 'rʌfiәn
ruffianism => 'rʌfiәnizәm
ruffianly => 'rʌfiәnli
ruffians => ˈrʌfi:ənz
ruffing => 'rʌfɪŋ
ruffle => 'rʌfl
ruffled => 'rʌfld
ruffles => ˈrʌflz
ruffling => 'rʌflɪŋ
ruffly => 'rʌfli
ruffs => rʌfs
rufiyaa => ru:fɪ'jɑ:
rufous => 'ru:fәs
rufus => 'ru:fәs
rug => rʌg
rugby => 'rʌ^bi
rugged => 'rʌgid
ruggedization => ,rʌ^idai'zeiʃən; -di'z-
ruggedize => 'rʌgidaiz
ruggedized => 'rʌɡɪdaɪzd
ruggedly => 'rʌɡɪdlɪ
ruggedness => 'rʌ^idnis
rugger => 'rʌgә
rugola => 'ru:ɡələ
rugosa => ru:'^әjsә, -zә
rugose => 'ru:^әjs, ru:'^әjs
rugosity => ru:'gɒsiti
Ruhr => ruә
ruin => ruin
ruination => ru(:)i'neiʃәn
ruine => 'ru:ɪn
ruined => 'ruind
ruing => ru:ɪŋ
ruining => ˈruinɪŋ
ruinous => 'ruinәs
ruinously => 'ru:ɪnəslɪ
rule => ru:l
rule of law => ru:l ɔv lɔ:
rulebook => 'ru:lbjk
ruleless => 'ru:llis
ruler => 'ru:lә
rulers => 'ru:ləz
rulership => 'ru:lәʃip
ruling => 'ru:liŋ
rum => rʌm
rum baba => rʌm ˈbɑ:bɑ:
rumania => ru(:)'meinjә
Rumanian => ru:'meiniәn
rumba => 'rʌmbә
rumble => 'rʌmbl
rumble strip => ˈrʌmbl strip
rumbled => ˈrʌmbld
rumbler => 'rʌmblә
rumbles => ˈrʌmblz
rumbling => 'rʌmb(ә)liŋ
rumbustious => rʌm'bʌstʃәs
rumbustiously => rәmˊbʌstʃәsli
rumen => 'ru:men
ruminant => 'ru:minәnt
ruminate => 'ru:mineit
ruminated => ˈru:məˌneɪtid
ruminates => ˈru:məˌneɪts
ruminating => ˈru:məˌneɪtɪŋ
rumination => .ru:mi'neiʃәn
ruminations => ˌru:məˈneɪʃənz
ruminative => 'ru:minәtiv
ruminatively => ˊruːminәtivli
ruminator => 'ru:mineitә(r)
rumly => 'rʌmli
rummage => 'rʌmidʒ
rummage sale => ˈrʌmidʒ seil
rummaged => ˈrʌmidʒd
rummager => 'rʌmidʒә(r)
rummages => ˈrʌmidʒz
rummaging => ˈrʌmidʒɪŋ
rummer => 'rʌmә
rummy => 'rʌmi
rumor => 'ru:mә
rumoring => ˈru:mərɪŋ
rumors => ˈru:məz
rumour => 'ru:mә
rumour-monger => ˈruːməmʌŋɡə(r)
rumourmonger => 'ru:mә'mʌŋ^ә, -mɔŋ
rumours => ˈru:məz
rump => rʌmp
rump steak => rʌmp steik
rumple => 'rʌmpl
rumpled => ˈrʌmpəld
rumples => ˈrʌmpəlz
rumpless => 'rʌmplis
rumpling => ˈrʌmpəlɪŋ
rumply => 'rʌmpli
rumpot => 'rʌmpɔt
rumps => rʌmps
rumpus => 'rʌmpәs
rums => rʌmz
run => rʌn
run interference => rʌn ˌɪntəˈfiərəns
run with => rʌn wið
run-around => 'rʌnər'aʊnd
run-on => 'rʌnɔn, -ɔ:n
runabout => 'rʌnә.baut
runabouts => ˈrʌnəˌbaʊts
runaround => 'rʌnә.raund
runaway => 'rʌnә.wei
runaways => ˈrʌnəˌweɪz
runcible spoon => ˈrʌnsəbəl
rundown => 'rʌndaun
rune => ru:n
rung => rʌŋ
runic => 'ru:nik
runlet => 'rʌnlit
runnable => 'rʌnәbl
runnel => 'rʌnl
runner => 'rʌnә
runner bean => ˈrʌnə bi:n
runnier => ˈrʌni:ə
running => 'rʌniŋ
running back => ˈrʌnɪŋ bæk
running commentary => ˈrʌnɪŋ ˈkɔmentəri
running dog => ˈrʌnɪŋ dɔɡ
running head => ˈrʌnɪŋ hed
running knot => ˈrʌnɪŋ nɔt
running mate => ˈrʌnɪŋ meit
running-board => 'rʌnɪŋb'ɔ:d
runny => 'rʌni
Runnymede => 'rʌnimi:d
runoff => 'rʌnɒf
runt => rʌnt
runts => rʌnts
runty => 'rʌnti
runway => 'rʌnwei
runways => ˈrʌnweiz
rupee => ru:'pi:
rupees => ru:ˈpi:z
Rupert => 'ru:pət
rupestrian => ru:'pestriәn
rupiah => ru:'pi:ә
rupture => 'rʌptʃә
ruptures => ˈrʌptʃəz
rupturing => ˈrʌptʃərɪŋ
rural => 'ruәrәl
rural dean => ˈruərəl di:n
rural delivery => ˈruərəl diˈlivəri
rural route => ˈruərəl ru:t
ruralism => 'ruәrәlizm
ruralist => 'ruәrәlist
rurality => ruә'ræliti
ruralize => 'ruәrәlaiz
Ruritania => ,rjәri'teiniә, -njә
Ruritanian => rjәri'teiniәn
rusa => 'ru:sә
ruse => ru:z
ruses => ru:siz
rush => rʌʃ
rush hour => rʌʃ ˈauə
rusher => 'rʌʃə
rushing => 'rʌʃiŋ
rushingly => 'rʌʃɪŋlɪ
rushlight => 'rʌʃlait
rushlike => 'rʌʃlaik
rushy => 'rʌʃi
rusk => rʌsk
rusks => rʌsks
russ => rʌs, ru:s, rjs
russell => 'rʌsәl
russet => 'rʌsit
russety => 'rʌsiti
Russia => 'rʌʃә