rustiness => 'rʌstinis
rusting => 'rʌstiŋ
rustle => 'rʌsl
rustled => ˈrʌsld
rustler => 'rʌslә
rustlers => ˈrʌsləz
rustles => ˈrʌslz
rustless => 'rʌstlis
rustling => 'rʌsliθ
rustproof => 'rʌstpru:f
rusty => 'rʌsti
rut => rʌt
rutabaga => .ru:tә'beigә
ruth => ru:θ
Ruthenia => ru:'θi:niә
ruthenium => ru:'θi:niәm
rutherford => 'rʌðәfәd
rutherfordium => ,rʌðә'fɔ:diәm
ruthless => 'ru:θlis
ruthlessly => 'ru:θləslɪ
rutilant => 'ru:tilәnt
rutile => 'ru:ti:l
rutin => 'ru:tin
Rutland => 'rʌtlәnd(ʃiә(r))
ruts => rʌts
rutted => 'rʌtid
Rutter => 'rʌtә(r)
ruttish => 'rʌtiʃ
rutty => 'rʌti
Ruwenzori => ,ru:wen'zɔ:ri
rwanda => rj'ændә
Rwandan => rj'ɑ:ndәn, -'æn-
Rwandese => ru,ɑ:n'di:z; -,æn-
rx => 'ɑ:r'eks
rya => ˈri:ə
ryan => 'raiәn
Ryazan => ,ri:ә'zæn, rjɑ:'zɑ:njә
rye => rai
ryegrass => 'raigræs
ryokan => ri'әjkәn
ryot => 'raiәt
Ryurik => 'rjәrik, 'rju:rik