j => dʒei
JA => jɑ:
jab => dʒæb
Jabalpur => ,dʒʌbәl'puә
jabbed => dʒæbd
jabber => 'dʒæbә
jabbered => ˈdʒæbəd
jabbering => ˈdʒæbərɪŋ
jabbers => ˈdʒæbəz
jabberwocky => 'dʒæbә.wɒki
jabbing => dʒæbɪŋ
jabiru => 'dʒæbiru:
jaborandi => ,dʒæbә'rændi
jabot => 'ʒæbәu
jabs => dʒæbz
jacal => hә'kɑ:l
jacamar => 'dʒækәmɑ:
jacana => ,ʒɑ:sә'nɑ:
jacaranda => .dʒækә'rændә
jacinth => 'dʒæsinθ
jack => dʒæk
jack mackerel => dʒæk ˈmækərəl
jack off => dʒæk ɔf
jack pine => dʒæk pain
jack plug => dʒæk plʌɡ
jack up => dʒæk ʌp
jack-in-the-box => 'dʒækinðәbɔks
jack-in-the-boxes => d'ʒæk'ɪnðəb'ɒksɪz
jack-up => 'dʒækʌp
jackal => 'dʒækɒ:l
jackals => ˈdʒækəlz
jackaroo => .dʒækә'ru:
jackass => 'dʒækæs
jackboot => 'dʒækbu:t
jackbooted => 'dʒæk,bu:tid
jackdaw => 'dʒækdɒ:
jackdaws => ˈdʒækdɔ:z
jackeroo => ,dʒækә'ru:
jacket => 'dʒækit
jacket potato => ˈdʒækit pəˈteitəu
jacketed => 'dʒækitid
jacketing => 'dʒækitiŋ
jackfish => 'dʒækfiʃ
jackfruit => 'dʒækfru:t
jackhammer => 'dʒækhæmә
jackie => 'dʒæki
jacking => 'dʒækiŋ
jackknife => 'dʒæknaif
jackknifed => ˈdʒæknaift
jackknifing => 'dʒæknaifiŋ
jackleg => 'dʒækleg
jackpot => 'dʒækpɔt
jackpots => ˈdʒækpɔts
jackrabbit => ˈdʒækræbɪt
jacks => dʒæks
jackscrew => 'dʒækskru:
jacksie => 'dʒæksi
jackson => 'dʒæksn
jacksonian => dʒæk'sәuniәn
jacksonville => 'dʒæksənvil
jackstaff => 'dʒækstɑ:f
jackstay => 'dʒækstei
jackstone => 'dʒækstәun
jackstraw => 'dʒækstrɒ:
jacksy => 'dʒæksi
jacky => 'dʒæki
jacob => 'dʒeikәb
Jacobean => .dʒækәu'bi:әn
Jacobethan => ,dʒækә'bi:θәn
Jacobian => dʒæ'kәubiәn
jacobin => 'dʒækәbin
Jacobinical => ,dʒækә'binikәl
Jacobinism => 'dʒækәubinizәm
Jacobite => 'dʒækәbait
jaconet => 'dʒækәnet
jacquard => dʒә'kɑ:d
jacqueline => 'dʒækli:n
jacquerie => ʒɑ:k'ri:
jacques => ʒɑ:k,dʒeiks
jactitation => .dʒækti'teiʃәn
Jacuzzi => dʒə'ku:zi
jade => dʒeid
jaded => 'dʒeidid
jadedness => dʒeɪ'dɪdnəs
jadeite => 'dʒeidait
jaeger => 'jei^ә
Jaffa => 'dʒæfә
Jaffna => 'dʒæfnә
jag => dʒæg
jagged => 'dʒægd
jaggedness => dʒæɡd'nes
jagger => 'jɑ:^ә
jaggery => 'dʒægәri
jagging => d'ʒæɡɪŋ
jaggy => 'dʒæ^i
jaguar => 'dʒægjuә
jaguars => ˈdʒægˌwɑ:z
jaguarundi => ,dʒæ^wә'rʌndi
Jahangir => dʒə'hɑ:ŋɡiə
jai alai => 'hailai, haiә'lai
jail => dʒeil
jailbait => 'dʒeilbeit
jailbird => 'dʒeilbә:d
jailbirds => ˈdʒeɪlˌbɜ:dz
jailbreak => 'dʒeilbreik
jailer => 'dʒeilә
jailers => ˈdʒeɪləz
jailhouse => 'dʒeilhajs
jailing => dʒeilɪŋ
jails => dʒeilz
Jain => dʒain
Jainism => 'dʒainizm
Jaipur => ,dʒai'puə
jakarta => dʒә'kɑ:tә
jake => dʒeik
jakes => dʒeiks
Jalalabad => dʒә'lɑ:lәbɑ:d
jalap => 'dʒælәp
jalapeno => ,hɑ:lә'peijәu
Jalisco => hɑ:'liskә
jalopies => dʒəˈlɔpiz
jalopy => dʒә'lɔpi
jalousie => 'ʒælu:zi:
jam => dʒæm
jam jar => dʒæm dʒɑ:
jam session => dʒæm ˈseʃən
jam tomorrow => dʒæm təˈmɔrəu
jam-packed => dʒæm 'pækt
jamadar => 'dʒemədɑ:
Jamaica => dʒә'meikә
jamaican => dʒә'meikәn
jamaicans => dʒəˈmeikənz
jamb => dʒæm
jambalaya => .dʒʌmbә'laiә
jambeau => 'dʒæmbәu
jamboree => 'dʒæmbә'ri:
jamborees => ˌdʒæmbəˈri:z
jambs => dʒæms
james => dʒeimz
Jamesian => 'dʒeimziәn
jameson => 'dʒeimsn, 'dʒimsn
jammer => 'dʒæmә
jammier => ˈdʒæmiə
jammies => 'dʒæmɪs
jamming => 'dʒæmiŋ
Jammu => 'dʒʌmu:
jammy => 'dʒæmi
jams => dʒæmz
Jamshedpur => dʒʌmʃed'puә
Jamshid => dʒæm'ʃi:d
Jan => dʒæn
Janata => 'dʒʌnətɑ:
jane => dʒein
JANET => 'dʒænit
jangle => 'dʒæŋgl
jangled => ˈdʒæŋgəld
jangles => ˈdʒæŋgəlz
jangling => 'dʒæŋglɪŋ
jangly => d'ʒæŋɡlɪ
janissary => dʒæ'nɪsərɪ
janitor => 'dʒænitә
janitorial => ,dʒæni'tɔ:riəl
janitors => ˈdʒænɪtəz
janker => 'dʒæŋkә
Jansenism => 'dʒænsәnizm
Jansenist => 'dʒænsәnist
January => 'dʒænjuәri
Janus => 'dʒeinәs
Jap => dʒæp
Japan => dʒә'pæn
Japanese => .dʒæpә'ni:z
japanned => dʒə'pænd
japanning => dʒә'pæniŋ
japans => dʒə'pæn
jape => dʒeip
Japheth => 'dʒeifeθ
japonica => dʒә'pɒnikә
Jaques => 'dʒeikwiz
jar => dʒɑ:
jarful => 'dʒarˌfʊl
jargon => 'dʒɑ:gәn
jargoning => 'dʒɑːg(ə)n
jargonistic => ,dʒɑ:ɡə'nistik
jargonize => 'dʒɑ:^әnaiz
jarl => jɑ:l
jarrah => 'dʒærә
jarring => 'dʒɑ:riŋ
jarringly => 'dʒɑ:riŋli
Jarvis => 'dʒɑ:vis
jasmine => 'dʒæsmin
jasper => 'dʒæspә
Jassy => 'jɑ:si
Jat => dʒɑ:t
jatha => 'dʒɑ:tә
jati => d'ʒɑ:tɪ
jato => 'dʒeitәu
jaundice => 'dʒɒ:ndis
jaundiced => 'dʒɒ:ndist
jaundicing => ˈdʒɔ:ndɪsɪŋ
jaunt => dʒɒ:nt
jaunted => dʒɔːnt
jauntily => 'dʒɒ:ntili
jauntiness => 'dʒɒ:ntinis
jaunting => dʒɒːntiŋ
jaunts => dʒɔ:nts
jaunty => 'dʒɒ:nti
Java => 'dʒɑ:vә
Javan => 'dʒɑ:vәn
Javanese => .dʒævә'ni:z
javelin => 'dʒævlin
javelina => ,hɑ:vi'li:nә
javelins => ˈdʒævəlinz
jaw => dʒɒ:
jaw-dropping => dʒɔ: ˈdrɔpiŋ
jaw-jaw => 'dʒɔ:'dʒɔ:
jawan => dʒә'wɑ:n
jawbone => 'dʒɒ:bәun
jawbones => ˈdʒɔ:ˌbəʊnz
jawbreaker => 'dʒɒ:breikә
jawed => dʒɔ:d
jawfish => 'dʒɔ:fiʃ
jawing => 'dʒɔ:iŋ
jawline => 'dʒɔ:,lain
jaws => jɒ:z
jay => dʒei
jaybird => 'dʒeib\\\\:d
jaywalk => 'dʒeiwɒ:k
jaywalked => ˈdʒeiwɔ:kt
jaywalker => 'dʒeɪwɔ:kə(r)
jaywalking => 'dʒeɪwɔ:kɪŋ
jaywalks => ˈdʒeiwɔ:ks
jazz => dʒæz
jazzer => 'dʒæzə
jazzercise => ˈdʒæzəsaɪz
jazzier => ˈdʒæzi:ə
jazzman => 'dʒæzmæn
jazzy => 'dʒæzi
JCB => ,dʒei si: 'bi:
JCR => dʒei si: 'ɑ:(r)
jct => d'ʒeɪs'i:t'i:
je ne sais quoi => ʒә nә sei'kwɑ:
jealous => 'dʒelәs
jealousies => ˈdʒeləsi:z
jealousy => 'dʒelәsi
jean => dʒi:n
Jeanette => dʒә'net
jeanne => dʒi:n
Jeannette => dʒi'net
jeans => dʒi:nz
jebel => 'dʒebl
jed => dʒed,jed
jeep => dʒi:p
jeepers => 'dʒi:pәz
jeer => dʒiә
jeered => dʒɪəd
jeeringly => 'dʒiriŋli
Jeeves => dʒi:vz
jeez => dʒi:z
jefe => 'heifei
jeff => dʒef
jefferson => 'dʒefәsn
Jeffersonian => .dʒefә'sәuniәn
jeffrey => 'dʒefri
jehad => dʒi'hɑ:d
Jehoshaphat => dʒi'hɔʃәfæt
Jehovah => dʒi'hәuvә
Jehovist => dʒi'hәuvist
jejune => dʒi'dʒu:n
jejunely => d'ʒɪdʒu:nlɪ
jejuneness => dʒɪd'ʒu:nnəs
jejunum => dʒi'dʒu:nәm
Jekyll => 'dʒi:kil, 'dʒekil
Jekyll and Hyde => dʒekil әnd 'haid
jell => dʒel
jellaba => 'dʒelәbә
jelled => dʒeld
jellied => 'dʒelid
jellies => 'dʒeliz
jellified => 'dʒelɪfaɪ
jellifies => 'dʒelɪfaɪ
jellify => 'dʒelifai
jellifying => 'dʒelɪfaɪ
jelling => 'dʒeliŋ
jello => 'dʒelәu
jells => dʒelz
jelly => 'dʒeli
jelly baby => ˈdʒeli: ˈbeibi
jelly roll => ˈdʒeli: rəul
jellyfish => 'dʒelifiʃ
jellyroll => 'dʒelɪrəʊl
jelutong => 'dʒelә,tɔŋ
jemadar => 'dʒemәdɑ:
JEMIMA => dʒi'maimә
jemmies => 'dʒemi
jemmy => 'dʒemi
jena => 'jeinә
Jenkin => 'dʒenkin
Jenner => 'dʒenә
jennet => 'dʒenit
jennie => 'dʒini,'dʒeni
jennies => d'ʒenɪz
jennifer => 'dʒenifә
jennings => 'dʒeniŋz
jenny => 'dʒeni
jensen => 'jensn, jenzn
jeon => dʒei'ɔ:n
jeopardize => 'dʒepәdaiz
jeopardized => ˈdʒepədaizd
jeopardizes => ˈdʒepədaiziz
jeopardizing => ˈdʒepədaizɪŋ
jeopardy => 'dʒepәdi
Jephthah => 'dʒefθә
jerboa => dʒә:'bәuә
jeremiad => .dʒeri'maiәd
Jeremiah => .dʒeri'maiә
jeremy => 'dʒerimi
Jericho => 'dʒerikәu
jerk => dʒә:k
jerk off => dʒə:k ɔf
jerked => dʒə:kt
jerkier => ˈdʒɜ:ki:ə
jerkily => 'dʒə:kili
jerkin => 'dʒә:kin
jerkiness => 'dʒә:kinis
jerkins => ˈdʒə:kinz
jerkwater => 'dʒә:kwɒ:tә
jerky => 'dʒә:ki
jeroboam => ,dʒerә'bәuәm
jerome => dʒә'rәum
jerry => 'dʒeri
jerry-built => 'dʒeribilt
jerrycan => 'dʒerikæn
jerrymander => 'dʒerimændә
jersey => 'dʒә:zi
Jerusalem => dʒә'ru:sәlәm
Jerusalem artichoke => dʒә'ru:sәlәm
Jervis => 'dʒɑ:vis, 'dʒә:vis
Jespersen => 'jespәsn, 'dʒes-
jess => dʒes
jessamine => 'dʒesәmin
Jesse => 'desi
jesses => dʒes
jessica => 'dʒesikә
jessie => 'dʒesi
jest => dʒest
jested => dʒestid
jester => 'dʒestә
jesters => ˈdʒestəz
jesting => 'dʒestiŋ
jests => dʒests
Jesu => 'dʒi:zju:
jesuit => 'dʒezjuit
Jesus => 'dʒi:zәs
jet => dʒet
jet lag => dʒet læɡ
jet set => dʒet set
jet stream => dʒet stri:m
jet-setting => dʒet ˈsetiŋ
jetboat => 'dʒetbәut
jetfoil => 'dʒetfɔil
jetliner => 'dʒetlainә
jetliners => ˈdʒetˌlainəz
jetsam => 'dʒetsәm
jetted => 'dʒetid
jetties => ˈdʒeti:z
jetting => 'dʒetiŋ
jettison => 'dʒetisәn
jettisoned => ˈdʒetɪsənd
jettisoning => d'ʒetɪsnɪŋ
jettisons => ˈdʒetɪsənz
jetton => 'dʒetn
jetty => 'dʒeti
jetway => ˈdʒetweɪ
jeunesse => ʒ\\\\:'nes
jeux => ʒә:
Jew => dʒu:
jewel => 'dʒu:әl
jewel box => ˈdʒu:əl bɔks
jeweler => 'dʒu:әlә(r)
jewelfish => 'dʒu:әlfiʃ
jewelled => 'dʒu:әld
jeweller => 'dʒu:әlә(r)
jewellers => ˈdʒu:ələz
jewellery => 'dʒu:әlri
jewelling => dʒu:ə'lɪŋ
jewelry => 'dʒu:әlri
jewelweed => 'dʒu:әlwi:d
Jewess => 'dʒu:s
jewfish => 'dʒu:fiʃ
Jewish => 'dʒu:iʃ
jewishness => 'dʒuːɪʃnəs
Jewry => 'dʒuәri
jezebel => 'dʒezәbl
Jiangsu => 'dʒjɑ:ŋ'su:
Jiangxi => 'dʒjɑ:ŋ'ʃi:
jiao => dʒau
jib => dʒib
jibba => 'dʒibә
jibbed => dʒɪbd
jibber => 'dʒibә
jibbing => dʒɪbɪŋ
jibe => dʒaib
jibed => dʒaɪbd
jibes => dʒaɪbz
jibing => dʒaɪbɪŋ
jibs => dʒɪbz
jicama => 'hi:kәmә
jiffy => 'dʒifi
jig => dʒig
jigaboo => 'dʒi^әbu:
jigged => dʒɪgd
jigger => 'dʒigә
jiggered => 'dʒigәd
jiggery-pokery => 'dʒigәri'pәukәri
jigging => ['dʒi^iŋ
jiggle => 'dʒigl
jiggled => ˈdʒɪgəld
jiggles => ˈdʒɪgəlz
jiggling => ˈdʒɪgəlɪŋ
jiggly => 'dʒi^li
jiggy => 'dʒiɡi
jigs => dʒɪgz
jigsaw => 'dʒigsɒ:
jigsaws => ˈdʒɪgˌsɔ:z
jihad => dʒi'hɑ:d
Jilin => 'dʒi:'lin
Jill => dʒil
jillaroo => dʒilә'ru:
jillion => 'dʒiljәn
jilt => dʒilt
jilted => dʒɪltid
jilting => dʒɪltɪŋ
jilts => dʒɪlts
jim => dʒim
jim-dandy => 'dʒim'dændi
jim-jams => ˈdʒɪm dʒæmz
jimmied => d'ʒɪmi:d
jimmies => 'dʒɪmɪz
jimmy => 'dʒimi
jimmying => d'ʒɪmi:ɪŋ
jimson weed => 'dʒimsn,wi:d
jin => dʒin
Jinan => 'dʒi:'næn
jing => dʒei
jingbang => 'dʒiŋ'bæŋ
jingle => 'dʒiŋgl
jingled => 'dʒiŋ^ld
jingles => ˈdʒɪŋgəlz
jingling => 'dʒiŋɡliŋ
jingo => 'dʒingәu
jingoism => 'dʒiŋ^әjiz(ә)m
jingoistic => ,dʒiŋ^әu'istik
jink => dʒiŋk
jinked => dʒiŋkt
jinker => 'dʒiŋkә
jinking => dʒiŋkɪŋ
jinks => dʒɪŋks
jinn => dʒin
jinny => 'dʒini
jinx => dʒiŋks
jinxed => dʒɪŋkst
jinxes => dʒɪŋksiz
jird => dʒiәd
jism => 'dʒizәm
jitney => 'dʒitni
jitter => 'dʒitә
jitterbug => 'dʒitәbʌ^
jitterbugged => ˈdʒitəbʌgd
jitterbugging => ˈdʒitəbʌgɪŋ
jitteriness => 'dʒitәrinis
jitters => 'dʒitәz
jittery => 'dʒitәri
Jivaro => 'hi:vɑ:rәu
jive => dʒaiv
jived => dʒaivd
jives => dʒaivz
jivey => 'dʒaivi
jiving => dʒaivɪŋ
jizz => dʒiz
jo => dʒәu
joanna => dʒәu'ænә
joanne => dʒәj'æn
job => dʒɒb
job-hunt => ˈdʒɔbˌhʌnt
job-share => 'dʒɔb'ʃeə
jobber => 'dʒɒbә
jobbery => 'dʒɒbәri
jobbing => 'dʒɔbiŋ
jobless => 'dʒɔblis
joblessness => 'dʒɔblisnis
jobs => dʒɔbs
jobseeker => 'dʒɔb,si:kә(r)
jobsworth => ˈdʒɒbzwɜ:θ
Jocasta => dʒәu'kæstә
Jocelyn => 'dʒɔsəlin
jock => dʒɔk
jockey => 'dʒɒki
jockeyed => ˈdʒɔkid
jockeying => ˈdʒɔkiŋ
jockeys => ˈdʒɔkiz
jockeyship => 'dʒɔkiʃip
jockstrap => 'dʒɒkstræp
jockstraps => ˈdʒɔkstræps
jocose => dʒә'kәus
jocosely => d'ʒəʊkəʊslɪ
jocosity => dʒәu'kɒsәti
jocular => 'dʒɒkjulә
jocularity => ,dʒɔkju'læriti
jocularly => 'dʒɔkjuləli
jocund => 'dʒɒkәnd
jocundity => dʒәu'kʌnditi
jodhpur => dʒɔd'puә
jodhpurs => 'dʒɔdpәz
jodie => 'dʒәjdi
jody => 'dʒәjdi
joe => dʒәu
Joe Bloggs => ˌdʒəʊ 'blɒgz
Joe Sixpack => 'sikspæk
joe-pye weed => ˈdʒəʊˈpaɪ
Joel => 'dʒәuәl
joey => dʒәui
jog => dʒɒg
jog trot => dʒɔɡ trɔt
jogged => 'dʒɔ^d
jogger => 'dʒɔɡә(r)
joggers => d'ʒɒɡəz
jogging => 'dʒɒgiŋ
joggle => 'dʒɒgl
joggled => ˈdʒɔɡld
joggling => 'dʒɔ^liŋ
Jogjakarta => ,dʒɔ^jә'kɑ:tә
jogs => dʒɔɡz
jogtrot => 'dʒɔ^trɔt
johanna => dʒәj'hænә
johannes => dʒәu'hænis
Johannesburg => dʒәu'hænisbә:^
Johannine => dʒә'hænain
Johannisberger => dʒәu'hænisbә:gә
john => dʒɔn
John Barleycorn => 'bɑ:likɔ:n
John Hancock => 'hænkɔk
johnboat => 'dʒɔnbәut
johnnies => ˈdʒɔniz
johnny => 'dʒɒni
Johnny-on-the-spot => 'dʒɔniɔnðə'spɔt
johns => dʒɔnz
johnson => 'dʒɔnsn
johnsonian => dʒɔn'sәunjәn, -niәn
johnston => 'dʒɔnstәn, 'dʒɔnsn
joie de vivre => ʒwa d'vi:vr
join => dʒɒin
join battle => dʒɔin ˈbætl
joinder => 'dʒɒindә
joiner => 'dʒɔinә
joiners => ˈdʒɔinəz
joinery => 'dʒɔinәri
joining => 'dʒɔiniŋ
joint => dʒɒint
joint-stock company => ˈdʒɔɪntˈstɔk
jointed => 'dʒɒintid
jointer => 'dʒɒintә
jointing => 'dʒɔintiŋ
jointless => 'dʒɒintlis
jointly => 'dʒɒintli
jointress => 'dʒɔintris
jointure => 'dʒɔintʃә
joist => dʒɒist
joisted => d'ʒɔɪstɪd
joists => dʒɔists
jojoba => həˈhəʊbə
joke => dʒәuk
joked => dʒəukt
joker => 'dʒәukә
jokers => ˈdʒəʊkəz
jokester => 'dʒәjkstә(r)
jokey => 'dʒәjki
jokiness => 'dʒәjkinis
joking => 'dʒәukiŋ
jokingly => 'dʒәukiŋli
joky => 'dʒәuki
jol => dʒәjl
jolie laide => ˌʒɔliˈled
jollier => d'ʒɒlɪər
jollies => ˈdʒɔliz
jollification => .dʒɒlifi'keiʃәn
jollily => 'dʒɒlili
jolliness => 'dʒɔlinis
jollity => 'dʒɒliti
jollo => 'dʒɔlәj
jolly => 'dʒɒli
jolly well => ˈdʒɔli wel
jollying => 'dʒɔliiŋ
jolt => dʒәult
jolted => dʒəultid
jolting => 'dʒәultiŋ
jolts => dʒəults
jolty => 'dʒәulti
Jomon => 'dʒәjmɔn
jon => dʒɔn
jonah => 'dʒәunә
jonathan => 'dʒɔnәθәn
jones => dʒәunz
jong => jɔŋ
jongleur => ʒɔ:ŋ'^lә:
jonquil => 'dʒɒŋkwil
Jonson => 'dʒɔnsn
Jonsonian => dʒɔn'sәjniәn
jook => dʒu:k
jordan => 'dʒɒ:dәn
Jordanian => dʒɒ:'deiniәn
jordanians => dʒɔ:ˈdeiniənz
jorum => 'dʒәurәm
Joseph => 'dʒәuzif
josephine => 'dʒәuzifi:n
josh => dʒɒʃ
joshed => dʒɔʃt
joshes => dʒɔʃiz
joshing => dʒɔʃɪŋ
Joshua => 'dʒɒʃuә
Josiah => dʒəu'saiə
joss => dʒɒs
joss stick => 'dʒɔs
josser => 'dʒɒsә
jostle => 'dʒɒsl
jostled => ˈdʒɔsəld
jostles => ˈdʒɔsəlz
jostling => 'dʒɔsliŋ
jot => dʒɒt
jota => 'hәutә
jots => dʒɔts
jotter => 'dʒɒtә
jotters => ˈdʒɔtəz
jotting => 'dʒɔtiŋ
jottings => ˈdʒɒtɪŋz
Jotun => 'jɔ:tun
Jotunheim => 'jɔ:tunheim
joual => ʒwɑ:l
jougs => d'ʒu:ɡz
jouk => 'ʒaʊk
joule => dʒaul
joules => dʒu:lz
jounce => dʒauns
jounced => dʒaunst
jouncing => dʒaunsɪŋ
journal => 'dʒә:nәl
journalese => .dʒә:nә'li:z
journaling => 'dʒә:nliŋ
journalism => 'dʒә:nәlizm
journalist => 'dʒә:nәlist
journalistic => ,dʒ\\\\: nә'listik
journalists => 'dʒɜ:nəlɪsts
journalize => 'dʒә:nәlaiz
journey => 'dʒә:ni
journeyer => 'dʒə:niə
journeyman => 'dʒ\\\\:nimәn
journeymen => 'dʒɜ:nɪmən
journo => 'dʒ\\\\:nәj
joust => dʒaust
jousted => dʒaʊstid
jousting => dʒaʊstɪŋ
jousts => dʒaʊsts
jove => dʒәuv
jovial => 'dʒәuviәl
joviality => .dʒәuvi'æliti
jovially => 'dʒəʊvɪəlɪ
jovian => 'dʒәuviәn
jowar => dʒә'wɑ:(r)
Jowett => 'dʒauit, 'dʒәuit
jowl => dʒaul
jowled => dʒajld
jowls => d'ʒaʊlz
jowly => 'dʒajli
joy => dʒɒi
joyce => dʒɔis
Joycean => 'dʒɔisiәn
joyed => dʒɒɪ
joyful => 'dʒɒiful
joyfulness => ˊdʒɒifulnis
joyless => 'dʒɒilis
joyous => 'dʒɒiәs
joyousness => ˊdʒɒiәsnis
joyride => 'dʒɔiraid
joyrider => 'dʒɔi,raidә(r)
joyrides => ˈdʒɔiraidz
joys => dʒɔiz
joystick => 'dʒɔi,stik
joysticks => d'ʒɔɪstɪks
ju-jitsu => dʒu:ˈdʒɪtsu:
juan => hwɑ:n
juanita => hwɑ:'ni:tә
Juba => 'dʒu:bә
jube => 'dʒu:bi
jubilance => 'dʒu:bilәns
jubilant => 'dʒu:bilәnt
jubilantly => 'dʒu:bɪləntlɪ
jubilate => 'dʒu:bileit
jubilated => ˌdʒu:biˈlɑ:tid
jubilating => ˌdʒu:biˈlɑ:tiŋ
jubilation => .dʒu:bi'leiʃәn
jubilee => 'dʒubili:
jubilees => ˈdʒu:bəˌli:z
Judaea => dʒu:'diә
Judaean => dʒu:'diən
Judaeo- => dʒu:'di:әj,-'dei-
Judah => 'dʒu:dә
Judaic => dʒu:'deiik
Judaism => 'dʒu:diizm
Judaist => 'dʒu:deiist
Judaize => 'dʒu:deiaiz
Judas => 'dʒu:dәs
judd => dʒʌd
judder => 'dʒʌdә
juddered => ˈdʒʌdəd
juddering => ˈdʒʌdərɪŋ
judders => ˈdʒʌdəz
Jude => dʒu:d
Judea => dʒu:'di:ә
Judenrat => 'ju:dәnrɑ:t
judge => dʒʌdʒ
judge-made => 'dʒʌdʒmeid
judged => dʒʌdʒd
judgement => 'dʒʌdʒmәnt
judgements => ˈdʒʌdʒmənts
judges => 'dʒʌdʒiz
judgeship => 'dʒʌdʒʃip
judgment => 'dʒʌdʒmәnt
judgment day => ˈdʒʌdʒmənt dei
judgmental => dʒʌdʒ'mentl
judgments => d'ʒʌdʒmənts
judicatory => 'dʒu:dikәtәri
judicature => 'dʒu:dikәtʃә
judicial => dʒu:'diʃәl
judicially => dʒʊ'dɪʃəlɪ
judiciary => dʒu:'diʃiәri
judicious => dʒu:'diʃәs
judith => 'dʒu:diθ
judo => 'dʒu:dәu
judoist => 'dʒu:dәjist
judoka => 'dʒu:'dәukә
Judy => 'dʒu:di
jug => dʒʌg
jug-eared => 'dʒʌ^iәd
jugal => 'dʒu:gәl
Jugendstil => 'ju:^әnt-ʃti:l
jugful => 'dʒʌgful
jugged => dʒʌ^d
juggernaut => 'dʒʌgәnɒ:t
juggernauts => ˈdʒʌgəˌnɔ:ts
juggins => 'dʒʌginz
juggle => dʒʌgl
juggled => ˈdʒʌɡld
juggler => 'dʒʌglә
jugglers => ˈdʒʌgləz
jugglery => 'dʒʌglәri
juggles => ˈdʒʌɡlz
juggling => 'dʒʌɡliŋ
Jugoslavia => ,ju:^әj'slɑ:viә
jugs => dʒʌɡz
jugular => 'dʒʌgjulә
jugular vein => ˈdʒʌɡjulə vein
jugulars => ˈdʒʌɡjuləz
jugulate => 'dʒʌgjuleit
jugum => 'dʒu:^әm
Jugurtha => dʒu'ɡə:θə
juice => dʒu:s
juiced => dʒu:st
juicer => 'dʒu:sә
juices => dʒu:siz
juicier => ˈdʒu:si:ə
juicily => 'dʒusili
juiciness => d'ʒu:sɪnəs
juicy => 'dʒusi
jujitsu => dʒu:'dʒitsu:
juju => 'dʒu:dʒu:
jujube => 'dʒu:dʒu:b
juke => dʒu:k
juke-box => d'ʒu:kb'ɒks
jukebox => 'dʒu:kbɒks
jukeboxes => ˈdʒu:kbɔksiz
jukes => dʒu:ks
juku => 'dʒu:ku:
julep => 'dʒu:lep
jules => dʒu:lz
julia => 'dʒu:ljә
Julian => 'dʒu:ljәn
Juliana => dʒu:li'ɑ:nә
julienne => ,dʒu:li'en
juliet => 'dʒu:ljәt, -liәt
julius => 'dʒu:ljәs
July => dʒu:'lai
jumbie => 'dʒʌmbi
jumble => dʒʌmbl
jumbles => ˈdʒʌmbəlz
jumbling => ˈdʒʌmbəlɪŋ
jumbo => 'dʒʌmbәu
jumbo jet => ˈdʒʌmbəu dʒet
jumbos => ˈdʒʌmbəuz
jumbuck => 'dʒʌmbʌk
Jumna => 'dʒʌmnә
jump => dʒʌmp
jump ball => dʒʌmp bɔ:l
jump for joy => dʒʌmp fɔ: dʒɔi
jump jet => dʒʌmp dʒet
jump out => dʒʌmp aut
jump rope => dʒʌmp rəup
jump seat => dʒʌmp si:t
jump ship => dʒʌmp ʃip
jump shot => dʒʌmp ʃɔt
jump the shark => dʒʌmp ðə ʃɑ:k
jump-off => 'dʒʌmpɔf
jump-start => 'dʒʌmpstɑ:t
jump-starting => dʒʌmp ˈstɑ:tiŋ
jumped-up => 'dʒʌmptʌp
jumper => 'dʒʌmpә
jumpers => d'ʒʌmpəz
jumpily => 'dʒʌmpili
jumpiness => ˊdʒʌmpinis
jumping => 'dʒʌmpiŋ
jumping gene => ˈdʒʌmpiŋ dʒi:n
jumping jack => ˈdʒʌmpiŋ dʒæk
jumping-off point => ˈdʒʌmpiŋˈɔf pɔint
jumpstart => 'dʒʌmp,sta:t
jumpsuit => ˈdʒʌmpsu:t
jumpy => 'dʒʌmpi
Jun => dʒʌn
junco => 'dʒʌŋkәu
junction => 'dʒʌŋkʃәn
juncture => 'dʒʌŋktʃә
junctures => ˈdʒʌŋktʃəz
June => dʒu:n
Jungfrau => ˊjuŋfrau
jungian => 'jjŋiәn
jungle => 'dʒʌŋgl
jungle cat => ˈdʒʌŋɡl kæt
jungle gym => ˈdʒʌŋɡl dʒim
jungled => d'ʒʌŋɡld
jungles => ˈdʒʌŋɡlz
jungli => 'dʒæŋgli
jungly => 'dʒʌŋgli
junior => 'dʒu:njә
junior school => ˈdʒu:njə sku:l
junior varsity => ˈdʒu:njə ˈvɑ:sɪti:
juniority => .dʒu:n'jɒriti
juniper => 'dʒu:nipә
junipers => ˈdʒu:nipəz
junk => dʒʌŋk
junk bond => dʒʌŋk bɔnd
junk food => dʒʌŋk fu:d
junked => dʒʌŋkt
junker => 'dʒʌŋkә
junket => 'dʒʌŋkit
junketing => 'dʒʌŋkitiŋ
junkets => ˈdʒʌŋkɪts
junkie => 'dʒʌŋki
junkies => d'ʒʌŋkɪz
junking => ˈdʒʌŋkiŋ
junkman => 'dʒʌŋkmәn
junks => dʒʌŋks
junky => 'dʒʌŋki
junkyard => 'dʒʌŋkjɑ:d
Juno => 'dʒu:nәu
Junoesque => .dʒu:nәu'esk
junta => 'dʒʌntә
juntas => ˈhʊntəz
junto => 'dʒʌntәu
Jupiter => 'dʒu:pitә
jura => 'dʒuәrә
jural => 'dʒuәrәl
Jurassic => dʒu'ræsik
jurat => 'dʒuәræt
juridical => .dʒuә'ridikәl
jurisconsult => .dʒuәris'kɒnsʌlt
jurisdiction => .dʒuәris'dikʃәn
jurisdictional => .dʒuәris'dikʃәnәl
jurisdictions => ˌdʒuərisˈdikʃənz
jurisprudence => .dʒuәris'pru:dәns
jurisprudent => .dʒuәris'pru:dәnt
jurisprudential => -'denʃәl
jurist => 'dʒuәrist
juristic => dʒuә'ristik
jurists => d'ʒʊərɪsts
juror => 'dʒuәrә
jurors => d'ʒʊərəz
jury => 'dʒuәri
jury-rigged => 'dʒjәriri^d
juryman => 'dʒuәrimәn
jurywoman => 'dʒjәri,wjmәn
jus => ʒju:s
jussive => 'dʒʌsiv
just => dʒʌst
just in case => dʒʌst in keis
justice => 'dʒʌstis
justices => d'ʒʌstɪsɪz
justiceship => 'dʒʌstisʃip
justiciable => dʒʌs'tiʃiәbl
justiciar => dʒʌs'tiʃiә
justiciary => dʒʌs'tiʃiәri
justifiability => ,dʒʌstifaiә'bilәti
justifiable => 'dʒʌstifaiәbl
justifiably => dʒʌstɪ'faɪəblɪ
justification => .dʒʌstifi'keiʃәn
justifications => dʒʌstɪfɪ'keɪʃnz
justificatory => 'dʒʌstifikeitəri
justifier => 'dʒʌstifaiә
justify => 'dʒʌstifai
justin => 'dʒʌstin
justine => dʒә'sti:n
justly => 'dʒʌstli
justness => 'dʒʌstnis
jut => dʒʌt
jute => dʒu:t
Jutish => 'dʒu:tiʃ
Jutland => 'dʒʌtlәnd
juts => dʒʌts
jutted => dʒʌtid
jutting => dʒʌtɪŋ
Juvenal => 'dʒu:vәnəl
juvenescence => ,dʒu:vi'nesns
juvenescent => ,dʒu:vi'nesnt
juvenile => 'dʒu:vinail
juvenilia => .dʒu:vә'niliә
juvenility => .dʒu:vә'niliti
juvenilize => 'dʒu: vәnilaiz
juvie => 'dʒu:vi
juxtaglomerular => ,dʒʌkstә,^lɔ'merulә
juxtapose => .dʒʌkstә'pәuz
juxtaposed => ˌdʒʌkstəˈpəʊzd
juxtaposes => ˌdʒʌkstəˈpəʊziz
juxtaposing => ˌdʒʌkstəˈpəʊzɪŋ
juxtaposition => .dʒʌkstәpә'ziʃәn
juxtapositions => ˌdʒʌkstəpəˈzɪʃənz
Jylland => 'ju:læn