K => kei
ka => kɑ:
Kaaba => 'kɑ:bә
kabob => kә'bɒb
kaboodle => ke'bu:dl
kabuki => ,kɑ:bu'ki
Kabul => 'kɑ:bәl
Kabyle => kә'bail
kachina => keɪt'ʃaɪnə
Kaddish => 'kædiʃ
kadi => 'kɑ:di
kaffeeklatsch => 'kɑ:fei,klɑ:tʃ, 'kɔ:fi:,klætʃ
kaffir => 'kæfə(r)
kaffiyeh => kɑ:'fi:jә
Kafiri => 'kæfәri
Kafkaesque => ,kɑ:fkə'esk
kaftan => 'kæftәn; kɑ:f'tɑ:n; kaf'tan
Kagoshima => ,kɑ:^ә'ʃi:mә
kahn => kɑ:n
kahuna => kəˈhu:nə
kainite => 'kainait
kairomone => 'kaɪrəʊməʊn
Kairouan => ker'wɔŋ
kaiser => 'kaizә
kaizen => ˌkaɪ'zen
kaka => 'kɑ:kɑ:
kakapo => ,kɑ:kә'pәu
kakemono => ,kæki'mәunәu
kaki => 'kɑ:ki:
Kalahari => ,kɑ:lɑ:'hɑ:ri
Kalahari Desert => ,kælə'hɑ:ri
Kalashnikov => kə'lɑːʃnɪkɒf
kale => keil
kaleidoscope => kә'laidәskәup
kaleidoscopes => kəˈlaɪdəˌskəʊps
kaleidoscopic => kә,laidә'skɔpik
kaleidoscopically => kə,li
kalends => 'kælәndz
Kalevala => .kɑ:li'vɑ:lә
kali => 'kæli
Kalidasa => 'kɑ:li'dɑ:sә
Kalimantan => ,kɑ:li'mɑ:ntɑ:n
kalimba => kә'limbә
Kalinin => kʌ'lji:njin
KALININGRAD => kә'linin^ræd
Kalisz => 'kɑ:liʃ
kalmia => 'kælmiә
Kalmyk => 'kælmik
kalong => 'kɑ:lɒŋ
kalpa => 'kælpә
kalsomine => 'kælsәmain
kama => 'kɑ:mә:, 'kamә
kamacite => 'kæmә,sait
Kamchatka => kæm'tʃætkә
kame => keim
kami => 'kɑ:mi
kamikaze => .kɑ:mi'kɑ:zi
Kampala => kɑ:m'pɑ:lә
kampong => kæm'pɒŋ
Kampuchea => kɑ:m'pu:tʃiә
Kampuchean => kæmpj'tʃiәn
kana => 'kɑ:nә
kanamycin => ,kænә'maisin
Kanarese => ,kænә'ri:z
kanban => 'kænbæn
Kanchenjunga => ,kɑ:ntʃәn'dʒɑ:ŋ^ә
Kandy => 'kændi
kane => kein
kang => kɑ:ŋ
Kanga => kɑ:ŋɡɔ
kangaroo => .kæŋgә'ru:
kangaroo paw => ˌkæŋgəˈru: pɔ:
kangaroo rat => ˌkæŋgəˈru: ræt
kangaroos => ˌkæŋgəˈru:z
kanji => 'kɑ:ndʒi:
Kano => 'kɑ:nәu
Kansas => 'kænzәs
Kansu => 'kæn'su:
kant => kænt
Kantian => 'kæntiәn
kanzu => 'kænzj
kaoliang => ,kɑ:әjli'æŋ
kaolin => 'keiәlin
kaolinite => 'keiәlinait
kaolinize => 'keiәlinaiz
kaon => 'keiɒn
kapok => 'keipɒk
kappa => 'kæpә
kapur => kә'puә
kaput => kә'pu:t
kara => 'kɑ:rә
karabiner => ,kә'ræbinә
Karachi => kә'rɑ:tʃi
Karafuto => kɑ:'rɑ:futәu
Karaganda => ,kærә^әn'dɑ:
Karaite => 'keәrәait
Karakalpak => kə'rɑ:kəl'pɑ:k
Karakorum => kærәˊkourәm
karakul => 'kærәkәl
karaoke => 'kærә.әuki. kærә'әuki
karat => 'kærәt
karate => kә'rɑ:ti
karate-chop => kə'rɑ:ti:tʃ'ɒp
karateka => kә'rɑ:tikɑ:
Karbala => 'kɑ:bәlә
Karelia => kә'ri:liә
Karelian => kә'ri:liәn, -'ri:ljәn
karen => 'kɑ:rәn
karez => kæ'rez
karl => kɑ:l
Karl-Marx-Stadt => kɑ:rl'mɑ:rks; ʃtɑ:t
Karlovy Vary => 'kɑ:lәvi 'vɑ:ri
Karlsruhe => 'kɑ: rls,ru: ә
karma => 'kɑ:mә
karmic => kɑmɪk
Karnataka => kɑ:'nɑ:tәkә
karoshi => kə'rɒʃɪ
kaross => kә'rɔs
karst => kɑ:st
karstification => ,kɑ:stifi'keiʃәn
kart => kɑ:t
karyokinesis => ,kæriәukai'ni:sis
karyolysis => ,kæri'ɔlisis
karyotype => 'kæriәtaip
karyotyping => 'kærɪəʊtaɪpɪŋ
karzy => 'kɑ:zi
kasbah => 'kɑ:zbɑ:
kasha => 'kɑ:ʃә
Kashmir => 'kæʃmiә
Kashmiri => kæʃ'miәri
kashrut => kɑ:ʃ'ru:t, 'kɑ:ʃrut
Kashubian => kæ'ʃu:biәn
Kassel => 'kæsәl, 'kɑ:s-
KAT => kɑ:t
kata => 'kɑ:tɑ:
katabatic => .kætә'bætik
katabolism => kә'tæbәlizәm
katakana => ,kɑ:tә'kɑ:nә
katana => kә'tɑ:nә
Katanga => kә'tæŋ^ә
Katangese => ,kætɑ:ŋ'^i:z
kate => keit
katharevousa => ,kɑ:θɑ:'revu:sɑ:
katharometer => ,kæθә'rɔmitә
kathleen => 'kæθli:n
Kathmandu => 'kɑ:tmɑ:n'du:
kathode => 'kæθәud
kathy => 'kæθi
katie => 'keiti
Katmandu => 'kɑ:tmɑ:n'du:
KATRINA => kә'tri:nә
katsuobushi => ,kɑ:tsuә'buʃi:
Kattegat => 'kæti^æt
katydid => 'keitidid
katzenjammer => 'kætsәn,dʒæmә
Kaunas => 'kajnәs
kauri => 'kauri:
kauri gum => ˈkauri: ɡʌm
kava => 'kɑ:vә
Kawabata => kɑ:wɑ:bɑ:tɑ:
Kawasaki => ,kɑ:wɑ:'sɑ:ki:
kay => kei
kayak => 'kaiæk
kayaks => ˈkaɪˌæks
kayo => 'kei'әu
kayoing => keɪ'əʊ
Kayseri => ,kaise'ri:
kazakh => kɑ:'zɑ:k
Kazakhstan => ˌkæzək'stæn
Kazan => kә'zɑ:n
kazillion => keɪ'zɪlɪən
kazoo => kә'zu:
kea => 'keiә
keats => ki:ts
kebab => kә'bɑ:b
kebabs => kəˈbɑ:bz
keck => kek
Kedah => 'kedә
keddah => 'kedә
kedge => 'kedʒ
kedgeree => ,kedʒә'ri:
keek => ki:k
keel => ki:l
keelage => 'ki:lidʒ
keelboat => 'ki:lbәut
keeled => ki:ld
Keeler => 'ki:lә(r)
keelhaul => 'ki:lhɒ:l
keelless => 'ki:llis
keels => ki:lz
keelson => 'kelsn, ki:lsn
keen => ki:n
keen on => ki:n ɔn
keened => ki:nd
keener => 'ki:nә
keening => 'ki:nɪŋ
keenly => 'ki:nli
keenness => 'ki:nnis
keens => ki:nz
keep => ki:p
keep going => ki:p ˈgəʊɪŋ
keep mum => ki:p mʌm
keep step => ki:p step
keep wicket => ki:p ˈwikit
keep-fit => ki:p fit
keeper => 'ki:pә
keepers => ˈki:pəz
keepership => 'ki:pəʃɪp
keeping => 'ki:piŋ
keepsake => 'ki:pseik
keepsakes => ˈki:pˌseɪks
keeshond => 'keishɔnd
keester => 'ki:stә(r)
kef => keif
keffiyeh => ke'fi:jә
kefir => 'kefә
keg => keg
keg beer => keg biə
kegger => 'keɡə
kegs => kegz
Keir => kiә
keiretsu => keɪ'retsu:
keister => 'ki:stә(r)
keith => ki:θ
Kelantan => kә'læntæn
kelim => kəˈli:m
Keller => 'kelə
kelley => 'keli
Kellogg => 'kelɔ^
Kelly => 'keli
keloid => 'ki:lɔid
kelp => kelp
kelpie => 'kelpi
KELSEY => 'kelsi
kelson => 'kelsn
Kelvin => 'kelvin
Kelvin scale => 'kelvin
kemp => kemp
Kempis => 'kempis
kempt => kempt
ken => ken
kenaf => kә'næf
Kendal => 'kendәl
kendall => 'kendl
kendo => 'kendәj
kennedy => 'kenidi
kennel => 'kenl
kennelled => ˈkenəld
kennelling => ˈkenəlɪŋ
kennelman => 'kenəlmәn
kenning => 'keniŋ
kenny => 'keni
keno => 'ki:nәu
kenosis => ki'nәusis
kenspeckle => 'kenspekl
Kent => kent
Kentish => 'kentiʃ
Kentuckian => kәn'tʌkiәn
Kentucky => kәn'tʌki
Kenya => 'kenjә
kenyan => 'kenjәn
kep => kep
kepi => 'kepi
kepler => 'keplә
Keplerian => kep'liәriәn
kept => kept
kept woman => kept ˈwumən
kerala => 'kerәlә
kerat- => 'kerәt
keratectomy => ,kerә'tektәmi
keratin => 'kerәtin
keratinization => ,kerәtinai'zeiʃәn
keratinize => 'kerәtinaiz
keratinocyte => 'kerәtinә,sait
keratinous => kә'rætinәs, kә'rætәnәs
keratitis => .kerә'taitis
kerato- => 'kerәtәj
keratomileusis => 'kerətəmaɪlju:sɪs
keratoplasty => 'kerәtәu,plæsti
keratosis => ,kerә'tәusis
keratotomy => ,kerә'tɔtәmi
kerb => kә:b
kerb crawler => kɜ:b ˈkrɔ:lə
kerbs => 'kɜ:bz
kerbside => 'kә:bsaid
kerbstone => 'kә:bstәun
Kerch => kə:tʃ
kerchief => 'kә:tʃif
kerchiefs => ˈkə:tʃifs
kerf => kә:f
kerfuffle => kә(:)'fʌfәl
kermes => 'kә:mi:z
kermis => 'k\\\\:mis
kern => kә:n
kerned => kɜːn
kernel => 'kә:nl
kernite => 'kә:nait
kero => 'kerәj
kerogen => 'kerәdʒәn
kerosene => 'kerәsi:n
kerria => 'keriә
kerry => 'keri
kersey => 'kә:zi
kerseymere => 'kә:zimiә
kerseys => 'kɜːzɪ
kestrel => 'kestrәl
kestrels => ˈkestrəlz
ketamine => 'ketәmi:n
ketch => ketʃ
ketches => ketʃiz
ketchup => 'ketʃәp
ketene => 'ki:ti:n
ketoacidosis => ,ki:tәu,æsi'dәusis
ketone => 'ki:tәun
ketonic => ki'tɔnik
ketonuria => ki:tәu'njuәriә
ketosis => ki:'tәusis
kettle => 'ketl
kettle hole => ˈketl həul
kettledrum => 'ketldrʌm
kettledrummer => ketldrʌm:ɜ
kettledrums => ˈketldrʌmz
kettles => ˈketlz
keurboom => 'kә:bu:m
Kev => kev
kevel => 'kevl
kevin => 'kenin
Kevlar => 'kevlɑ:(r)
kewpie => 'kju:pi
key => ki:
key card => ki: kɑ:d
key grip => ki: ɡrip
key light => ki: lait
key signature => ki: ˈsiɡnitʃə
keyboard => 'ki:bɒ:d
keyboarder => ˈki:bɔ:də(r)
keyboardist => 'ki:,bɔ:dist
keye => 'ki:
keyed => ki:d
keyed up => ki:d ʌp
keyer => ki:ә
keyhole => 'ki:hәul
keyhole saw => ˈki:ˌhəʊl sɔ:
keyhole surgery => ˈki:ˌhəʊl ˈsə:dʒəri
keyholes => ˈki:ˌhəʊlz
keying => 'ki:iŋ
keyless => 'ki:lis
keylogger => 'ki:lɒgə(r)
keynes => keinz
Keynesian => 'keinziәn
Keynesianism => 'keinziәnizəm
keynote => 'ki:nәut
keynoted => ˈki:ˌnəʊtid
keynoter => 'ki:nәutә
keynotes => 'ki:nəʊts
keynoting => ˈki:ˌnəʊtɪŋ
keypad => 'ki:pæd
keypal => ˈki:pæl
keypunch => 'ki:pʌntʃ
keyring => 'ki:rɪŋ
keystone => 'ki:stәun
keystones => ˈki:stəunz
keystroke => 'ki:strәuk
keystrokes => ˈki:strəuks
keyway => 'ki:wei
keyword => 'ki:wәd
keywords => 'ki:wә:dz
Khabarovsk => xɑ:'bɑ:rәfsk
khadi => 'kɑ:di:
khaki => 'kɑ:ki
khakis => 'ka:kiz
khalif => kɑ:'li:f
khalifate => 'kælifeit
Khalkha => 'kælkə
khamsin => 'kæmsin
khan => kɑ:n
khanate => 'kɑ:nit
khanga => 'kɑ:n^ә
kharif => kә'ri:f
Kharkov => 'kɑ:rkɔ:f
Khartoum => ka:'tu:m
khat => kɑ:t
khayal => kә'jɑ:l
khedive => ki'di:v
Kherson => keər'sɔ:n
Khmer => kmєә
Khoisan => 'kɔisɑ:n
Khorramshahr => ,kɔ:rәm'ʃɑ:
khoum => 'ku:m
Khrushchev => kru'ʃtʃɒf
Khrushchevian => ,kruʃ'tʃɔviən
Khufu => 'ku:fu:
kiaat => kiɑ:t
kiang => ki:'æŋ
Kiangsi => 'kjæŋ'si:
Kiangsu => 'kjæŋ'su:
kibble => kibl
kibbutz => ki:'bu:ts
kibbutznik => ki:'bu:tsnik
kibe => kaib
kibitka => ki'bitkә
kibitz => 'kibits
kibitzed => ˈkibitst
kibitzer => 'kibitsә(r)
kibitzes => ˈkibitsiz
kibitzing => ˈkibitsɪŋ
kiblah => 'kiblɑ:
kibosh => 'kaibɒʃ
kiboshed => 'kaɪbɒʃ
kiboshes => 'kaɪbɒʃ
kiboshing => 'kaɪbɒʃ
kick => kik
kick down => kik daun
kick in => kik in
kick-ass => 'kikæs
kick-down => 'kɪkd'aʊn
kick-start => ˈkɪkˌstɑ:t
kick-starting => kik ˈstɑ:tiŋ
kickback => 'kikbæk
kickbacks => 'kɪkbæks
kickball => 'kikbɒ:l
kickboxing => 'kik.bɔksiŋ
kicked => kikt
kicker => 'kikә
kicking => 'kikiŋ
kickoff => 'kikɒf
kickshaw => 'kikʃɔ:
kicksorter => 'kik,sɔ:tә(r)
kickstand => 'kik,stænd
kicky => 'kɪkɪ
kid => kid
kidded => kɪd
Kidderminster => 'kidәminstә
kiddie => 'kidi
KIDDIES => 'kidi
kiddle => 'kidl
kiddo => 'kidәu
kiddush => ki'du:ʃ, 'kiduʃ
kiddy => 'kidi
kidnap => 'kidnæp
kidnaps => ˈkidnæps
kidney => 'kidni
kidney machine => ˈkidni məˈʃi:n
kidney stone => ˈkidni stəun
kidney-shaped => 'kɪdni:ʃ'eɪpt
kidneys => 'kidniz
kidology => ki'dɔlәdʒi
kidskin => 'kidskin
kidult => ˈkɪdʌlt
kidvid => 'kidvid
kiekie => 'ki:ki:
kiel => ki:l
kielbasa => ki:l'bɑ:sә
kier => kiә
kieselguhr => 'ki:zәl^uә
kieserite => 'ki:zәrait
kiev => 'ki:ev
kif => kif
kike => kaik
kikoi => 'ki:kɔi
Kikongo => ki:'kɔŋ^әu
kikuyu => ki'ku:ju:
kilderkin => 'kildәkin
kilim => ki'lim
Kilimanjaro => 'kilimәn'dʒɑ:rәu
kill => kil
Killarney => ki'lɑ:ni
killas => 'kilәs
killdeer => 'kildiә
killed => 'kild
killer => 'kilә
killer bee => ˈkɪlə bi:
killer cell => ˈkɪlə sel
killer instinct => ˈkɪlə ˈinstiŋkt
killer whale => 'kilә
killers => ˈkɪləz
killick => 'kilik
killifish => 'kili,fiʃ
killing => 'kiliŋ
killjoy => 'kildʒɒi
killjoys => ˈkildʒɔiz
kiln => kiln
kiln-dry => 'kilndrai,'kil-
kilns => kɪlnz
kilo => 'kilәu
kilo- => 'kiәlj
kilobase => kaɪləʊ'beɪs
kilobit => 'kilәubit
KIlobyte => 'kilәubait
kilocalorie => 'kilәkælәri
kilocycle => 'kilәu.saikl
kilogram => 'kilәgræm
kilogramme => 'kilәj^ræm
kilograms => 'kɪləgræm
kilohertz => 'kilәhә:ts
kilojoule => 'kilәdʒu:l
kilolitre => 'kilәj,li:tә(r)
kilometer => 'kilәmi:tә
kilometers => ˈkiləˌmi:təz
kilometre => 'kilәjmi:tә(r)
kilometres => ˈkiləˌmi:təz
kilometric => ,kilә'metrik
kiloton => 'kilәutʌn
kilovolt => 'kilәvәult
kilowatt => 'kilәwɒt
kilowatt-hour => 'kilәjwɔt'ajә(r)
kilowatts => ˈkɪləˌwɔts
Kilroy => 'kilrɔi
kilt => kilt
kilted => ˈkɪltɪd
kilter => 'kiltә
kiltie => 'kilti
kilts => kɪlts
Kimberley => 'kimbәli
kimberlite => 'kimbәlait
Kimbundu => kim'bjndu:
kimchi => 'kimtʃi:
kimono => ki'mәunәu
kimonos => kəˈməʊnəz
kin => kin
kin group => kin ɡru:p
kin selection => kin siˈlekʃən
kina => 'ki:nә
Kinabalu => ,kinәbә'lu:
kinaesthesia => ,kaini(:)s'θi:zjә
kinaesthetic => ,kinis'θetik,,kai-
kinase => 'kineis
Kincardine => kin'kɑ:din(ʃә(r))
Kinchinjunga => ,kintʃin'dʒʌŋ^ә
kincob => 'kiŋkәb
kind => kaind
kind of => kaind ɔv
kind-hearted => 'kaind'hɑ:tid
kinda => 'kaindә
kinder => 'kindәr
kindergarten => 'kindә.gɑ:tn
kindergartens => 'kɪndəɡɑ:tnz
kindest => kaɪnd
kindle => 'kindl
kindled => ˈkɪndld
kindles => ˈkɪndlz
kindliness => 'kaindlinis
kindling => 'kindliŋ
kindly => 'kaindli
kindness => 'kaindnis
kindnesses => ˈkaindnisiz
kindred => 'kindrid
kindy => 'kindi
kine => kain
kinematic => .kaini'mætik
kinematically => kaɪnɪ'mætɪklɪ
kinematics => .kaini'mætiks
kinematograph => ,kaini'mætә^rɑ:f
kinescope => 'kainiskәup
kinesic => ki'ni:sik,kai-
kinesics => ki'ni:siks, kai-
kinesiology => ki.ni:si'ɒlәdʒi
kinesis => ki'ni:sis
kinesthesia => .kinis'θi:ʒiә
kinesthetic => .kinis'θetik
kinetic => kai'netik
kinetic art => kɪˈnetɪk ɑ:t
kinetic theory => kɪˈnetɪk ˈθiəri
kinetics => kai'netiks
kinetin => 'kainәtin
kineto- => ki'netәj,-'ni:-
kinetochore => ki'ni:tәkɔ:
kinetoplast => ki'ni:tә,plɑ:st
kinetoscope => kai'ni:tәskәup
kinfolk => 'kinfәuk
king => kiŋ
king crab => kiŋ kræb
king penguin => kiŋ ˈpeŋɡwin
king post => kiŋ pəust
kingbird => 'kiŋb\\\\:d
kingbolt => 'kiŋbәult
kingcraft => 'kiŋkræft
kingcup => 'kiŋkʌp
kingdom => 'kiŋdәm
kingdoms => ˈkiŋdəmz
kingfish => 'kiŋfiʃ
kingfisher => 'kiŋfiʃә
kingfishers => ˈkɪŋˌfɪʃəz
kinghood => 'kɪŋhʊd
kingklip => 'kiŋklip
kinglet => 'kiŋlit
kinglike => 'kɪŋlaɪk
kingliness => 'kiŋlinis
kingly => 'kiŋli
kingmaker => 'kiŋmeikә
kingpin => 'kiŋpin
kingpins => ˈkiŋpinz
kingship => 'kiŋʃip
kingside => 'kiŋsaid
kingsnake => 'kiŋ,sneik
kingston => 'kiŋstәn
kinin => 'kainin
kink => kiŋk
kinkajou => 'kiŋkәdʒu:
kinked => kiŋkt
kinkier => ˈkiŋkiə
kinkily => ˊkiŋkili
kinking => 'kiŋkiŋ
kinks => kiŋks
kinky => 'kiŋki
kinless => 'kinlis
kinnikinnick => ˌkinikiˈnik
kino => 'ki:nәu
kinorhynch => 'kinә,riŋk
Kinross => kin'rɔs
Kinross-shire => kin'rɔsʃə
kinsey => 'kinzi
kinsfolk => 'kinzfәuk
Kinshasa => kin'ʃɑ:sә
kinship => 'kinʃip
kinsman => 'kinzmәn
kinsmen => 'kinzmən
kinswoman => 'kinzwumәn
kinswomen => 'kɪnzwɪmɪn
kiosk => ki'ɒsk
kiosks => ˈki:ˌɔsks
kip => kip
kipling => 'kipliŋ
kipped => kɪpt
kipper => 'kipә
kippered => 'kipәd
kippering => 'kɪpə
kippers => ˈkipəz
kipping => kɪpɪŋ
Kirghiz => kiә'gi:z
Kiri => 'ki:ri
Kiribati => 'kiribæs
Kirin => 'ki:rin
kirk => kә:k
Kirkcudbright => kə:'ku:bri
Kirkcudbrightshire => k\\\\:'ku:briʃә(r)
kirkman => 'kә:kmәn
kirkmen => 'kə:kmən
Kirkuk => kir'ku:k
Kirman => kiә'mɑ:n
kirov => 'ki:rɔf
Kirovabad => ki'rәjvәbæd
kirpan => kɪə'pɑ:n
kirsch => kiәʃ
Kirsten => 'k\\\\:stәn
kirtle => 'kә:tl
Kiruna => 'kirjnɑ:
Kisangani => 'ki:sәn'^ɑ:ni:
kish => kiʃ
kishke => 'kiʃkә
Kislev => 'kislef
kismet => 'kismet
kiss => kis
kiss ass => kis æs
kiss of peace => kis ɔv pi:s
kiss-ass => 'kisæs
kiss-curl => 'kɪsk'ɜ:l
kiss-off => 'kis,ɔf
kissable => 'kɪseɪbl
kisser => 'kisә
kissing => 'kisiŋ
kissing cousin => ˈkisiŋ ˈkʌzn
kissing disease => ˈkisiŋ diˈzi:z
Kissinger => 'kisәndʒә
kissogram => ˈkɪsəgræm
kissy => 'kisi
kist => kist
Kiswahili => ki,swɑ:'hi:li
kit => kit
kit fox => kit fɔks
Kitakyushu => 'ki:tɑ:'kju:ʃu:
kitbag => 'kitbæ^
kitbags => ˈkitbæɡz
kitchen => 'kitʃin
kitchen garden => ˈkitʃin ˈɡɑ:dn
kitchen roll => ˈkitʃin rəul
kitchen sink => 'kitʃinsiŋk
kitchener => 'kitʃinә
kitchenette => ,kitʃi'net
kitchenettes => ˌkitʃiˈnets
kitchens => ˈkitʃinz
kitchenware => 'kitʃinwєә
kite => kait
kite-flying => 'kaɪtfl'aɪɪŋ
kitemark => 'kaitmɑ:k
kitenge => ki'teŋ^i
kith => kiθ
kiting => 'kaitiŋ
kitsch => kitʃ
kitschy => 'kitʃi
kitted => kɪt
kitten => 'kitn
kittened => ˈkitnd
kittening => ˈkitnɪŋ
kittenish => 'kitniʃ
kittens => ˈkitnz
kittiwake => 'kitiweik
kittle => 'kitl
kitty => 'kiti
Kitwe => 'ki:twei
kiva => 'ki:vә
Kiwanian => ki'wɑ:niәn
Kiwanis => ki'wɑ:nis
kiwi => 'ki:wi:
kiwis => ˈki:wi:z
Klagenfurt => 'klɑ:^әnfjrt
Klaipeda => 'klaipidə
Klamath => 'klæmәθ
Klan => klæn
Klansman => 'klænzmәn
klatch => klɑ:tʃ,klætʃ
klaus => klaus
klaxon => 'klæksәn
Kleenex => 'kli:neks
klepht => kleft
kleptocracy => klep'tɔkrәsi
kleptocratic => ,kleptə'krætik
kleptomania => ,kleptәu'meiniә
kleptomaniac => .kleptә'meiniæk
klezmer => k'lezmər
klick => klik
klicks => k'lɪks
klipfish => klip,fiʃ
klipspringer => 'klipspriŋә
KLM => kim
Klondike => 'klɔndaik
klong => klɒŋ
kloof => klu:f
kludge => klu:dʒ
Kluge => klu:dʒ
klutz => klʌts
klutzy => 'klʌtsɪ
klystron => 'klaistrɒn
knack => næk
knacker => 'nækә
knackered => 'nækәd
knackwurst => 'knɑ:k,wә:st
knag => næg
knap => næp
knapped => næpt
knapper => 'næpә
knapping => næpɪŋ
knapsack => 'næpsæk
knapsacks => ˈnæpˌsæks
knapweed => 'næpwi:d
knar => nɑ:
knave => neiv
knaveries => ˈneivəriz
knavery => 'neivәri
knaves => neɪvz
knavish => 'neiviʃ
knavishly => 'neɪvɪʃlɪ
knawel => 'nɔ:әl
knead => ni:d
kneadable => 'ni:deɪbl
kneaded => 'ni:dɪd
kneader => 'ni:dә
kneading => 'ni:diŋ
kneads => ni:dz
knee => ni:
knee breeches => ni: ˈbrɪtʃɪz
knee-length => ni: leŋθ
knee-slapper => 'ni:sl'æpə
kneecap => 'ni:kæp
kneecapped => ˈni:kæpt
kneecapping => 'ni:,kæpiŋ
kneecaps => ˈni:kæps
kneehole => 'ni:hәul
kneel => ni:l
kneeler => 'ni:lә
kneels => ni:lz
knees => ni:z
knell => nel
knelled => neld
knelling => nelɪŋ
knells => nelz
knelt => nelt
Knesset => 'kneset
knew => nju:
knickerbocker => 'nikәbɔkә
knickerbockers => 'nikәbɔkәz
knickers => 'nikәz
knickknacks => 'nɪknæk
knife => naif
knife pleat => naif pli:t
knife-edges => 'naifedʒ
knifed => naift
knifefish => 'naiffiʃ
knifepoint => 'naifpɔint
knifer => 'naifә
knifes => ˈnaifiŋz
knifing => 'naifiŋ
knight => nait
knight errant => nait ˈerənt
knight-errant => 'nait'erәnt
knight-errantry => 'nait'erәntri
knightage => 'naitidʒ
knighted => naɪt
knighthood => 'naithud
knighthoods => ˈnaɪtˌhʊdz
knighting => naɪt
knightliness => 'naɪtlɪnəs
knightly => 'naitli
knish => kniʃ
knit => nit
knits => nits
knitter => 'nitә
knitters => 'nɪtəz
knitting => 'nitiŋ
knitting machine => ˈnɪtɪŋ məˈʃi:n
knitting needle => ˈnɪtɪŋ ˈni:dl
knitwear => 'nit,weә
knives => naivz
knob => nɒb
knobbing => 'nɒbɪŋ
knobble => 'nɒbl
knobbling => 'nɔbliŋ
knobbly => 'nɔbli
knobby => 'nɒbi
knobkerrie => 'nɒb.keri
knobstick => 'nɔbstik
knock => nɒk
knock on => nɔk ɔn
knock-off => ˌnɒkˌɒf
knock-on => 'nɔk'ɔn
knock-up => nɔk ʌp
knockabout => 'nɒkәbaut
knockdown => 'nɒkdaun
knocked => nɔkt
knocker => 'nɒkә
knockers => 'nɒkəz
knocking => 'nɔkiŋ
knocking copy => ˈnɔkiŋ ˈkɔpi
knockoff => 'nɒkɔ:f
knockout => 'nɔ'kaut
knockouts => 'nɒkaʊts
knocks => nɔks
knockwurst => 'nɔkw\\\\:st
knoll => nәul
knolls => 'nəʊlz
knop => nɒp
knot => nɒt
knot garden => nɔt ˈɡɑ:dn
knotgrass => 'nɒtgræs
knothole => 'nɒthәul
knotless => nɒt'les
knotted => 'nɔtid
knotter => 'nɔtә
knottier => ˈnɔti:ə
knottiness => 'nɒtinis
knotting => 'nɔtiŋ
knotty => 'nɒti
knotweed => 'nɔtwi:d
knotwork => 'nɒtwә:k
knout => naut
know => nәu
know best => nəʊ best
know-all => 'nәj ɔ:l
know-how => 'nәuhau
know-it-all => 'nәjitɔ:l
know-nothing => 'nәj,nʌθiŋ
know-nothingism => 'nәj,nʌθiŋizәm
knowable => 'nәuәbl
knowing => 'nәuiŋ
knowingly => 'nәjiŋli
knowledgable => 'nɔlidʒәbl
knowledge => 'nɒlidʒ
knowledgeability => .nɒlidʒә'biliti
knowledgeable => 'nɒlidʒәbl
known => nәun
knox => nɔks
knuckle => 'nʌkl
knuckle sandwich => ˈnʌkl ˈsænwidʒ
knuckle-dusters => 'nʌkld'ʌstəz
knuckleball => 'nʌklbɔ:l
knuckleballer => 'nʌkl,bɔ:lә(r)
knuckled => ˈnʌkld
knuckleduster => 'nʌkl,dʌstә(r)
knucklehead => 'nʌklhed
knuckleheads => 'nʌk(ə)lhed
knuckles => ˈnʌklz
knuckling => 'nʌkliŋ
knur => n\\\\:(r)
knurl => nә:l
knurled => nɜ:ld
KO => 'kei'әu
koa => 'kәuә
koala => kә'ɑ:lә
koalas => kəʊˈɑ:ləz
koan => 'kәuɑ:n
kob => kɔb
Koblenz => 'kәjblents
kobo => 'kɔ:,bɔ:
kobold => 'kɔbәuld
koch => kɔx
kodak => 'kәjdæk
koel => 'kәuәl
Koestler => 'kestlə,  'kestlə
kofta => 'kɔftә
kohl => kәul
kohlrabi => 'kәul'rɑ:bi
Koil => 'kəuəl; kɔil
koine => 'kɒini:
koinonia => ,kɔinә'niә
kokanee => kәu'kæni:
koko => 'kәukәu
kokowai => 'kәukә,wai
kola => 'kәulә
kolinsky => kә'linski
kolkhoz => kɔl'hɔz
kolo => 'kәulәu
Kolyma => kә'li:mә
komatik => kәu'mætik
kombu => kɒm'bʌ
Komi => 'kәjmi
Komodo dragon => kә'mәudәu'dræ^әn
Komsomolsk => 'kɔmsә'mɔlsk
konfyt => kәn'fait
kong => kɔŋ
Kongo => 'kɔŋ^әu
kongoni => kɔŋ'^әuni
konimeter => kәu'nimitә
Konrad => 'kɔnræd
kook => ku:k
kookaburra => 'kukәbә:rә
kookiness => 'kʊkɪnəs
kooks => ku:ks
kooky => 'ku:ki
koori => ˈkʊəri
Kop => kɔp
kopeck => 'kәupek
kopecks => 'kəupek
kopek => 'kәupek
kopje => 'kɒpi
koppie => 'kɔpi
kora => 'kɔrә
koradji => kɒːˊrɑːdʒi
Koran => kɒ'rɑ:n
Koranic => kɒ'rænik
Kordofan => ,kɔ:dәj'fæn
Korea => kә'riә
Korean => kә'riәn
koreans => kəˈri:ənz
kori => 'kɔri
koruna => kәu'ru:nɑ:
Kos => kәus
Kosciusko => ,kɔsi'ʌskәj
kosher => 'kәuʃә
Kosovo => 'kɔ:sәvәj
Kotka => 'kɔ:tkә
koto => 'kәutәu
kotwal => 'kɒtwɑ:l
kotwali => 'kәutwɑ:li
koumiss => 'ku:mis
kouprey => 'ku:prei
kouros => 'kurɔs
kowhai => 'kәuai
kowloon => 'kaj'lu:n
kowtow => .kәu'tau
kowtowed => kaʊˈtaʊd
kowtowing => kaʊˈtaʊɪŋ
kowtows => kaʊˈtaʊz
Kozhikode => 'kәjʒikәjd
kph => ˌkeɪ pi: ˈeɪtʃ
Kraal => krɑ:l
kraft => krɑ:ft
krait => krait
Krakatoa => ,kra:kə'təuə
kraken => 'krɑ:kәn
Krakow => 'krɑ:ku:f
krantz => krɑ:nts
Krasnodar => 'kræsnədɑ:r
Krasnoyarsk => ,kræsnə'jɑ:rsk
krater => 'kreitә, 'krɑ:-
Kraut => kraut
krauts => kraut
Kremlin => 'kremlin
kreplach => 'kreplɑ:k
kriegspiel => 'kri:^spi:l
krill => kril
krimmer => 'krimә
Krio => 'kri:əu
kris => kri:s
Krishna => 'kriʃnә
Krishnaism => 'kriʃnəizəm
Kriss Kringle => 'kris 'kriŋ^l
Kristiansand => 'kristʃәnsænd
kromesky => krәu'meski
krona => 'krәunә
krone => 'krәune
kroner => ˈkrəʊnə(r)
Kronos => 'krәjnɔs
Kronstadt => 'krɔnʃtæt
kroon => kru:n
Kropotkin => krәu'pɔtkin
Kru => kru:
kruger => 'stefәnjsjәj'hænis'pɔ:lj
krugerrand => krʌ'ɡerənd
krugerrands => 'kru:ɡərænd
krummholz => 'krumhәults
krummhorn => 'krʌmhɔ:n
Krupp => krʌp
krypton => 'kriptɒn
krytron => k'raɪtrɒn
Kshatriya => 'kʃɑ:trijә
Ku Kluxer => 'kju:'klʌksə
Kuala Lumpur => .kɑ:lә'lumpuә
kuan => ^wɑ:n
Kublai Khan => 'ku:blai 'kɑ:n
kuchen => 'ku:kәn
Kuching => 'ku:tʃiŋ
kudo => 'kju:dәu
kudos => 'kju:dɒs
kudu => 'ku:du:
kudzu => 'kædzu:
Kufic => 'kju:fik, 'ku:-
kuhn => ku:n
Kuibyshev => 'kwibiʃev
kukri => 'kukri
kuku => 'kuku:
kula => 'ku:lә
kulak => ku:'lɑ:k
kulan => 'ku:lɑ:n
Kultur => kul'tuә
Kumamoto => 'ku:mә'mәutәu
Kumasi => ku:'mɑ:si, -'mæsi
kumis => 'ku:mɪs
kumite => kj'mi:ti:
kumquat => 'kʌmkwɔt
kuna => 'ku:nə
kundalini => ,kjndә'li:ni
kung fu => kjŋ'fu:
Kunming => 'kjn'miŋ
kunzite => 'kuntsait
kuomintang => 'kwәumin'tæŋ
kurchatovium => ,kuәtʃɑ:'tɔviәm
Kurd => kuәd
Kurdish => 'kә:diʃ
Kurdistan => ,k\\\\:di'stɑ:n
kurgan => kjәr'^ɑ:n
Kuroshio => ku'rәuʃi:әu
kurrajong => 'kʌrәdʒɒ:ŋ
Kursk => 'kjәrsk
kurt => kә:t
kurta => 'k\\\\:tә
kurtosis => kә:'tәusis
kuru => 'ku:ru
kurus => ku'ru:ʃ
kusimanse => ,ku:sә'mænsә
Kutani => kj'tɑ:ni
Kuwait => kә'wait
Kuwaiti => ku'weiti, kә'waiti
kuwaitis => kuˈweitiz
kvass => kvɑ:s
kvell => kvel
kvetch => kvetʃ
kvetched => kvetʃt
kvetches => kvetʃiz
kvetching => kvetʃɪŋ
Kwa => kwɑ:
kwacha => 'kwɑ:tʃɑ:
Kwakiutl => ,kwɑ:ki:'u:tl
Kwangchow => '^wɑ:ŋ'dʒej
Kwangju => '^wɔ:ŋ'dʒu:
Kwangtung => '^wɑ:ŋ'djŋ
kwanza => k'wænzə
Kwanzaa => 'kwa:nzə
kwashiorkor => ,kwɑ:ʃi'ɔ:kɔ:
Kweichow => '^wei'dʒәj
Kweilin => '^wei'lin
Kweiyang => '^wei'jɑ:ŋ
KWIC => kwik
kyanite => 'kaiә,nait
kyat => kjɑ:t
kyle => kail
kylie => 'kaili
kylin => 'ki:lin
kylix => 'kailiks, 'kiliks
kyloe => 'kailәu
kymograph => 'kaimәugræf
kymographic => ,kaiməu'ɡræfik
Kyoto => ki'әutәu
kyphosis => kai'fәusis
Kyrgyzstan => kiə'ɡizstən
Kyte => kait
Kyushu => 'kju:'ʃu: