colour code => ˈkʌlə kəud
colour scheme => ˈkʌlə ski:m
colour separation => ˈkʌlə ˌsepəˈreɪʃən
colour sergeant => ˈkʌlə ˈsɑ:dʒənt
colour supplement => ˈkʌlə ˈsʌpliment
colourable => 'kʌlәrәbl
colourant => 'kʌlәrәnt
colouration => ,kʌlә'reiʃәn
coloured => 'kʌlәd
Coloureds => 'kʌləd
colourfast => 'kʌlәfɑ:st
colourful => 'kʌlәful
colouring => 'kʌlәriŋ
colourist => 'kʌlәrist
colourize => 'kʌlәraiz
colourless => 'kʌlәlis
colourway => 'kʌlәwei
colportage => 'kɔl,pɔ:tidʒ
colporteur => 'kɒl.pɒ:tә
colposcope => 'kɔlpәskәup
colt => kәult
colter => 'kәultә
coltish => 'kәultiʃ
colts => 'kəʊlts
coltsfoot => 'kәultsfut
colubrid => 'kɔlubrid
colubrine => 'kɒljubrain
colugo => kә'lu:^әu
Columba => kә'lʌmbә
columbarium => kɒlәm'bєәriәm
Columbia => kә'lʌmbiә
Columbian => kә'lʌmbiәn
columbine => 'kɒlәmbain
columbines => 'kɒləmbaɪn
columbite => kә'lʌmbait
columbium => kә'lʌmbiәm
columbus => kә'lʌmbәs
columella => kɒlju'melә
column => 'kɒlәm
columnar => kә'lʌmnә
columned => 'kɒlәmd
columnist => 'kɒlәmist
columnists => ˈkɔləmnists
colure => kә'ljuә
Colvin => 'kɔlvin
coly => 'kәjli
colza => 'kɒlzә
com- => kɔm, kәm, kʌm
coma => 'kәumә
comal => kәu'mɑ:l
Comanche => kәu'mæntʃi:
comandante => kəʊmən'dænti:
comas => ˈkəʊməz
comatose => 'kɒmәtәus
comb => kәum
comb-out => 'kәjmajt
combat => 'kɒmbæt
combatant => 'kɒmbәtәnt
combatants => kəm'bætnts
combated => ˈkɔmbətid
combating => ˈkɔmbətɪŋ
combative => kәm'bætiv
combatively => kɒm'bətɪvlɪ
combats => ˈkɒmbæts
Combe => ku:m
combed => kəumd
comber => 'kәumә
combi => 'kɔmbi
combination => .kɒmbi'neiʃәn
combinative => 'kɒmbinәtiv
combinatorial => ,kɔmbinә'tɔ:riәl
combinatoric => ,kɔmbinə'tɔ:rik
combinatorics => ,kɔmbinei'tɔriks
combinatory => kɔm'bainәtәri
combine => kәm'bain
combine harvester => kəmˈbain ˈhɑ:vɪstə
combined => kәm'baind
combines => kəmˈbainz
combing => 'kәumiŋ
combing wool => ˈkəumiŋ wul
combining => kәm'bainiŋ
combining form => kəmˈbainiŋ fɔ:m
combo => 'kɒmbәu
combos => ˈkɔmbəʊz
combs => kɔmz
combust => kәm'bʌst
combusted => kəm'bʌst
combustibility => kәm.bʌstә'biliti
combustible => kәm'bʌstibl
combustibles => kəmbʌs'təblz
combusting => kəm'bʌst
combustion => kәm'bʌstʃәn
combustive => kәm'bʌstiv
combustor => kәm'bʌstә
combusts => kəm'bʌst
come => kʌm
come close => kʌm kləuz
come hell or high water => kʌm hel ɔ: hai ˈwɔ:tə
come running => kʌm ˈrʌnɪŋ
come short => kʌm ʃɔ:t
come-outer => ,kʌm'ajtә(r)
comeback => 'kʌmbæk
comebacks => ˈkʌmbæks
COMECON => 'kɔmәkɔn
comedian => kә'mi:djәn
comedians => kəˈmi:di:ənz
comedic => kә'mi:dik
comedienne => kә.meidi'en
comedo => 'kɒmidәu
comedown => 'kʌmdaun
comedy => 'kɒmidi
comelier => ˈkʌmli:ə
comeliness => 'kʌmlinis
comely => 'kʌmli
comer => 'kʌmә
comers => 'kʌməz
comes => 'kɔmis
comestible => kә'mestibl
comestibles => 'kəmestəblz
comet => 'kɒmit
comeuppance => .kʌm'ʌpәns
comfier => ˈkʌmfiə
comfily => 'kʌmfili
comfit => 'kʌmfit
comfort => 'kʌmfәt
comfort food => ˈkʌmfət fu:d
comfortable => 'kʌmfәtәbl
comfortably => 'kʌmfәtәbli
comforted => ˈkʌmfətid
comforter => 'kʌmfәtә
comforters => ˈkʌmfətəz
comforting => 'kʌmfәtiŋ
comfortingly => 'kʌmfətiŋli
comfortless => 'kʌmfәtlis
comforts => ˈkʌmfəts
comfrey => 'kʌmfri
comfy => 'kʌmfi
comic => 'kɒmik
comic opera => ˈkɔmik ˈɔpərə
comical => 'kɒmikәl
comicality => ,kɔmi'kæliti
comics => 'kɔmiks
coming => 'kʌmiŋ
Comintern => 'kɔmintә:n
comity => 'kɒmiti
comma => 'kɒmә
command => kә'mɑ:nd
command performance => kəˈmɑ:nd pəˈfɔ:məns
command-driven => kəˈmɑ:nd ˈdrɪvən
commandant => .kɒmәn'dænt
commanded => kəˈmɑ:ndid
commandeer => .kɒmәn'diә
commandeered => ˌkɔmənˈdɪəd
commandeering => ˌkɔmənˈdɪərɪŋ
commandeers => ˌkɔmənˈdɪəz
commander => kә'mɑ:ndә
commanders => kəˈmɑ:ndəz
commandership => kә'mɑ:ndәʃip
commanding => kә'mɑ:ndiŋ
commandment => kә'mɑ:ndmәnt
commandments => kəˈmændmənts
commando => kә'mɑ:ndәu
commandos => kəˈmændəʊz
commas => ˈkɔməz
comme il faut => kɔ:mi:l'fәu
commemorate => kә'memәreit
commemorated => kəˈmeməreitid
commemorates => kəˈmeməreits
commemorating => kəˈmeməreitɪŋ
commemoration => kә.memә'reiʃәn
commemorative => kә'memәrәtiv
commence => kә'mens
commenced => kəˈmenst
commencement => kә'mensmәnt
commences => kəˈmensiz
commencing => kəˈmensɪŋ
commend => kә'mend
commendable => kә'mendәbl
commendably => kə'mendəblɪ
commendation => .kɒmen'deiʃәn
commendations => ˌkɔmənˈdeɪʃənz
commendatory => kә'mendәtәri
commended => kəˈmendid
commending => kəˈmendɪŋ
commends => kəˈmendz
commensal => kә'mensәl
commensalism => kә'mensәlizm
commensality => .kɒmen'sæliti
commensurability => kә,menʃәrә'biliti
commensurable => kә'menʃәrәbl
commensurate => kә'menʃәrit
comment => 'kɒment
commentaries => ˈkɔmentəriz
commentary => 'kɒmәntәri
commentate => 'kɒmәnteit
commentated => ˈkɔmənˌteɪtid
commentates => ˈkɔmənˌteɪts
commentating => ˈkɔmənˌteɪtɪŋ
commentator => 'kɔmenteitә
commentators => ˈkɔmənˌteɪtəz
commenter => 'kɒmentә
commerce => 'kɒmә:s
commercial => kә'mә:ʃәl
commercialisation => kəˌmɜ:ʃəlaɪ'zeɪʃən
commercialise => kə'mɜ:ʃəlaɪz
commercialised => kə'mə:ʃəlaiz
commercialism => k'm\\\\:ʃә'liz(ә)m
commercialize => kә'mә:ʃәlaiz
commercialized => kəˈmɜː(r)ʃəlaɪzd
commercializes => kəˈmɜː(r)ʃəlaɪziz
commercializing => kəˈmɜː(r)ʃəlaɪzɪŋ
commercials => kə'mɜ:ʃlz
commie => 'kɒmi
commies => ˈkɔmiz
commination => .kɒmi'neiʃәn
comminatory => 'kɒminәtәri
commingle => kɒ'miŋgl
commingled => kəˈmɪŋgəld
commingles => kəˈmɪŋgəlz
commingling => kəˈmɪŋgəlɪŋ
comminute => 'kɒminu:t
comminuted => ˈkɔminju:tid
comminution => .kɒmi'nju:ʃәn
commis => kɔ:'mi:
commiserate => kә'mizәreit
commiserated => kəˈmɪzəˌreɪtid
commiserates => kəˈmɪzəˌreɪts
commiserating => kəˈmɪzəˌreɪtɪŋ
commiseration => kә.mizә'reiʃәn
commiserations => kə,mizə'reiʃən
commiserative => kә'mizәreitiv
commissar => .kɒmi'sɑ:
commissarial => .kɒmi'sєәriәl
commissariat => .kɒmi'sєәriәt
commissariats => ˌkɔmiˈsɛəriəts
commissaries => ˈkɔmisəriz
commissary => 'kɒmisәri
commission => kә'miʃәn
commissionaire => kә,miʃә'neә
commissionaires => kə,mɪʃə'neə
commissioned officer => kəˈmɪʃənd
commissioner => kә'miʃәnә
commissioners => kəˈmɪʃənəz
commissioning => kә'miʃәniŋ
commissions => kəˈmiʃənz
commissural => .kɒmi'sjuәrәl
commissure => 'kɒmisjuә
commit => kә'mit
commitment => kә'mitmәnt
commitments => kə'mɪtmənts
commits => kəˈmits
committal => kә'mitәl
committee => kә'miti
committee stage => kəˈmiti steidʒ
committeeman => kә'mitimәn
committeewoman => kә'miti,wjmәn
commix => kɒ'miks
commixed => kɔˈmikst
commixes => kɔˈmiksiz
commixing => kɔˈmiksɪŋ
commixture => kɒ'mikstʃә
commo => 'kɒməʊ
commode => kә'mәud
commodes => kəˈməudz
commodification => kə,mɔdifi'keiʃən
commodify => kə'mɒdəˌfɑɪ
commodious => kә'mәudjәs
commodiously => kə'məʊdɪəslɪ
commodities => kəˈmɔditiz
commoditization => kəmɒdɪtaɪ'zeɪʃn
commoditize => kə'mɔdətaiz
commodity => kә'mɒditi
commodore => 'kɒmәdɒ:
commodores => ˈkɔməˌdɔ:z
common => 'kɒmәn
common chord => ˈkɔmən kɔ:d
common denominator => ˈkɔmən dɪˈnɔməˌneɪtə
common fraction => ˈkɔmən ˈfrækʃən
common knowledge => ˈkɔmən ˈnɔlidʒ
common noun => ˈkɔmən naun
common or garden => ˈkɔmən ɔ: ˈɡɑ:dn
common soldier => ˈkɔmən ˈsəuldʒə
common time => ˈkɔmən taim
commonable => 'kɒmәnәbl
commonage => 'kɒmәnidʒ
commonality => .kɒmә'næliti
commonalty => 'kɒmәnәlti
commoner => 'kɒmәnә
commoners => ˈkɔmənəz
commonhold => ˈkɒmənhəʊld
commonly => 'kɒmәnli
commonness => 'kɒmәnnis
commonplace => 'kɒmәnpleis
commonplace book => ˈkɔmənpleis buk
commonplaces => ˈkɔmənpleisiz
commons => 'kɒmәns
commonsense => ,kɔmәn'sens
commonweal => 'kɒmәnwi:l
commonwealth => 'kɔmәnwelθ
commotion => kә'mәuʃәn
communal => 'kɒmjunәl
communalism => 'kɒmjunәlizm
communalist => 'kɒmjunәlist
communalistic => .kɒmjunә'listik
communality => ,kɔmju'næliti
communalize => 'kɒmjunәlaiz
communalized => ˈkɔmjunəlaizd
communalizes => ˈkɔmjunəlaiziz
communalizing => ˈkɔmjunəlaizɪŋ
Communard => 'kɔmjunɑ:d
commune => kә'mju:n
communed => ˈkɔmju:nd
communes => ˈkɔmju:nz
communicable => kә'mju:nikәbl
communicant => kә'mju:nikәnt
communicants => kə'mjuːnɪk(ə)nt
communicate => kә'mju:nikeit
communicated => kəˈmju:nikeitid
communicates => kəˈmju:nikeits
communication => kә.mju:ni'keiʃәn
communicational => kəmjuːnɪ'keɪʃənəl
communications => kәmju:ni'keiʃ(ә)nz
communicative => kә'mju:nikeitiv
communicator => kә'mju:nikeitә
communicatory => kә'mju:nikәtәri
communing => ˈkɔmju:nɪŋ
Communion => kә'mju:njәn
communions => kəˈmju:njənz
communique => kә'mju:nikei
communiques => kə'mju:nɪkeɪ
communism => 'kɒmjunizm
communist => 'kɒmjunist
communistic => .kɒmju'nistik
communists => ˈkɔmjunists
communitarian => kә,mju:ni'teәriәn
communitarianism => kəmju:nɪteə'rɪənɪzəm
community => kә'mju:niti
community care => kəˈmju:niti kɛə
community centre => kəˈmju:niti ˈsentə
community college => kəˈmju:niti ˈkɔlidʒ
community service => kəˈmju:niti ˈsɜːvɪs
communization => .kɒmjunai'zeiʃәn
communize => 'kɔmjunaiz
commutability => kә.mju:tә'biliti
commutable => kә'mju:tәbl
commutate => 'kɒmjuteit
commutated => ˈkɔmjuteitid
commutates => ˈkɔmjuteits
commutating => ˈkɔmjuteitɪŋ
commutation => kɒmju'teiʃәn
commutative => kә'mju:tәtiv
commutator => 'kɒmjuteitә
commute => kә'mju:t
commuted => kəˈmju:tid
commuter => kә'mju:tә
commuters => kəˈmju:təz
commutes => kəˈmju:ts
commuting => kә'mju:tiŋ
como => 'kәjmәj
Comoran => 'kɔmәrәn
comorbidity => kemɒr'bɪdətɪ
Comorin => 'kɔmәrin
Comoros => 'kɔmәrәus
comp => kɔmp
compact => kәm'pækt
compact car => kəmˈpækt kɑ:
compacting => kәm'pæktiŋ
compaction => kәm'pækʃәn
compactly => kәm'pæktli
compactness => kәm'pæktnis
compactor => kәm'pæktә
compacts => kəmˈpækts
compadre => kәm'pɑ:dri
compagnie => kɔnpa'nji:
compander => kәm'pændә(r)
companied => 'kʌmp(ə)nɪ
companion => kәm'pænjәn
companionable => kәm'pænjәnәbl
companionably => kəm'pænɪənəblɪ
companionate => kәm'pænjәnit
companions => kəmˈpænjənz
companionship => kәm'pænjәnʃip
companionway => kәm'pænjәnwei
company => 'kʌmpәni
company car => ˈkʌmpəni kɑ:
company officer => ˈkʌmpəni ˈɔfisə
companying => 'kʌmp(ə)nɪ
comparability => ,kɔmpәrә'biliti
comparable => 'kɒmpәrәbl
comparably => 'kɒmpәrәbli
comparatist => kәm'pærәtist
comparative => kәm'pærәtiv
comparative linguistics => kəmˈpærətiv lɪŋˈgwɪstɪks
comparatively => kәm'pærәtivli
comparatives => kəmˈpærətivz
comparator => 'kɒmpәreitә
compare => kәm'pєә
compares => kəmˈpɛəz
comparison => kәm'pærisn
comparison-shop => kәm'pærisәn'ʃɔp
comparisons => kəm'pærɪsnz
compartment => kәm'pɑ:tmәnt
compartmental => ,kɔmpɑ:t'mentәl
compartmentalise => ,kɔmpɑ:t'mentəlaiz
compartmentalize => kәm,pɑ:t'mentәlaiz
compartmentalized => kəmˌpɑ:tˈmentəlaizd
compartmentalizes => kəmˌpɑ:tˈmentəlaiziz
compartmentalizing => kəmˌpɑ:tˈmentəlaizɪŋ
compartmentation => kәm,pɑ:tmen'teiʃәn
compartmented => kəm'pɑːtm(ə)nt
compartments => kəmˈpɑ:tmənts
compass => 'kʌmpәs
compass card => ˈkʌmpəs kɑ:d
compass rose => ˈkʌmpəs rəuz
compass saw => ˈkʌmpəs sɔ:
compassed => 'kʌmpəs
compasses => 'kʌmpәsis
compassion => kәm'pæʃәn
compassionate => kәm'pæʃәnit
compassionate leave => kəmˈpæʃənɪt li:v
compassionately => kəm'pæʃənətlɪ
compatibility => kәm.pætә'biliti
compatible => kәm'pætәbl
compatibly => kәm'pætәbli
compatriot => kәm'pætriәt
compatriots => kəmˈpeɪtri:əts
compeer => kɒm'piә
compel => kәm'pel
compelling => kәm'peliŋ
compellingly => kəm'pelinli
compendia => kəmˈpendiə
compendious => kәm'pendiәs
compendiously => kəm'pendɪəslɪ
compendiousness => kəm'pendɪəsnəs
compendium => kәm'pendiәm
compensable => kәm'pensәbl
compensate => 'kɒmpenseit
compensated => ˈkɔmpenseitid
compensates => ˈkɔmpenseits
compensating => 'kɔmpenseitiŋ
compensation => .kɒmpen'seiʃәn
compensational => kɒmpenˊseiʃәnәl
compensations => ˌkɔmpenˈseiʃənz
compensative => kәm'pensәtiv
compensator => 'kɒmpenseitә
compensatory => kәm'pensәtәri
compere => 'kɒmpєә
compered => ˈkɔmˌpeəd
comperes => ˈkɔmˌpeəz
compering => ˈkɔmˌpeərɪŋ
compete => kәm'pi:t
competed => kəmˈpi:tid
competence => 'kɒmpitәns
competency => 'kɔmpit(ә)nsi
competent => 'kɒmpitәnt
competes => kəmˈpi:ts
competition => .kɒmpi'tiʃәn
competitive => kәm'petitiv
competitor => kәm'petitә
competitors => kəm'petɪtəz
compilation => .kɒmpi'leiʃәn
compilations => kɒmpɪ'leɪʃnz
compile => kәm'pail
compiler => kәm'pailә
compiles => kəmˈpailz
comping => 'kɔmpiŋ
complacence => kәm'pleisәns
complacency => kәm'pleisәnsi
complacent => kәm'pleisnt
complacently => kəm'pleɪsntlɪ
complain => kәm'plein
complainant => kәm'pleinәnt
complainants => kəmˈpleinənts
complained => kəmˈpleind
complaining => kәm'pleiniŋ
complainingly => kəmp'leɪnɪŋlɪ
complains => kəmˈpleinz
complaint => kәm'pleint
complaints => kəm'pleɪnts
complaisance => kәm'pleizәns
complaisant => kәm'pleizәnt
compleat => kәm'pli:t
complect => kәm'plekt
complected => kɔm'plektid
complement => 'kɒmplimәnt
complement fixation test => ˈkɔmplimənt fɪkˈseɪʃən test
complemental => .kɒmpli'mentl
complementarity => .kɒmplimen'tæriti
complementary => .kɒmpli'mentәri
complementary colour => ˌkɔmpləˈmentəri: ˈkʌlə
complementary distribution => ˌkɔmpləˈmentəri: ˌdistriˈbju:ʃən
complementation => ,kɔmplimen'teiʃәn
complemented => 'kɔmplә.mentid
complementizer => 'kɔmplimentaizә
complete => kәm'pli:t
completely => kәm'pli:tli
completeness => kәm'pli:tnis
completing => kəmˈpli:tɪŋ
completion => kәm'pli:ʃәn
completions => kəmˈpli:ʃənz
completist => kәm'pli:tist
completive => kәm'pli:tiv
complex => kәm'pleks
complex sentence => ˈkɔmpleks ˈsentəns
complexation => kɔmplek'seiʃ(ә)n
complexed => 'kɒmpleks
complexion => kәm'plekʃn
complexioned => kәm'plekʃәnd
complexions => kəmˈplekʃənz
complexities => kəmˈpleksɪti:z
complexity => kәm'pleksiti
compliance => kәm'plaiәns
compliant => kәm'plaiәnt
compliantly => kəmp'laɪəntlɪ
complicate => 'kɒmplikeit
complicated => 'kɒmplikeitid
complicates => ˈkɔmplɪˌkeɪts
complicating => ˈkɔmplɪˌkeɪtɪŋ
complication => .kɒmpli'keiʃәn
complicit => kәm'plisit
complicities => kəmˈplɪsɪti:z
complicitous => kәm'plisitәs
complicity => kәm'plisiti
complies => kəmˈplaiz
compliment => 'kɒmplimәnt
complimentary => .kɒmpli'mentәri
complimented => ˈkɔmpliməntid
complimenting => ˈkɔmpliməntɪŋ
compline => 'kɒmplin
comply => kәm'plai
complying => kəmˈplaiŋ
compo => 'kɒmpәu
component => kәm'pәunәnt
comport => kәm'pɒ:t
comported => kəmˈpɔ:tid
comporting => kəmˈpɔ:tɪŋ
comportment => kәm'pɒ:tmәnt
comports => kəmˈpɔ:ts
compose => kәm'pәuz
composed => kәm'pәuzd
composedly => kәm'pәuzidli
composer => kәm'pәuzә
composers => kəm'pəʊzəz
composes => kəmˈpəuziz
composing => kәm'pәuziŋ
composite => kәm'pɒzit
composition => kɒmpә'ziʃәn
compositor => kәm'pɒzitә
compositors => kəm'pɒzɪtəz
compossible => kɒm'pɒsibl
compost => 'kɒmpәust
compost heap => ˈkɔmpɔst hi:p
composted => ˈkɔmpɔstid
composting => 'kɔmpɔstiŋ
composts => ˈkɔmpɔsts
composure => kәm'pәuʒә
compote => 'kɒmpәut
compotes => kɒm'pɒts
compound => kәm'paund
compound sentence => ˈkɔmpaund ˈsentəns
compounded => 'kɔmpaudid
compounder => kәm'paundә
compounding => 'kɔmpaundiŋ
compounds => ˈkɔmpaundz
comprador => .kɒmprә'dɒ:
comprehend => .kɒmpri'hend
comprehended => ˌkɔmpriˈhendid
comprehending => ˌkɔmpriˈhendɪŋ
comprehends => ˌkɔmpriˈhendz
comprehensible => .kɒmpri'hensibl
comprehensibly => .kɒmpri'hensibli
comprehension => .kɒmpri'henʃәn
comprehensive => .kɒmpri'hensiv
comprehensiveness => ˌkɒmprɪ'hensɪvnəs
comprehensives => ˌkɔmpriˈhensivz
compress => kәm'pres
compressed => kәm'prest
compressibility => kәm.presә'biliti
compressible => kәm'presәbl
compression => kәm'preʃәn
compressional => kəm'preʃənəl
compressive => kәm'presiv
compressor => kәm'presә
compressors => kəmp'resəz
comprise => kәm'praiz
comprises => kəmˈpraiziz
comprising => kəmˈpraizɪŋ
compromise => 'kɒmprәmaiz
compromised => ˈkɔmprəmaizd
compromises => ˈkɔmprəmaiziz
compton => 'kɔmptәn
comptroller => kәn'trәulә
compulsion => kәm'pʌlʃәn
compulsions => kəmˈpʌlʃənz
compulsive => kәm'pʌlsiv
compulsorily => kәm'pʌlsәrili
compulsoriness => kәmˊpʌlsәrinis
compulsory => kәm'pʌlsәri
compunction => kәm'pʌŋkʃәn
compunctious => kәm'pʌŋkʃәs
compurgation => kɒmpә:'geiʃәn
compurgator => 'kɔmpә:^eitә
computable => kәm'pju:tәbl
computation => .kɒmpju'teiʃәn
computational => .kɒmpju'teiʃәnәl
computations => kɒmpjʊ'teɪʃnz
compute => kәm'pju:t
computed => kәm'pju:tid
computer => kәm'pju:tә
computer literacy => kəmˈpju:tə ˈlitərəsi
computer-literate => kəmˈpju:tə ˈlitərit
computerate => kәm'pju:tәrәt
computerisation => kәm,pju: tәrai'zeiʃәn; - ri'z-
computerise => kәm'pju:tәraiz
computerised => kəm'pju:təraɪzd
computerization => kәm,pju:tәrai'zeiʃәn; -ri'z-
computerize => kәm'pju:tәraiz
computerized => kәm'pju:tәraizd
computerizes => kəmˈpju:təˌraɪziz
computerizing => kəmˈpju:təˌraɪzɪŋ
computes => kəmˈpju:ts
computing => kәm'pju:tiŋ
comrade => 'kɒmreid
comradely => 'kɔmreidli
comrades => 'kɒmreɪdz
comradeship => 'kɔmreidʃip
comte => kɔ:nt
con => kɒn
con amore => .kɒnæ'mɒ:rei
con brio => kɔn ˈbri:əu
con man => kɔn mæn
con moto => kɔn ˈməutəu
con sordino => ˌkɒn sɔ:ˈdi:nəʊ
conacre => 'kɔneikә(r)
Conakry => 'kɔnәkri
conan => 'kәunәn, 'kɔnәn
conation => kәu'neiʃәn
conative => 'kәunәtiv
concatenate => kɒn'kætәneit
concatenated => kɔn'kætineitid
concatenates => kɔn'kætineits
concatenation => .kɒnkæti'neiʃәn
concave => 'kɒnkeiv
concavity => kɒn'kæviti
concavo-concave => kɔn'keivәu'kɔnkeiv
concavo-convex => kɔn'keivәu'kɔnveks
conceal => kәn'si:l
concealing => kənˈsi:lɪŋ
concealment => kәn'si:lmәnt
conceals => kənˈsi:lz
concede => kәn'si:d
conceded => kənˈsi:did
concedes => kənˈsi:dz
conceding => kənˈsi:dɪŋ
conceit => kәn'si:t
conceited => kәn'si:tid
conceitedly => kәn'si:tidli
conceitedness => kən'si:tidnis
conceits => kənˈsi:ts
conceivability => kәn.si:vә'biliti
conceivable => kәn'si:vәbl
conceivably => kәn'si:vәbli
conceive => kәn'si:v
conceived => kənˈsi:vd
conceives => kənˈsi:vz
conceiving => kənˈsi:vɪŋ
concelebrant => kɔn'selibrәnt
concelebrate => kɔn'selibreit
concelebration => kɔn,seli'breiʃәn
concentrate => 'kɒnsәntreit
concentrated => 'kɒnsәntreitid
concentrates => ˈkɔnsəntreits
concentration => .kɒnsәn'treiʃәn
concentration camp => ˌkɔnsənˈtreiʃən kæmp
concentrations => kɒnsənt'reɪʃnz
concentrative => 'kɒnsәntreitiv
concentrator => 'kɒnsәntreitә
concentre => kɔn'sentә(r)
concentred => kɔn'sentə
concentric => kɒn'sentrik
concentrically => kən'sentrɪklɪ
concentricity => .kɒnsәn'trisiti
concentring => kɔn'sentə
concept => 'kɒnsept
conception => kɒn'sepʃәn
conceptional => kən'sepʃənl
conceptions => kən'sepʃnz
conceptual => kәn'septʃuәl
conceptual art => kənˈseptjuəl ɑ:t
conceptualise => kәn'septjjәlaiz
conceptualism => kәn'septʃuәlizm
conceptualist => kәn'septjjәlist
conceptualization => kәn,septjjәlai'zeiʃәn; -li'z-
conceptualize => kәn'septjuәlaiz
conceptualized => kənˈseptjuəlaizd
conceptualizes => kənˈseptjuəlaiziz
conceptualizing => kənˈseptjuəlaizɪŋ
conceptually => kәn'septʃuәli
conceptus => kәn'septәs
concern => kәn'sә:n
concerned => kәn'sә:nd
concernedly => kәn'sә:nidli
concerning => kәn'sә:niŋ
concernment => kәn'sә:nmәnt
concert => 'kɒnsәt
concert band => ˈkɔnsət bænd
concert grand => ˈkɔnsət ɡrænd
concert hall => ˈkɔnsət hɔ:l
concert party => ˈkɔnsət ˈpɑ:ti
concert pitch => ˈkɔnsət pitʃ
concertante => ,kɔntʃә'tænti
concerted => kәn'sә:tid
concertgoer => 'kɔnsәt,^әjә(r)
concertina => .kɒnsә'ti:nә
concertinaed => ,kɒnsə'tiːnə
concertinaing => ,kɒnsə'tiːnə
concertinas => ˌkɔnsəˈti:nəz
concerting => 'kɒnsət
concertino => 'kɔntʃeә'ti:nәu
concertize => 'kɔnsәtaiz
concertmaster => 'kɔnsәt,mɑ:stә(r)
concerto => kәn'tʃєәtәu
concerto grosso => '^rәjsәj
concerts => ˈkɔnsəts
concession => kәn'seʃәn
concessionaire => kәn,seʃә'neә
concessionaires => kənˌseʃəˈnɛəz
concessional => kәn'seʃәnl
concessionary => kәn'seʃәnәri
concessioner => kәn'seʃәnә(r)
concessions => kən'seʃənz
concessive => kәn'sesiv
conch => kɒŋk
concha => 'kɔŋkә
conchie => 'kɔntʃi
conchiolin => kɔŋ'kaiәlin
conchoid => 'kɔŋkɔid
conchoidal => kɒŋ'kɒidl
conchological => ,kɒŋkə'lɒdʒɪkəl
conchologist => kɒŋ'kɒlәdʒist
conchology => kɒŋ'kɒlәdʒi
concierge => ,kɔ:nsi'eәʒ
concierges => ˌkɔ:nsiˈɛəʒz
conciliar => kәn'siliә
conciliate => kәn'silieit
conciliated => kənˈsɪli:ˌeɪtid
conciliates => kənˈsɪli:ˌeɪts
conciliating => kənˈsɪli:ˌeɪtɪŋ
conciliation => kәn.sili'eiʃәn
conciliative => kәn'siliәtiv
conciliator => kәn'silieitә
conciliatory => kәn'siliәtәri
concinnity => kәn'siniti
concise => kәn'sais
concisely => kən'saɪslɪ
concision => kәn'siʒәn
conclave => 'kɒnkleiv
conclaves => ˈkɔnkleivz
conclude => kәn'klu:d
concluded => kənˈklu:did
concludes => kənˈklu:dz
concluding => kәn'klu:diŋ
conclusion => kәn'klu:ʒәn
conclusions => kənk'lu:ʒnz
conclusive => kәn'klu:siv
concoct => kәn'kɒkt
concocted => kənˈkɔktid
concocting => kənˈkɔktɪŋ
concoction => kәn'kɒkʃәn
concoctions => kənˈkɒkʃ(ə)nz
concocts => kənˈkɔkts
concomitance => kәn'kɒmitәns
concomitant => kәn'kɒmitәnt
concomitantly => kən'kɒmɪtəntlɪ
concomitants => kən'kɒmɪtənts
concord => 'kɒŋkɒ:d
concordance => kәn'kɒ:dәns
concordances => kən'kɔ:dənsɪz
concordant => kәn'kɒ:dәnt
concordat => kɔn'kɔ:dæt
concorde => kɔn'kɔ:d
concords => ˈkɔnˌkɔ:dz
concours => kjŋ'ku:әr
concourse => 'kɒŋkɒ:s
concourses => ˈkɔnˌkɔ:siz
concrescence => kɒn'kresns
concrete => 'kɒnkri:t
concrete jungle => ˈkɔnkri:t ˈdʒʌŋɡl
concrete poetry => ˈkɔnkri:t ˈpəuitri
concreted => 'kɒŋkriːt
concreteness => 'kɒnkri:tnɪs
concretes => ˈkɔnkri:ts
concreting => 'kɒŋkri:tɪŋ
concretion => kәn'kri:ʃәn
concretionary => kәn'kri:ʃәnәri
concretization => kɔn,kri:tai'zeiʃәn; -ti'z-
concretize => 'kɒnkri:taiz
concretized => kɔnˈkri(:)taizd
concretizes => kɔnˈkri(:)taiziz
concretizing => 'kɒnkri:taɪzɪŋ
concubinage => kɒn'kju:binidʒ
concubinary => kɔn'kju:bi,nәri
concubine => 'kɒŋkjubain
concubines => ˈkɔŋkjəˌbaɪnz
concupiscence => kәn'kju:pisәns
concupiscent => kәn'kju:pisәnt
concur => kәn'kә:
concurrence => kәn'kʌrәns
concurrent => kәn'kʌrәnt
concuss => kәn'kʌs
concussed => kənˈkʌst
concusses => kənˈkʌsiz
concussing => kənˈkʌsɪŋ
concussion => kәn'kʌʃәn
concussive => kәn'kʌsiv
condemn => kәn'dem
condemnable => kәm'demnәbl
condemnation => kɒndem'neiʃәn
condemnations => ˌkɔndemˈneɪʃənz
condemnatory => kәn'demnәtәri
condemned => kәn'demd
condemns => kənˈdemz
condensable => kәn'densәbl
condensate => kәn'deinseit
condensation => .kɒnden'seiʃәn
condense => kәn'dens
condensed => kәn'denst
condenser => kәn'densә
condensers => kənˈdensəz
condenses => kən'densɪz
condensing => kәn'densiŋ
condescend => .kɒndi'send
condescended => ˌkɔndɪˈsendid
condescending => .kɒndi'sendiŋ
condescendingly => ,kɔndi'sendiŋli
condescends => ˌkɔndɪˈsendz
condescension => .kɒndi'senʃәn
condign => kәn'dain
condignly => kən'daɪnlɪ
condiment => 'kɒndimәnt
condition => kәn'diʃәn
conditional => kәn'diʃәnl
conditionality => kәn.diʃә'næliti
conditionally => kәn'diʃәnәli
conditioned => kәn'diʃәnd
conditioned response => kənˈdiʃənd riˈspɔns
conditioner => kәn'diʃәnә
conditioners => kənˈdiʃənəz
conditioning => kәn'diʃәniŋ
condo => kәn'dәu
condole => kәn'dәul
condoled => kənˈdəʊld
condolence => kәn'dәulәns
condolences => kənˈdəʊlənsiz
condoles => kənˈdəʊlz
condoling => kənˈdəʊlɪŋ
condom => 'kɒndәm
condominium => .kɒndә'miniәm
condominiums => ˌkɒndə'mɪnɪəmz
condoms => 'kɒndɒmz
condon => 'kɔ ndәn
condonation => kɔndәu'neiʃәn
condone => kәn'dәun
condoned => kənˈdəʊnd
condones => kənˈdəʊnz
condoning => kənˈdəʊnɪŋ
condor => 'kɒndɒ:
condors => ˈkɔnˌdɔ:z
condottiere => ,kondo'tje:rә
conduce => kәn'dju:s
conduced => kənˈdu:st
conduces => kənˈdu:siz
conducing => kənˈdu:sɪŋ
conducive => kәn'dju:siv
conduct => 'kɔndʌkt, -dәkt
conductance => kәn'dʌktәns
conducted => kənˈdʌktɪd
conductible => kәn'dʌktәbl
conducting => kənˈdʌktɪŋ
conduction => kәn'dʌkʃәn
conductive => kәn'dʌktiv
conductive education => kənˈdʌktiv ˌedju:ˈkeiʃən
conductivity => .kɒndʌk'tiviti
conductor => kәn'dʌktә
conductors => kən'dʌktəz
conductress => kәn'dʌktris
conductresses => kən'dʌktris
conducts => kənˈdʌkts
conduit => 'kɒndit
conduits => ˈkɔndits
condylar => 'kɔndilә(r)
condyle => 'kɒndil
condyloid => 'kɔndilɔid
condyloma => ,kɔndi'lәumә
cone => kәun
coned => kəʊnd
coneflower => 'kәunflauә
cones => kәunz
coney => 'kәuni
confab => 'kɔnfæb
confabbed => ˈkɔnfæbd
confabbing => ˈkɔnfæbɪŋ
confabs => ˈkɔnfæbz
confabulate => kәn'fæbjuleit
confabulated => kən'fæbjʊleɪt
confabulates => kənˈfæbjuleits
confabulating => kənˈfæbjuleitɪŋ
confabulation => kәn.fæbju'leiʃәn
confabulatory => kənfæbjʊ'lətərɪ
confect => kәn'fekt
confected => kən'fekt
confecting => kən'fekt
confection => kәn'fekʃәn
confectionary => kәn'fekʃәnәri
confectioner => kәn'fekʃәnә
confectioners => kənˈfekʃənəz
confectionery => kәn'fekʃәnәri
confections => kənˈfekʃənz
confects => kən'fekt
confederacy => kәn'fedәrәsi
confederal => kәn'fedәrәl
confederate => kәn'fedәrit
confederates => kənˈfedərəts
confederation => kәn.fedә'reiʃәn
confederations => kənˌfedəˈreɪʃənz
confer => kәn'fә:
conferee => .kɒnfә'ri:
conferees => kɒnfə'riː
conference => 'kɒnfәrәns
conferment => kәn'fә:mәnt
conferrable => kәn'fә:rәbl
conferral => kәn'f\\\\:rәl
conferred => kənˈfə:d
conferring => kənˈfə:ɪŋ
confers => kənˈfə:z
confess => kәn'fes
confessant => kәn'fesәnt
confessed => kәn'fest
confessedly => kәn'fesidli
confesses => kənˈfesiz
confessing => kənˈfesɪŋ
confession => kәn'feʃәn
confessional => kәn'feʃәnl
confessionals => kənˈfeʃənəlz
confessionary => kәn'feʃәnәri
confessions => kən'feʃnz
confessor => kәn'fesә(r)
confessors => kənˈfesəz
confetti => kәn'feti
confidant => .kɒnfi'dænt
confidante => .kɒnfi'dænt
confidantes => ˌkɔnfiˈdænts
confidants => 'kɒnfɪdænts
confide => kәn'faid
confided => kənˈfaidid
confidence => 'kɒnfidәns
confidence man => ˈkɔnfidəns mæn
confidence trick => ˈkɔnfidəns trik
confidences => ˈkɔnfidənsiz
confident => 'kɒnfidәnt
confidential => .kɒnfi'denʃәl
confides => kənˈfaidz
confiding => kәn'faidiŋ
confidingly => kən'faɪdɪŋlɪ
configural => kɒn'fɪɡjʊrəl
configuration => kәn.figju'reiʃәn
configure => kәn'figә
configures => kənˈfiɡəz
confine => kәn'fain
confined => kәn'faind
confinement => kәn'fainmәnt
confinements => kənˈfaɪnmənts
confines => kәn'fains
confining => kәn'fainiŋ
confirm => kәn'fә:m
confirmand => 'kɒnfәmænd
confirmation => .kɒnfә'meiʃәn
confirmations => ˌkɔnfəˈmeɪʃənz
confirmative => kәn'f\\\\:mәtiv
confirmatory => kәn'f\\\\:mәtәri
confirmed => kәn'fә:md
confirming => kənˈfə:mɪŋ
confirms => kənˈfə:mz
confiscate => 'kɒnfiskeit
confiscated => ˈkɔnfiskeitid
confiscates => ˈkɔnfiskeits
confiscation => kɒnfis'keiʃәn
confiscator => .kɒnfis'keitә
confiscatory => kәn'fiskәtәri
confit => kɒn'fɪt
conflagration => .kɒnflә'greiʃәn
conflagrations => kɒnfləɡ'reɪʃnz
conflate => kәn'fleit
conflated => kən'fleɪt
conflates => kən'fleɪt
conflating => kən'fleɪt
conflation => kәn'fleiʃәn
conflict => 'kɒnflikt
conflicted => kənˈflɪktɪd
conflicting => kәn'fliktiŋ
conflictive => kən'flɪktɪv
conflicts => ˈkɔnflikts
confluence => 'kɒnfluәns
confluences => ˈkɔnflu:ənsiz
confluent => 'kɒnfluәnt
conflux => 'kɔnflʌks
confocal => kɔn'fәukl
conform => kәn'fɒ:m
conformability => kәn.fɒ:mә'biliti
conformable => kәn'fɒ:mәbl
conformably => kәn'fɒ:mәbli
conformal => kәn'fɒ:mәl
conformance => kәn'fɒ:mәns
conformation => .kɒnfɒ:'meiʃәn
conformational => ,kɔnfɔ:'meiʃәnәl
conformed => kənˈfɔ:md
conformism => kәn'fɔ:mizәm
conformist => kәn'fɒ:mist
conformists => kənˈfɔ:mists
conformity => kәn'fɒ:miti
conforms => kənˈfɔ:mz
confound => kәn'faund
confounded => kәn'faundid
confoundedly => kәn'fajndidli
confounds => kənˈfaʊndz
confraternities => ˌkɔnfrəˈtə:nitiz
confraternity => .kɒnfrә'tә:niti
confrere => 'kɔnfreә
confront => kәn'frʌnt
confrontation => .kɔnfrʌn'teiʃәn
confrontational => ˌkɒnfrʌnˈteɪʃnl
confrontations => kɒnfrʌn'teɪʃnz
confronted => kənˈfrʌntid
confronting => kənˈfrʌntɪŋ
confronts => kənˈfrʌnts
Confucian => kәn'fju:ʃ(ә)n
Confucianism => kәn'fju:ʃjәnizm
Confucius => kәn'fju:ʃjәs
confusable => kәn'fju:zәbl
confuse => kәn'fju:z
confused => kәn'fju:zd
confusedly => kәn'fju:zidli
confuses => kənˈfju:ziz
confusion => kәn'fju:ʒәn
confutation => .kɒnfju:'teiʃәn
confute => kәn'fju:t
confuted => kənˈfju:tid
confutes => kənˈfju:ts
confuting => kənˈfju:tɪŋ
cong => kɔŋ
conga => 'kɒŋgә
congaed => 'kɒŋgə
congaing => 'kɒŋgə
congas => ˈkɔnɡəz
congeal => kәn'dʒi:l
congealed => kənd'ʒi:ld
congealment => kənd'ʒi:lmənt
congeals => kənˈdʒi:lz
congee => 'kɒndʒi:
congeed => ˈkɔndʒi:d
congeeing => ˈkɔndʒi:ɪŋ
congees => ˈkɔndʒi:z
congelation => .kɒndʒi'leiʃәn
congener => 'kɒndʒinә
congeneric => .kɒndʒi'nerik
congenerous => kәn'dʒenәrәs
congenial => kәn'dʒi:njәl
congeniality => kәn.dʒi:ni'æliti
congenially => kən'dʒi:nɪəlɪ
congenital => kәn'dʒenitәl
congenitally => kən'dʒenɪtəlɪ
conger => 'kɔŋә(r)
conger eel => ˈkɔŋə i:l
congeries => kɔn'dʒiәri:z
congery => 'kɔndʒәri
congest => kәn'dʒest
congested => kәn'dʒestid
congestion => kәn'dʒestʃәn
congestive => kәn'dʒestiv
congius => 'kɔndʒiәs
conglobulate => kәn'^lɔbjjleit
conglomerate => kәn'glɒmәrit
conglomerated => kən'glɒm(ə)rət
conglomerates => kənˈglɔməˌreɪts
conglomerating => kən'glɒm(ə)rət
conglomeration => kәnglɒmә'reiʃәn
conglomerations => kɔnˌɡlɔməˈreiʃənz
Congo => 'kɔŋ^әu
Congolese => ,kɔŋ^ә'li:z
congrats => kәn'græts
congratulate => kәn'grætʃәleit
congratulated => kənˈɡrætjuleitid
congratulates => kənˈɡrætjuleits
congratulating => kənˈɡrætjuleitɪŋ
congratulation => kәn.grætʃә'leiʃәn
congratulator => kәn'grætʃәleitә
congratulatory => kәn'grætʃәlәtәri
congregant => 'kɔŋ^ri^әnt
congregate => 'kɒŋgrigeit
congregated => ˈkɔŋɡriɡeitid
congregates => ˈkɔŋɡriɡeits
congregating => ˈkɔŋɡriɡeitɪŋ
congregation => .kɒŋgri'geiʃәn
congregational => .kɒŋgri'geiʃәnl
Congregationalist => ,kɔŋ^ri'^eiʃәnәlist
congregations => ˌkɔŋgrɪˈgeɪʃənz
congress => 'kɒŋgres
congresses => ˈkɔŋɡresiz
congressional => kәn'greʃәnl
congressman => 'kɒŋgresmәn
congressperson => 'kɔn^res,p\\\\:sәn
congresswoman => 'kɒŋgreswumәn
Congreve => 'kɔŋ^ri:v
congruence => 'kɒŋgruәns
congruency => 'kɒŋgruәnsi
congruent => 'kɒŋgruәnt
congruity => kәŋ'gru:iti
congruous => 'kɒŋgruәs
congruously => 'kɒŋɡrʊəslɪ
conic => 'kɒnik
conic section => ˈkɔnik ˈsekʃən
conical => 'kɔnikәl
conical projection => ˈkɔnɪkəl prəˈdʒekʃən
conically => 'kɒnɪklɪ
conics => 'kɒniks
conidiophore => kәu'nidiәfɔ:
conidium => kәu'nidiәm
conifer => 'kɒnifә
coniferous => kәu'nifәrәs
conifers => 'kɒnɪfəz
coniform => 'kәunifɒ:m
coniine => 'kәunii:n, -in
conjecturable => kәn'dʒektʃәrәbl
conjectural => kәn'dʒektʃәrәl
conjecture => kәn'dʒektʃә
conjectured => kənˈdʒektʃəd
conjectures => kənˈdʒektʃəz
conjecturing => kənˈdʒektʃərɪŋ
conjoin => kәn'dʒɒin
conjoined => kәn'dʒɔind
conjoining => kənd'ʒɔɪnɪŋ
conjoins => kənˈdʒɔinz
conjoint => kәn'dʒɒint
conjointly => kən'dʒɔɪntlɪ
conjugacy => 'kɔndʒu^әsi
conjugal => 'kɒndʒugәl
conjugal rights => ˈkɔndʒəgəl raits
conjugality => .kɒndʒu'gæliti
conjugate => 'kɒndʒugeit
conjugated => 'kɔndʒj^eitid
conjugates => 'kɒndʒʊɡeɪts
conjugation => .kɒndʒu'geiʃәn
conjunct => kәn'dʒʌŋkt
conjunction => kәn'dʒʌŋkʃәn
conjunctional => kənd'ʒʌŋkʃənl
conjunctiva => .kɒndʒʌŋk'taivә
conjunctive => kәn'dʒʌŋktiv
conjunctivitis => kәn,dʒʌŋkti'vaitis
conjuncture => kәn'dʒʌŋktʃә
conjuration => ,kɔndʒuә'reiʃәn
conjure => 'kʌndʒә
conjured => ˈkɔndʒəd
conjurer => 'kʌndʒәrә(r)
conjurers => ˈkɔndʒəəz
conjures => ˈkɔndʒəz
conjuring => 'kʌndʒәriŋ
conjuror => 'kʌndʒәrә(r)
conk => kɒŋk
conker => 'kɔŋkә
conkers => 'kɒŋkәz
conking => kɔŋkɪŋ
conks => kɔŋks
conn => kɒn
Connacht => 'kɔnɔ:t
connate => 'kɒneit
connatural => kә'nætʃәrәl
connect => kә'nekt
connected => kә'nektid
connectedly => kə'nektɪdlɪ
Connecticut => kә'netikәt
connecting => kә'nektiŋ
connection => kә'nekʃәn
connective => kә'nektiv
connectivity => kәnek'tiviti
connector => kә'nektә
connects => kəˈnekts
conned => kɔnd
Conner => 'kɔnә
connexion => kә'nekʃәn
connie => 'kɔni
conning => kɔnɪŋ
conning tower => 'kɔniŋ
conniption => kә'nipʃәn
connivance => kә'naivәns
connive => kә'naiv
connived => kəˈnaɪvd
connives => kəˈnaɪvz
conniving => kəˈnaɪvɪŋ
connoisseur => .kɒnә'sә:
connoisseurs => ˌkɔnəˈsɜ:z
connoisseurship => ,kɔnә's\\\\:ʃip
connotation => .kɒnәu'teiʃәn
connotations => kɒnə'teɪʃnz
connotative => 'kɔnәuteitiv, kә'nәutәtiv
connote => kɔ'nәut
connoted => kəˈnəʊtid
connotes => kəˈnəʊts
connoting => kəˈnəʊtɪŋ
connubial => kә'nju:bjәl
connubiality => kә.nju:bi'æliti
connubially => kәˊnjuːbjәli
conodont => 'kәunәdɔnt, 'kɔnә-
conoid => 'kәunɒid
conquer => 'kɒŋkә
conquerable => 'kɒŋkәrәbl
conquered => ˈkɔŋkəd
conquering => ˈkɔŋkərɪŋ
conqueror => 'kɒŋkәrә
conquerors => ˈkɔŋkɵrəz
conquers => ˈkɔŋkəz
conquest => 'kɒŋkwest
conquests => ˈkɔŋkwests
conquistador => kɒn'kwistәdɒ:
conrad => 'kɔnræd
Conroy => 'kɔnrɔi
consanguine => kɔn'sæŋ^win
consanguineous => .kɒnsæŋ'gwiniәs
consanguinity => .kɒnsæŋ'gwiniti
conscience => 'kɒnʃәns
conscience money => ˈkɔnʃəns ˈmʌni
conscience-stricken => ˈkɑnʃəns ˈstrɪkən
conscienceless => 'kɒnʃәnslis
consciences => ˈkɔnʃənsiz
conscientious => .kɒnʃi'enʃәs
conscientiousness => ˌkɒnʃɪ'enʃəsnɪs
conscious => 'kɒnʃәs
consciousness => 'kɒnʃәsnis
consciousness-raising => 'kɔnʃәsnis,reiziŋ
consciousnesses => ˈkɔnʃəsnɪsiz
conscript => 'kɒnskript
conscripted => ˈkɔnˌskrɪptid
conscripting => ˈkɔnˌskrɪptɪŋ
conscription => kәn'skripʃәn
conscripts => ˈkɔnˌskrɪpts
consecrate => 'kɒnsikreit
consecrated => 'kən(t)səˌkrətɪd
consecrates => ˈkɔnsɪˌkreɪts
consecrating => ˈkɔnsɪˌkreɪtɪŋ
consecration => .kɒnsi'kreiʃәn
consecratory => 'kɒnsikrәtәri
consecutive => kәn'sekjutiv
consecutively => kən'sekjətɪvlɪ
consensual => kәn'sensjuәl
consensually => kən'senʃuəli
consensus => kәn'sensәs
consent => kәn'sent
consented => kənˈsentid
consentient => kәn'senʃәnt
consents => kənˈsents
consequence => 'kɒnsikwәns
consequences => ˈkɔnsikwənsiz
consequent => 'kɒnsikwәnt
consequential => ,kɔnsi'kwenʃәl
consequentiality => -ʃi'æliti
consequentially => ˌkɑ:nsɪ'kwenʃəlɪ
consequently => 'kɒnsikwәntli
conservancy => kәn'sә:vәnsi
conservation => .kɒnsә'veiʃәn
conservational => kɒnsə'veɪʃənəl
conservationist => ,kәnsә'veiʃәnist
conservationists => ˌkɔnsɜ:ˈveɪʃənɪsts
conservatism => kәn'sә:vәtizәm
Conservative => kәn'sә:vәtiv
conservatively => kən'sɜ:vətɪvlɪ
conservativeness => kən'sɜ:vtɪvnɪs
conservatoire => kәn'sә:vәtwɑ:
conservator => 'kɒnsәveitә
conservatories => kənˈsɜ:vəˌtɔ:ri:z
conservatorium => kәn,s\\\\:vә'tɔ:riәm
conservatory => kәn'sә:vәtәri
conserve => kәn'sә:v
conserves => kənˈsə:vz
consider => kәn'sidŋ
considerable => kәn'sidәrәbl
considerably => kәn'sidәrәbli
considerate => kәn'sidәrit
considerately => kən'sɪdərətlɪ
considerateness => kәnˊsidәritnis
consideration => kәn.sidә'reiʃәn
considerations => kənsɪdə'reɪʃnz
considered => kәn'sidәd
considering => kәn'sidәriŋ
considers => kənˈsɪdəz
consigliere => kɒnsɪ'lɪərə
consign => kәn'sain
consigned => kənˈsaɪnd
consignee => .kɒnsai'ni:
consigning => kənˈsaɪnɪŋ
consignment => kәn'sainmәnt
consignments => kənˈsaɪnmənts
consignor => kәn'sainә
consigns => kənˈsaɪnz
consilience => kɒn'siliәns
consilient => kɒn'siliәnt
consist => kәn'sist
consisted => kənˈsistid
consistencies => kənˈsɪstənsi:z
consistency => kәn'sistәnsi
consistent => kәn'sistәnt
consisting => kənˈsistɪŋ
consistorial => .kɒnsi'stɒ:riәl
consistory => kәn'sistәri
consists => kənˈsists
consociation => kәn.sәusi'eiʃәn
consol => 'kɔnsәl
consolable => kәn'sәulәbl
consolation => .kɒnsә'leiʃәn
consolation prize => ˌkɔnsəˈleɪʃən praiz
consolatory => kәn'sɒlәtәri
console => kәn'sәul
console table => kənˈsəul ˈteibl
consoled => kən'səʊl
consoles => kənˈsəulz
consolidate => kәn'sɒlideit
consolidated => kәn'sɔlideitid
consolidates => kənˈsɔlideits
consolidating => kənˈsɔlideitɪŋ
consolidation => kәn.sɒli'deiʃәn
consolidations => kənˌsɔlɪˈdeɪʃənz
consolidator => kәn'sɔlideitә
consols => 'kɒnsәlz
consomme => kәn'sɔmei
consonance => 'kɒnsәnәns
consonant => 'kɒnsәnәnt
consonantal => .kɒnsә'næntl
consonants => ˈkɔnsənənts
consort => 'kɒnsɒ:t
consorted => ˈkɔnˌsɔ:tid
consortia => kən'sɒti:əm
consorting => ˈkɔnˌsɔ:tɪŋ
consortium => kәn'sɒ:tjәm
consortiums => kənˈsɔ:ti:əmz
consorts => ˈkɔnˌsɔ:ts
conspecific => ,kɔnspi'sifik
conspectus => kәn'spektәs
conspicuity => ,kɔnspi'kju:әti
conspicuous => kәn'spikjuәs
conspicuously => kən'spɪkjʊəslɪ
conspicuousness => kәnˊspikjuәsnis
conspiracies => kənˈspirəsiz
conspiracy => kәn'spirәsi
conspiracy theory => kənˈspirəsi ˈθiəri
conspirator => kәn'spirәtә
conspiratorial => kәn.spirә'tɒ:riәl
conspirators => kənˈspɪərətəz
conspire => kәn'spaiә
conspired => kənˈspaiəd
conspires => kənˈspaiəz
conspiring => kənˈspaiərɪŋ
constable => 'kʌnstәbl
constables => ˈkɔnstəbəlz
constabularies => kənˈstæbjʊləri:z
constabulary => kәn'stæbjulәri
constance => 'kɔnstәns
constancy => 'kɒnstәnsi
constant => 'kɒnstәnt
constantan => 'kɒnstәntæn
Constantine => 'kɔnstәntain
Constantinople => ,kɔnstænti'nәupl
constantly => 'kɒnstәntli
constative => kәn'steitiv
constellate => 'kɒnstәleit
constellated => ˈkɔnstəleitid
constellates => ˈkɔnstəleits
constellating => ˈkɔnstəleitɪŋ
constellation => .kɒnstә'leiʃәn
consternate => 'kɒnstәneit
consternation => .kɒnstә'neiʃәn
constipate => 'kɒnstipeit
constipated => 'kɔnstipeitid
constipates => ˈkɔnstipeits
constipating => ˈkɔnstipeitɪŋ
constipation => .kɒnsti'peiʃәn
constituencies => kənˈstɪtʃu:ənsi:z
constituency => kәn'stitjuәnsi
constituent => kәn'stitjuәnt
constitute => kәn'stitjut
constituted => ˈkɔnstitju:tid
constituting => ˈkɔnstitju:tɪŋ
constitution => .kɒnsti'tju:ʃәn
constitutional => .kɒnsti'tju:ʃәnl
constitutionalism => ,kɔnsti'tju:ʃәnәlizәm
constitutionalist => -ist
constitutionality => 'kɔnsti,tju:ʃә'nælәti
constitutionalize => ,kɔnsti'tju: ʃәnәlaiz
constitutionalized => ,kɔnsti'tu:ʃənəlaiz
constitutionalizing => ,kɔnsti'tu:ʃənəlaiz
constitutionally => ,kɔnsti'tju:ʃәnәli
constitutions => kɒnstɪt'ju:ʃnz
constitutive => 'kɔnstitju:tiv
constrain => kәn'strein
constrained => kәn'streind
constrainedly => kәn'streinidli
constraining => kənˈstreinɪŋ
constrains => kənˈstreinz
constraint => kәn'streint
constraints => kən'streɪnt
constrict => kәn'strikt
constricted => 'kənstriktid
constricting => kənst'rɪktɪŋ
constriction => kәn'strikʃәn
constrictions => kənˈstrɪkʃənz
constrictive => kәn'striktiv
constrictor => kәn'striktә
constricts => kənˈstrikts
construable => kәn'stru:әbl
construal => kәn'stru:әl
construct => kәn'strʌkt
constructed => kənˈstrʌktid
construction => kәn'strʌkʃәn
construction paper => kənˈstrʌkʃən ˈpeipə
construction site => kənˈstrʌkʃən sait
constructional => kәn'strʌkʃәnl
constructionism => kәn'strʌkʃәnizәm
constructionist => kәn'strʌkʃәnist
constructive => kәn'strʌktiv
constructiveness => kənst'rʌktɪvnəs
constructivism => kәn'strʌktivizm
constructivist => kәn'strʌktivist
constructor => kәn'strʌktә
construe => kәn'stru:
construed => kənˈstru:d
construes => kənˈstru:z
construing => kənˈstru:ɪŋ
consubstantial => .kɒnsәb'stænʃәl
consubstantiality => ,kɔnsәb,stænʃi'æliti
consubstantiation => kɔnsәb'stænʃ(ә)n
consuetude => 'kɒnswitju:d
consuetudinary => ,kɔnswi'tju:dinәri
consul => 'kɒnsәl
consular => 'kɒnsjulә
consulate => 'kɒnsjulit
consulates => ˈkɔnsjulits
consuls => ˈkɔnsəlz
consulship => 'kɒnsәlʃip
consult => kәn'sʌlt
consultancies => kənˈsʌltnsi:z
consultant => kәn'sʌltәnt
consultants => kən'sʌltənts
consultation => .kɒnsәl'teiʃәn
consultations => ˌkɔnsəlˈteɪʃənz
consultative => kәn'sʌltәtiv
consulted => kənˈsʌltid
consultee => ,kɔnsʌl'ti:
consulting => kәn'sʌltiŋ
consults => kənˈsʌlts
consumable => kәn'sju:mәbl
consume => kәn'sju:m
consumer => kәn'sju:mә
consumer research => kənˈsju:mə riˈsə:tʃ
consumerism => kәn'sju:mәrizm
consumerist => kən'su:mərɪst
consumeristic => kən,su:mə'ristik
consumes => kənˈsju:mz
consuming => kәn'su:miŋ
consumingly => kən'sju:mɪŋlɪ
consummate => 'kɒnsәmeit
consummated => ˈkɔnsəˌmeɪtid
consummately => 'kɑnsəmɪtli
consummates => ˈkɔnsəˌmeɪts
consummating => ˈkɔnsəˌmeɪtɪŋ
consummation => .kɒnsә'meiʃәn
consummator => 'kɔnsʌmeitә
consummatory => kənˈsʌmətəri
consumption => kәn'sʌmpʃәn
consumptive => kәn'sʌmptiv
consumptives => kən'sʌm(p)tɪv
contact => 'kɒntækt
contact lens => ˈkɔntækt lenz
contact print => ˈkɔntækt print
contact sport => ˈkɔntækt spɔ:t
contacted => ˈkɔntæktid
contactee => ,kɔntæk'ti:
contactless => 'kɔntæktlis
contadina => kɔntә'di:nә
contadino => kɔntә'di:no
contagion => kәn'teidʒәn
contagious => kәn'teidʒәs
contagiously => kən'teɪdʒəslɪ
contagiousness => kən'teɪdʒəsnes
contain => kәn'tein
contained => kәn'teind
container => kәn'teinә
container ship => kənˈteinə ʃip
containerization => kәn,teinәrai'zeiʃәn; -ri'z-
containerize => kәn'teinәraiz
containerized => kənˈteɪnəraɪzd
containerizes => kənˈteinəraiziz
containerizing => kənˈteinəraizɪŋ
containment => kәn'teinmәnt
containments => kən'teɪnm(ə)nt
contaminant => kәn'tæminәnt
contaminants => kən'tæmɪnənts
contaminate => kәn'tæmineit
contaminated => kәn'tæmineitid
contaminates => kənˈtæmineits
contaminating => kənˈtæmineitɪŋ
contamination => kәn.tæmi'neiʃәn
contaminator => kәn'tæmineitә
contango => kәn'tæŋgәu
conte => kuŋt
contemn => kәn'tem
contemned => kənˈtemd
contemning => kənˈtemɪŋ
contemns => kənˈtemz
contemplate => 'kɒntempleit
contemplates => ˈkɔntempleits
contemplating => ˈkɔntempleitɪŋ
contemplation => .kɒntem'pleiʃәn
contemplative => 'kɒntempleitiv
contemplator => 'kɔntempleitә
contemporaneity => kәn,tempәrә'ni:iti
contemporaneous => kәn.tempә'reinjәs
contemporaneously => kənˌtempə'renɪəslɪ
contemporary => kәn'tempәrәri
contempt => kәn'tempt
contemptible => kәn'temptibl
contemptibly => kən'temptəblɪ
contemptuous => kәn'temptʃuәs
contend => kәn'tend
contended => kənˈtendid
contender => kәn'tendә(r)
contenders => kənˈtendəz
contends => kənˈtendz
content => kәn'tent
contented => kәn'tentid
contentedness => kәnˊtentidnis
contention => kәn'teinʃәn
contentions => kən'tenʃnz
contentious => kәn'tenʃәs
contentment => kәn'tentmәnt
contents => 'kɒntents
conterminous => kɔn'tә:minәs
conterminously => kən'tə:minəsli
contessa => kɔn'tesә
contest => 'kɒntest
contestable => kәn'testәbl
contestant => kәn'testәnt
contestants => kənˈtestənts
contestation => kɒntes'teiʃәn
contested => kənˈtestid
contests => kənˈtests
context => 'kɒntekst
contexts => 'kɒnteksts
contextual => kɒn'tekstjuәl
contextualise => kən'tekstjuəlaiz
contextualization => kənˌtekstʃuəlaɪ'zeɪʃn
contextualize => kɔn'tekstjjәlaiz
contextually => kən'tekstju:əli
contig => kən'tɪɡ
contiguity => .kɒnti'gju:iti
contiguous => kәn'tigjuәs
continence => 'kɒntinәns
continent => 'kɒntinәnt
continental => .kɒnti'nentl
continental breakfast => ˌkɔntəˈnentl ˈbrekfəst
continentals => ˌkɔntəˈnentlz
continently => 'kɒntɪnəntlɪ
continents => ˈkɔntinənts
contingency => kәn'tindʒәnsi
contingency plan => kənˈtɪndʒənsi: plæn
contingent => kәn'tindʒәnt
contingently => kən'tɪndʒəntlɪ
contingents => kənˈtindʒənts
continua => kәn'tinjjә
continual => kәn'tinjuәl
continually => kәn'tinjuәli
continuance => kәn'tinjuәns
continuant => kәn'tinjuәnt
continuation => kәn.tinju'eiʃәn
continuations => kənˌtɪnju:ˈeʃənz
continuative => kәn'tinjuәtiv
continuator => kәn'tinjuәtә
continue => kәn'tinju:
continued => kәn'tinju:d
continued fraction => kənˈtinju:d ˈfrækʃən
continuing => kәn'tinjuiŋ
continuing education => kənˈtinjuiŋ ˌedju:ˈkeiʃən
continuities => ˌkɔntiˈnjuitiz
continuity => .kɒnti'nju:iti
continuo => kәn'tinjuәu
continuous => kәn'tinjuәs
continuous assessment => kənˈtinjuəs əˈsesmənt
continuous stationery => kənˈtinjuəs ˈsteiʃənəri
continuously => kәn'tinjuәsli
continuum => kәn'tinjuәm
contort => kәn'tɒ:t
contorted => kәn'tɔ:tid
contorting => kənˈtɔ:tɪŋ
contortion => kәn'tɒ:ʃәn
contortionist => kәn'tɔ:ʃәnist
contortionists => kənˈtɔ:ʃənists
contorts => kənˈtɔ:ts
contour => 'kɒntuә
contour feather => ˈkɔnˌtʊə ˈfeðə
contoured => 'kɔntuәd
contouring => kәn'tuәriŋ
contours => ˈkɔnˌtʊəz
contra => 'kɒntrә
contraband => 'kɒntrәbænd
contrabandist => 'kɔntrә,bændist
contrabass => 'kɒntrәbeis
contrabassoon => .kɒntrәbә'su:n
contraception => .kɒntrә'sepʃәn
contraceptive => .kɒntrә'septiv
contraceptives => kɒntrə'septɪvz
contract => 'kɒntrækt
contractable => kən'træktəbl
contracted => kәn'træktid
contractible => kәn'træktәbl
contractile => kәn'træktail
contractility => .kɒntræk'tiliti
contracting => 'kɔntræktiŋ
contraction => kәn'trækʃәn
contractionary => kənt'rækʃənrɪ
contractions => kənˈtrækʃənz
contractive => kәn'træktiv
contractor => 'kɒntræktә
contractors => kɒnt'ræktəz
contracts => kənˈtrækts
contractual => kәn'træktʃuәl
contractural => kənt'ræktʃərəl
contracture => kәn'træktʃә
contradance => 'kɔntrәdɑ:ns
contradict => .kɒntrә'dikt
contradicted => ˌkɔntrəˈdiktid
contradicting => ˌkɔntrəˈdiktɪŋ
contradiction => .kɒntrә'dikʃәn
contradictions => kɒntrə'dɪkʃnz
contradictories => ˌkɔntrəˈdɪktəri:z
contradictorily => .kɒntrә'diktәrili
contradictoriness => kɒntrədɪk'tərɪnɪs
contradictory => .kɒntrә'diktәri
contradicts => ˌkɔntrəˈdikts
contradistinction => ,kɔntrәdis'tiŋkʃәn
contradistinguish => ,kɔntrәdis'tiŋ^wiʃ
contradistinguished => ˌkɔntrədisˈtiŋɡwiʃt
contradistinguishes => ˌkɔntrədisˈtiŋɡwiʃiz
contradistinguishing => ˌkɔntrədisˈtiŋɡwiʃɪŋ
contrafactual => ,kɔntrә'fæktʃjәl
contraflow => 'kɔntrәflәu
contrail => 'kɒntreil
contraindicate => kɔntrә'indikeit
contraindicated => kɔntrəˈindikeitid
contraindicates => kɔntrəˈindikeits
contraindicating => kɔntrəˈindikeitɪŋ
contraindication => 'kɔntrә,indi'keiʃәn
contralateral => ,kɔntrә'lætәrәl
contralto => kәn'træltәu
contraltos => kənˈtræltəʊz
contraposition => .kɒntrәpә'ziʃәn
contrapositive => ,kɔntrә'pɔzәtiv
contrapposto => ,kɔntrә'pɔstә
contraption => kәn'træpʃәn
contraptions => kənˈtræpʃənz
contrapuntal => .kɒntrә'pʌntl
contrapuntally => ,kɔntrə'pʌntəl
contrapuntist => .kɒntrә'pʌntist
contrarian => kənt'reərɪən
contraries => ˈkɔntrəriz
contrarieties => ˌkɔntrəˈraiətiz
contrariety => .kɒntrә'raiәti
contrarily => 'kɒntrәrili
contrariness => 'kɒntrәrinis
contrariwise => 'kɒntrәriwaiz
contrary => 'kɒntrәri
contras => 'kɔntrәz
contrast => kәn'træst
contrasted => ˈkɔntræstid
contrasting => kənˈtrɑ:stɪŋ
contrastive => kɔn'trɑ:stiv, -'træ-
contrasts => ˈkɔntræsts
contrasty => 'kɒntrɑ:sti
contravene => ,kɔntrә'vi:n
contravened => ˌkɔntrəˈvi:nd
contravenes => ˌkɔntrəˈvi:nz
contravening => ˌkɔntrəˈvi:nɪŋ
contravention => .kɒntrә'venʃәn
contredanse => 'kɔntrә,dɑ:ns, -dæns
contretemps => 'kɔ:ntrәtә:ŋ
contribute => kәn'tribju:t
contributes => kənˈtribjuts
contribution => .kɒntri'bju:ʃәn
contributive => kәn'tribjutiv
contributor => kәn'tribjutә
contributories => kən'trɪbjʊt(ə)rɪ
contributors => kənt'rɪbju:təz
contributory => kәn'tribjutәri
contrite => 'kɒntrait
contritely => 'kɔntraitli
contrition => kәn'triʃәn
contrivable => kәn'traivәbl
contrivance => kәn'traivәns
contrivances => kənˈtraivənsiz
contrive => kәn'traiv
contrived => kәn'traivd
contriver => kәn'traivә
contrives => kənˈtraivz
contriving => kənˈtraivɪŋ
control => kәn'trәul
control key => kənˈtrəul ki:
control tower => kənˈtrəul ˈtauə
controllable => kәn'trәulәbl
controlled => kәn'trәuld
controlled substance => kənˈtrəuld ˈsʌbstəns
controller => kәn'trәulә
controllers => kənt'rəʊləz
controllership => kənt'rəʊləʃɪp
controversial => .kɒntrә'vә:ʃәl
controversialist => ,kɔntrә'v\\\\:ʃәlist
controversially => ,kɔntrə'və:ʃəli
controversies => ˈkɔntrəvə:siz
controversy => 'kɒntrәvә:si
controvert => 'kɒntrәvә:t
controverted => ˈkɔntrəˌvɜ:tid
controvertible => .kɒntrә'vә:tibl
controverting => ˈkɔntrəˌvɜ:tɪŋ
controverts => ˈkɔntrəˌvɜ:ts
contumacious => .kɒntju:'meiʃәs
contumacy => 'kɒntjumәsi
contumelious => .kɒntju'mi:ljәs
contumely => 'kɒntju:mili
contuse => kәn'tju:z
contused => kənˈtu:zd
contuses => kənˈtu:ziz
contusing => kənˈtu:zɪŋ
contusion => kәn'tju:ʒәn
contusions => kənt'ju:ʒnz
conundrum => kә'nʌndrәm
conundrums => kəˈnʌndrəmz
conurbation => .kɒnә:'beiʃәn
conurbations => ˌkɔnəˈbeiʃənz
conure => 'kɔnjә
convalesce => .kɒnvә'les
convalesced => ˌkɔnvəˈlest
convalescence => .kɒnvә'lesns
convalescent => ,kɔnvә'lesnt
convalescents => ˌkɔnvəˈlesɵnts
convalesces => ˌkɔnvəˈlesiz
convalescing => ˌkɔnvəˈlesɪŋ
convect => kәn'vekt
convected => kənˈvektid
convecting => kənˈvektɪŋ
convection => kәn'vekʃәn
convectional => kәn'vekʃәnәl
convective => kәn'vektiv
convector => kәn'vektә
convectors => kən'vektə
convects => kənˈvekts
convenable => kәn'vi:nәbl
convenance => 'kɔ:ŋvinә:ns
convene => kәn'vi:n
convened => kənˈvi:nd
convener => kәn'vi:nә(r)
conveners => kənˈvi:nəz
convenes => kənˈvi:nz
convenience => kә'vi:njәns
convenience food => kənˈvi:njəns fu:d
conveniences => kәn'vi:njәnsis
conveniency => kәn'vi:njәnsi
convenient => kәn'vi:njәnt
convening => kənˈvi:nɪŋ
convenors => kən'vi:nə
convent => 'kɒnvәnt
convent school => ˈkɔnvənt sku:l
conventicle => kәn'ventikl
convention => kәn'venʃәn
conventional => kәn'venʃәnl
conventionalism => kәn'venʃәnәlizәm
conventionalist => kәn'venʃәnәlist
conventionalities => kənˌvenʃəˈnælɪti:z
conventionality => kәn,venʃә'næliti
conventionalize => kәn'venʃәnlaiz
conventionalized => kənˈvenʃənəlaizd
conventionalizes => kənˈvenʃənəlaiziz
conventionalizing => kən'venʃənəlaɪz
conventionally => kәn'venʃәnәli
conventioneer => kәn,venʃә'niә
convents => ˈkɔnvənts
conventual => kәn'ventjuәl
converge => kәn'vә:dʒ
convergence => kәn'vә:dʒәns
convergences => kən'vɜ:dʒənsɪz
convergent => kәn'vә:dʒәnt
converges => kənˈvə:dʒz
converging => kәn'vә:dʒiŋ
conversance => kɒn'vә:sәns
conversant => kәn'vә:sәnt
conversation => .kɒnvә'seiʃәn
conversation piece => ˌkɔnvəˈseiʃən pi:s
conversational => .kɒnvә'seiʃәnl
conversationalists => ˌkɔnvəˈseɪʃənəlɪsts
conversationally => ˌkɒnvə'seɪʃənlɪ
conversations => ˌkɔnvəˈseiʃənz
conversazione => .kɒnvәsætsi'әuni
converse => kәn'vә:s
conversed => kənˈvə:st
conversely => 'kɔnv\\\\:sli
converses => kənˈvə:siz
conversing => kənˈvə:sɪŋ
conversion => kәn'vә:ʃәn
conversions => kən'vɜ:ʃnz
convert => kәn'vә:t
converted => kәn'vә:tid
converter => kәn'v\\\\:tә(r)
convertibility => kәn.vә:tә'biliti
convertible => kәn'vә:tәbl
convertibles => kən'vɜ:təblz
converting => kәn'vә:tiŋ
convertor => kәn'vә:tә
convertors => kən'və:tə
converts => kənˈvə:ts
convex => 'kɒnveks
convexities => kɔnˈveksitiz
convexity => kɒn'veksiti
convexly => kɒn'vekslɪ
convexo-concave => kɔn'veksәu'kɔnkeiv
convexo-convex => kɔn'veksәu'kɔnveks
convey => kәn'vei
conveyable => kәn'veiәbl
conveyance => kәn'veiәns
conveyancer => kәn'veiәnsә
conveyances => kənˈveɪənsiz
conveyancing => kәn'veiәnsiŋ
conveyed => kənˈveid
conveying => kәn'veiiŋ
conveyors => kən'veɪəz
conveys => kənˈveiz
convict => kәn'vikt
convicted => kən'vɪktɪd
convicting => kənˈviktɪŋ
conviction => kәn'vikʃәn
convictions => kənˈvikʃənz
convicts => kənˈvikts
convince => kәn'vins
convinced => kәn'vinst
convinces => kənˈvinsiz
convincible => kәn'vinsәbl
convincing => kәn'vinsiŋ
convivial => kәn'viviәl
conviviality => kәn.vivi'ælәti
convivially => kən'vɪvɪəlɪ
convocation => .kɒnvәu'keiʃәn
convocations => ˌkɔnvəˈkeɪʃənz
convoke => kәn'vәuk
convoked => kənˈvəʊkt
convokes => kənˈvəʊks
convoking => kənˈvəʊkɪŋ
convolute => 'kɒnvәlu:t
convoluted => 'kɔnvәlju:tid
convolutes => ˈkɔnvəlju:ts
convoluting => ˈkɔnvəlju:tɪŋ
convolution => .kɒnvә'lu:ʃәn
convolutions => kɒnvə'lu:ʃnz
convolve => kәn'vɒlv
convolved => kənˈvɔlvd
convolves => kənˈvɔlvz
convolving => kənˈvɔlvɪŋ
convolvulus => kәn'vɒlvjulәs
convoy => 'kɒnvɒi. kәn'vɒi
convoyed => 'kɒnvɒɪ
convoying => 'kɒnvɒɪ
convoys => ˈkɔnˌvɔɪz
convulsant => kәn'vʌlsәnt
convulse => kәn'vʌls
convulsed => kənˈvʌlst
convulses => kənˈvʌlsiz
convulsing => kənˈvʌlsɪŋ
convulsion => kәn'vʌlʃәn
convulsions => kәn'vʌlʃәns
convulsive => kәn'vʌlsiv
convulsively => kən'vʌlsɪvlɪ
cony => 'kәuni
coo => ku:
cooed => ku:d
cooee => 'ku:i
cook => kuk
cook-chill => kuk tʃil
cookbook => 'kukbuk
cookbooks => ˈkʊkˌbʊks
cooked => kukt
cooker => 'kukә
cookers => 'kʊkəz
cookery => 'kukәri
cookie => 'kuki
cookie sheet => ˈkuki ʃi:t
cooking => 'kukiŋ
cooking apple => ˈkʊkɪŋ ˈæpl
cookout => 'kjkajt
cookshop => 'kjkʃɔp
cookstove => 'kukstәuv
cooktop => 'kjktɔp
cookware => 'kjkweә(r)
cooky => 'kjki
cool => ku:l
coolabah => 'ku:lәbɑ:
coolant => 'ku:lәnt
coolants => ˈku:lənts
cooled => ku:ld
cooler => 'ku:lә
coolibah => 'ku:libә
coolie => 'ku:li
coolies => 'ku:lɪz
cooling => 'ku:liŋ
coolish => 'ku:liʃ
coolly => 'ku:li
coolness => 'ku:lnis
coolth => 'ku:lθ
coomb => ku:m,kәum
coombe => ku:m
coon => ku:n
cooncan => 'ku:nkæn
coonhound => 'ku:nhaund
coons => ku:nz
coonskin => 'ku:nskin
coop => ku:p
cooped => kuːp
cooper => 'ku:pә
cooperage => 'ku:pәridʒ
cooperant => kәu'ɔpәrәnt
cooperate => kәu'ɒpәreit
cooperated => kəuˈɔpəreitid
cooperates => kəuˈɔpəreits
cooperating => kәu'ɔpәreitiŋ
cooperation => kәu.ɒpә'reiʃәn
cooperative => kәu'ɔpәrәtiv
cooperatively => kəu'ɔpəreitivli
cooperatives => kə'ʊɒpərətɪvz
cooperator => kәu'ɔpәreitә
coopered => 'kuːpə
coopering => 'kuːpə
Coopers => 'kuːpə
coopery => 'ku:pәri
coops => ku:ps
coopt => kəu'ɔpt
coordinate => kәu'ɒ:dineit
coordinates => kәu'ɔ:dineits
coordinating conjunction => kəʊˈɔ:dnˌeɪtɪŋ
coordination => kәu.ɒ:di'neiʃәn
coordinative => kәu'ɔ:dinәtiv
coordinator => kәu'ɒ:dineitә
coordinators => kə'ʊɔ:dɪneɪtəz
coos => ku:z
coot => ku:t
cootie => 'ku:ti
cooties => 'ku:tiz
coots => ku:ts
cooty => 'ku:ti
cooze => ku:z
cop => kɒp
copacetic => .kәupә'setik
copal => 'kәupәl
coparcenary => kәu'pɑ:sәnәri
coparcener => 'kәu'pɑ:sinә
cope => kәup
copeck => 'kәupek
coped => kəupt
Copenhagen => .kәupәn'heigәn
copepod => 'kәupәpɒd
copepods => kəʊp'pɒdz
coper => 'kәupә
Copernican => kәu'pә:nikәn
Copernicus => kәu'pә:nikәs
copes => kəups
copestone => 'kәupstәun
copier => 'kɔpiә
copiers => ˈkɔpiəz
copilot => 'kәupailәt
coping => 'kәupiŋ
coping saw => ˈkəupiŋ sɔ:
coping stone => ˈkəupiŋ stəun
copious => 'kәupiәs
copiously => 'kəʊpɪəslɪ
copiousness => 'kəʊpɪəsnɪs
copita => kә'pi:tә
coplanar => kәj'pleinә(r)
coplanarity => ,kәuplә'næriti
Copland => 'kɔplәnd, 'kәu-
copolymer => kәu'pɔlimә
copolymerization => kәu,pɔlimәrai'zeiʃәn
copolymerize => kәu'pɔlimәraiz
copped => 'kɔpid
copper => 'kɒpә
copper beech => ˈkɔpə bi:tʃ
copper pyrites => ˈkɔpə paiˈraiti:z
copper sulphate => ˈkɔpə ˈsʌlfeit
copperas => 'kɒpәrәs
Copperbelt => 'kɔpәbelt
coppered => 'kɒpə
copperfield => 'kɔpәfi:ld
copperhead => 'kɒpәhed
coppering => 'kɔpәriŋ
coppernob => 'kɔpәnɔb
copperplate => 'kɒpәpleit
coppers => ˈkɔpəz
coppersmith => 'kɒpәsmiθ
coppery => 'kɒpәri
coppice => 'kɒpis
coppiced => ˈkɔpist
coppices => ˈkɔpisiz
coppicing => 'kɔpisiŋ
copping => 'kɔpiŋ
copra => 'kɒprә
copro- => 'kɔprәj
coprolalia => ,kɔprә'leiljә
coprolite => 'kɒprәlait
coprophagous => kɒ'prɒfәgәs
coprophilia => .kɒprә'filiә
cops => kɔps
copse => kɒps
copses => kɔpsiz
Copt => kɔpt
copter => 'kɔptә
Coptic => 'kɔptik
copts => kɔpt
copula => 'kɒpjulә
copular => 'kɒpjulә
copulate => 'kɒpjuleit
copulated => ˈkɔpjuleitid
copulates => ˈkɔpjuleits
copulating => ˈkɔpjuleitɪŋ
copulation => .kɒpju'leʃәn
copulative => 'kɒpjuleitiv
copulatory => 'kɒpjulәtәri
copy => 'kɒpi
copybook => 'kɒpibuk
copycat => 'kɒpikæt
copycats => ˈkɔpi:ˌkæts
copydesk => 'kɒpidesk
copyhold => 'kɔpihәjld
copyholder => 'kɒpihәuldә
copying => 'kɔpiiŋ
copyist => 'kɒpiist
copyread => 'kɔpiri:d
copyreader => 'kɔpi,ri:dә(r)
copyreading => 'kɔpi,ri:diŋ
copyreads => 'kɒpɪ,riːd
copyright => 'kɒpirait
copyrighting => ˈkɔpiraitɪŋ
copywriter => 'kɒpiraitә
copywriters => ˈkɔpiraitəz
copywriting => 'kɔpi,raitiŋ
coq => kɔk
coq au vin => kɔk әu 'væn
coquelicot => 'kәuklikәu
coquetry => 'kɒkitri
coquette => kәu'ket
coquettes => kəʊˈkets
coquettish => kɒ'ketiʃ
coquettishly => kəu'ketiʃli
coquina => kәu'ki:nә
coquito => kәu'ki:tәu
cor => kɔ:(r)
cor anglais => 'kɔ:'ɔŋ^lei
cor blimey => kɔ: ˈblaimi
cora => 'kɔ:rә
coracle => 'kɔrәkl
coracles => ˈkɔrəklz
coracoid => 'kɒ:rәkɒid
coral => 'kɒrәl
coral reef => ˈkɔrəl ri:f
coralberry => 'kɔ:rәl,beri
coralline => 'kɒrәlain
corallita => kɔrә'litә
corallite => 'kɒrәlait
coralloid => 'kɔrәlɔid
coralroot => 'kɔrәlru:t
corals => ˈkɔrəlz
coram => 'kɔ:rәm
corbeil => 'kɒ:bel
corbel => 'kɒ:bәl
corbelled => 'kɔ:rbeld
corbelling => kɔ:r'belɪŋ
corbels => ˈkɔ:bəlz
corbicula => kɔ:'bikjulә
corbie => 'kɔ:bi
Corbin => 'kɔ:bin
Corcovado => ,kɔ:kɔ:'vɑ:du
Corcyra => kɔ:'sairə
cord => kɒ:d
cordage => 'kɔ:didʒ
cordate => 'kɒ:deit
corded => 'kɒ:did
Cordelia => kɔ:'di:ljə
cordgrass => 'kɔ:dɡrɑ:s
cordial => 'kɒ:djәl
cordiality => .kɒ:di'æliti
cordially => 'kɒ:djәli
cordials => ˈkɔ:djəlz
cordierite => 'kɔ:diәrait
cordillera => kɔ:di'ljeәrә
cording => 'kɔ:diŋ
cordite => 'kɒ:dait
cordless => 'kɒ:dlis
cordoba => 'kɔ:dәuvә
cordon => 'kɒ:dәn
cordon sanitaire => kɔ:ˌdɔ:ŋsɑ:ni:ˈteə
cordoned => ˈkɔ:dnd
cordoning => ˈkɔ:dnɪŋ
cordons => ˈkɔ:dnz
cordova => 'kɔ:dəvə
cordovan => 'kɔ:dәvәn
corduroy => 'kɒ:dәrɒi
cordwainer => 'kɔ:dweinә
cordwood => 'kɔ:dwud
CORE => kɒ:
Corea => kɔ:'riәn
coreference => kәu'refrәns
corella => kә'relә
coreopsis => .kɒ:ri'ɒpsis
corer => 'kɒ:rә
corey => 'kәjri, 'kɔ:ri
corf => kɒ:f
Corfe => kɔ:f
CORFU => kɔ:'fu:
corgi => 'kɔ:^i
corgis => ˈkɔ:ɡiz
coriaceous => .kɒri'eiʃәs
coriander => ,kɔri'ændә
coring => 'kɔ:riŋ
Corinne => kәj'rin, -'ri:n
Corinth => 'kɔrinθ
Corinthian => kә'rinθiәn
Corinthians => kə'rinθiənz
Coriolanus => ,kɔriәj'leinәs
corium => 'kɒ:riәm
cork => kɒ:k
cork oak => kɔ:k əuk
corkage => 'kɒ:kidʒ
corkboard => 'kɔ:kbɔ:d
corked => kɔ:kt
corker => 'kɒ:kә
corking => 'kɒ:kiŋ
corks => kɔ:ks
corkscrew => 'kɒ:kskru:
corkscrewed => ˈkɔ:kskru:d
corkscrewing => ˈkɔ:kskru:ɪŋ
corkscrews => ˈkɔ:kskru:z
corkwood => 'kɒ:kwud
corky => 'kɒ:ki
corm => kɒ:m
cormel => 'kɔ:mәl
cormorant => 'kɒ:mәrәnt
cormorants => ˈkɔ:mərənts
corn => kɒ:n
corn borer => kɔ:n ˈbɔ:rə
corn chip => kɔ:n tʃip
corn dolly => kɔ:n ˈdɔli
corn earworm => kɔ:n ˈiəwə:m
corn marigold => kɔ:n ˈmæriɡəuld
corn pone => kɔ:n pəun
corn salad => kɔ:n ˈsæləd
corn snake => kɔ:n sneik
corn snow => kɔ:n snəu
corn whiskey => kɔ:n ˈhwɪski:
cornball => 'kɔ:nbɔ:l
cornbrash => 'kɒ:nbræʃ
cornbread => ˈkɔ:nbred
corncob => 'kɔ:nkɔb
corncrake => 'kɒ:nkreik
cornea => 'kɒ:niә
corneal => 'kɒ:niәl
corneas => ˈkɔ:ni:əz
corned => kɒ:nd
corned beef => ˌkɔ:nd ˈbi:f
cornel => 'kɒ:nәl
cornelia => kɔ:'ni:ljә
cornelian => kɒ:'ni:ljәn
cornelian cherry => kɔ:ˈni:ljən ˈtʃeri:
cornell => kɔ:'nel
corneous => 'kɒ:niәs
corner => 'kɒ:nә
corner shop => ˈkɔ:nə ʃɔp
cornerback => 'kɔ:nәbæk
cornered => 'kɔ:nәd
cornering => 'kɔ:nərɪŋ
cornerman => 'kɔ:nəmæn
cornerstone => 'kɔ:nәstәjn
cornerstones => ˈkɔ:nəˌstəʊnz
cornerwise => 'kɔ:nәwaiz
cornet => 'kɒ:nit
cornetcy => 'kɔ:nitsi
cornetist => kɔ:'netist
cornets => kɔ:ˈnets
cornetto => kɔ:'netәj
corneum => 'kɔniәm
cornfield => 'kɒ:nfi:ld
cornfields => ˈkɔ:nfi:ldz
cornflake => 'kɔ:nfleɪk
cornflour => ˈkɔ:nflaʊə(r)
cornflower => 'kɒ:nflauә
cornflowers => ˈkɔ:nflauəz
cornhusk => 'kɔ:nhʌsk
cornice => 'kɒ:nis
corniced => 'kɒ:nist
cornices => ˈkɔ:nisiz
corniche => 'kɔ:niʃ
cornier => ˈkɔ:ni:ə
cornily => ˊkɒːnili
corniness => ˊkɒːninis
cornish => 'kɔ:niʃ
cornishman => 'kɔ:niʃmәn
cornmeal => 'kɒ:nmi:l
cornrow => 'kɔ:nrәu
cornrows => ˈkɔ:nrəʊz
cornsilk => kɔ:n'sɪlk
cornstalk => 'kɒ:nstɒ:k
cornstarch => 'kɒ:nstɑ:tʃ
cornstone => 'kɔ:nstәjn
cornu => 'kɔ:nju:, -nu:
cornucopia => .kɒ:nju'kәupiә
cornucopian => kɒːnjuˊkoupiәn
cornucopias => ˌkɔ:nəˈkəʊpi:əz
cornus => 'kɔ:nәs
cornwall => 'kɔ:nwɔ:l
corny => 'kɒ:ni
corolla => kә'rɒlә
corollaries => kəˈrɔləriz
corollary => kә'rɒlәri
coromandel => ,kɔrә'mændәl
corona => 'kɔrәnә
Corona Australis => kə'rəunəɔ:'streilis
coronach => 'kɒrәnәk
coronagraph => kә'rәunә,^ræf
coronal => 'kɒrәnәl
coronaries => ˈkɔrəˌneriz
coronary => 'kɒrәnәri
coronas => kəˈrəʊnəz
coronation => .kɔ:rә'neiʃәn
coronations => ˌkɔ:rəˈneɪʃənz
coronavirus => ,kɔrәnә'vairәs
coroner => 'kɒrәnә
coroners => ˈkɔrənəz
coronet => 'kɒrәnit
coroneted => 'kɒrənetɪd
coronets => ˈkɔrənits
corpora => 'kɔ:pәrә
corporal => 'kɒ:pәrәl
corporality => kɒ:pә'ræliti
corporally => 'kɒ:pәrәli
corporals => ˈkɔ:pərəlz
corporate => 'kɒ:pәrit
corporate raider => ˈkɔ:pərit ˈreidə
corporation => .kɒ:pә'reiʃәn
corporatism => 'kɔ:pәrәtizәm
corporatist => 'kɔ:pәrәtist
corporative => 'kɒ:pәreitiv
corporativism => 'kɔ:pә,reitivizәm
corporatization => kɔ:pərətaɪ'zeɪʃn
corporatize => 'kɔpərətaiz
corporator => 'kɒ:pәreitә
corporeal => kɒ:'pɒ:riәl
corporeality => kɒ:.pɒ:ri'æliti
corporeally => kɔ:pɔ:'rɪəlɪ
corporeity => .kɒ:pә'ri:әti
corposant => 'kɒ:pәzænt
corps => kɒ:
corps de ballet => kɔ: dә 'bælei
corpse => kɒ:ps
corpses => kɔ:psiz
corpsman => 'kɒ:mәn
corpulence => 'kɒ:pjulәns
corpulent => 'kɒ:pjulәnt
corpus => 'kɒ:pәs
Corpus Christi => 'kristi
corpus delicti => di'liktai
corpuscle => 'kɒ:pʌsәl
corpuscles => 'kɔ:pʌslz
corpuscular => kɒ:'pʌskjulә
corral => kɒ:'rɑ:l
corrals => kəˈrælz
correct => kә'rekt
corrected => kә'rektid
correction => kә'rekʃәn
correction fluid => kəˈrekʃən ˈflu:ɪd
correctional => kә'rekʃәnәl
corrections => kə'rekʃnz
correctitude => kә'rektitju:d
corrective => kә'rektiv
correctly => kә'rektli
corrector => kә'rektә
corrects => kəˈrekts
correlate => 'kɒrәleit
correlated => 'kɒrәleitid
correlates => ˈkɔrileits
correlation => .kɒrә'leiʃәn
correlations => ˌkɔ:rəˈleɪʃənz
correlative => kә'relәtiv
correlativity => kәrelә'tiviti
correspond => .kɒri'spɒnd
corresponded => ˌkɔrisˈpɔndid
correspondence => .kɒri'spɒndәns
correspondence course => ˌkɔrisˈpɔndəns kɔː(r)s
correspondences => ˌkɔrisˈpɔndənsiz
correspondent => .kɒri'spɒndәnt
correspondents => ˌkɔrisˈpɔndənts
corresponding => .kɒri'spɒndiŋ
corresponds => ˌkɔrisˈpɔndz
corrida => kɒ:'ri:ðɑ:
corridor => 'kɒridɒ:
corridors => 'kɒrɪdɔ:z
corrie => 'kɒri
Corriedale => 'kɔrideil
corrigendum => .kɒri'dʒendәm
corrigibility => .kɒridʒi'biliti
corrigible => 'kɔridʒәbl
corroborate => kә'rɒbәreit
corroborated => kəˈrɔbəˌreɪtid
corroborates => kəˈrɔbəˌreɪts
corroborating => kəˈrɔbəˌreɪtɪŋ
corroboration => kә.rɒbә'reiʃәn
corroborative => kә'rɔbәrәtiv
corroborator => kә'rɒbәreitә
corroboratory => kә'rɔbәrәtәri
corroboree => kә'rɔbәri
corrode => kә'rәud
corroded => kəˈrəudid
corrodes => kəˈrəudz
corrodible => kә'rәudәbl
corrody => 'kɔ:rədi
corrosion => kә'rәuʒәn
corrosive => kә'rәusiv
corrugate => 'kɒrugeit
corrugated => 'kɒrugeitid
corrugated iron => ˈkɔruɡeitid ˈaiən
corrugation => .kɒru'geiʃәn
corrugations => ,kɔːrʊ'ɡeɪʃən
corrupt => kә'rʌpt
corruptibility => kә.rʌptә'biliti
corruptible => kә'rʌptәbl
corrupting => kəˈrʌptɪŋ
corruption => kә'rʌpʃәn
corruptive => kә'rʌptiv
corruptly => kə'rʌptlɪ
corrupts => kəˈrʌpts
corsage => kɒ:'sɑ:ʒ
corsages => kɔ:ˈsɑ:ʒz
corsair => 'kɒ:sєә
corse => kɔ:s
corselet => 'kɒ:slit
corselette => kɔ:səˈlet
corset => 'kɒ:sit
corseted => 'kɔ:sɪtɪd
corseting => 'kɔːsɪt
corsetry => 'kɔ:sitri
corsets => ˈkɔ:sits
corsica => 'kɔ:sikә
Corsican => 'kɔ:sikәn
cortege => kɒ:'teiʒ
Cortes => 'kɔ:tes, -tez
cortex => 'kɒ:teks
cortical => 'kɒ:tikәl
corticate => 'kɔ:tikeitid
cortico- => 'kɔ:tikәj
corticosteroid => ,kɔtikәu'stiәrɔid
corticosterone => ,kɔ:ti'kɔstәrәun
corticotrophin => ,kɔ:tikәu'trәufin
cortile => kɒ:'ti:lei
cortisol => 'kɔ:tisɔl
cortisone => 'kɒ:tizәun
corundum => kә'rʌndәm
coruscant => kә'rʌskәnt
coruscate => 'kɒrәskeit
coruscated => ˈkɔ:rəˌskeɪtid
coruscates => ˈkɔ:rəˌskeɪts
coruscating => ˈkɔ:rəˌskeɪtɪŋ
coruscation => .kɒrәs'keiʃәn
corve => kɔ:v
corves => kɔ:vz
corvette => kɔ:'vet
corvina => kɔ:'vi:nә
corvine => 'kɒ:vain
Corvus => 'kɔ:vәs
corydalis => kә'ridlis
corymb => 'kɒrimb
corymbose => kә'rimbәus
corynebacterium => ,kɔ:rini:bæk'tiәriәm
coryza => kә'raizә
cos => kɔs
Cosa Nostra => kausә'nәustrә
cose => kәuz
cosecant => kәu'si:kәnt
cosh => kɔʃ
coshed => kɔʃt
coshes => kɔʃiz
coshing => kɔʃɪŋ
cosier => ˈkəuziə
cosies => ˈkəuziz
cosignatory => .kәu'signәtәri
cosily => 'kәuzili
cosine => 'kәusain
cosines => 'kəʊsaɪn
cosiness => 'kəʊzɪnəs
cosmeceutical => 'kɔzmə'sju:tikəl
cosmetic => kɒz'metik
cosmetic surgery => kɔzˈmetik ˈsə:dʒəri
cosmetically => kɔz'metikli
cosmetician => ,kɔzmә'tiʃәn
cosmetologist => ,kɔzmә'tɔlәdʒist
cosmetology => .kɒzmә'tɒlәdʒi
cosmic => 'kɒzmik
cosmic dust => ˈkɔzmik dʌst
cosmic string => ˈkɔzmik striŋ
cosmical => 'kɔzmikәl
cosmically => 'kɒzmikәli
cosmo => 'kɔzmәj
cosmo- => 'kɔzmәj
cosmodrome => 'kɒzmәdrәum
cosmogenesis => ,kɔzmә'dʒenisis
cosmogenetic => ,kɔzmәdʒi'netik
cosmogenic => ,kɔzmә'dʒenik
cosmogonic => ,kɔzmәj'^ɔnik
cosmogonical => kɒzməʊ'ɡɒnɪkəl
cosmogonist => kɒz'mɒgәnist
cosmogony => kɒz'mɒgәni
cosmographer => kɒz'mɒgrәfә
cosmographic => ,kɔzmәj'^ræfik
cosmographical => kɒzmouˊgræfikәl
cosmography => kɒz'mɒgrәfi
cosmological => .kɒzmә'lɒdʒikl
cosmological constant => ˌkɔzməˈlɔdʒikəl ˈkɔnstənt
cosmologies => kɒz'mɒlədʒɪ
cosmologist => kɒz'mɒlәdʒist
cosmologists => kɔz'mɔlədʒist
cosmology => kɒz'mɒlәdʒi
cosmonaut => 'kɒzmәnɒ:t
cosmonauts => ˈkɔzməˌnɔ:ts
cosmopolis => kɒz'mɒpәlis
cosmopolitan => ,kɔzmә'pɔlitәn
cosmopolitanism => ,kɔzmә'pɔlitәnizәm
cosmopolitanize => ,kɔzmә'pɔlitәnaiz
cosmopolitans => kɒzmə'pɒlɪtənz
cosmopolite => kɔz'mɔpәlait
cosmos => 'kɔzmɔs
COSPAR => 'kәjspɑ:(r)
Cossack => 'kɔsæk
cosset => 'kɒsit
cosseted => ˈkɔsɪtid
cosseting => ˈkɔsɪtɪŋ
cossets => ˈkɔsɪts
cossie => 'kɔzi
cost => kɒst
cost of living => kɔst ɔv ˈliviŋ
cost-benefit => 'kɔst'benifit
cost-effective => kɒst ɪ'fektɪv
cost-effectiveness => kɒst ɪˌfek'tɪvnɪs
cost-efficient => 'kɔsti'fiʃәnt
cost-of-living index => ˈkɔstəvˈliviŋ ˈindeks
cost-plus => 'kɔst'plʌs
cost-push => 'kɒstp'ʊʃ
costa => 'kɒstә
Costa Rica => 'kɔstә'ri:kә
Costa Rican => .kɒ:stә'ri:kәn
costal => 'kɒstl
costate => 'kɒsteit
costello => kɔs'telәu
coster => 'kɔstә
costermonger => 'kɔstәmʌŋ^ә(r)
costing => 'kɒstiŋ
costive => 'kɒstiv
costliness => 'kɒstlinis
costly => 'kɒstli
costmary => 'kɒstmәri
costume => 'kɒstju:m
costume drama => ˈkɔstju:m ˈdrɑ:mə
costume jewellery => ˈkɔstju:m ˈdʒu:əlri
costumed => ˈkɒstju:md
costumer => 'kɔstju:mә(r), kɔ'stju:-
costumier => kɔ'stju:miә(r)
costuming => 'kɔstju:miŋ
cot => kɒt
cotangent => .kәu'tændʒәnt
cote => kәut
coterie => 'kәutәri
coterminous => kәu'tә:minәs
cotillion => kә'tiljәn, kәu-
cotinga => kә'tiŋ^ә
cotoneaster => kә,tәuni'æstә
Cotonou => kәutә'nu:
Cotopaxi => ,kәjtә'pæksi
Cotswold => 'kɔtswәuld
cotta => 'kɒtә
cottage => 'kɒtidʒ
cottage loaf => ˈkɔtidʒ ləuf
cottage pie => ˈkɔtidʒ pai
cottager => 'kɔtidʒә(r)
cottagers => 'kɒtɪdʒə
cottages => ˈkɔtidʒz
cottaging => ˈkɒtɪdʒɪŋ
cottar => 'kɔtә(r)
cottier => 'kɒtiә
Cottle => 'kɔtl
cotton => 'kɒtn
cotton bud => ˈkɔtən bʌd
cotton candy => ˈkɔtən ˈkændi
cotton grass => ˈkɔtən ɡrɑ:s
cotton rat => ˈkɔtən ræt
cotton stainer => ˈkɔtən ˈsteinə
cotton-picking => 'kɔtən,pikiŋ
cottonmouth => 'kɔtәn.mauθ
cottons => ˈkɔtənz
cottonseed => 'kɔtәnsi:d
cottontail => 'kɔtәnteil
cottonweed => 'kɔtәnwi:d
cottonwood => 'kɔtәnwjd
cottony => 'kɒtәni
cottony-cushion scale => 'kɔtni'ku:ʃən
cotyledon => .kɒti'li:dn
cotyledonary => 'kɒtɪli:dəʊnərɪ
coucal => 'ku:kәl
couch => kautʃ
couch potato => kautʃ pəˈteitəu
couchant => 'kautʃәnt
couches => kautʃiz
couchette => ku:'ʃet
cougar => 'ku:gә
cough => kɒf
cough mixture => kɔf ˈmikstʃə
coughed => kɔft
coughing => ˈkɒfɪŋ
coughs => kɔfs
could => kud
couldn't => 'kudnt
coulee => 'ku:li
coulibiac => 'ku:libiæk
coulisse => ku:'li:s
couloir => 'ku:lwɑ:
coulomb => ku:'lɒm
coulter => 'kәultә
coumarin => 'ku:mәrin
coumarone => 'ku:mә,rәun
council => 'kaunsәl
council house => ˈkaunsl haus
council tax => ˈkaunsl tæks
councillor => 'kaunsilә
councillors => ˈkaʊnsələz
councilman => 'kaunslmәn
councilmen => 'kaʊns(ə)lmən; -sɪl-
councilor => 'kaunsilә
councils => ˈkaunslz
councilwoman => 'kajnsәl,wjmәn
counsel => 'kaunsәl
counseling => 'kaunsәliŋ
counsellor => 'kaunsәlә
counsellors => ˈkaʊnsələz
counselor => 'kaunsәlә
counsels => ˈkaunsəlz
count => kaunt
count noun => kaunt naun
count sheep => kaunt ʃi:p
countable => 'kauntәbl
countdown => 'kauntdaun
counted => kauntid
countenance => 'kauntәnәns
countenanced => ˈkaʊntənənst
countenances => ˈkaʊntənənsiz
countenancing => ˈkaʊntənənsɪŋ
counter => 'kauntә
counter- => 'kajntә(r)
counter-attack => ˈkauntə əˈtæk
counter-attraction => 'kauntərə'trækʃən
counter-intelligence => ˈkaʊntɚ ɪnˈtɛlədʒəns
counter-offer => 'kaʊntər'ɒfər
counter-revolution => ˈkaʊntɚ ˌrɛvəˈluʃən
counter-revolutionary => ˈkaʊntɚ ˌrɛvəˈluʃəˌnɛri
counteract => .kauntә'rækt
counteracted => ˌkauntəˈræktid
counteracting => ˌkauntəˈræktɪŋ
counteraction => .kauntә'rækʃәn
counteractive => .kauntә'ræktiv
counteracts => ˌkauntəˈrækts
counterattack => 'kauntәrә.tæk
counterattacked => ˈkaʊntərəˌtækt
counterattacks => ˈkaʊntərəˌtæks
counterbalance => 'kauntә.bælәns
counterbalanced => ˈkaʊntəˌbælənst
counterblast => 'kauntәblɑ:st
counterbore => kauntә'bɔ:
counterchange => .kauntә'tʃeindʒ
countercharge => 'kauntәtʃɑ:dʒ
countercheck => 'kauntәtʃek
counterchecked => ˈkauntətʃekt
counterchecking => ˈkauntətʃekɪŋ
counterchecks => ˈkauntətʃeks
counterclaim => 'kauntәkleim
counterclaimed => ˈkauntəkleimd
counterclaiming => ˈkauntəkleimɪŋ
counterclockwise => .kauntә'klɒkwaiz
countercultural => ,kaʊntə'kʌltʃərəl
counterculture => 'kauntәkʌltʃә
countercurrent => 'kauntә.kʌrәnt
counterdemonstration => 'kauntә,demәns'treiʃәn
counterfactual => ,kajntә'fæktʃjәl
counterfeit => 'kauntәfit
counterfeited => ˈkaʊntəˌfɪtid
counterfeiter => 'kauntәfitә
counterfeiting => 'kaʊntəfɪtɪŋ
counterfeits => 'kaʊntəfɪts
counterfoil => 'kauntәfɒil
counterfoils => ˈkaʊntəˌfɔɪlz
counterforce => 'kauntәfɒ:s
counterinsurgency => 'kauntәrin'sә:dʒәnsi
counterintelligence => 'kauntәrin,telidʒәns
counterintuitive => ,kajntәrin'tju:itiv
counterirritant => .kauntәr'iritәnt
counterirritation => 'kajntәr,iri'teiʃәn
counterman => 'kauntәmæn
countermand => .kauntә'mɑ:nd
countermanded => ˈkaʊntəˌmændid
countermanding => ˈkaʊntəˌmændɪŋ
countermands => ˈkaʊntəˌmændz
countermarch => 'kauntәmɑ:tʃ
countermark => 'kauntәmɑ:k
countermeasure => 'kauntә.meʒә
countermelody => 'kajntә,melәdi
countermine => 'kauntәmain
countermined => ˈkauntəmaind
countermines => ˈkauntəmainz
countermining => ˈkauntəmainɪŋ
countermove => 'kauntәmu:v
countermovement => 'kajntә,mu:vmәnt
counteroffensive => 'kauntәrә'fensiv
counteroffer => 'kauntә,ɔ:fә
counterpane => 'kauntәpein
counterpanes => ˈkauntəpeinz
counterpart => 'kauntәpɑ:t
counterparty => 'kauntə,pɑ:ti
counterplot => 'kauntәplɒt
counterpoint => 'kauntәpɒint
counterpointed => ˈkauntəpɔintid
counterpointing => ˈkauntəpɔintɪŋ
counterpoints => ˈkauntəpɔints
counterpoise => 'kauntәpɒiz
counterpoised => ˈkauntəpɔizd
counterpoises => ˈkauntəpɔiziz
counterpoising => ˈkauntəpɔizɪŋ
counterpose => 'kauntәpәus
counterproductive => .kauntәprә'dʌktiv
counterproposal => 'kauntәprә.pәuzl
counterpunch => 'kauntә,pʌntʃ
counterrevolution => kauntәrevә'lu:ʃәn
counterrotation => 'kauntәrәu'teiʃәn
counters => ˈkauntəz
counterscarp => 'kauntә,skɑ:p
countershading => 'kajntә,ʃeidiŋ
countershaft => 'kauntәʃæft
countersign => 'kauntәsain
countersignature => .kauntә'signәtʃә
countersigned => ˈkaʊntəˌsaɪnd
countersigning => ˈkaʊntəˌsaɪnɪŋ
countersigns => ˈkaʊntəˌsaɪnz
countersink => 'kauntәsiŋk
counterspy => 'kauntәspai
counterstain => 'kauntәstein
counterstroke => 'kauntәstrәuk
countersubject => 'kajntә,sʌbdʒikt
countersunk => 'kajntәsʌŋk
countertenor => 'kauntә'tenә
countertenors => ˌkauntəˈtenəz
counterterrorism => 'kaʊntəˌterərɪzəm
counterterrorist => ,kaʊntə'terərɪst
countertop => 'kajntәtɔp
countertrade => 'kɑʊntəˌtreɪd
countervail => .kauntә'veil
countervailing => ˈkaʊntəveɪlɪŋ
counterweight => 'kauntәweit
counterweights => 'kaʊntəweɪts
countess => 'kauntis
countesses => ˈkaʊntɪsiz
countian => 'kajntiәn
counties => ˈkauntiz
counting => 'kauntiŋ
countless => 'kauntlis
countrified => 'kʌntrifaid
country => 'kʌntri
country club => ˈkʌntri klʌb
country cousin => ˈkʌntri ˈkʌzn
country dance => ˈkʌntri dɑ:ns
country dancing => ˈkʌntri ˈdænsɪŋ
country gentleman => ˈkʌntri ˈdʒentlmən
country mile => ˈkʌntri mail
country music => ˈkʌntri ˈmju:zik
countryfied => 'kʌntrifaid
countryman => 'kʌntrimәn
countryside => 'kʌntrisaid
countrywide => 'kʌntriwaid
countrywoman => 'kʌntri,wjmәn
countship => 'kajnt-ʃip
county => 'kaunti
county council => ˈkaunti ˈkaunsl
county town => ˈkaunti taun
coup => 'ku:
coup de main => ,ku:dә'mæŋ
coupe => 'ku:pei
couped => kuː
coupes => ˈku:peiz
coupla => 'kʌplә
couple => 'kʌpl
couple up => ˈkʌpl ʌp
coupled => 'kʌpld
coupledom => 'ku:pli:dəm
coupler => 'kʌplә
couplet => 'kʌplit
couplets => 'kʌplɪts
coupling => 'kʌpliŋ
coupon => 'ku:pɒn
coups => ku:z
courage => 'kʌridʒ
courageous => kә'reidʒәs
courageousness => kə'reɪdʒəsnes
courant => ku'rɑ:nt
courante => ku'rɑ:nt
courbette => 'kuә'bet
coureur de bois => ku:'rә:dә'bwɑ:
courgette => ku:ә'ʒet
courgettes => ku:əˈʒets
courier => 'kuriә
couriers => ˈkʊəri:əz
course => kɒ:s
coursed => kɔ:st
courser => 'kɒ:sә
coursework => ˈkɔ:swɜ:k
coursing => 'kɔ:siŋ
court => kɒ:t
court bouillon => kɔ:t ˈbu:jɔŋ
court card => kɔ:t kɑ:d
court martial => kɔ:t ˈmɑ:ʃəl
court of law => kɔ:t ɔv lɔ:
court reporter => kɔ:t riˈpɔ:tə
court shoe => kɔ:t ʃu:
court tennis => kɔ:t ˈtenis
court-martial => kɔ:t'mɑ:ʃ(ә)l
courted => kɔːtid
courteous => 'kә:tjәs
courtesan => kɔ:ti'zæn; (?@) 'kɔ:tizn
courtesans => kɔ:tiˈzænz
courtesies => ˈkə:tisiz
courtesy => 'kә:tisi
courtesy light => ˈkə:tisi lait
courthouse => 'kɒ:thaus
courthouses => ˈkɔ:tˌhaʊsiz
courtier => 'kɒ:tjә
courtiers => ˈkɔ:ti:əz
courtliness => 'kɒ:tlinis
courtly => 'kɒ:tli
Courtrai => 'ku:rtre
courtroom => 'kɒ:trum
courtrooms => ˈkɔ:tru:mz
courtship => 'kɒ:tʃip
courtyard => 'kɒ:tjɑ:d
courtyards => 'kɔ:tjɑ:dz
couscous => 'ku:sku:s, ku:s'ku:s
cousin => 'kʌzәn
couth => ku:θ
couture => ku'ty:r
couturier => kutyr'je
couturiers => kutyrˈjez
couvade => ku:'vɑ:d
couverture => ,kjvә'tjjә(r)
covalence => kәu'veilәns
covalency => kәu'veilәnsi
covalent => kәu'veilәnt
covariance => kәu'vєәriәns
covariant => kәu'veәriәnt
covariate => kʌ'veərɪət
covariation => kәj,veәri'eiʃәn
cove => kәuv
coved => kəʊvd
covelline => kәj'velain, -lin
covellite => kәj'velait
coven => 'kʌvәn, 'kәu-
covenant => 'kʌvәnәnt
covenantal => 'kʌvənənt
covenanting => ˈkʌvənəntɪŋ
covenantor => 'kʌvәnәntә(r)
covenants => ˈkʌvənənts
covent => 'kɔvәnt
Covent Garden => 'kɔvәnt^ɑ:dn
Coventry => 'kɔvәntri
cover => 'kʌvә
cover charge => ˈkʌvə tʃɑ:dʒ
cover crop => ˈkʌvə krɔp
cover girl => ˈkʌvə ɡə:l
cover letter => ˈkʌvə ˈletə
cover story => ˈkʌvə ˈstɔ:ri
cover version => ˈkʌvə ˈvə:ʃən
cover-ups => 'kʌvər'ʌps
coverage => 'kʌvәridʒ
coverages => 'kʌv(ə)rɪdʒ
coverall => 'kʌvәrɒ:l
Coverdale => 'kʌvәdeil
covered => 'kʌvәd
covering => 'kʌvәriŋ
coverlet => 'kʌvәlit
coverlets => ˈkʌvəlɪts
coverslip => 'kʌvəslɪp
covert => 'kʌvәt. 'kәuvәt
coverts => 'kʌvəts
coverture => 'kʌvәtʃә
coves => kəʊvz
covet => 'kʌvit
coveted => ˈkʌvɪtid
coveting => ˈkʌvɪtɪŋ
covetous => 'kʌvitәs
covetously => kʌ'vɪtəslɪ
covetousness => 'kʌvitəsnis
covets => ˈkʌvɪts
covey => 'kʌvi
covin => 'kʌvin
coving => 'kәuviŋ
cow => kau
cow town => kau taun
cowabunga => ,kaʊə'bʌŋgə; ,kɑːwə-
coward => 'kauәd
cowardice => 'kauәdis
cowardly => 'kauәdli
cowards => 'kaʊədz
cowbane => 'kaubein
cowbell => 'kaubel
cowberry => 'kaubәri
cowbird => 'kaubә:d
cowboy => 'kaubɒi
cowboy hat => ˈkaʊˌbɔɪ hæt
cowcatcher => 'kau.kætʃә
cowed => kaʊd
cower => 'kauә
cowered => ˈkaʊəd
cowering => ˈkaʊərɪŋ
cowers => ˈkaʊəz
Cowes => kauz
cowfish => 'kaufiʃ
cowgirl => 'kaugә:l
cowgirls => 'kaʊɡɜːl
cowhand => 'kau.hænd
cowherd => 'kauhә:d
cowhide => 'kauhaid
cowhided => ˈkaʊˌhaɪdid
cowhides => ˈkaʊˌhaɪdz
cowhiding => ˈkaʊˌhaɪdɪŋ
cowl => kau
cowled => kauld
Cowley => 'kauli
cowling => 'kauliŋ
cowls => kaulz
cowman => 'kajmәn
cowpea => 'kaupi:
Cowper => 'kaupә,'ku:pә
cowpoke => 'kajpәjk
cowpox => 'kaupɒks
cowpuncher => 'kau.pʌntʃә
cowrie => 'kajri
cowries => ˈkauriz
cowry => 'kauri
cowshed => 'kauʃed
cowsheds => ˈkauʃedz
cowslip => 'kajslip
cox => kɒks
coxa => 'kɒksә
coxal => 'kɒksәl
coxcomb => 'kɒkskәum
coxcombry => 'kɒkskәumri
coxed => kɔkst
coxes => kɔksiz
coxing => kɔksɪŋ
coxless => 'kɔkslis
coxopodite => kɔk'sɔpә,dait
coxswain => 'kɒkswein
coy => kɒi
coydog => 'kɔidɔ^
coyly => kɔɪlɪ
coyness => kɔɪnəs
coyote => 'kɒiәut
coyotes => kaɪˈəʊti:z
coypu => 'kɔipu:
coz => kʌz
cozen => 'kʌzn
cozenage => 'kʌznidʒ
Cozens => 'kʌz(ə)n
cozily => 'kәuzili
coziness => 'kәuzinis
cozy => 'kәuzi
CPO => sipiəu
crab => kræb
crab apple => kræb ˈæpl
crab stick => kræb stik
crabapple => k'ræbæpl
Crabb => kræb
crabbed => 'kræbid
crabber => 'kræbә
crabbily => 'kræbili
crabby => 'kræbi
crabgrass => 'kræbgrɑ:s
crablike => 'kræblaik
crabmeat => k'ræbmi:t
crabs => kræbz
crabwise => 'kræbwaiz
crack => kræk
crack-ups => 'krækʌp
crackbrained => 'krækbreind
crackdown => 'krækdaun
crackdowns => ˈkrækˌdaʊnz
cracked => krækt
cracker => 'krækә
cracker-barrel => 'krækә,bærәl
crackerjack => 'krækәdʒæk
crackers => 'krækәz
cracking => 'krækiŋ
crackle => 'krækl
crackled => 'krækәld
crackles => ˈkrækəlz
crackling => 'krækliŋ
cracklings => k'ræklɪŋz
crackly => 'krækli
cracknel => 'kræknәl
crackpot => 'krækpɒt
crackpots => ˈkrækpɔts
cracksman => 'kræksmәn
cracksmen => 'kræksmən
cracky => 'kræki
Cracow => 'krækәu
cradle => 'kreidl
cradle-snatch => 'kreidl,snætʃ
cradles => ˈkreidlz
cradling => 'kreidliŋ
craft => kræft
craftier => ˈkræfti:ə
craftily => 'kræftili
craftiness => 'kræftinis
craftsman => 'kræftsmәn
craftspeople => 'krɑ:ftspi:pl
craftsperson => 'krɑ:fts,p\\\\:sәn;'kræfts-
craftswoman => 'krɑ:fts,wjmәn; 'kræfts-
craftwork => 'krɑ:ftw\\\\:k;'kræft-
crafty => 'kræfti
crag => kræg
craggy => 'kræ^i
crags => krægz
cragsman => 'krægzmәn
cragsmen => 'krægzmən
craic => kræk
craig => krei^
Craigavon => krei^'ævәn
Craigie => 'kræ^i
Craik => kreik
Craiova => krә'jәjvә
crake => kreik
cram => kræm
cram-full => 'kræm'fjl
crambo => 'kræmbәu
crammed => kræmd
crammer => 'kræmә
cramming => 'kræmiŋ
cramp => kræmp
cramped => 'kræmpt
cramping => 'kræmpiŋ
crampon => 'kræmpәn
cramps => kræmps
crams => kræmz
cran => 'kræn
cranage => 'kreinidʒ
cranberries => ˈkrænbəriz
cranberry => 'krænbәri
crane => krein
crane fly => krein flai
cranes => kreinz
cranial => 'kreiniәl
craniate => 'kreinieit
cranio- => 'kreiniәj
craniofacial => ,kreiniәj'feiʃәə
craniologist => .kreini'ɒlәdʒist
craniology => .kreini'ɒlәdʒi
craniometry => .kreini'ɒmitri
craniotomy => ,kreini'ɔtәmi
cranium => 'kreiniәm
crank => kræŋk
crankcase => 'kræŋkkeis
crankily => 'kræŋkili
crankiness => 'kræŋkinis
crankpin => 'kræŋkpin
cranks => kræŋks
crankshaft => 'kræŋkʃæft
crankshafts => k'rænkʃɑ:fts
cranky => 'kræŋki
crannied => 'krænid
crannies => ˈkræniz
crannog => 'krænә^
cranny => 'kræni
Cranston => 'krænstәn
crap => kræp
crap game => kræp ɡeim
crape => kreip
crape myrtle => kreip ˈmə:tl
crapola => kræ'pәjlә
crapped => kræp
crapper => 'kræpә
crappie => 'kræpi
crappier => ˈkræpiə
crappy => 'kræpi
craps => kræps
crapshoot => 'kræpʃu:t
crapshooter => 'kræp,ʃu:tә(r)
crapulence => 'kræpjulәns
crapulent => -lәnt
crapulous => 'kræpjjlәs
crapy => 'kreipi
craquelure => 'krækәljә(r)
crash => kræʃ
crash barrier => kræʃ ˈbæriə
crash course => kræʃ kɔː(r)s
crash dive => kræʃ daiv
crash helmet => kræʃ ˈhelmit
crash test => kræʃ test
crash-dive => 'kræʃdaiv
crash-dived => 'kræʃ,daiv
crash-diving => 'kræʃ,daiv
crashed => kræʃt
crasher => 'kræʃә
crashes => kræʃiz
crashing => 'kræʃiŋ
crashworthiness => k'ræʃwɜ:ðɪnəs
crashworthy => 'kræʃ,w\\\\:ði
crasis => 'kreisis
crass => kræs
crasser => kræsə
crassitude => 'kræsitju:d
crassly => kræslɪ
crassness => 'kræsnis
cratch => krætʃ
crate => kreit
crated => kreitid
crateful => k'reɪtfəl
crater => 'kreitә
cratered => k'reɪtərd
cratering => 'kreitәriŋ
craters => ˈkreitəz
crates => kreits
crating => kreitɪŋ
craton => 'kreitɔn
cravat => krә'væt
cravats => krəˈvæts
cravatted => krə'væt
crave => kreiv
craved => kreivd
craven => 'kreivәn
cravenly => 'kreɪvnlɪ
craver => kreiv
craves => kreivz
craving => 'kreiviŋ
craw => krɒ:
crawdad => 'krɔ:dæd
crawfish => 'krɔ:fiʃ
crawl => krɒ:l
crawled => krɔ:ld
crawler => 'krɔ:lә
crawlers => k'rɔ:ləz
crawling => 'krɔ:liŋ
crawls => krɔ:lz
crawlspace => k'rɔ:lspeɪs
crawly => 'krɒ:li
craws => krɔ:s
cray => krei
crayfish => 'kreifiʃ
crayfishes => 'kreɪfɪʃ
crayon => 'kreiәn
crayoned => ˈkreiənd
crayoning => ˈkreiənɪŋ
crayons => ˈkreiənz
craze => kreiz
crazed => kreizd
crazes => kreɪziz
crazies => ˈkreiziz
crazily => 'kreizili
craziness => 'kreizinis
crazing => 'kreiziŋ
crazy => 'kreizi
crazy paving => ˈkreizi ˈpeiviŋ
crazy quilt => ˈkreizi kwilt
creak => kri:k
creaked => kri:kt
creakier => 'kri:ki
creaking => kri:kɪŋ
creaks => kri:ks
creaky => 'kri:ki
cream => kri:m
cream cheese => kri:m tʃi:z
cream cracker => kri:m ˈkrækə
cream soda => kri:m ˈsəudə
cream tea => kri:m ti:
creamer => 'kri:mә(r)
creameries => ˈkri:məriz
creamery => 'kri:mәri
creamier => ˈkri:mi:ə
creamily => k'ri:mɪlɪ
creaminess => 'kri:minis
creamware => 'kri:mweә(r)
creamy => 'kri:mi
crease => kri:s
create => kri:'eit
created => kri: 'eitid
creatine => 'kri:әtin
creatinine => kri:'ætini:n
creation => kri:'eiʃәn
creationism => kri:'eiʃәnizәm
creationist => krɪ'eɪʃnɪst
creative => kri:'eitiv
creative accounting => kriˈeitiv əˈkaʊntɪŋ
creativity => .kri:ei'tiviti
Creator => kri:'eitә(r)
creature => 'kri:tʃә
creaturely => 'kri:tʃәli
creatures => 'kri:tʃəz
creche => kreiʃ
cred => kred
credal => 'kri:dl
credence => 'kri:dәns
credential => kri'denʃәl
credenza => kri'denzә
credibility => .kredi'biliti
credible => 'kredәbl
credibly => 'kredәbli
credit => 'kredit
credit analyst => ˈkredit ˈænəlist
credit crunch => ˈkredit krʌntʃ
creditability => .kreditә'biliti
creditable => 'kreditәbl
creditably => 'kreditәbli
creditor => 'kreditә
credits => 'kredits
creditworthiness => 'kredɪtwɜ:ðɪnəs
credo => 'kri:dәu
credos => ˈkri:dəʊz
credulity => kri'dju:liti
credulous => 'kredʒulәs
credulously => k'redjʊləslɪ
credulousness => 'kredjʊləsnɪs
cree => kri:
creed => kri:d
creedal => 'kri:dәl
creeds => kri:dz
creek => kri:k
creeks => kri:ks
creel => kri:l
creep => kri:p
creep up => kri:p ʌp
creeper => 'kri:pә
creepers => k'ri:pəz
creepie => 'kri:pi
creepier => ˈkri:piə
creepily => k'ri:pɪlɪ
creeping => 'kri:piŋ
creepy => 'kri:pi
creese => kri:s
crema => 'kreɪmə
cremate => 'kri:meit
cremated => ˈkri:ˌmeɪtid
cremates => ˈkri:ˌmeɪts
cremating => ˈkri:ˌmeɪtɪŋ
cremation => kri'meiʃәn
cremations => krə'meʃən
cremator => 'krimeitә
crematoria => ˌkreməˈtɔ:riə
crematorium => ,kremә'tɔ:riәm
crematory => 'kremәtәri
crenate => 'kri:neit
crenated => 'kri:neitid
crenation => kri'neiʃәn
crenel => 'krenәl
crenellate => 'krenileit
crenellated => ˈkrenəleɪtɪd
crenulate => 'krenju:lit, -leit
crenulated => k'rɪnjʊleɪtɪd
creodont => 'kri:әdɔnt
Creole => 'kri:әul
creoles => ˈkriːəʊlz
creolization => kri:әlai'zeiʃәn
creolize => ˈkri:əlaɪz
creosol => 'kriәsɒl
creosote => 'kriәsәut
creosote bush => ˈkriəsəut buʃ
creosoted => 'kriːəsəʊt
creosoting => krɪə'səʊtɪŋ
crepe => kreip
creped => kreɪp
crepes => kreips
creping => k'repɪŋ
crepitant => 'krepitәnt
crepitate => 'krepileit
crepitates => 'krepɪteɪt
crepitating => 'krepɪteɪt
crepitation => .krepi'teiʃәn
crept => krept
crepuscular => kri'pʌskjulә
crescendo => kri:'ʃendәu
Crescent => 'kresәnt
crescent wrench => ˈkresnt rentʃ
crescents => ˈkresnts
cresol => 'kri:sɒl
cress => kres
cresset => 'kresit
Cressida => 'kresidә
crest => krest
crested => 'krestid
crestfallen => 'krest.fɒ:lәn
cresting => 'krestiŋ
crestless => 'krestlis
crests => krests
cresyl => 'kresil
cretaceous => kri'teiʃәs
cretan => 'kri:tәn
crete => kri:t
cretic => 'kri:tik
cretin => 'kretin
cretinism => 'kretinizm
cretinous => 'kretinәs
cretins => ˈkretinz
cretonne => 'kretɒn
crevasse => kri'væs
crevette => krә'vet
crevice => 'krevis
creviced => k'revɪst
crevices => k'revɪsɪz
crew => kru:
crew neck => kru: nek
crewel => 'kru:әl
crewman => 'kru:mәn
crewmate => 'kru:meit
crewmen => 'kruːmən
crib => krib
crib death => krib deθ
cribbage => 'kribidʒ
cribbage board => ˈkribidʒ bɔ:d
cribbed => kribd
cribber => 'kribә
cribbing => 'kribiŋ
cribellate => 'kribileit
cribellum => kri'belәm
cribo => 'kraibәj
cribriform => 'kribrifɒ:m
cribs => kribz
cribwork => 'kribwә:k
Crichton => 'kraitn
crick => krik
cricked => krikt
cricket => 'krikit
cricketer => 'krikitә
cricketers => ˈkrikitəz
cricketing => ˈkrɪkɪtɪŋ
crickets => ˈkrikits
cricking => krikɪŋ
cricks => kriks
cricoid => 'kraikɒid
cried => kraid
crier => 'kraiә
criers => 'kraɪə
crikey => 'kraiki
Crim => krim
crime => kraim
crime wave => kraim weiv
crime-fighter => 'kraim,faitə
Crimea => krai'miә
crimean => krai'miәn
criminal => 'kriminәl
criminalise => 'krimənəlaiz
criminalist => 'krɪmɪnəlɪst
criminalistics => .kriminә'listiks
criminality => .krimi'næliti
criminalizing => k'rɪmɪnəlaɪzɪŋ
criminals => k'rɪmɪnlz
criminological => .kriminә'lɒdʒikl
criminologist => .krimi'nɒlәdʒist
criminology => .krimi'nɒlәdʒi
crimp => krimp
crimped => krɪmpt
crimper => 'krimpә
crimplene => 'krimpli:n
crimps => krimps
crimpy => 'krimpi
crimson => 'krimzәn
cringe => krindʒ
cringed => krɪndʒd
cringer => k'rɪndʒə
cringes => krɪndʒz
cringingly => 'krindʒiŋli
cringle => 'kriŋgl
crinkle => 'kriŋkl
crinkled => ˈkrɪŋkəld
crinkles => ˈkrɪŋkəlz
crinkling => k'rɪŋklɪŋ
crinkly => 'kriŋkli
crinkum-crankum => 'kriŋkәm'kræŋkәm
crinoid => 'krainɒid
Crinoidea => krai'nɔidiә
crinoline => 'krinәlin
crinolines => ˈkrinəli:nz
criollo => kri:'әulәu
crip => krip
cripes => 'kraips
cripple => 'kripl
crippled => 'krɪpld
crippledom => 'kripldәm
cripples => ˈkriplz
crippling => 'kripliŋ
Cripps => krips
crisis => 'kraisis
crisp => krisp
crispate => 'krispeit
crispbread => 'krispbred
crisped => k'rɪspt
crisper => 'krispә(r)
crispier => ˈkrispiə
crispin => 'krispin
crisping => 'krispiŋ
crisply => krɪsplɪ
crispness => krɪspnəs
crispy => 'krispi
criss-cross => ˈkrɪs krɒs
crisscross => 'kriskrɒs
crisscrossed => 'krɪs,krɒs
crisscrosses => 'krɪs,krɒs
crista => 'kristә
cristate => 'kristeit
cristobalite => kris'tәubәlait
crit => krit
criteria => krai'tiәriә
criterion => krai'tiәriәn
critic => 'kritik
critical => 'kritikәl
criticality => kriti'kæliti
critically => 'kritikәli
criticalness => 'krɪtɪkəlnɪs
criticaster => 'kriti.kæstә
criticise => 'kritisaiz
criticised => 'krɪtɪ,saɪz
criticising => 'krɪtɪ,saɪz
criticism => 'kritisizm
criticisms => k'rɪtɪsɪzəmz
criticize => 'kritisaiz
criticized => ˈkritisaizd
criticizes => ˈkritisaiziz
criticizing => ˈkritisaizɪŋ
critique => kri'ti:k
critiques => krɪˈti:ks
critter => 'kritә
critters => 'krɪte
croak => krәuk
croaked => krəʊkt
croaker => 'krәukә
croaking => krəʊkɪŋ
croaks => krəʊks
croaky => 'krәuki
croat => 'krәuәt
Croatia => krәu'eiʃjә
Croatian => krej'әiʃ(ә)n
croc => krɔk
crochet => 'krәuʃei
crocheted => krəʊˈʃeɪd
crocheting => krəʊ'ʃeɪɪŋ
crochets => krəʊˈʃeɪz
croci => 'krәjsai, -kai
crocidolite => krәu'sidәlait
crock => krɒk
crocked => krɔkt
crockery => 'krɒkәri
crocket => 'krɒkit
crockett => 'krɔkit
Crockford => 'krɔkfәd
crockpot => 'krɔkpɔt
crocks => krɔks
crocodile => 'krɒkәdail
crocodile clip => ˈkrɔkədail klip
crocodiles => ˈkrɔkədailz
crocodilian => .krɒkә'diliәn
crocoite => 'krәukәuait
crocus => 'krәukәs
croft => krɒft
crofter => 'krɒftә
Crofters => 'krɔftɚ
crofting => k'rɒftɪŋ
Crohn => 'krɔn
croissant => krwә:'sɑ:nt
croissants => krwɑ:ˈsɑ:ŋz
crombec => 'krɔmbek
Crombie => 'krɔmbi
Cromer => 'krәjmә(r)
Cromerian => krәj'miәriәn
cromlech => 'krɔmlek
Crompton => 'krʌmptәn
cromwell => 'krɔmwәl
cromwellian => krɔm'weljәn
crone => krәun
crones => krəunz
cronies => ˈkrəʊni:z
Cronin => 'krәunin
cronk => krɒŋk
Cronus => 'krәjnәs
crony => 'krәuni
cronyism => 'krәjniizəm
crook => kruk
crookback => 'krukbæk
crooked => 'krukid
crookedly => 'krʊkɪdlɪ
crookedness => k'rʊkɪdnəs
crookery => 'krjkәri
Crookes => kruks
crooking => 'krukiŋ
crookneck => 'kruknek
crooks => krʊks
croon => kru:n
crooned => kru:nd
crooner => 'kru:nә(r)
crooners => ˈkru:nəz
crooning => kru:nɪŋ
croons => kru:nz
crop => krɒp
crop circle => krɔp ˈsə:kl
crop dusting => krɔp ˈdʌstiŋ
crop top => krɔp tɔp
crop-dusting => 'krɔp,dʌstiŋ
cropland => 'krɔplænd
cropper => 'krɒpә
cropping => 'krɔpiŋ
croquembouche => krɔkɔŋ'bu:ʃ
croquet => 'krәukei
croqueted => 'krəʊkeɪ; -kɪ
croqueting => 'krəʊkeɪ; -kɪ
croquets => 'krəʊkeɪ; -kɪ
croquette => krәu'ket
croquettes => krəuˈkets
crore => krɔ:
crosier => 'krәuʒә
cross => krɒs
cross head => krɔs hed
cross oneself => krɔs wʌnˈself
cross over => krɔs ˈəuvə
cross stitch => krɔs stitʃ
cross street => krɔs stri:t
cross- => krɔs,krɔ:s
cross-beam => k'rɒsb'i:m
cross-bencher => krɔs ˈbentʃə
cross-border => 'krɔsbɔ:də
cross-breed => krɔs bri:d
cross-check => krɔs'tʃek; (?@) 'krɔ:s-
cross-checked => krɔs tʃekt
cross-checking => k'rɒstʃ'ekɪŋ
cross-connection => k'rɒskən'ekʃn
cross-contamination => krɔs kənˌtæməˈneʃən
cross-correlation => k'rɒskɒrəl'eɪʃn
cross-country => krɔs'kʌntri; (?@) 'krɔ:s-
cross-cultural => 'krɔs'kʌltʃərəl
cross-cut => k'rɒsk'ʌt
cross-dress => k'rɒsdr'es
cross-dresser => 'krɔ:s'dresə
cross-dressing => krɔs ˈdresiŋ
cross-examinations => 'krɔsig,zæmi'neiʃn
cross-examine => krɔsi^'zæmin; (?@) 'krɔ:s-
cross-eyed => 'krɔsaid; (?@) 'krɔ:s-
cross-fade => 'krɔsfeid
cross-fertilization => krɔs ˌfɚtlɪˈzeʃən
cross-fertilize => krɔs'f\\\\:tilaiz; (?@) 'krɔ:s-
cross-grained => 'krɔs^reind; (?@) 'krɔ:s-
cross-hatch => krɔs hætʃ
cross-legged => krɔs'le^d; (?@) 'krɔ:s-
cross-license => k'rɒsl'aɪsns
cross-link => 'krɔsliŋk
cross-platform => krɔs ˈplætfɔ:m
cross-ply => k'rɒspl'aɪ
cross-pollinate => krɔs'pɔlineit; (?@) 'krɔ:s-
cross-question => krɔs'kwestʃ(ә)n; (?@) 'krɔ:s-
cross-refer => krɔsri'f\\\\:(r); (?@) 'krɔ:s-
cross-reference => 'krɔsrifәrәns; (?@) 'krɔ:s-
cross-referencing => k'rɒsr'efrənsɪŋ
cross-sectional => 'krɔs'sekʃənәl
cross-stitch => 'krɔsstitʃ; (?@) 'krɔ:s-
cross-subsidization => k'rɒssʌbsɪdaɪz'eɪʃn
cross-training => krɔs ˈtreiniŋ
crossbar => 'krɒsbɑ:
crossbars => k'rɒsbɑ:z
crossbeam => 'krɒsbi:m
crossbill => 'krɒsbil
crossbones => 'krɒsbәunz
crossbow => 'krɒsbәu
crossbowman => 'krɒs.bәumәn
crossbows => ˈkrɔ:sˌbəʊz
crossbreed => 'krɒ:sbri:d
crossbreeding => 'krɒsbri:dɪŋ
crossbreeds => ˈkrɔ:sbredz
crosscheck => 'krɔstʃek
crosscurrent => 'krɒs'kʌrәnt
crosscut => 'krɔskʌt
crosscuts => ˈkrɔskʌts
crosscutting => k'rɒskʌtɪŋ
crosse => krɒs
crossed => krɒst
crosses => krɔsiz
crossfire => 'krɔsfaiә
crossflow => 'krɔsflәu
crosshair => 'krɔ:sheə
crosshairs => 'krɔsheәz
crosshatch => 'krɒshætʃ
crosshatched => k'rɒshætʃt
crosshead => 'krɒshed
crossing => 'krɒsiŋ
crossing over => ˈkrɔsiŋ ˈəuvə
crossly => 'krɒsli
crossness => 'krɒsnis
crossopterygian => krɔ,sɔptә'ridʒiәn
crossover => 'krɒsәuvә
crosspatch => 'krɒspætʃ
crosspiece => 'krɒspi:s
crossroad => 'krɒsrәud
crosstalk => 'krɔs,tɔ:k
crosstown => ˌkrɒsˈtaʊn
crosstree => 'krɔ:s,tri:
crosstrees => 'krɔstri:z
crosswalk => 'krɒswɒ:k
crossway => 'krɔswei
crossways => 'krɔsweis; (?@) 'krɔ:s-
crosswind => 'krɒswind
crosswinds => krɒs'wɪndz
crosswise => 'krɒswaiz
crossword => 'krɔswә:d
crosswords => ˈkrɔsˌwɜ:dz
crotch => krɒtʃ
crotches => krɔtʃiz
crotchet => 'krɒtʃit
crotchetiness => 'krɒtʃitinis
crotchets => ˈkrɔtʃits
crotchety => 'krɒtʃiti
croton => 'krәutәn
crouch => 'krautʃ
crouched => krautʃt
crouches => krautʃiz
croup => kru:p
croupade => 'kru:peid
croupier => 'kru:piә
croupiers => ˈkru:piəz
croupy => 'kru:pi
croustade => kru:'stɑ:d
crouton => 'kru:tɔn
croutons => ˈkru:tɔnz
crow => krәu
crowbait => 'krəu,beit
crowbar => 'krәjbɑ:(r)
crowbars => ˈkrəubɑ:z
crowberry => 'krәjbәri
crowd => kraud
crowded => 'kraudid
crowdie => 'krajdi
crowds => kraudz
crowfoot => 'krәu,fut
crowing => krəuɪŋ
crown => kraun
crown colony => kraun ˈkɔləni
crown fire => kraun ˈfaiə
crown gall => kraun gɔ:l
crown imperial => kraun imˈpiəriəl
crowning => 'krauniŋ
crowns => kraunz
crows => krəuz
croydon => 'krɔidәn
croze => krәuz
Crozier => 'krәuʒә
cru => kru:
crubeen => kru:'bi:n
cruces => 'kru:si:z
crucial => 'kru:ʃәl
crucially => ˈkru:ʃɪəlɪ
crucian => 'kru:ʃәn
cruciate => 'kru:ʃiit
cruciate ligament => ˈkru:ʃiit ˈlɪgəmənt
crucible => 'kru:sibl
crucibles => ˈkru:siblz
crucifer => 'kru:sifә
crucified => ˈkru:səˌfaɪd
crucifix => 'kru:sifiks
crucifixes => ˈkru:səˌfɪksiz
crucifixion => ,krusi'fikʃәn
crucifixions => ˌkru:səˈfɪkʃənz
cruciform => 'kru:sifɒ:m
crucify => 'kru:sifai
cruck => krʌk
crud => krʌd
cruddy => 'krʌdi
crude => kru:d
crudely => 'kru:dli
crudeness => 'kru:dnis
cruder => kru:də
crudites => ˈkru:dɪteɪ
crudities => 'kruːdɪtɪ
crudity => 'kru:diti
cruel => 'kru:әl
crueller => ˈkru:ələ
cruelly => 'kru:әli
cruelties => ˈkru:əlti:z
cruelty => 'kru:әlti
cruelty-free => k'ru:əlti:fr'i:
cruet => 'kru:it
cruets => ˈkruits
cruise => kru:z
cruise control => kru:z kənˈtrəul
cruise missile => kru:z ˈmisail
cruised => kru:zd
cruiser => 'kru:zә
cruisers => ˈkru:zəz
cruiserweight => 'kru:zәweit
cruising => 'kru:ziŋ
cruller => 'krʌlә
crumb => krʌm
crumb structure => krʌm ˈstrʌktʃə
crumble => 'krʌmbl
crumbled => ˈkrʌmbld
crumbles => ˈkrʌmblz
crumblier => ˈkrʌmbliə
crumbliness => krʌmblɪ'nəs
crumbly => 'krʌmbli
crumby => 'krʌmi
crumhorn => 'krʌmhɔ:n
crummier => ˈkrʌmiə
crummy => 'krʌmi
crump => krʌmp
crumped => krʌmp
crumpet => 'krʌmpit
crumpets => ˈkrʌmpits
crumping => krʌmp
crumple => 'krʌmpl
crumples => ˈkrʌmplz
crumpling => ˈkrʌmplɪŋ
crumply => 'krʌmpli
crumps => krʌmp
crunch => krʌntʃ
crunched => krʌntʃt
cruncher => k'rʌntʃər
crunches => krʌntʃiz
crunchier => ˈkrʌntʃiə
crunchiness => k'rʌntʃɪnəs
crunching => krʌntʃɪŋ
crunchy => 'krʌntʃi
crupper => 'krʌpә
crura => 'krjәrә
crural => 'kruәrәl
crus => krʌs
crusade => kru:'seid
crusaded => kru:ˈseɪdid
crusader => kru:'seidә
crusading => kru:ˈseɪdɪŋ
cruse => kru:z
crush => krʌʃ
crush bar => krʌʃ bɑ:
crusher => 'krʌʃә
crushes => krʌʃiz
crushing => 'krʌʃiŋ
crushingly => 'krʌʃɪŋlɪ
crusoe => 'kru:sәu
crust => krʌst
Crustacea => krʌs'teiʃjә
crustacean => krʌ'steiʃjәn
crustaceans => krʌs'teɪʃnz
crustaceous => krʌ'steiʃjәs
crustal => 'krʌstәl
crusted => 'krʌstid
crustier => ˈkrʌstiə
crustily => 'krʌstili
crustiness => 'krʌstinis
crustless => k'rʌstles
crustose => 'krʌstәjs
crusts => krʌsts
crusty => 'krʌsti
crutch => krʌtʃ
crutches => krʌtʃiz
crux => krʌks
cry => krai
cry foul => krai faul
cry out for => krai aut fɔ:
crybaby => 'kraibeibi
crying => 'kraiiŋ
cryo- => 'kraiәj
cryobiologist => kraɪəb'ɪɒlədʒɪst
cryobiology => 'kraiәubai'ɔlәdʒi
cryogen => 'kraiәdʒәn
cryogenic => 'kraiәdʒenik
cryogenically => ,kraiə'dʒenik
cryogenics => kraiәj'dʒeniks
cryoglobulin => ,kraiәu'^lɔbjulin
cryolite => 'kraiәlait
cryonics => krai'ɔniks
cryoprecipitate => ,kraiә,pri'sipiteit
cryopreservation => ,kraiә,prezә'veiʃәn
cryoprotectant => kraɪɒprə'tektənt
cryostat => 'kraiәstæt
cryosurgery => ,kraiәu'sә:dʒәri
cryotherapy => 'kraiәuθerәpi
crypt => kript
cryptanalysis => .kriptә'nælәsis
cryptanalyst => krip'tænәlist
cryptic => 'kriptik
cryptically => 'kriptikəli
crypto- => 'kriptәj
cryptobiosis => ,kriptә'baiɔsis
cryptococcosis => ,kriptәukɔk'kәusis
cryptocrystalline => 'kriptәu'kristәlin
cryptogam => 'kriptәugæm
cryptogenic => ,kriptәu'dʒenik
cryptogram => 'kriptәugræm
cryptographer => krip'tɒgrәfә
cryptographic => kriptә'græfik
cryptographically => krɪptə'græfɪklɪ
cryptography => krip'tɒgrәfi
cryptological => ,kriptә'lɔdʒikәl
cryptology => krip'tɔlәdʒi
cryptomeria => .kriptә'miәriә
cryptonym => 'kriptәnim
cryptorchid => krip'tɔ:kid
cryptorchidism => krip'tɔ:kidizәm
cryptosporidiosis => krɪptəʊs'pɔ:rɪdi:əʊsɪs
cryptozoa => ,kriptә'zә uә
cryptozoic => ,kriptәj'zәjik
cryptozoology => krɪptəzu':ɒlədʒɪ
crypts => krɪpts
crystal => 'kristl
crystal ball => ˈkristəl bɔ:l
crystal clear => ˈkristəl kliə
crystal meth => ˈkristəl meθ
crystalize => 'kristәlaiz
crystallin => 'kristәlin
crystalline => 'kristәlain
crystallisation => 'krɪstəlaɪ'zeɪʃən
crystallise => 'kristәlaiz
crystallised => 'kristəlaiz
crystallite => 'kristәlait
crystallization => 'kristәlai'zeiʃәn
crystallize => 'kristәlaiz
crystallized => ˈkrɪstəlaɪzd
crystallizes => ˈkrɪstəˌlaɪziz
crystallography => .kristә'lɒgrәfi
crystalloid => 'kristәlɒid
CS => 'si:,es
ctenidium => ti'nidiәm
ctenoid => 'ti:nɒid
ctenophore => 'tenә,fɔ:, 'ti:nә-
cuadrilla => kwɑː'drɪljə
cuatro => 'kwɑ:trәj
cub => kʌb
cub reporter => kʌb riˈpɔ:tə
Cuba => 'kju:bә
cubage => 'kju:bidʒ
Cuban => 'kju:bәn
cubature => 'kju:bәtʃә
cubbed => kʌb
cubbing => 'kʌbiŋ
cubby => 'kʌbi
cubbyhole => 'kʌbihәul
cube => kju:b
cubeb => 'kju:beb
cubed => kju:bd
cubes => kju:bz
cubic => 'kju:bik
cubical => 'kju:bikәl
cubicle => 'kju:bikl
cubicles => ˈkju:bɪkəlz
cubiform => 'kju:bifɒ:m
cubing => 'kju:biŋ
cubism => 'kju:bizm
cubist => 'kju:bist
cubit => 'kju:bit
cubital => 'kju:bitәl
cubits => 'kjuːbɪt
cubitus => 'kju:bitәs
cuboid => 'kju:bɒid
cuboidal => kju:'bɒidәl
cuckold => 'kʌkәuld
cuckolded => ˈkʌkəldid
cuckolding => ˈkʌkəldɪŋ
cuckoldry => 'kʌkәldri
cuckolds => ˈkʌkəldz
cuckoo => 'kuku:
cuckoo clock => ˈku:ku: klɔk
cuckoo spit => ˈku:ku: spit
cuckooflower => 'kjku:,flajә(r)
cuckoos => ˈku:ku:z
cucumber => 'kju:kәmbә
cucumber mosaic => ˈkju:kʌmbə məʊˈzeɪɪk
cucumbers => k'ju:kʌmbəz
cucurbit => kju'kә:bit
cucurbitaceous => kju.kә:bi'teiʃәs
cud => kʌd
cuddle => 'kʌdl
cuddled => ˈkʌdld
cuddles => ˈkʌdlz
cuddlesome => 'kʌdlsәm
cuddlier => ˈkʌdliə
cuddling => ˈkʌdlɪŋ
cuddly => 'kʌdli
cuddy => 'kʌdi
cudgel => 'kʌdʒәl
cudgelled => 'kʌdʒ(ə)l
cudgelling => 'kʌdʒ(ə)l
cudgels => ˈkʌdʒəlz
cudweed => 'kʌdwi:d
cue => kju:
cue ball => kju: bɔ:l
cue card => kju: kɑ:d
cued => kju:d
cueing => kju':ɪŋ
cueist => 'kju:ist
Cuenca => 'kweŋkɑ:
cues => kju:z
cuesta => 'kwestә
cuff => kʌf
cuff link => kʌf liŋk
cuffed => kʌft
cufflink => ˈkʌflɪŋk
cuirass => kwi'ræs
cuirasses => kwɪ'ræs
cuirassier => .kwirә'siә
cuisine => kwi:'zi:n
cuisse => kwis
cuke => kju:k
cul-de-sac => ,kuldә'sæk
culch => kʌltʃ
culex => 'kju:leks
culicine => 'kju:lisain, -sin
culinary => 'kʌlinәri
cull => kʌl
culled => kʌld
cullender => 'kʌlindә
cullet => 'kʌlit
Cullis => 'kʌlis
culls => kʌlz
cully => 'kʌli
culm => kʌlm
culmen => 'kʌlmәn
culminant => 'kʌlminәnt
culminate => 'kʌlmineit
culminated => ˈkʌlmineitid
culminates => ˈkʌlmineits
culminating => 'kʌlmineitiŋ
culmination => .kʌlmi'neiʃәn
culotte => kju:'lɔt
culottes => kju(:)'lɔts
culpability => .kʌlpә'biliti
culpable => 'kʌlpәbl
culpably => 'kʌlpәbli
culprit => 'kʌlprit
culprits => 'kʌlprɪts
cult => kʌlt
cultch => kʌltʃ
cultigen => 'kʌltidʒen
cultivable => 'kʌltivәbl
cultivar => 'kʌltivɑ:, -'vә
cultivatable => 'kʌltiveitәbl
cultivate => 'kʌltiveit
cultivated => 'kʌltiveitid
cultivates => ˈkʌltiveits
cultivating => ˈkʌltiveitɪŋ
cultivation => .kʌlti'veiʃәn
cultivator => 'kʌltiveitә
cultivators => ˈkʌltəˌveɪtəz
cults => kʌlts
cultural => 'kʌltʃәrәl
culturati => ,kәltʃә'rɑ:ti
culture => 'kʌltʃә
culture shock => ˈkʌltʃə ʃɔk
culture-bound => 'kʌltʃərb'aʊnd
cultured => 'kʌltʃәd
cultus => 'kʌltәs
culverin => 'kʌlvәrin
culvert => 'kʌlvәt
culverts => 'kʌlvəts
cum => kʌm
cumber => 'kʌmbә
cumbered => 'kʌmbə
cumbering => 'kʌmbə
cumberland => 'kʌmbәlәnd
cumbers => 'kʌmbə
cumbersome => 'kʌmbәsәm
Cumbria => 'kʌmbriә
cumbrian => 'kʌmbriәn
cumbrous => 'kʌmbrәs
cumene => 'kju:min
cumin => 'kʌmin
cummerbund => 'kʌmәbʌnd
cummin => 'kʌmin
cummingtonite => 'kʌmiŋtә,nait
cumquat => 'kʌmkwɒt
cumulate => 'kju:mjulit
cumulates => k'ju:mjʊleɪts
cumulating => 'kjuːmjʊleɪt
cumulation => .kju:mju'leiʃәn
cumulative => 'kju:mjulәtiv
cumulonimbus => .kju:mjulә'nimbәs
cumulus => 'kju:mjulәs
Cundy => 'kʌndi
cuneate => 'kju:niit
cuneiform => 'kju:niifɒ:m
Cunene => ku:'neinə
cunner => 'kʌnә(r)
cunnilingus => kʌni'liŋ^әs
cunning => 'kʌniŋ
cunningham => 'kʌniәm
cunt => kʌnt
cunts => kʌnts
cup => kʌp
cup fungus => kʌp ˈfʌŋɡəs
cupboard => 'kʌpbɒ:d
cupboard love => ˈkʌbəd lʌv
cupboards => 'kʌbədz
cupcake => 'kʌpkeik
cupel => 'kju:pәl
cupellation => .kju:pә'leiʃәn
cupful => 'kʌpful
cupfuls => ˈkʌpˌfʊlz
Cupid => 'kju:pid
cupidity => kju:'piditi
cupola => 'kju:pәlә
cupolas => ˈkju:pələz
cuppa => 'kʌpә
cuppas => ˈkʌpəz
cupped => kʌpt
cupping => 'kʌpiŋ
cuppy => 'kʌpi
cupr- => kju:pr
cupreous => 'kju:priәs
cupric => 'kju:prik
cuprite => 'kju:prait
cupro- => 'kju:prәj
cuprous => 'kju:prәs
cupule => 'kju:pju:l
cur => kә:
curability => .kjurә'biliti
curable => 'kjurәbl
curacies => 'kjʊərəsɪ
curacy => 'kjurәsi
curare => kjjә'rɑ:ri
curassow => 'kjurәsәu
curate => 'kjurit
curates => ˈkjuərits
curation => ˌkjuːˈreɪʃən
curative => 'kjurәtiv
curator => kjuә'reitә
curatorial => .kjurә'tɒ:riәl
curators => kjʊˈreɪtəz
curatorship => kju'reitәʃip
curb => kә:b
curb roof => kə:b ru:f
curbed => kə:bd
curbing => 'kә:biŋ
curbs => kə:bz
curbside => 'k\\\\:bsaid
curbstone => 'kә:bstәun
curculio => kә:'kju:liәu
curcuma => 'kә:kjumә
curd => kә:d
curd cheese => kɜ:d tʃi:z
curded => kɜːd
curdle => 'kә:dl
curdled => ˈkɜ:dld
curdles => ˈkɜ:dlz
curdling => 'kә:dliŋ
curds => 'kɜ:dz
curdy => 'kә:di
cure => kjuә
cured => 'kjuәd
curer => 'kjuәrә
curettage => ,kjuәri'tɑ:dʒ, kju'retidʒ
curette => kjuә'ret
curfew => 'kә:fju:
curfews => 'kɜ:fju:z
curia => 'kjuәriә
curie => 'kjuәri
curing => 'kjuәriŋ
curio => 'kjuәriәu
curios => 'kjʊəri:ˌəʊθ
curiosa => .kjuәri'әusә
curiosities => ˌkjuəriˈɔsitiz
curiosity => .kjuәri'ɒsiti
curious => 'kjuәriәs
curiouser => 'kjʊərɪəs
curiously => 'kjuәriәsli
curiousness => 'kjʊərɪənɪs
Curitiba => ,kjәri'ti:bә
curium => 'kjuәriәm
curl => kә:l
curler => 'kә:lә
curlers => ˈkə:ləz
curlew => 'kә:lu:
curlicue => 'k\\\\:likju:
curlier => ˈkɜ:li:ə
curliness => 'kә:linis
curling => 'kә:liŋ
curling tongs => ˈkə:liŋ tɔ:ŋz
curls => kə:lz
curly => 'kә:li
curly endive => ˈkɜ:li: ˈendiv
curmudgeon => kә:'mʌdʒәn
currach => 'kʌrәk
curragh => 'kʌrә
currajong => 'kʌrәdʒɔŋ,'k\\\\:-
currant => 'kʌrәnt
currants => 'kʌrənts
currawong => 'kʌrәwɔŋ
currencies => ˈkʌrənsiz
currency => 'kʌrәnsi
current => 'kʌrәnt
currently => 'kʌrәntli
curricle => 'kʌrikl
curricula => kә'rikjulә
curricular => kә'rikjulә
curriculum => kә'rikjulәm
curriculum vitae => 'vi:tai
Currie => 'k ʌri
curried => 'kʌrid;'k\\\\:rid
currier => 'kʌriә
currish => 'kә:riʃ
currishly => 'kə:riʃli
curry => 'kʌri. 'kә:ri
curry favour => ˈkɜ:ri: ˈfeivə
curry powder => ˈkɜ:ri: ˈpaudə
curse => kә:s
cursed => kә:st
curses => kə:siz
cursillo => kjә'si:ljәj
cursing => 'k\\\\:siŋ
cursive => 'kә:siv
cursor => 'kә:sә
cursorial => kә:'sɒ:riәl
cursorily => 'kә:sәrili
cursoriness => 'kә:sәrinis
cursors => ˈkɜ:səz
cursory => 'kә:sәri
curst => kә:st
curt => kә:t
curtail => kә:'teil
curtailing => kə:ˈteilɪŋ
curtailment => kә: 'teilmәnt
curtails => kə:ˈteilz
curtain => 'kә:tәn
curtain ring => ˈkə:tn riŋ
curtain wall => ˈkə:tn wɔ:l
curtain-up => 'k\\\\:tәn,ʌp
curtained => 'kɜːtənd
curtains => 'kә:tәnz
curtal => 'kә:tl
curtana => kә:'tɑ:nә
curtilage => 'kә:tilidʒ
curtis => 'kә:tis
curtly => 'kә:tli
curtness => 'kә:tnis
curtsey => 'k\\\\:tsi
curtsied => ˈkɜ:tsi:d
curtsies => ˈkɜ:tsi:z
curtsy => 'kә:tsi
curtsying => ˈkɜ:tsi:ɪŋ
curule => 'kjuәru:l
curvaceous => kә:'veiʃәs
curvature => 'kә:vәtʃә
curve => kә:v
curvet => kә:'vet
curvets => kɜː'vet
curvetted => kɜː'vet
curvetting => kɜː'vet
curvilinear => .kә:vi'liniә
curving => 'kә:viŋ
curvy => 'kә:vi
cuscus => 'kʌskʌs
cusec => 'kju:sek
cush => kuʃ
cush-cush => 'ku:ʃ,ku:ʃ
cushat => 'kʌʃәt
cushaw => kә'ʃɔ:
cushier => ˈkuʃiə
cushing => 'kuʃiŋ
cushion => 'kuʃәn
cushions => ˈkuʃənz
cushiony => 'kjʃәni
Cushitic => kʌ'ʃitik, kuʃ-
cushy => 'kuʃi
cusk => kʌsk
cusp => kʌsp
cuspate => 'kʌspit, -peit
cusped => kʌspt
cuspid => 'kʌspid
cuspidate => 'kʌspideit
cuspidor => 'kʌspidɒ:
cuss => kʌs
cussed => 'kʌsid
cussedness => ˊkʌsidnis
cusses => kʌsiz
cussing => kʌsɪŋ
custard => 'kʌstәd
custard apple => ˈkʌstəd ˈæpl
custard pie => ˈkʌstəd pai
custard powder => ˈkʌstəd ˈpaudə
custer => 'kʌstә
custodial => kʌ'stәudjәl
custodian => kʌ'stәudjәn
custodians => kʌˈstəʊdi:ənz
custody => 'kʌstәdi
custom => 'kʌstәm
custom-built => 'kʌstәm'bilt
customarily => 'kʌstәmәrili
customary => 'kʌstәmәri
customer => 'kʌstәmә
customisation => 'krstemi'seifen
customise => 'kʌstәmaiz
customised => 'kʌstəmaɪz
customize => kʌstәmaiz
customizes => ˈkʌstəˌmaɪziz
custumal => 'kʌstjjmәl
cut => kʌt
cut-and-come-again => 'kʌtәnd'kʌmә'^en
cut-in => 'kʌtin
cut-out => kʌt aut
cut-up => 'kʌtˌʌp
cutaneous => kju:'teinjәs
cutaway => 'kʌtә.wei
cutback => 'kʌtbæk
cutbacks => ˈkʌtˌbæks
cutch => kʌtʃ
cute => kju:t
cutely => kju:tlɪ
cuteness => kju:tnəs
cutesy => 'kju:tsi
cutey => 'kju:ti
Cuthbert => 'kʌθbәt
cuticle => 'kju:tikl
cuticular => kju:'tikjulә
cutie => 'kju:ti
cutin => 'kju:tin
cutis => 'kju:tis
cutlass => 'kʌtlәs
cutlasses => ˈkʌtləsiz
cutlassfish => 'kʌtləsfɪʃ
cutler => 'kʌtlә
cutlery => 'kʌtlәri
cutlet => 'kʌtlit
cutlets => ˈkʌtlits
cutline => 'kʌtlain
cutoff => 'kʌtɒf
cutout => 'kʌtaut
cutouts => 'kʌt,aʊt
cutover => 'kʌtәuvә
cutpurse => 'kʌtpә:s
cutter => 'kʌtә
cutthroat => 'kætθru:t
cutthroats => 'kʌt,θrəʊt
cutting => 'kʌtiŋ
cutting board => ˈkʌtɪŋ bɔ:d
cutting edge => ˈkʌtɪŋ edʒ
cutting room => ˈkʌtɪŋ ru:m
cutting-edge => 'kʌtɪŋ'edʒ
cuttle => 'kʌtl
cuttlebone => 'kʌtlbәun
cuttlefish => 'kʌtlfiʃ
cutty => 'kʌti
cutwater => 'kʌt.wɒ:tә
cutwork => 'kʌtwә:k
cutworm => 'kʌtwә:m
cuvette => kju:'vet
cuvier => 'kju:viei
cuzco => 'ku:skәu
Cwm => ku:m
cwt => 'si:d'əbəlju:t'i:
cyan => 'saiæn
cyanamide => sai'ænәmaid
cyanate => 'saiәneit
cyanic => s ai'ænik
cyanide => 'saiәnaid
cyaniding => 'saiәnaidiŋ
cyano- => 'saiәnәj,sai'ænәj
cyanoacrylate => ,saiәnәu'ækrileit
cyanobacteria => saɪænɒ'bæktɪərɪə
cyanocobalamin => ,saiәnәukә'bælәmin
cyanogen => sai'ænәdʒin
cyanogenesis => ,saiænә'dʒenisis
cyanogenic => ,saiәnәj'dʒenik
cyanohydrin => ,saiәnәu'haidrin
cyanosis => .saiә'nәusis
cyanotic => ,saiә'nɔtik
cyathium => sai'æθiәm
Cybele => 'sibili
cyber => 'saibә
cyber- => ˈsaɪbə(r)
cybercafe => ˈsaɪbəkæfeɪ
cybernate => 'saibәneit
cybernated => 'saɪbəneɪt
cybernates => 'saɪbəneɪt
cybernating => 'saɪbəneɪt
cybernetic => .saibә'nætik
cybernetician => ,saibәnә'tiʃәn
cyberneticist => ,saibә'netisist
cybernetics => ,saibә:'netiks
cyberphobia => ˈsaibəˈfəubiə
cyberpunk => ˈsaɪbəpʌŋk
cybersquatting => ˈsaɪbəskwɒtɪŋ
cyberterrorism => saɪbə'terərɪzəm
cyberworld => 'saibə,wə:ld
cyborg => 'saibɔ:^
cyborgs => ˈsaibɔ:ɡz
cycad => 'saikæd
Cyclades => 'siklәdi:z
Cycladic => si'klædik
cyclamate => 'saiklәmeit
cyclamen => 'siklәmәn
cyclamens => ˈsikləmənz
cyclase => 'sikleis
cycle => 'saikl
cycle rickshaw => ˈsaikl ˈrɪkʃɔ:
cycleway => saɪk'lu:eɪ
cyclic => 'saiklik
cyclical => 'siklik(e)l
cyclin => 'saɪklɪn
cycling => 'saikliŋ
cyclist => 'saiklist
cyclists => 'saɪklɪsts
cyclization => ,saikli'zeiʃәn
cyclize => 'saiklaiz
cyclo => 'si:klәu, 'saiklәu
cyclo-cross => ˈsaɪkləʊ krɒs
cycloaddition => ,saiklәuә'diʃәn
cycloalkane => ,saiklәj'ælkein
cyclohexane => ,saiklәu'heksein
cyclohexyl => ,saiklәu'heksil
cycloid => 'saiklɒid
cycloidal => sai'klɒidәl
cyclometer => sai'klɒmitә
cyclone => 'saiklәun
cyclones => 'saɪkləʊnz
cyclonic => saɪ'klɒnɪk
cycloparaffin => saiklәu'pærәfin
cyclopedia => ,saiklәu'pi:djә
cyclopedic => ,saiklәj'pi:dik
cyclophosphamide => ,saiklәu'fɔsfæmaid
cyclopropane => ,saiklәu'prәupein
cyclops => 'saiklɔps
cyclorama => .saiklә'rɑ:mә
cycloramic => .saiklә'ræmik
cyclostome => 'saiklәstәjm
cyclostyle => 'saiklәstail
cyclostyled => 'saikləu,stail
cyclostyles => 'saikləu,stail
cyclostyling => 'saikləu,stail
cyclothymia => .saiklә'θaimiә
cyclothymic => ,saiklә'θaimik
cyclotron => 'saiklә,trɔn
cyder => 'saidә
cygnet => 'signit
cygnets => ˈsɪgnɪts
Cygnus => 'si^nәs
cylinder => 'silindә
cylinder lock => ˈsilində lɔk
cylinder seal => ˈsilində si:l
cylinders => 'sɪlɪndəz
cylindrical => si'lindrik(ә)l
cymbal => 'simbl
cymbals => 'simbәlz
Cymbeline => 'simbili:n
cymbidium => sim'bidiәm
cyme => saim
cymose => 'saimәjs
Cymric => 'kimrik
Cynewulf => 'kinәwjlf
cynic => 'sinik
cynical => 'sinikәl
cynicism => 'sinisizm
cynics => ˈsɪnɪks
cynodont => 'sainәudɔnt
cynosure => 'sinә.zjuә
Cynthia => 'sinθjә
cypher => 'saifә
cyphers => 'saɪfə
cypress => 'saiprәs
cypresses => ˈsaɪprɪsiz
Cyprian => 'sipriәn
cyprinid => si'prainid
cyprinoid => 'siprinɒid
Cypriot => 'sipriәt
cypripedium => ,sipri'pi:diәm
Cyprus => 'saiprәs
cypsela => 'sipsәlә
Cyrenaic => ,saiәri'neiik
Cyrenaica => ,sirә'neiikә
Cyrenaicism => ,sirә'neiisizәm
cyril => 'siril
Cyrillic => si'rilik
cyrus => 'saiәrәs
cyst => sist
cystectomy => sis'tektәmi
cysteine => 'sistin
cystic => 'sistik
cystic fibrosis => ˌsɪstɪk faɪˈbrəʊsɪs
cysticercoid => ,sisti'sә:kɔid
cysticercus => .sisti'sә:kәs
cystine => 'sisti:n, -tin
cystitis => sis'taitis
cystoscope => 'sistәskәup
cystoscopic => .sistә'skɒpik
cystoscopy => sis'tɔskәpi
cystotomy => sis'tɒtәmi
cysts => sists
Cytherea => ,siθә'ri(:)ә
Cytherean => ,siθә'ri(:)әn
cytidine => 'saitәdin
cytoarchitectonic => saɪtɔ:tʃɪtek'tɒnɪk
cytoarchitectonics => ,saitәuɑ:kitek'tɔniks
cytoarchitectural => saɪtɔ:tʃɪ'tektʃərəl
cytoarchitecture => ,saitәu'ɑ:kitektʃә
cytocentrifuge => 'sɪtəʊsentrɪfju:dʒ
cytochrome => 'saitәukrәum
cytogenetic => ,saitәjdʒi'netik
cytogenetical => sɪtəʊdʒɪ'netɪkəl
cytogenetically => sɪtəʊdʒɪ'netɪklɪ
cytogeneticist => saɪtəʊdʒɪ'netɪsɪst
cytogenetics => ,saitәudʒi'netiks
cytokine => ˌsɪtə'kɪn
cytokinesis => ,saitәukai'ni:sis
cytokinin => 'saitәu'kinin
cytological => saɪ'tɒlədʒɪkl
cytologist => sai'tɒlәdʒist
cytology => sai'tɒlәdʒi
cytolysis => sai'tɒlisis
cytomegalic => ,saitәmi'^ælik
cytomegalovirus => ,saitә,me^әlәu'vaiәrәs
cytophotometer => ,saitәufә'tɔmitә
cytophotometry => ,saitәfәj'tɔmitri
cytoplasm => 'saitәplæzm
cytoplasmic => .saitә'plæzmik
cytosine => 'saitәsi:n
cytosol => 'saitәusɔl
cytosolic => 'saɪtəzəlɪk
cytotoxic => ,saitә'tɔksik
cytotoxicity => ,saitəutɔk'sisiti
czar => zɑ:
czardas => 'tʃɑ:dæʃ
czarina => zɑ:'ri:nә
czarist => 'zɑ:rist
Czech => tʃek
Czechoslovak => 'tʃekәu'slәuvæk
Czechoslovakia => .tʃekәuslәu'vækiә
Czechoslovakian => 'tʃekәuslәu'vækiәn
czechs => tʃeks