C => si:
C-section => 'si:,sekʃən
Caaba => 'kɑ:bә
caatinga => 'kɑ:tɪnɡə
cab => kæb
cabal => kә'bæl
cabaletta => ,kæbә'letә
cabalistic => ,kæbә'listik
caballed => kə'bæl
caballero => .kæbә'lєәrәu
caballing => kә'bæliŋ
cabals => kəˈbælz
cabana => kә'bɑ:nә
cabaret => 'kæbәrei
cabarets => ˌkæbəˈreɪz
cabbage => 'kæbidʒ
cabbage palm => ˈkæbidʒ pɑ:m
cabbage tree => ˈkæbidʒ tri:
cabbage white => ˈkæbidʒ hwait
cabbaged => ˈkæbɪdʒ
cabbages => ˈkæbidʒz
cabbageworm => 'kæbidʒw\\\\:m
cabbaging => ˈkæbɪdʒ
cabbagy => 'kæbɪdʒɪ
cabbalism => ˊkæbәlizәm
cabbalist => ˊkæbәlist
cabbalistic => kæbәˊlistik
cabbed => kæbd
cabbie => ˈkæbi
cabbies => 'kæbɪz
cabbing => kæbɪŋ
cabby => 'kæbi
cabdriver => 'kæb,draivә(r)
caber => 'keibә
Cabernet => 'kæbәrnei
cabezon => 'kæbizɔn
cabin => 'kæbin
cabin crew => ˈkæbin kru:
cabin cruiser => ˈkæbin ˈkru:zə
cabin fever => ˈkæbin ˈfi:və
Cabinda => kә'bindә
cabinet => 'kæbinit
cabinet-maker => 'kæbɪnətm'eɪkər
cabinetmaker => 'kæbinit.meikә
cabinetmaking => 'kæbinit,meikiŋ
cabinetry => 'kæbɪnətrɪ
cabinets => 'kæbɪnəts
cabins => ˈkæbinz
cable => 'keibl
cable railway => ˈkeibl ˈreilwei
cable stitch => ˈkeibl stitʃ
cable-laid => 'keiblleid
cablegram => 'keiblgræm
cableway => 'keiblwei
cabling => 'keibliŋ
cabman => 'kæbmәn
cabochon => kæbɔ'ʃɔŋ
caboodle => kә'bu:dl
caboose => kә'bu:s
caboshed => kә'bɔʃt
cabot => 'kæbәt
cabotage => 'kæbәtɑ:ʒ
cabriole => 'kæbriәul
cabriolet => .kæbriәu'lei
cabs => kæbz
cabstand => 'kæbstænd
cacao => kә'kɑ:әu
cacciatore => ,kætʃi'tɔ:ri
cachaca => kɑ:'tʃɑ:sɑ:
cachalot => 'kæʃәlɒt
cache => kæʃ
cachectic => kә'kektik
cached => kæʃt
cachepot => 'kæʃpɔt
cachet => kæ'ʃei
cachexia => kә'kesiә
cachinnate => 'kækineit
cachinnated => ˈkækineitid
cachinnating => ˈkækineitɪŋ
cachinnation => kæki'neiʃәn
cachou => kә'ʃu:, kæ'ʃu:
cachucha => kә'tʃu:tʃә
cacique => kæ'si:k
cack => kæk
cack-handed => ˌkæk ˈhændɪd
cackle => 'kækl
cackled => ˈkækəld
cackles => ˈkækəlz
cackling => ˈkækəlɪŋ
cacodemon => ,kækә'di:mәn
cacodyl => 'kækәdil
cacodylate => ,kækә'dileit
cacoethes => .kækәu'i:θi:z
cacographer => kæ'kɒgrәfә
cacography => kæ'kɔ^rәfi
cacology => kæ'kɒlәdʒi
cacomistle => 'kækә,misl
cacophonous => kæ'kɒfәnәs
cacophony => kæ'kɒfәni
cactaceous => kæk'teiʃәs
cacti => 'kæktai
cactus => 'kæktәs
cacuminal => kә'kju:minl
cad => kæd
cadastral => kә'dæstrәl
cadaver => kә'deivә
cadaverous => kә'dævәrәs
cadavers => kəˈdævəz
Cadbury => 'kædbəri
caddie => 'kædi
caddied => ˈkædid
caddies => ˈkædiz
caddis => 'kædis
caddish => 'kædiʃ
Caddoan => 'kædәjәn
caddy => 'kædi
caddying => ˈkædiŋ
cade => keid
cadelle => kә'del
cadence => 'keidns
cadenced => 'keidәnst
cadences => ˈkeidənsiz
cadency => 'keidәnsi
cadential => kei'denʃәl
cadenza => kә'denzә
cadenzas => kəˈdenzəz
cadet => kә'det
cadets => kəˈdets
cadetship => kә'detʃip
cadge => kædʒ
cadged => kædʒd
cadger => 'kædʒә
cadges => kædʒz
cadging => kædʒɪŋ
cadi => 'kɑ:di
Cadillac => 'kædilæk
Cadmean => kæd'mi:әn
cadmium => 'kædmiәm
Cadmus => 'kædmәs
cadre => 'kædri.'kɑ:dә
cadres => ˈkædri:z
cads => kædz
caduceus => kә'dju:siәs
caducity => kә'dju:siti
caducous => kә'dju:kәs
caecal => 'si:kәl
caecilian => si:'siliәn
caecitis => si:'saitis
caecum => 'si:kәm
Caedmon => 'kædmәn
Caelum => 'si:lәm
Caen => si:n
Caernarvon => kɑ:'nɑ:vәn
Caerphilly => keә'fili
Caesar => 'si:zә
Caesarean => si'zєәriәn
caesarian => si'zεәriәn
caesium => 'si:ziәm
caesium clock => ˈsi:ziəm klɔk
caesura => si:'zjuәrә
caesural => saɪ'zərəl
cafard => kә'fɑ:
cafe => kɑ:'fei
cafe noir => ˈkæfei nwɑ:
cafeteria => .kæfi'tiәriә
caff => kæf
caffeinated => ˈkæfɪneɪtɪd
caffeine => 'kæfi:n
caftan => 'kæftәn
cage => keidʒ
cages => keidʒz
cagey => 'keidʒi
cagily => 'keɪdʒɪlɪ
caginess => 'keɪdʒɪnəs
caging => 'keidʒiŋ
Cagliari => kæ'ljɑ:ri
cagoule => 'kæ^әul
cagoules => 'kægəul
cahier => kɑ:'jei
cahill => 'kɑ:hil
cahoot => kә'hu:t
cahoots => kә'hu:ts
cahow => kә'haj
caiman => 'keimәn
cain => kein
Cainozoic => kainә'zәuik, 'kei-
caique => kai'i:k
caird => kєәd
Cairene => 'kaiәri:n
cairn => kєәn
cairngorm => 'kєәngɒ:m
Cairo => 'kaiәrәu
caisson => 'keisn
Caithness => 'keiθnes
caitiff => 'keitif
cajole => kә'dʒәul
cajoled => kəˈdʒəʊld
cajolement => keɪd'ʒɒlmənt
cajolery => kә'dʒәulәri
cajoles => kəˈdʒəʊlz
cajoling => kəˈdʒəʊlɪŋ
cajun => 'keidʒәn
cajuput => 'kædʒәpәt
cake => keik
caked => keɪkt
cakewalk => 'keikwɒ:k
cakewalked => ˈkeikˌwɔ:kt
cakewalking => ˈkeikˌwɔ:kɪŋ
cakewalks => ˈkeikˌwɔ:ks
caking => 'keikiŋ
CAL => kæl
calabash => 'kælәbæʃ
calabaza => ,kælə'bɑ:zə
calaboose => 'kælәbu:s
calabrese => ,kælə'breizi
Calabria => kә'leibriә
Calabrian => ,kә'leibriәn
caladium => kә'leidiәm
calais => 'kælei
calamanco => kælә'mæŋkәu
calamander => kælә'mændә
calamari => merɪ
calamine => 'kælәmain
calamint => 'kælәmint
calamities => kəˈlæmitiz
calamitous => kә'læmitәs
calamitously => kәˊlæmitәsli
calamity => kә'læmiti
calamondin => kælә'mɔndin
calamus => 'kælәmәs
calando => kә'lændәu
calash => kә'læʃ
calc- => kælk
calcaneus => kæl'keiniәs
calcareous => kæl'keәriәs
calceolaria => kælsiә'leәriә
calces => 'kælsi:z
calci- => 'kælsi
calcic => 'kælsik
calcicole => 'kælsikәul
calcicolous => 'kælsɪkʌləs
calciferol => kæl'sifәrәul
calciferous => kæl'sifәrәs
calcific => kæl'sifik
calcification => kælsәfi'keiʃәn
calcifications => ,kælsɪfɪ'keɪʃən
calcified => ˈkælsəˌfaɪd
calcifies => ˈkælsəˌfaɪz
calcifuge => 'kælsifju:dʒ
calcify => 'kælsifai
calcifying => ˈkælsəˌfaɪŋ
calcimine => 'kælsimain
calcination => kælsi'neiʃәn
calcine => 'kælsain
calcined => kæl'si:nd
calcines => ˈkælsainz
calcite => 'kælsait
calcitonin => ,kælsi'tәunin
calcium => 'kælsiәm
calcrete => 'kælkrit
calculability => .kælkjulә'biliti
calculable => 'kælkjulәbl
calculably => ˊkælkjulәbli
calculate => 'kælkjuleit
calculated => 'kælkjuleitid
calculatedly => 'kælkjʊleɪtɪdlɪ
calculates => ˈkælkjuleits
calculating => 'kælkjuleitiŋ
calculation => .kælkju'leiʃәn
calculative => 'kælkjulәtiv
calculator => 'kælkjuleitә
calculus => 'kælkjulәs
Calcutta => kæl'kʌtә
caldarium => kæl'deәriәm
calder => 'kɔ:ldә
caldera => kæl'dєәrә
caldron => 'kɒ:ldrәn
caldwell => 'kɔ:ldwәl
caleb => 'kælәb
caleche => 'keɪlɪʃ
Caledonia => ,kæli'dәunjә
Caledonian => .kæli'dәuniәn
calefacient => .kæli'feiʃәnt
calendar => 'kælindә
calendared => 'kælɪndə
calendars => ˈkælindəz
calender => 'kælindә
calendered => ˈkælindəd
calenders => ˈkælindəz
calendric => kæ'lendrik
calendrical => kə'lendrikəl
calends => 'kælindz
calendula => kæ'lendjulә
calenture => 'kælәn.tjuә
calf => kɑ:f
calfskin => 'kɑ:fskin
calgary => 'kæl^әri
Caliban => 'kælibæn
caliber => 'kælibә
calibrate => 'kælibreit
calibrates => ˈkæləˌbreɪts
calibrating => ˈkæləˌbreɪtɪŋ
calibration => .kæli'breiʃәn
calibrator => 'kælibreitә
calibre => 'kælibә
calibres => ˈkæləbəz
caliche => kɑ:'li:tʃi
calico => 'kælikәu
Calicut => 'kælikәt
California => .kæli'fɒ:njә
Californian => .kæli'fɒ:njәn
californians => ,kæli'fɔ:njən
californium => .kæli'fɒ:niәm
caliginous => kә'lidʒinәs
Caligula => kə'liɡjulə
caliper => 'kælipә
calipers => 'kælipәz
caliph => 'kælif
caliphate => 'kælifeit
caliphs => ˈkeɪlɪfs
calisthenic => kælis'θenik
calisthenics => kælis'θeniks
calix => 'keiliks
calk => kɒ:k
call => kɒ:l
call centre => kɔ:l ˈsentə
call girl => kɔ:l ɡə:l
call-in => 'kɔ:lin
call-over => 'kɔ:l,әjvә(r)
calla => 'kælә
callable => 'kɒ:lәbl
callaloo => ,kælə'luː
callan => 'kælәn
Callao => kɑ:'jɑ:әu
callas => ˈkæləz
callback => 'kɒ:lbæk
caller => 'kɒ:lә
callers => ˈkɔ:ləz
calligraph => 'kæli^rɑ:f
calligrapher => kә'ligrәfә
calligraphic => .kæli'græfik
calligraphist => kә'li^rәfist
calligraphy => kә'ligrәfi
calling => 'kɒ:liŋ
Calliope => kә'laiәpi
calliper => 'kælipә
callipers => 'kælipәs
callipygian => ,kæli'pidʒiәn
callipygous => ˌkæliˈpaiɡəs
callisthenic => , kælis'θenik
callisthenics => .kælis'θeniks
callop => 'kælәp
callosity => kæ'lɒsiti
callous => 'kælәs
calloused => ˈkæləst
callouses => ˈkæləsiz
callousing => ˈkæləsɪŋ
callously => 'kæləsli
callousness => 'kæləsnis
callow => 'kælәu
callowness => 'kæləunis
callus => 'kælәs
calluses => ˈkæləsiz
calm => kɑ:m
calmative => 'kælmәtiv
calmed => kɑ:md
calmly => 'kɑ:mli
calmness => 'kɑ:mnis
calms => kɑ:mz
calomel => 'kælәmel
calor => 'kælә(r)
caloric => kә'lɒrik
calorically => kə'lɒrɪklɪ
calorie => 'kælәri
calorific => .kælә'rifik
calorimeter => .kælә'rimitә
calorimetric => ,kæləri'metrik
calorimetry => .kælә'rimitri
calory => 'kælәri
calotype => 'kælәtaip
calque => kælk
caltrop => 'kæltrәp
calumet => 'kæljumet
calumniate => kә'lʌmnieit
calumniated => kəˈlʌmni:ˌeɪtid
calumniates => kəˈlʌmni:ˌeɪts
calumniating => kəˈlʌmni:ˌeɪtɪŋ
calumniation => kә.lʌmni'eiʃәn
calumniator => kә'lʌmnieitә
calumnies => ˈkæləmni:z
calumnious => kә'lʌmniәs
calumny => 'kælәmni
calutron => 'kæljutrɒn
calvados => 'kælvәdɒs
Calvary => 'kælvәri
calve => kɑ:v
calved => kɑ:vd
Calver => 'kɑ:vә
calvert => 'kælvә(:)t, 'kɔ:lvәt
calves => kɑ:vz;kævz
calvin => 'kælvin
calving => 'kɑ:viŋ
Calvinism => 'kælvinizm
Calvinist => 'kælvinist
Calvinistic => ,kælvi'nistik
calx => kælks
calypso => kә'lipsәu
calypsonian => kə'lɪpsʌnjən
calypsos => kə'lɪpsəʊz
calyx => 'keiliks
calyxes => ˈkeiliksiz
calzone => 'kælzәun
cam => kæm
camaraderie => .kæmә'rɑ:dәri:
camarilla => kæmә'rilә
camber => 'kæmbә
cambered => 'kæmbəd
cambering => 'kæmbәriŋ
cambers => ˈkæmbəz
Camberwell => 'kæmbәwәl
cambial => 'kæmbaɪəl
cambium => 'kæmbiәm
Cambodia => kæm'bәudiә
cambodian => kæm'bәjdiәn
cambodians => kæm'bəʊdɪən
Cambrian => 'kæmbriәn
cambric => 'keimbrik
Cambridge => 'keimbridʒ
Cambridge blue => 'keimbridʒ
Cambridgeshire => 'keimbridʒʃә
camcorder => kæm'kɔ:dә
camcorders => ˈkæmkɔ:dəz
camden => 'kæmdәn
came => keim
camel => 'kæml
camel hair => ˈkæməl hɛə
camelback => 'kæmәlbæk
cameleer => .kæmi'liә
camelhair => 'kæməlhεə
camelid => 'kæməlid
camellia => kә'mi:ljә
camellias => kəˈmi:ljəz
camelopard => 'kæmilәpɑ:d
Camelopardalis => kә,milә'pɑ:dәlis
Camelot => 'kæmilɒt
camels => 'kæməlz
camembert => 'kæmәmbeә(r)
cameo => 'kæmiәu
cameos => ˈkæmi:ˌəʊz
camera => 'kæmәrә
camera lucida => 'lu:sidә
camera obscura => ɔb'skjjәrә
camera-shy => 'kæmәrәʃai
cameraman => 'kæmәrәmæn
cameramen => 'kæmən
camerawork => 'kæmәrәw\\\\:k
cameron => 'kæmәrәn
Cameroon => 'kæmәru:n
Cameroonian => kæmә'ru:niәn
cami => 'kæmɪ
camiknicker => kə'mɪnɪkər
camiknickers => ,kæmi'nikәz
Camilla => kə'milə
camille => kә'mi:l
camisole => 'kæmisәul
camo => kæməʊ
camomile => 'kæmәmail
camouflage => 'kæmuflɑ:ʒ
camouflaged => ˈkæməˌflɑ:ʒd
camouflages => 'kæməflɑ:ʒɪz
camouflaging => ˈkæməˌflɑ:ʒɪŋ
camp => kæmp
camp follower => kæmp ˈfɔləʊə
camp meeting => kæmp ˈmi:tiŋ
campaign => kæm'pein
campaigned => kæm'peɪn
campaigner => kæm'peinә
campaigners => kæmˈpeinəz
campaigning => kæm'peɪn
campaigns => kæmˈpeinz
Campania => kæm'peinjә
campanile => .kæmpә'ni:li
campanological => ,kæmpәnә'lɔdʒikәl
campanologist => ,kæmpә'nɔlәdʒist
campanology => kæmpә'nɔlәdʒi
campanula => kәm'pænjulә
campanulate => kәm'pænjuleit
campari => kæm'pɑ:ri
campbell => 'kæmbl
campcraft => 'kæmpkrɑ:ft
Campeche => kæm'pi:tʃi
camper => 'kæmpә
campesino => .kæmpә'si:nәu
campesinos => ˌkɑ:mpɪˈsi:nəʊz
campfire => 'kæmpfaiә
campfires => ˈkæmpfaiəz
campground => 'kæmpɡrәund
camphor => 'kæmfә
camphor tree => ˈkæmfə tri:
camphorate => 'kæmfәreit
camping => 'kæmpiŋ
campion => 'kæmpiәn
campions => 'kæmpɪən
campo => 'kæmpәu
camporee => .kæmpә'ri:
campsite => kæmp'sait
campsites => kæmpˈsaits
campstool => 'kæmpstu:l
campus => 'kæmpәs
campy => 'kæmpi
campylobacter => ˈkæmpiləuˌbæktə
CAMRA => 'kæmrə
camshaft => 'kæmʃæft
camshafts => 'kæmʃɑ:fts
Camus => kɑ:'mju, kә'mjɔ
camwood => 'kæmwud
can => kæn
can opener => kæn ˈəʊpənə
can't => kɑ:nt
can-do => kæn du:
cana => 'keinә
Canaan => 'keinәn
Canaanite => 'keinәnait
Canada => 'kænәdә
Canadian => kә'neidiәn
Canadien => kә'neidiәn
canaille => kә'neili
canal => kә'næl
canal boat => kəˈnæl bəut
canalization => .kænәlai'zeiʃәn
canalize => 'kænәlaiz
canalled => 'kənælled
canals => kəˈnælz
canalside => kə'nælsaɪd
canape => kænә'pei
canapes => kænəˈpeiz
canard => kæ'nɑ:d
canards => kæ'nɑ:dz
Canarese => ,kænә'ri:z
canaries => kә'neәris
canary => kә'nєәri
canasta => kә'næstә
Canberra => 'kænbәrә
cancan => 'kaŋkɑ:ŋ
cancel => 'kænsәl
canceled => ˈkænsəld
cancellation => kænsә'leiʃәn
cancellations => ,kænsə'leɪʃ(ə)n
cancelled => 'kænsəld
cancelling => 'kænsәliŋ
cancellous => 'kænsilәs
cancels => ˈkænsəlz
cancer => 'kænsә
cancerous => 'kænsәrәs
cancers => 'kænsəz
candela => kæn'di:lә
candelabra => .kændi'lɑ:brә
candelabras => ,kændə'lɑbrə
candelabrum => .kændi'lɑ:brәm
Candice => 'kændis
candid => 'kændid
Candida => 'kændidә
candidacies => 'kændɪdəsɪ
candidacy => 'kændidәsi
candidate => 'kændideit
candidates => 'kændɪdeɪts
candidature => 'kændidәtʃә
candidiasis => ,kændi'daiәsis
candidly => 'kændidli
candidness => 'kændɪdnɪz
candied => 'kændid
candle => 'kændl
candleberry => 'kændlbәri
candlefish => 'kændlfiʃ
candleholder => 'kændl,hәjldә(r)
candlelight => 'kændllait
candlelit => ˈkændllɪt
Candlemas => 'kændlmәs
candlenut => 'kændlnʌt
candlepower => 'kændl.pauә
candler => 'kændlә
candlestick => 'kændlstik
candlesticks => ˈkændlˌstɪks
candlewick => 'kædlwik
candling => 'kændlɪŋ
candor => 'kændә
candour => 'kændә
candy => 'kændi
candy cane => ˈkændi kein
candy-striped => ˈkændi straɪpt
candyfloss => ˈkændiflɒs
candytuft => 'kænditʌft
cane => kein
cane rat => kein ræt
canebrake => 'keinbreik
caner => 'keinә
canes => keinz
canid => 'kænid
canine => 'keinain
canines => 'kænaɪnz
caning => 'keiniŋ
Canis Minor => 'keinis'mainə
canister => 'kænistә
canisters => ˈkænistəz
canker => 'kæŋkә
cankered => 'kæŋkәd
cankering => ˈkæŋkərɪŋ
cankerous => 'kæŋkәrәs
cankers => ˈkæŋkəz
cankerworm => 'kænŋkәwә:m
canna => 'kænә
cannabinoid => 'kænəbi,nɔid
cannabinol => 'kænәbinɔl
cannabis => 'kænәbis
canned => kænd
cannelloni => ,kæni'lәuni
cannelure => 'kænәljuә
canner => 'kænә
canneries => ˈkænəri:z
cannery => 'kænәri
Cannes => kæn
cannibal => 'kænibәl
cannibalise => 'kænibәlaiz
cannibalism => 'kænibәlizm
cannibalistic => ,kænibә'listik
cannibalize => 'kænibәlaiz
cannibalized => ˈkænibəlaizd
cannibalizes => ˈkænibəlaiziz
cannibalizing => ˈkænibəlaizɪŋ
cannibals => ˈkænəbəlz
cannier => ˈkæni:ə
cannily => 'kænili
canniness => 'kæninis
canning => 'kæniŋ
cannister => 'kænistә
cannoli => kә'nәjli:
cannon => 'kænәn
cannonade => kænә'neid
cannonball => 'kænәnbɒ:l
cannoneer => .kænә'niә
cannons => ˈkænənz
cannot => 'kænɒt
cannula => 'kænjulә
cannulate => 'kænjjlit,-leit
cannulated => 'kænjʊleɪt
cannulation => -'leiʃәn
canny => 'kæni
canoe => kә'nu:
canoeing => kә'nu:iŋ
canoeist => kә'nu:ist
canoes => kəˈnu:z
canola => kə'nəʊlə
canon => 'kænәn
canon regular => ˈkænən ˈreɡjulə
canoness => 'kænәnis
canonic => kә'nɔnik
canonical => kә'nɔnikәl
canonicals => kә'nɒnikәl
canonicity => .kænә'nisiti
canonisation => ˌkænənaɪ'zeɪʃn
canonise => 'kænәnaiz
canonised => 'kænənaiz
canonist => 'kænәnist
canonistic => kænə'nɪstɪk
canonization => .kænәnai'zeiʃәn
canonize => 'kænәnaiz
canonized => ˈkænəˌnaɪzd
canonizes => ˈkænəˌnaɪziz
canonizing => ˈkænəˌnaɪzɪŋ
canonry => 'kænәnri
canons => 'kænənz
canoodle => kә'nu:dl
canoodled => kəˈnu:dld
canoodles => kəˈnu:dlz
canoodling => kəˈnu:dlɪŋ
canopied => 'kænәpid
canopies => ˈkænəpi:z
Canopus => kә'nәupәs
canopy => 'kænәpi
canorous => kә'nɒ:rәs
cans => kænz
canst => kænst
cant => kænt
cant dog => kænt dɔɡ
cant hook => kænt huk
cantabile => kæn'tɑ:bili
Cantabrian => kæn'teibriәn
Cantabrigian => .kæntә'bridʒiәn
cantal => 'kæntәl
cantaloup => 'kæntәlu:p
cantaloupe => 'kæntәlu:p
cantankerous => kæn'tæŋkәrәs
cantankerously => kæn'tæŋkərəsli
cantata => kæn'tɑ:tә
cantatas => kənˈtɑ:təz
canteen => kæn'ti:n
canteen culture => kænˈti:n ˈkʌltʃə
canteens => kænˈti:nz
canter => 'kæntә
canterbury => 'kæntәbәri
Canterbury bell => 'kæntәbәri
cantharides => kæn'θæridi:z
canthus => 'kænθәs
canticle => 'kæntikl
canticles => 'kæntɪk(ə)l
cantilena => .kænti'li:nә
cantilever => 'kæntili:vә
cantilevered => 'kæntɪli:vəd
cantilevers => ˈkæntili:vəz
cantillate => 'kæntileit
cantillated => 'kæntɪleɪt
cantillates => 'kæntɪleɪt
cantillating => 'kæntɪleɪt
cantillation => ,kæntɪ'leɪʃən
cantina => kæn'ti:nә
canting => 'kæntiŋ
cantle => 'kæntl
canto => 'kæntәu
canton => kæn'tɒn
Cantona => 'kæntәunә
cantonal => 'kæntәnl
Cantonese => .kæntә'ni:z
cantonment => kæn'tu:nmәnt
cantonments => kænˈtu:nmənts
cantons => ˈkæntɔnz
cantor => 'kæntɒ:
cantorial => kæn'tɒ:riәl
cantoris => kæn'tɔ:ris
cantrail => 'kænt,reil
cantrip => 'kæntrip
cantus => 'kæntәs
cantus firmus => 'f\\\\:mәs
Canuck => kә'nʌk
Canute => kə'nju:t
canvas => 'kænvәs
canvasback => 'kænvәsbæk
canvases => ˈkænvəsiz
canvass => 'kænvәs
canvassed => ˈkænvəst
canvasser => 'kænvәsә
canvasses => ˈkænvəsiz
canvassing => ˈkænvəsɪŋ
canyon => 'kænjәn
canyoning => ˈkænjənɪŋ
canyons => ˈkænjənz
canzona => kæn'zejnә
canzone => kæn'tsәuni
caoutchouc => 'kautʃuk
cap => kæp
cap sleeve => kæp sli:v
capabilities => ˌkeɪpəˈbɪlɪti:z
capability => .keipә'biliti
capable => 'keipәbl
capably => 'keipәbli
capacious => kә'peiʃәs
capacitance => kә'pæsitәns
capacitate => kә'pæsiteit
capacitates => kə'pæsɪteɪt
capacitating => kə'pæsɪteɪt
capacitation => kəpæsɪ'teɪʃən
capacities => kəˈpæsitiz
capacitive => kә'pæsitiv
capacitor => kә'pæsitә
capacitors => kə'pæsɪtəz
capacity => kә'pæsiti
caparison => kә'pærisәn
caparisoned => kəˈpærɪsnd
caparisoning => kəˈpærisnɪŋ
caparisons => kəˈpærisnz
cape => keip
Cape Verde Islands => və:d
Capel => 'kæpәl
capelin => 'kæpәlin
capellini => ,kæpə'li:ni:
caper => 'keipә
capercaillie => kæpә'keili
capered => ˈkeɪpəd
capering => ˈkeɪpərɪŋ
capes => keips
capeskin => 'keipskin
capetian => kə'pi:ʃən
Capetonian => keip'tәjniәn
capful => 'kæpful
capias => 'keipiæs
capillaries => 'kəpɪlərɪz
capillarity => .kæpi'læriti
capillary => kæ'pilәri
capital => 'kæpitәl
capital gain => ˈkæpitl ɡein
capital punishment => ˈkæpitl ˈpʌnɪʃmənt
capital-intensive => ˌkæpɪtlɪnˈtensɪv
capitalisation => ,kæpitәlai'zeiʃən;-li'z-
capitalise => 'kæpitәlaiz
capitalism => 'kæpitәlizәm
capitalist => 'kæpitәlist
capitalistic => .kæpitә'listik
capitalists => ˈkæpɪtlɪsts
capitalization => .kæpitәlai'zeiʃәn
capitalize => kә'pitәlaiz
capitalizes => ˈkæpɪtlˌaɪziz
capitalizing => ˈkæpɪtlˌaɪzɪŋ
capitally => 'kæpitәli
capitals => 'kæpɪtəlz
capitate => 'kæpiteit
capitated => 'kæpɪteɪt
capitation => kæpi'teiʃәn
Capitol => 'kæpitl
capitular => kә'pitjulә
capitulary => kә'pitjulәri
capitulate => kә'pitjuleit
capitulated => kəˈpɪtʃəˌleɪtid
capitulates => kəˈpɪtʃəˌleɪts
capitulating => kəˈpɪtʃəˌleɪtɪŋ
capitulation => kәpitju'leiʃәn
capitulum => kә'pitʃәlәm
caplet => 'kæplit
caplin => 'kæplin
capo => 'keipәu
capoeira => ,kɑ:pә'weirә
capon => 'keipәn
caponata => ,kɑ:pә'nɑ:tә
caponier => ,kæpә'niә(r)
caponize => 'keipәnaiz
caponized => 'keɪpə,naɪz
caponizes => 'keɪpə,naɪz
caponizing => keɪ'pɒnaɪzɪŋ
capons => ˈkeipənz
capot => kә'pɒt
capote => kә'pәut
capotted => kə'pɔt
Cappadocia => ,kæpə'dəuʃi:ə
cappelletti => kæpә'leti
capper => 'kæpә
capping => 'kæpiŋ
cappuccino => kæpj'tʃi:nәj
capri => 'kɑ:pri:
capri pants => kəˈpri: pænts
capriccio => kә'pritʃiәu
capriccioso => kә,pri:tʃi:'әuzәu
caprice => kә'pri:s
caprices => kəˈpri:siz
capricious => kә'priʃәs
capriciously => kə'prɪʃəslɪ
capricorn => 'kæprikɔ:n
Capricornian => ,kæpri'kɔ:niәn
Capricornus => ,kæpri'kɔ:nәs
caprine => 'kæprain
capriole => 'kæpriәul
caproate => 'kæprәu,eit
caprolactam => ,kæprәu'læktәm
caprylate => 'kæprileit
capsaicin => kæp'seiәsin
Capsian => 'kæpsiәn
capsicum => 'kæpsikәm
capsicums => kæpsɪ'kəmz
capsid => 'kæpsid
capsize => kæp'saiz
capsized => ˈkæpˌsaɪzd
capsizes => ˈkæpˌsaɪziz
capsizing => ˈkæpˌsaɪzɪŋ
capstan => 'kæpstәn
capstone => 'kæpstәun
capsular => 'kæpsjulә
capsulate => 'kæpsjuleit
capsule => 'kæpsju:l
capsulize => 'kæpsjjlaiz
captain => 'kæptin
captan => 'kæptәn
caption => 'kæpʃәn
captioning => ˈkæpʃənɪŋ
captions => ˈkæpʃənz
captious => 'kæpʃәs
captivate => 'kæptiveit
captivated => ˈkæptəˌveɪtid
captivates => ˈkæptəˌveɪts
captivating => 'kæptiveitiŋ
captivation => kæpti'veiʃәn
captive => 'kæptiv
captives => ˈkæptivz
captivity => kæp'tiviti
captor => 'kæptә
captors => ˈkæptəz
capture => 'kæptʃә
captured => ˈkæptʃəd
captures => ˈkæptʃəz
capturing => 'kæptʃәriŋ
capuchin => 'kæpjuʃin
capybara => ,kæpi'bɑ:rә
car => kɑ:
car bomb => kɑ: bɔm
car boot sale => kɑ: bu:t seil
car park => kɑ: pɑ:k
car phone => kɑ: fəun
car pool => kɑ: pu:l
carabao => .kɑ:rә'beiәu
carabid => 'kærәbid
carabineer => ,kærәbi'niә(r)
carabiner => kærә'binә
carabinero => kærəbɪ'neərəʊ
carabiniere => kærəbinˈjɛəri
caracal => 'kærәkæl
Caracalla => ,kærə'kælə
caracara => ,kɑ:rә'kɑ:rә
caracas => kә'rækәs
caracole => 'kærәkәul
caracul => 'kærәkәl
Caradoc => kә'rædәk
carafe => kә'ræf
caragana => ,kærә'gɑ:nә
caramba => kә'rɑ:mbɑ:
carambola => ,kærәm'bәulә
caramel => 'kærәmel
caramelise => 'kærәmәlaiz
caramelised => 'kærəməlaiz
caramelization => ,kærәmәlai'zeiʃən;-li'z-
caramelize => 'kærәmәlaiz
caramelized => ˈkærəməlaizd
caramelizes => ˈkærəməlaiziz
caramelizing => ˈkærəməlaizɪŋ
caramels => ˈkærəmelz
carangid => kә'rændʒid
carapace => 'kærәpeis
carat => 'kærәt
carats => ˈkærəts
Caravaggesque => ,kærәvæ'dʒesk
caravan => 'kærәvæn
caravanner => kærə'vænɜ:
caravanning => ˈkærəvænɪŋ
caravans => 'kærəvænz
caravanserai => ,kærә'vænsәrai
caravel => 'kærәvel
caraway => 'kærәwei
carb => kɑ:b
carbamate => 'kɑ:bәmeit
carbamazepine => ,kɑ:bә'mæzәpi:n
carbanion => 'kɑ:bәnaiәn
carbaryl => 'kɑ:bәril
carbazole => 'kɑ:bәzәul
carbene => 'kɑ:bi:n
carbide => 'kɑ:baid
carbine => 'kɑ:bain
carbines => ˈkɑ:bainz
carbo- => 'kɑ:bәj
carbocation => ,kɑ:bә'keiʃәn
carbohydrate => .kɑ:bәu'haidreit
carbohydrates => kɑ:bə'haɪdreɪts
carbolic => kɑ:'bɒlik
carbon => 'kɑ:bәn
carbon credit => ˈkɑ:bən ˈkredit
carbon footprint => ˈkɑ:bən ˈfʊtˌprɪnt
carbon trading => ˈkɑ:bən ˈtreɪdɪŋ
carbon-neutral => ˈkɑ:bən ˈnju:trəl
carbonaceous => .kɑ:bә'neiʃәs
carbonado => .kɑ:bә'neidәu
carbonara => ,kɑ:bә'nɑ:rә
carbonate => 'kɑ:bәneit
carbonates => ˈkɑ:bəneits
carbonation => .kɑ:bә'neiʃәn
carbonatite => 'kɑ:bәnәtait
carbonic => kɑ:'bɒnik
Carboniferous => .kɑ:bә'nifәrәs
carbonization => .kɑ:bәnai'zeiʃәn
carbonize => 'kɑ:bәnaiz
carbonless => ˈkɑ:bənlis
carbonnade => ,kɑ:bә'nɑ:d
carbons => 'kɑ:bənz
carbonyl => 'kɑ:bәnil
carborundum => .kɑ:bә'rʌndәm
carboxyl => kɑ:'bɒksil
carboxylase => kɑ:'bɔksileis
carboxylate => kɑ:'bɔksileit
carboxylic => ,kɑ:bɔk'silik
carboy => 'kɑ:bɒi
carbuncle => 'kɑ:bʌŋkl
carbuncled => 'kɑ:bʌŋkld
carbuncles => ˈkɑ:bʌŋklz
carburation => ,kɑ:bju'reiʃәn
carburet => 'kɑ:bjuret
carbureted => 'kɑ:bjʊretɪd
carburetor => kɑ:bә'retә(r); (?@) 'kɑ:rbәreitәr
carburetted => kɑ:bjʊ'retɪd
carburettors => ˈkɑ:bjʊretəz
carburization => ,kɑ:bjjrai'zeiʃәn;-ri'z-
carburize => 'kɑ:bjuraiz
carburizes => 'kɑːbjʊraɪz; -bə-
carburizing => 'kɑ:bjuraiziŋ
carcajou => 'kɑ:kә,dʒu:
carcase => 'kɑ:kәs
carcass => 'kɑ:kәs
carcasses => 'kɑ:kəsɪz
carcinogen => kɑ:'sinәdʒәn
carcinogenesis => ,kɑ:sinәj'dʒenisis
carcinogenic => kɑ:sinә'dʒәnik
carcinogenicity => ,kɑ:sinәjdʒә'nisәti
carcinogens => kɑ:'sɪnədʒɪnz
carcinoid => 'kɑ:si,nɔid
carcinoma => .kɑ:si'nәumә
carcinomatosis => ,kɑ:si,nәumә'tәusis
card => kɑ:d
card table => kɑ:d ˈteibl
cardamom => 'kɑ:dәmәm
cardboard => 'kɑ:dbɒ:d
cardboard city => ˈkɑ:dbɔ:d ˈsiti
carded => 'kɑ:dɪd
carder => 'kɑ:dә
cardholder => 'kɑ:d,hәjldә(r)
cardia => 'kɑ:diә
cardiac => 'kɑ:diæk
cardiff => 'kɑ:dif
cardigan => 'kɑ:digәn
cardigans => ˈkɑ:dɪgənz
Cardiganshire => 'kɑ:di^әnʃә(r)
cardinal => 'kɑ:dinәl
cardinal flower => ˈkɑ:dinl ˈflauə
cardinal sin => ˈkɑ:dinl sin
cardinal vowel => ˈkɑ:dinl ˈvaʊəl
cardinalate => 'kɑ:dinәleit
cardinality => ,kɑ:di'næliti
cardinals => ˈkɑ:dinlz
cardinalship => 'kɑ:dɪnəlʃɪp
carding => 'kɑ:diŋ
cardio- => 'kɑ:diәj
cardiogram => 'kɑ:diәgræm
cardiograph => 'kɑ:diәgrɑ:f
cardioid => 'kɑ:diәɔid
cardiology => .kɑ:di'ɒlәdʒi
cardiomegaly => ,kɑ:diәu'me^әli
cardiomyopathy => ,kɑ:diәjmai'ɔpәθi
cardiopathy => ,kɑ:di'ɔpәθi
cardiopulmonary => ,kɑ:diәj'pʌlmәnәri
cardiorespiratory => 'kɑ:diәuris'paiәrәtәri
cardiovascular => kɑ:diәu'væskjulә
cardioversion => kɑ:diә'vә:ʃәn
carditis => kɑ:'daitis
cardoon => kɑ:'du:n
cardphone => ˈkɑ:dfəʊn
cardsharp => 'kɑ:dʃɑ:p
care => kєә
care label => kɛə ˈleibəl
care package => kɛə ˈpækidʒ
care worker => kɛə ˈwə:kə
cared => kɛəd
careen => kә'ri:n
careened => kəˈri:nd
careening => kəˈri:nɪŋ
careens => kəˈri:nz
career => kә'riә
careerism => kә'riәrizm
careerist => kә'riәrist
careerists => kəˈriərists
carefree => 'kєәfri:
careful => 'kєәful
carefully => 'kєәfuli
carefulness => 'kєәfulnis
caregiver => ˈkeəgɪvə(r)
careless => 'kєәlis
carelessly => 'kєәlisli
carer => 'kεәrә
caress => kә'res
caressed => kəˈrest
caresses => kə'resɪs
caressing => kә'resiŋ
caressingly => kә'resiŋli
caret => 'kærәt
caretake => 'keәteik
caretaker => 'kєәteikә
caretakers => ˈkɛəˌteikəz
caretaking => 'keəteɪkɪŋ
careworn => 'kєәwɒ:n
carex => 'kæreks
carey => 'keәri
carfare => 'kɑ:fєә
Carfax => 'kɑ:fæks
carful => 'kɑ:fjl
cargador => kɑ:^ә'dɔ:(r)
cargo => 'kɑ:gәu
cargo cult => ˈkɑ:ɡəu kʌlt
cargoes => ˈkɑ:ɡəuz
carhop => 'kɑ:hɔp
Cariban => 'kæribәn
Caribbean => .kæri'bi:әn
caribou => 'kæribu:
caricature => 'kærikәtʃә
caricatured => ˈkærɪkəˌtʃʊəd
caricatures => ˈkærɪkəˌtʃʊəz
caricaturing => ˈkærɪkəˌtʃʊərɪŋ
caricaturist => 'kærikәtjuәrist
Caricom => ,kæri'kɔm
caries => 'kєәrii:z
carillon => 'kæriljәn
carillonneur => .kәriljә'nә:
carillons => 'kærɪljən; -lɒn; kə'rɪljən
carina => kә'rainә
carinal => kə'raɪnəl
carinate => 'kærineit
carinated => 'kærineitid
caring => 'kεәriŋ
Carinthia => kə'rinθiə
carioca => kæri'әjkә
cariogenic => kæraɪəʊd'ʒenɪk
cariole => 'kæriәul
carious => 'kєәriәs
caritas => 'kæritæs
carjack => 'kɑ:dʒæk
carjacking => ˈkɑ:dʒækɪŋ
cark => kɑ:k
carked => kɑːk
carking => 'kɑ:kiŋ
carks => kɑːk
Carl => kɑ:l
carla => 'kɑ:lә
carless => 'kɑ:lis
carlin => 'kɑ:lin
carline => 'kɑ:lin
carling => 'kɑ:liŋ
carlisle => kɑ:'lail
Carlism => 'kɑ:lizәm
Carlist => 'kɑ:list
carload => 'kɑ:lәud
carlos => 'kɑ:lɔs
Carlotta => kɑ:'lɔtə; 意大利语kɑ:r'lɔ:ttɑ:
Carlovingian => ,kɑ:lәu'vindʒiәn
Carlsberg => 'ka:sbə:g
carlton => 'kɑ:ltәn
Carlyle => kɑ:'lail
carmaker => 'kɑ:,meikә(r)
carman => 'kɑ:mәn
Carmarthen => kə'mɑ:ðən
Carmarthenshire => kә'mɑ:ðәnʃә(r)
CARMEL => 'kɑ:mel
Carmelite => 'kɑ:mlait
carmen => 'kɑ:men
carminative => 'kɑ:minәtiv
carmine => 'kɑ:main
Carn => kɑ:n
Carnaby => 'kɑ:nәbi
carnage => 'kɑ:nidʒ
carnal => 'kɑ:nl
carnality => kɑ:'næliti
carnallite => 'kɑ:nәlait
carnally => 'kɑ:nәli
Carnarvon => kɑ:'nɑ:vәn
carnassial => kɑ:'næsiәl
carnation => kɑ:'neiʃәn
carnations => kɑ:ˈneɪʃənz
carnauba => kɑ:'naubә
carnegie => kɑ:'ne^i
carnelian => kә'ni:ljәn
carnet => kɑ:'ne
carney => 'kɑ:ni
carnitine => 'kɑ:niti:n
carnival => 'kɑ:nivәl
carnivalesque => 'kɑ:nɪveɪlesk
carnivals => ˈkɑ:nəvəlz
Carnivora => kɑ:'nivәrә
carnivore => 'kɑ:nivɒ:
carnivores => ka:nɪvɔ:z
carnivorous => kɑ:'nivәrәs
carnotite => 'kɑ:nәtait
carny => 'kɑ:ni
carob => 'kærәb
carobs => ˈkærəbz
carol => 'kærәl
caroler => kæ'rələr
Carolina => .kærә'lainә
caroline => 'kærәlaiŋ
Caroline Islands => 'kærәlain 'ailәndz
Carolingian => kærә'lindʒiәn
Carolinian => kærә'liniәn
carolled => ˈkærəld
caroller => 'kærəl
carolling => ˈkærəlɪŋ
carols => ˈkærəlz
carom => 'kærәm
caromed => ˈkærəmd
caroming => ˈkærəmɪŋ
caroms => 'kərəmz
carotene => 'kærәti:n
carotenoid => kә'rɔtәnɔid
carotid => kә'rɒtid
carotid artery => kəˈrɒtɪd ɑ:təri
carousal => kә'rauzәl
carouse => kә'rauz
caroused => kəˈraʊzd
carousel => kә'rauzәl
carousels => ˌkærə'selz
carouser => kә'rauzә
carouses => kəˈraʊziz
carousing => kəˈraʊzɪŋ
carp => kɑ:p
carpaccio => kɑ:'pɑ:ttʃɔ:
carpal => 'kɑ:pәl
Carpathian => kɑ:'peiθiәn
carpe diem => 'kɑ:pi 'daiem
carped => kɑ:pt
carpel => 'kɑ:pәl
carpellary => kɑ:'pelərɪ
Carpentaria => ,kɑ:pәn'teәriә
carpenter => 'kɑ:pintә
carpenter ant => ˈkɑ:pintə ænt
carpenter bee => ˈkɑ:pintə bi:
carpentering => ˈkɑːpəntə(r)
carpenters => ˈkɑ:pintəz
carpentry => 'kɑ:pintri
carper => 'kɑ:pә
carpet => 'kɑ:pit
carpet bag => ˈkɑ:pit bæɡ
carpet beetle => ˈkɑ:pit ˈbi:tl
carpet shark => ˈkɑ:pit ʃɑ:k
carpet slipper => ˈkɑ:pit ˈslipə
carpet sweeper => ˈkɑ:pit ˈswi:pə
carpetbag => 'kɑ:pitbæg
carphology => kɑ:'fɔlәdʒi
carping => 'kɑ:piŋ
carpology => kɑ:'pɒlәdʒi
carpool => 'kɑ:pu:l
carpooler => 'kɑ:pu:lə
carpophore => 'kɑ:pәfɔ:
carport => 'kɑ:pɒ:t
carps => kɑ:ps
carpus => 'kɑ:pәs
carrack => 'kærәk
carrageen => 'kærә^i:n
carrageenan => ,kærә'^i:nәn
Carrara => kə'rɑ:rə
carrel => 'kærәl
carriage => 'kæridʒ
carriage bolt => ˈkæridʒ bəult
carriage clock => ˈkæridʒ klɔk
carriage dog => ˈkæridʒ dɔɡ
carriage house => ˈkæridʒ haus
carriages => 'kærɪdʒɪz
carriageway => 'kæridʒwei
carriageways => ˈkæridʒweiz
Carrick => 'kærik
carrie => 'kæri
carried => 'kærid
carrier => 'kæriә
carriers => 'kærɪəz
carriole => 'kæriәul
carrion => 'kæriәn
carrion flower => ˈkæri:ən ˈflauə
Carroll => 'kærəl
carronade => .kærә'neid
carrot => 'kærәt
carrot-and-stick => 'kærət'ændst'ɪk
carroty => 'kærәti
carrousel => .kærә'sel
carry => 'kæri
carry-on => 'kærɪ ɒn
carry-over => 'kæri,әuvә
carryall => 'kæriɔ:l
carrycot => 'kærikɔt
carrying => 'kæriiŋ
carse => kɑ:z
carsick => 'kɑ:sik
carsickness => 'kɑ:siknis
carson => 'kɑ:sn
cart => kɑ:t
cartage => 'kɑ:tidʒ
Cartagena => ,kɑ:tә'dʒi:nә
carte => kɑ:t
carte blanche => kɑ:t 'blɑʃ
cartel => kɑ:'tel
cartelize => kɑ:'telaiz
cartels => kɑ:ˈtelz
carter => 'kɑ:tә
Cartesian => kɑ:'ti:ziәn
Cartesianism => kɑ:'ti:ziәnizәm
cartful => 'kɑ:tful
Carthage => 'kɑ:θidʒ
Carthaginian => .kɑ:θә'dʒiniәn
Carthusian => kɑ:'θju:zjәn
Cartier => kɑː'tiːə
cartilage => 'kɑ:tilidʒ
cartilages => ˈkɑ:tlɪdʒz
cartilaginous => ,kɑ:ti'lædʒinәs
cartilaginous fish => ˌkɑrtlˈædʒənəs fɪʃ
carting => 'kɑ:tɪŋ
cartload => 'kɑ:tlәud
cartogram => 'kɑ:tәgræm
cartographer => kɑ:'tɒgrәfә
cartographers => kɑ:ˈtɔgrəfəz
cartographical => kaːˊtɒgrәfikәl
cartography => kɑ:'tɒgrәfi
cartomancy => 'kɑ:tәmænsi
carton => 'kɑ:tn
cartons => ˈkɑ:tənz
cartoon => kɑ:'tu:n
cartoonish => kɑ:'tu:nɪʃ
cartoonist => kɑ:'tu:nist
cartoonists => kɑ:ˈtu:nists
cartophily => kɑ:'tɔfili
cartouche => kɑ:'tu:ʃ
cartridge => 'kɑ:tridʒ
cartridges => 'kɑ:trɪdʒɪz
cartwheel => 'kɑ:thwi:l
cartwheeled => 'kɑːtwiːl
cartwheeling => 'kɑːtwiːl
cartwheels => ˈkɑ:twi:lz
cartwright => 'kɑ:trait
caruncle => 'kærәŋkl
carve => kɑ:v
carve-up => kɑ:v ʌp
carvel => 'kɑ:vәl
carvel-built => 'kɑ:vәl,bilt
carven => 'kɑ:vn
carver => 'kɑ:vә
carves => kɑ:vz
carving => 'kɑ:viŋ
carving fork => ˈkɑ:vɪŋ fɔ:k
carving knife => ˈkɑ:vɪŋ naif
carwash => 'kɑ:rwɒʃ
cary => 'keәri
caryatid => .kæri'ætid
Caryl => 'kæril
caryopsis => .kæri'ɒpsis
casa => 'kɑ:sә
casaba => kә'sɑ:bә
Casablanca => ,kæsә'blæŋkә
Casanova => .kæzә'nәuvә
casbah => 'kɑ:zbɑ:
cascabel => 'kæskәbel
cascade => kæ'skeid
cascara => kæ'skɑ:rә
case => keis
case in point => keis in pɔint
case-sensitive => keis ˈsensitiv
caseation => ,keisi'eiʃәn
casebook => 'keisbuk
casebooks => 'keɪsbʊk
cased => keist
casein => 'keisi:in
caseload => 'keislәjd
casemate => 'keismeit
casement => 'keismәnt
casements => ˈkeismənts
caseous => 'keisiәs
casework => 'keiswә:k
caseworker => ˈkeɪswɜ:kə(r)
casey => 'keisi
cash => kæʃ
cash bar => kæʃ bɑ:
cash card => kæʃ kɑ:d
cash cow => kæʃ kau
cash desk => kæʃ desk
cash-strapped => kæʃ stræpt
cashable => 'kæʃəbl
cashbox => 'kæʃbɒks
cashed => kæʃt
cashes => kæʃiz
cashew => 'kæʃu:
cashews => ˈkæʃu:z
cashflow => 'kæʃfləʊ
cashier => kæ'ʃiә
cashiered => kæˈʃiəd
cashiering => kæˈʃiərɪŋ
cashiers => kæˈʃiəz
cashing => 'kæʃiŋ
cashless => 'kæʃlis
cashmere => 'kæʃmiә
casing => 'keisiŋ
casino => kә'si:nәu
casita => kә'si:tә
cask => kæsk. kɑ:sk
casket => 'kɑ:skit
caskets => ˈkɑ:skits
casks => kæsks
Caslon => 'kæzlәn
Caspar => 'kæspə
Caspian => 'kæspiәn
casque => kæsk
cass => kæs
Cassandra => kә'sændrә
cassareep => 'kæsә,ri:p
cassata => kə'sɑ:tə
cassation => kæ'seiʃәn
cassava => kә'sɑ:vә
Cassel => 'kæsәl
casserole => 'kæsәrәul
casseroled => 'kæsərəʊl
casseroles => ˈkæsəˌrəʊlz
casseroling => 'kæsərəʊl
cassette => kæ'set
cassette player => kəˈset ˈpleɪə
cassettes => kəˈsets
cassia => 'kæsiә
Cassie => 'kæsi
Cassino => kә'si:nәj
Cassiopeia => .kæsiәu'pi:ә
cassis => 'kæsis
cassiterite => kә'sitәrait
cassius => 'kæsjәs
cassock => 'kæsәk
cassocked => 'kæsəkt
cassocks => 'kæsəks
cassoulet => ,kæsu'lei
cassowaries => ˈkæsəwɛəriz
cassowary => 'kæsәwєәri
cast => kɑ:st. kæst
cast-iron => 'kɑ:st'aiәn
cast-off => kɑ:st ɔf
Castalia => kæs'teiliә
Castalian => kæ'steiljәn
castanet => .kæstә'net
castanets => ,kæstә'nets
castaway => 'kɑ:stәwei
castaways => ˈkɑ:stəweiz
caste => kæst. kɑ:st
casteism => 'kɑ:stɪzəm
castellan => 'kæstәlәn
castellated => 'kæstәleitid
castellation => ,kæstә'leiʃәn
caster => 'kæstә. 'kɑ:stә
caster sugar => ˈkɑ:stə ˈʃuɡə
castes => 'kɑ:sts
castigate => 'kæstigeit
castigated => ˈkæstɪˌgeɪtid
castigates => ˈkæstɪˌgeɪts
castigating => ˈkæstɪˌgeɪtɪŋ
castigation => .kæsti'geiʃәn
castigatory => 'kæstigәtәri
Castile => kæs'ti:l
Castilian => kæ'stiljәn
casting => 'kɑ:stiŋ
casting couch => ˈkæstɪŋ kautʃ
casting director => ˈkæstɪŋ diˈrektə
castle => 'kæsl. 'kɑ:sl
castled => 'kɑ:sld
castles => ˈkɑ:slz
castling => 'ka:stlɪŋ
castor => 'kɑ:stә
castor sugar => ˈkæstə ˈʃuɡə
castors => 'kɑ:stəz
castrate => 'kæstreit
castrated => ˈkæsˌtreɪtid
castrates => ˈkæsˌtreɪts
castrating => ˈkæsˌtreɪtɪŋ
castration => kæ'streiʃәn
castrato => kæs'trɑ:tәu
Castries => kæ'stri:, 'kɑ:stris
Castro => 'kæstrəu
casual => 'kæʒjuәl
casual water => ˈkæʒjuəl ˈwɔ:tə
casualization => ,kæʒjjәlai'zeiʃәn; -li'z-
casualize => 'kæʒjjәlaiz
casually => 'kæʒjuәli
casuals => ˈkæʒjuəlz
casualty => 'kæʒjuәlti
casualty department => ˈkæʒjuəlti diˈpɑ:tmənt
casuarina => .kæʒuә'ri:nә
casuist => 'kæzjuist
casuistic => ,kæzju'istik
casuistical => ,kæzju'istikәl
casuistry => 'kæzjuistri
casus belli => ,kɑ:sjs'beli:, ,keisәs'belai
cat => kæt
cat and mouse => kæt ænd maus
cat door => kæt dɔ:
cat flap => kæt flæp
cat suit => kæt sju:t
cata- => 'kætә
catabolic => ,kætә'bɔlik
catabolism => kә'tæbәlizm
catabolite => kә'tæbәlait
catachresis => ,kætә'kri:sis
catachrestic => keɪ'tækrestɪk
cataclasis => ,kætә'kleisis
cataclastic => ,kætә'klæstik
cataclysm => 'kætәklizm
cataclysmic => ,kætә'klizmik
cataclysms => ˈkætəˌklɪzəmz
catacomb => 'kætәkәum
catacombs => ˈkætəku:mz
catadioptric => ,kætәdai'ɔptrik
catadromous => kә'tædrәmәs
catafalque => 'kætәfælk
Catalan => 'kætәlәn
catalase => 'kætәleis
catalectic => .kætә'lektik
catalepsy => 'kætәlepsi
cataleptic => .kætә'leptik
catalina => .kætә'li:nә
catalog => 'kætәlɒg
cataloged => ˈkætəlɔɡd
catalogue => 'kætәlɒg
catalogued => 'kætəlɒgd
catalogues => ˈkætəlɔɡz
cataloguing => 'kætəlɒɡɪŋ
catalonia => ,kætә'lәjniә
Catalonian => ,kætə'ləuniən
catalpa => kә'tælpә
catalufa => ,kætә'lu:fә
catalyse => ˈkætəlaɪz
catalyses => kəˈtælɪsɪsiz
catalysis => kә'tælisis
catalyst => 'kætәlist
catalysts => 'kætəlɪsts
catalytic => .kætә'litik
catalyze => 'kætәlaiz
catalyzed => ˈkætəlaizd
catalyzes => ˈkætəlaiziz
catamaran => .kætәmә'ræn
catamarans => kætəmə'rænz
catamite => 'kætәmait
catamount => 'kætәmaunt
catananche => ,kætә'næŋki
Catania => kә'teinjә
cataphatic => ,kætә'fætik
cataphora => kә'tæfәrә
cataphoric => ,kætә'fɔ:rik
cataphract => 'kætәfrækt
cataplasm => 'kætәplæzm
cataplectic => ,kætә'plektik
cataplexy => 'kætә,pleksi
catapult => 'kætәpʌlt
catapulted => ˈkætəˌpʌltid
catapulting => ˈkætəˌpʌltɪŋ
catapults => ˈkætəˌpʌlts
cataract => 'kætәrækt
cataracts => 'kætərækts
catarrh => kә'tɑ:
catarrhine => 'kætәrain
catastrophe => kә'tæstrәfi
catastrophes => kə'tæstrəfɪz
catastrophic => .kætә'strɒfik
catastrophism => kә'tæstrәfizәm
catastrophist => kætəst'rɒfɪst
catastrophize => kə'tæstrəfaiz
catatonia => .kætә'tәuniә
catatonic => ,kætә'tɔnik
catawba => kә'tɔ:bә
catbird => 'kætbә:d
catbird seat => ˈkætbɜ:d si:t
catboat => 'kætbәut
catcall => 'kætkɒ:l
catcalls => 'kætkɔːl
catch => kætʃ
catch crop => kætʃ krɔp
catch fire => kætʃ ˈfaiə
catchable => 'kætʃəbl
catchall => 'kætʃɔ:l
catcher => 'kætʃә
catchers => ˈkætʃəz
catchfly => 'kætʃflai
catchier => ˈkætʃiə
catching => 'kætʃiŋ
catchline => ˈkætʃlaɪn
catchment => 'kætʃmәnt
catchpenny => 'kætʃ.peni
catchphrase => 'kætʃfreiz
catchup => 'kætʃәp
catchweight => 'kætʃweit
catchword => 'kætʃwә:d
catchy => 'kætʃi
cate => keit
catechesis => ,kætә'ki:sis
catechetic => kætiˊketik
catechetical => .kæti'ketikәl
catechetics => ,kæti'ketiks
catechin => 'kætitʃin, -kin
catechism => 'kætikizm
catechismal => ,kæti'kizməl
catechisms => 'kætəkɪzəmz
catechist => 'kætikist
catechize => 'kætikaiz
catechized => ˈkætikaizd
catechizes => ˈkætikaiziz
catechizing => ˈkætikaizɪŋ
catechol => 'kætitʃәul
catecholamine => ,kæti'kәjlәmi:n
catechu => 'kætitʃu:
catechumen => ,kæti'kju:men
categorial => ,kæti'^әjriәl
categorical => .kæti'gɒrikl
categorisation => ˌkætɪgərə'zeɪʃən
categorise => 'kæti^әraiz
categorize => 'kæti^әraiz
categorized => ˈkætɪgəˌraɪzd
categorizes => ˈkætɪgəˌraɪziz
categorizing => ˈkætɪgəˌraɪzɪŋ
category => 'kætigәri
catena => kә'ti:nә
catenaccio => ,kɑ:tә'nɑ:ttʃi:әj
catenane => 'kætnein
catenary => kә'ti:nәri
catenate => 'kætineit
catenated => ˈkætineitid
catenation => .kæti'neiʃәn
catenative => 'kætineitiv
catenoid => 'kætinɔid
cater => 'keitә
cateran => 'kætәrәn
catered => ˈkeitəd
caterer => 'keitәrә
caterers => ˈkeɪtɵrəz
catering => 'keitәriŋ
caterpillar => 'kætәpilә
caterpillars => kætə'pɪləz
caters => ˈkeitəz
caterwaul => 'kætәwɒ:l
caterwauling => 'kætә,θɔ:liʒ
catfight => 'kætfait
catfish => 'kætfiʃ
catgut => 'kætgʌt
Cathar => 'kæθә(r)
Catharine => 'kæθәrin
catharsis => kә'θɑ:sis
cathartic => kә'θɑ:tik
Cathay => kæ'θei
cathead => 'kæthed
cathectic => kә'θektik
cathedral => kә'θi:drәl
cathedrals => kəˈθi:drəlz
catherine => 'kæθәrin
catheter => 'kæθitә
catheterization => -rai'zeiʃәn
catheterize => 'kæθitәraiz
cathetometer => ,kæθi'tɔmitә
cathexis => kә'θeksis
cathodal => 'kæθәudәl
cathode => 'kæθәud
cathodes => 'kæθəʊdz
cathodic => kә'θɔdik
catholic => 'kæθәlik
Catholicism => kә'θɒlisizm
catholicity => .kæθәu'lisiti
cathouse => 'kæthaus
cathy => 'kæθi
cation => 'kætaiәn
catkin => 'kætkin
catkins => ˈkætkinz
catlick => 'kætlik
catlike => 'kætlaik
catlinite => 'kætli,nait
catmint => 'kætmint
catnap => 'kætnæp
catnapped => ˈkætnæpt
catnapping => ˈkætnæpɪŋ
catnaps => ˈkætnæps
catnip => 'kætnip
Cato => 'keitәu
Caton => 'kɛtən
catoptric => kә'tɒptrik
catoptrics => kә'tɒptriks
catsuit => 'kætsju:t
catsup => 'kætsәp
cattail => 'kætteil
catted => 'kætted
Cattell => kæ'tel
cattery => 'kætәri
cattier => ˈkætiə
cattily => 'kætili
cattiness => 'kætinis
catting => 'kætɪŋ
cattish => 'kætiʃ
cattle => kætl
cattle cake => ˈkætl keik
cattle grid => ˈkætl grɪd
cattleman => 'kætlmәn
cattlemen => 'kæt(ə)lmən
cattleya => 'kætliә
catty => 'kæti
catty-cornered => 'kæti:k'ɔ:nəd
catwalk => 'kætwɒ:k
catwalks => ˈkætwɔ:ks
Caucasian => kɒ:'keiziәn
Caucasoid => 'kɔ:kәsɔid
Caucasus => 'kɔ:kәsәs
caucus => 'kɒ:kәs
caucused => ˈkɔ:kəst
caucuses => ˈkɔ:kəsiz
caucusing => ˈkɔ:kəsɪŋ
caudal => 'kɒ:dәl
caudal fin => ˈkɔ:dl fin
caudate => 'kɔ:deit
caudex => 'kɔ:deks
caudillo => kɔ:'dilәu
caught => kɒ:t
caul => kɒ:l
cauldron => 'kɒ:ldrәn
cauldrons => ˈkɔ:ldrənz
cauliflower => 'kɒliflauә
cauliflowers => ˈkɔliflauəz
caulk => kɒ:k
caulked => kɔ:kt
caulker => 'kɒ:kә
caulking => 'kɔ:kiŋ
causal => 'kɒ:zәl
causalgia => kɒ:'zældʒiә
causality => kɒ:'zæliti
causation => kɒ:'zeiʃәn
causative => 'kɒ:zәtiv
cause => kɒ:z
causeless => 'kɒ:zlis
causer => 'kɔ:zә(r)
causerie => 'kәuzәri(:)
causeway => 'kɒ:zwei
causewayed => 'kɔːzweɪ
causeways => ˈkɔ:zˌweɪz
causey => 'kɔ:ziei
caustic => 'kɒ:stik
caustically => 'kɒ:stikli
causticity => kɒ:'stisiti
cauterise => 'kɔ:təraɪz
cauterization => .kɒ:tәrai'zeiʃәn
cauterize => 'kɒ:tәraiz
cauterized => ˈkɔ:təraizd
cauterizes => ˈkɔ:təraiziz
cauterizing => ˈkɔ:təraizɪŋ
cautery => 'kɒ:tәri
caution => 'kɒ:ʃәn
cautionary => 'kɒ:ʃәnәri
cautioned => ˈkɔ:ʃənd
cautioning => ˈkɔ:ʃənɪŋ
cautions => ˈkɔ:ʃənz
cautious => 'kɒ:ʃәs
cautiously => 'kɒ:ʃәsli
cautiousness => 'kɔ:ʃəsnis
cavalcade => .kævәl'keid
cavalcades => ˌkævəlˈkeɪdz
cavalier => .kævә'liә
cavalierly => ,kævə'lɪrli
cavaliers => ˌkævə'lɪəz
cavalry => 'kævәlri
cavalry twill => ˈkævəlri twil
cavalryman => 'kævәlrimәn
Cavan => 'kævən
cavatina => ,kævә'ti:nә
cave => keiv
cave painting => keiv ˈpeintiŋ
cave-like => keiv laik
caveat => 'keiviæt
caveat emptor => 'kæviæt 'emptɔ:(r)
caveats => ˈkeɪvi:ˌæts
cavefish => 'keivfiʃ
Cavell => 'kævl, kә'vel
cavemen => 'keivmən
cavendish => 'kævәndiʃ
caver => 'keivә
cavern => 'kævәn
cavernous => 'kævәnәs
caverns => ˈkævənz
caves => keivz
cavesson => keɪ'vesʌn
caviar => 'kæviɑ:
caviare => 'kæviɑ:
cavies => ˈkeiviz
cavil => 'kævil
cavilled => ˈkævəld
caviller => kæ'vɪlə
cavilling => 'kæviliŋ
cavils => ˈkævəlz
caving => 'keiviŋ
cavitary => 'kævitәri
cavitation => .kævi'teiʃәn
cavities => ˈkævitiz
cavity => 'kæviti
cavort => kә'vɒ:t
cavorted => kəˈvɔ:tid
cavorting => kəˈvɔ:tɪŋ
cavorts => kəˈvɔ:ts
cavy => 'keivi
caw => kɒ:
cawed => kɔ:d
cawing => kɔ:ɪŋ
caws => kɔ:z
Caxton => 'kækstәn
cay => kei
cayenne => kei'en
cayman => 'keimәn
Cayman Islands => 'keimәn 'ailәndz
cayuse => kai'ju:s
CD-ROM => si:di:'rɔm
ceanothus => .si:ә'nәuθәs
cease => si:s
ceasefire => ˈsi:sfaɪə(r)
ceasefires => ˈsi:sfaiəz
ceaseless => 'si:slis
ceaselessly => 'si:slisli
ceases => si:siz
ceasing => 'si:siŋ
cebid => 'si:bid
Cebu => se'bu:
cecil => 'sesl, 'sisl
cecilia => si'siljә
Cecily => 'sisili
cecitis => si'saitis
cecum => 'si:kәm
cedar => 'si:dә
cedarn => 'si:dәn
cedars => ˈsi:dəz
cede => si:d
ceded => si:did
cedes => si:dz
cedi => 'seidi
cedilla => si'dilә
ceding => si:dɪŋ
Ceefax => 'si:fæks
ceiba => 'seibә
ceil => si:l
ceilidh => ˈkeɪli
ceiling => 'si:liŋ
ceiling rose => ˈsi:liŋ rəuz
ceilings => 'si:lɪŋz
celadon => 'selәdɒn
celandine => 'selәndain
celeb => si'leb
celebrant => 'selibrәnt
celebrants => ˈselibrənts
celebrate => 'selibreit
celebrated => 'selibreitid
celebrates => ˈselibreits
celebrating => ˈselibreitɪŋ
celebration => .seli'breiʃәn
celebrations => ˌselɪˈbreɪʃɵnz
celebrator => 'selәbreitә
celebratory => ˌseləˈbreɪtəri
celebrity => si'lebrti
celebutante => selɪb'ju:tɑ:nt
celeriac => sә'leriæk
celerity => si'leriti
celery => 'selәri
celesta => si'lestә
celeste => si'lest
celestial => si'lestjәl
celestial equator => səˈlestʃəl iˈkweitə
celestial latitude => səˈlestʃəl ˈlætitju:d
celestial longitude => səˈlestʃəl ˈlɔndʒitju:d
celestial mechanics => səˈlestʃəl mɪˈkænɪks
celestial navigation => səˈlestʃəl ˌnæviˈɡeiʃən
celestial pole => səˈlestʃəl pəul
celestial sphere => səˈlestʃəl sfiə
celestially => sɪ'lestjəlɪ
celia => 'si:ljә
celiac => 'si:liæk
celibacy => 'selibәsi
celibate => 'selibәt
celibates => ˈseləbɪts
cell => sel
cell line => sel lain
cell membrane => sel ˈmemˌbreɪn
cell-like => 'sell'aɪk
cella => 'selә
cellar => 'selә
cellarage => 'selәridʒ
cellarer => 'selәrә
cellaret => selә'ret
cellars => ˈseləz
cellblock => 'selblɔk
celled => seld
cellist => 'tʃelist
cellists => ˈtʃelɪsts
cellmate => ˈselmeɪt
cello => 'tʃelәu
cellophane => 'selәufein
cellos => ˈtʃeləʊz
cellphone => 'selfәun
cellphones => 'sel,fəʊn
cellular => 'seljulә
cellularity => ,selju'læriti
cellulase => 'seljuleis
cellulite => ˈseljulaɪt
cellulitis => ,selju'laitis
celluloid => 'seljulɒid
cellulose => 'seljulәus
cellulosic => ,seljʊ'ləʊsɪk
celosia => se'ləʊzɪə
celsius => 'selsiәs
Celt => kelt; selt
Celtic => 'keltik; 'seltik
cembalo => 'tʃembәlәu
cement => si'ment
cementation => .si:men'teiʃәn
cementer => sɪ'mentər
cementing => si'mentiŋ
cementite => si'mentait
cementitious => ,simen'tiʃiәs
cements => siˈments
cemeteries => ˈsemitriz
cemetery => 'semitәri
cenacle => 'senәkl
cenobite => 'si:nәubait
cenotaph => 'senәutɑ:f
cenotaphs => ˈsenətɑ:fs
cense => sens
censed => senst
censer => 'sensә
censing => sensɪŋ
censor => 'sensә
censored => ˈsensəd
censorial => sen'sɒ:riәl
censoring => ˈsensərɪŋ
censorious => sen'sɒ:riәs
censoriously => senˊsɒːriәsli
censoriousness => senˊsɒːriәsnis
censors => ˈsensəz
censorship => 'sensәʃip
censurable => 'senʃәrәbl
censure => 'senʃә
censured => ˈsenʃəd
censures => ˈsenʃəz
censuring => ˈsenʃərɪŋ
census => 'sensәs
censuses => ˈsensəsiz
cent => sent
centaur => 'sentɒ:
centaurea => sen'tɔ:riә
centaurs => ˈsentɔ:z
Centaurus => sen'tɔ:rәs
centaury => 'sentɒ:ri
centavo => sen'tɑ:vәu
centenarian => senti'nєәriәn
centenarians => ˌsentiˈnɛəriənz
centenaries => senˈtenəri:z
centenary => sen'ti:nәri
centennial => sen'tenjәl
center => 'sentә
centerboard => 'sentә,bɔ:d
centered => 'sentәd
centerfold => 'sentəˌfəʊld
centering => 'sentәriŋ, 'sentriŋ
centerline => 'sentәlain
centerpiece => 'sentәpi:s
centesimal => sen'tesiml
centesimally => ˊsentәsimәli
centesimo => sen'tesi,mәu
centi- => 'senti
centigrade => 'sentigreid
centigram => 'sentigræm
centile => 'sentail, -til
centime => 'sә:nti:m
centimes => 'sɒnti:mz
centimeter => 'sentimi:tә
centimeters => 'sentɪˌmi:təz
centimetre => 'senti,mi:tә(r)
centimetres => ˈsentiˌmi:təz
centimo => 'senti'mou
centimorgan => senti'mɔ:^әn
centipede => 'sentipi:d
centipedes => sentɪ'pi:dz
cento => 'sentәu
centra => 'sentrә
central => 'sentrәl
central government => ˈsentrəl ˈɡʌvənmənt
central reservation => ˈsentrəl ˌrezəˈveiʃən
centrale => sent'rɑ:l
centralisation => ,sentrәlɑi'zeiʃәn;-li'z-
centralise => 'sentrәlɑiz
centralised => 'sentrəlaɪz
centralism => 'sentrәlizm
centralist => 'sentrәlist
centralities => senˈtrælitiz
centrality => sen'træliti
centralization => .sentrәlai'zeiʃәn
centralize => 'sentrәlaiz
centralized => 'sentrәlaizd
centralizes => ˈsentrəˌlaɪziz
centralizing => ˈsentrəˌlaɪzɪŋ
centrally => 'sentrәli
centre => 'sentә
centre back => ˈsentə bæk
centre bit => ˈsentə bit
centre half => ˈsentə hɑ:f
centre of buoyancy => ˈsentə ɔv ˈbɔɪənsi:
centre of curvature => ˈsentə ɔv ˈkɜ:vəˌtʃʊə
centre of flotation => ˈsɛntɚ ʌv floˈteʃən
centre spread => ˈsentə spred
centre stage => ˈsentə steidʒ
centred => ˈsentəd
centreline => 'sentəlain
centremost => 'sentәmәust
centrepiece => 'sentәpi:s
centrepieces => ˈsentəpi:siz
centres => ˈsentəz
centric => 'sentrik
centrical => 'sentrikәl
centricity => sen'trisiti
centrifugal => sen'trifjugl
centrifugally => senˊtrifjugәli
centrifugation => sen,trifju'^eiʃәn
centrifuge => 'sentrifju:dʒ
centrifuges => ˈsentrifju:dʒz
centrifuging => 'sentrifjudʒiŋ
centring => 'sentriŋ
centriole => 'sentriәul
centripetal => sen'tripitәl
centripetally => senˊtripitәli
centrism => 'sentrizәm
centrist => 'sentrist
centro => 'sentrəʊ
centroid => 'sentrɒid
centromere => 'sentrә,miә
centrosome => 'sentrәsәum
centrum => 'sentrәm
cents => sents
centuple => 'sentjupl
centurial => sen'tjuriәl, -'tur-
centuries => 'sentʃərɪz
centurion => sen'tjuәriәn
centurions => senˈtjuəriənz
century => 'sentʃuri
century plant => ˈsentʃuri plɑ:nt
cephalic => si'fælik
cephalin => 'sefәlin
cephalization => .sefәlai'zeiʃәn
cephalo- => 'sefәlәj
cephalochordate => sefәlә'kɔ:deit
cephalometric => ,sefәlәj'metrik
cephalometry => ,sefә'lɔmitri
cephalon => 'sefәlәn
cephalopod => 'sefәlәupɒd
cephalosporin => ,sefәlәu'spɔ:rin
cephalothorax => .sefәlәu'θɒ:ræks
cepheid => 'kɪfaɪd
Cepheus => 'si:fju:s
ceramic => si'ræmik
ceramics => si'ræmiks
ceramist => 'serәmist
cerastes => si'ræsti:z
cerastium => si'ræstiәm
ceratite => 'serә,tait
ceratobranchial => ,serәtәu'bræŋkiәl
Cerberus => 'sә:bәrәs
cercaria => sә'kæriә
cerclage => sә:'klædʒ
cercus => 'sә:kәs
cere => siә
cereal => 'siәriәl
cerebellar => ,serә'belә
cerebellopontine => seɪə'beləpɒntaɪn
cerebellum => .seri'belәm
cerebral => 'seribrәl
cerebral aqueduct => ˈserəbrəl ˈækwɪˌdʌkt
cerebrate => 'seribreit
cerebrated => ˈseriˌbreitid
cerebrates => ˈseriˌbreits
cerebrating => ˈseriˌbreitɪŋ
cerebration => seri'breiʃ(ә)n
cerebro- => 'seribrәj, si'ri: -
cerebroside => 'seribrәusaid
cerebrospinal => .seribrәu'spainәl
cerebrovascular => ,seribrәj'væskjjlә(r)
cerebrum => 'seribrәm
cerecloth => 'siәklɔθ
cerement => 'siәmәnt
ceremonial => .seri'mәunjәl
ceremonialism => ,seri'mәjnjәlizəm
ceremonially => .seri'mәunjәli
ceremonials => ˌserəˈməʊni:əlz
ceremonies => ˈseriməniz
ceremonious => .seri'mәunjәs
ceremoniously => .seri'mәunjәsli
ceremony => 'serimәni
Ceres => 'siәri:z
ceresin => 'serisin
cereus => 'siәriәs
cerise => sә'ri:z
cerium => 'siәriәm
cermet => 'sә:met
CERN => s\\\\:n
cero => 'siәrәu
cero- => 'siәrә, 'seәrә
ceroplastic => siәrә'plæstik
cert => sә:t
certain => 'sә:tәn
certainly => 'sә:tәnli
certainties => ˈsə:tntiz
certainty => 'sә:tәnti
certes => 'sә:tiz
certifiable => 'sә:tifaiәbl
certificate => sә'tifikeit
certificates => səˈtifikeits
certification => .sә:tifi'keiʃәn
certified => 'sә:tifaid
certified cheque => ˈsə:tifaid tʃek
certify => 'sә:tifai
certifying => ˈsə:tifaiŋ
certiorari => ,sә:tiɔ:'reәrai
certitude => 'sә:titju:d
cerulean => si'ru:ljәn
cerumen => si'ru:men
ceruse => 'siәru:s
Cervantes => sә'væntiz
cervelat => 's\\\\:vәlæt
cervical => 'sә:vikәl
cervical smear => ˈsə:vikəl smiə
cervicitis => ,sә:vi'saitis
cervid => 'sә:vid
cervix => 'sә:viks
cesarean => si'zeәriәn
cesium => 'si:ziәm
cess => ses
cessation => se'seiʃәn
cesser => 'sesә
cession => 'seʃәn
cesspit => 'sespit
cesspits => ˈsespits
cesspool => 'sespu:l
cestode => 'sestәud
cetacean => si'teiʃjәn
cetane => 'si:tein
ceteris paribus => 'sitәris'pæribәs
cetologist => se'tɒlədʒɪst
cetology => si'tɔlәdʒi
cetrimide => 'setrimaid
Cetus => 'si:tәs
Ceuta => 'sju:tә
ceviche => sә'vi:tʃei
Ceylon => si'lɒn
cha => tʃɑ:
cha-cha => 'tʃɑ:tʃɑ:
chabazite => 'tʃæbәzait
chablis => 'ʃæbli:
chaconne => ʃɑ:'kɔn
Chad => tʃæd
Chadian => 'tʃædiәn
chadwick => 'tʃædwik
chaebol => 'tʃæbəul
chaeta => 'ki:tә
chaetognath => 'ki:tә ^næθ
chafe => tʃeif
chafed => tʃeɪft
chafer => 'tʃeifә
chafes => tʃeɪfs
chaff => tʃæf
chaff-cutter => 'tʃɑ:f,kʌtә(r)
chaffed => tʃɑːf; tʃæf
chaffer => 'tʃæfә
chaffered => ˈtʃæfəd
chafferer => 'tʃæfәrә
chaffering => ˈtʃæfərɪŋ
chaffers => ˈtʃæfəz
chaffinch => 'tʃæfintʃ
chaffinches => ˈtʃɑ:fintʃiz
chaffs => tʃɑːf; tʃæf
chaffy => 'tʃæfi
chafing dish => ˈtʃeɪfɪŋ
chagrin => 'ʃægrin
chagrined => 'ʃæɡrɪnd
chagrining => ʃəˈgrɪnɪŋ
chagrins => ʃəˈgrɪnz
chai => tʃai
chain => tʃein
chain gang => tʃein ɡæŋ
chain-driven => t'ʃeɪndr'ɪvn
chain-smoked => tʃein sməʊkt
chain-smoker => tʃein ˈsməʊkə
chain-smoking => tʃein ˈsməʊkɪŋ
chained => tʃeind
chaining => 'tʃeiniŋ
chainsaw => 'tʃeinsɔ:
chair => tʃєә
chair car => tʃɛə kɑ:
chairlady => 'tʃεә.leidi
chairlift => ˈtʃeəlɪft
chairlifts => t'ʃeərlɪfts
chairman => 'tʃєәmәn
chairmans => ˈtʃɛəmənz
chairmanship => 'tʃєәmәnʃip
chairperson => 'tʃeәp\\\\:s(e)n
chairpersons => ˈtʃeəpə:s(e)nz
chairwoman => 'tʃєәwumәn
chaise => ʃeiz
chaise lounge => ʃeɪz laundʒ
chakka => 'tʃɑ:kә
chakra => ˈtʃʌkrə
chalaza => kә'leizә
chalcedonic => 'kælsedənɪk
chalcedonies => kælˈsedəniz
chalcedony => kæl'sedәni
chalcid => 'kælsid
Chalcis => 'kælsis
Chalcolithic => ,kælkә'liθik
chalcopyrite => .kælkә'pairait
Chaldea => kæl'di:ә
Chaldean => kæl'di:әn
Chaldee => kæl'di:
chalet => 'ʃælei
chalets => ʃæˈleɪz
chalice => 'tʃælis
chalices => ˈtʃælɪsiz
chalk => tʃɒ:k
chalk talk => tʃɔ:k tɔ:k
chalkboard => 'tʃɒ:kbɒ:d
chalked => tʃɔ:kt
chalkiness => 'tʃɒ:kinis
chalking => 'tʃɔ:kiŋ
chalks => tʃɔ:ks
chalky => 'tʃɒ:ki
challah => 'hɑ:lә
challenge => 'tʃælindʒ
challenged => 'tʃælindʒid
challenger => 'tʃælindʒә
challengers => ˈtʃælindʒəz
challenges => ˈtʃælindʒz
challenging => 'tʃælindʒiŋ
challis => 'ʃælis; -li:
chalone => 'kælәun
chalumeau => 'ʃælju,mәu
chalupa => 'tʃælupә
chalybeate => kә'libiәt
chamaephyte => 'kæmiәfait
chamber => 'tʃeimbә
chamber of commerce => ˈtʃeimbə ɔv ˈkɔmə:s
chamber orchestra => ˈtʃeimbə ˈɔ:kistrə
chambered => 'tʃeimbәd
chambering => 'tʃeimbәriŋ
chamberlain => 'tʃeimbәlin
chamberlains => ˈtʃeimbəlinz
chambermaid => 'tʃeimbәmein
chambermaids => ˈtʃeɪmbəˌmeɪdz
Chambers => 'tʃeimbәz
Chambertin => 'tʃeimbәtin
chambray => 'ʃæmbrei
chameleon => kә'mi:liәn
chameleonic => kә.mi:li'ɒnik
chameleons => kəˈmi:ljənz
chamfer => 'tʃæmfә
chamfered => t'ʃæmfəd
chamfering => 'tʃæmfәriŋ
chamois => 'ʃæmwɑ:
chamomile => ' k æmәmail
Chamonix => 'ʃæməni:
Chamorro => tʃɑ:'mɔ:rәu
champ => tʃæmp
champagne => ʃæm'pein
champagne socialist => ʃæmˈpein ˈsəuʃəlist
champaign => 'tʃæmpein
champak => 'tʃæmpæk
champed => tʃæmpt
champertous => 'tʃæmpətəs
champerty => 'tʃæmpәti
champignon => tʃæm'pinjәm
champing => tʃæmpɪŋ
champion => 'tʃæmpiәn
championship => 'tʃæmpiәnʃip
championships => t'ʃæmpɪənʃɪps
Champlain => ʃæm'plein
chance => tʃæns. tʃɑ:ns
chancel => 'tʃɑ:nsl
chancellery => 'tʃɑ:nsәlәri
chancellor => 'tʃɑ:nsәlә
chancellors => ˈtʃɑ:nsələz
chancellorship => t'ʃɑ:nsələʃɪp
chancels => ˈtʃɑ:nsəlz
chancer => ˈtʃɑ:nsə(r)
chancery => 'tʃænsәri
chances => tʃɑ:nsiz
chanciness => 't ʃɑ:nsinis
chancre => 'ʃæŋkә
chancroid => 'ʃæŋkrɒid
chancy => 'tʃɑ:nsi
chandelier => ,ʃændi'liә
chandeliers => ˌʃændəˈlɪəz
chandelle => ʃɑ:n'del
chandelled => ʃæn'del
chandelling => ʃæn'del
chandler => 'tʃɑ:ndlә
chandlery => 'tʃɑ:ndlәri
Chanel => ʃɑ:'nel
chang => tʃɑ:ŋ. tʃæŋ
Changchun => 'tʃɑ:ŋ'tʃjn
change => tʃeindʒ
change over => tʃeindʒ ˈəuvə
change purse => tʃeindʒ pə:s
change-up => 'tʃeindʒʌp
changeability => ..tʃeindʒә'biliti
changeable => 'tʃeindʒәbl
changeableness => t'ʃeɪndʒəbəlnɪs
changeably => 'tʃeindʒәbli
changeful => 'tʃeindʒful
changeless => 'tʃeindʒlis
changelessly => t'ʃeɪndʒlezslaɪ
changelessness => ˊtʃeindʒilisnis
changeling => 'tʃeindʒliŋ
changelings => ˈtʃeindʒliŋz
changeover => 'tʃeindʒәuvә
changeovers => ˈtʃeindʒˈəuvəz
changer => 'tʃeindʒә
changers => 'tʃeɪn(d)ʒə
changing => 'tʃeindʒiŋ
changing room => ˈtʃeindʒiŋ ru:m
Changsha => 'tʃɑ:ŋ'ʃɑ:
channel => 'tʃænәl
channel-surf => 'tʃænəlsə:f
channeled => 'tʃænәld
channeler => t'ʃænələr
channeling => 'tʃænәliŋ
channelize => 'tʃænәlaiz
Channing => 'tʃæniŋ
chanson => 'ʃænsәn
chant => tʃænt. tʃɑ:nt
chanted => tʃɑ:ntid
chanter => 'tʃɑ:ntә
chanterelle => ʃɒŋtә'rel
chanteuse => ʃɔŋ't\\\\:z
chantey => 'ʃænti
chanticleer => .tʃænti'kliә
Chantilly => ʃæn'tili
chantry => 'tʃɑ:ntri
chanty => 'tʃɑ:nti
Chanukah => 'kɑ: nu,kɑ:
chaos => 'keiɒs
chaotic => kei'ɒtik
chaotic attractor => keiˈɔtik əˈtræktə
chap => tʃæp
chaparral => .tʃæpә'ræl
chapati => tʃə'pɑ:tɪ
chapatti => tʃəˈpæti
chapbook => 'tʃæpbuk
chape => tʃeip
chapeau => ʃæ'pәu
chapel => 'tʃæpәl
chapelry => 'tʃæpәlri
chapels => ˈtʃæpəlz
chaperon => 'ʃæpәrәun
chaperonage => 'ʃæpərəʊnɪdʒ
chaperone => 'ʃæpәrәun
chaperoned => ˈʃæpərəʊnd
chaperones => ˈʃæpərəʊnz
chaperoning => ˈʃæpərəʊnɪŋ
chaperons => ˈʃæpəˌrəʊnz
chaplain => 'tʃæplin
chaplaincy => ˈtʃæplɪnsi
chaplains => t'ʃæplɪnz
chaplet => 'tʃæplit
chapleted => 'tʃæplitid
chaplin => 'tʃæplin
Chaplinesque => ,tʃæpli'nesk
chapman => 'tʃæpmәn
chappal => 'tʃʌpәl
chapped => tʃæpt
chappie => 'tʃæpi
chapping => tʃæpɪŋ
chappy => 'tʃæpi
chaps => tʃæps
chapstick => 'tʃæpstik
chaptalize => 'ʃæptәlaiz
chapter => 'tʃæptә
char => tʃɑ:
chara => 'ʃærә
characin => 'kærәsin
character => 'kærәktә
characterful => 'kærәktәfjl
characterisation => ,kærәktәrai'zeiʃən; -ri'z-
characterise => 'kærәktәraiz
characteristic => .kærәktә'ristik
characteristically => .kærәktә'ristikli
characteristics => .kærәktә'ristiks
characterization => ,kæriktәrai'zeiʃәn
characterizations => kærɪktəraɪ'zeɪʃənz
characterize => 'kærәktәraiz
characterized => ˈkæriktəraizd
characterizes => ˈkæriktəraiziz
characterizing => ˈkæriktəraizɪŋ
characterless => 'kærәktәrlis
characterological => ,kærәktәrә'lɔdʒikəl
charade => ʃә'rɑ:d
charango => tʃə'ræŋgəʊ
charas => 'tʃɑ:rәs
charbroil => 'tʃɑ:brɔil
charcoal => 'tʃɑ:kәul
charcoaling => ˈtʃɑ:kəulɪŋ
charcoals => ˈtʃɑ:kəulz
charcuterie => ʃɑ:,kju:tә'ri:
chard => tʃɑ:d
Chardin => pjeәr
chardonnay => ,ʃɑ:dә'nei
charge => tʃɑ:dʒ
charge card => tʃɑ:dʒ kɑ:d
chargeable => 'tʃɑ:dʒәbl
charged => tʃɑ:dʒd
chargehand => 'tʃɑ:dʒhænd
chargepayer => tʃɑ:dʒɪ'peɪə
charger => 'tʃɑ:dʒә
chargers => ˈtʃɑ:dʒəz
charging => 'tʃɑ:dʒiŋ
charier => ˊtʃєәriә
chariest => ˊtʃєәriist
charily => 'tʃєәrili
charing => 'tʃɑ:riŋ
chariot => 'tʃæriәt
charioteer => .tʃæriә'tiә
charioteers => tʃærɪə'tɪə
chariots => ˈtʃæri:əts
charisma => kә'rizmә
charismatic => ,kæriz'mætik
charitable => 'tʃæritәbl
charitably => 'tʃærətəblɪ
charities => ˈtʃæritiz
charity => 'tʃæriti
charity shop => ˈtʃæriti ʃɔp
charivari => .ʃɑ:ri'vɑ:ri
charlady => 'tʃɑ:leidi
charlatan => 'ʃɑ:lәtәn
charlatans => ˈʃɑ:lətənz
Charlemagne => 'ʃɑ:lә'mein
charlene => ʃɑ:'li:n
charles => tʃɑ:lz
Charleston => 'tʃɑ:lstәn
charley horse => ˈtʃɑ:li hɔ:s
CHARLIES => 'tʃɑːlɪ
charlock => 'tʃɑ:lɒk
charlotte => 'ʃɑ:lәt
charlotte russe => ˈru:s
Charlottetown => 'ʃɑ:lәttajn
charm => tʃɑ:m
charm offensive => tʃɑ:m əˈfensiv
charmed => tʃɑ:md
charmer => 'tʃɑ:mә
charmers => ˈtʃɑ:məz
charmeuse => ʃɑ:'mu:z
charming => 'tʃɑ:miŋ
charmless => 'tʃɑ:mlis
charmonium => tʃɑ:'mәjniәm
charnel => 'tʃɑ:nәl
charolais => 'ʃærәlei
charon => 'keәrәn
charpoy => 'tʃɑ:pɔi
charr => tʃɑ:
charred => ˈtʃɑ:d
charrette => ʃә'ret
chart => tʃɑ:t
chartbuster => 'tʃɑ:t,bʌstә(r)
charter => 'tʃɑ:tә
charter member => ˈtʃɑ:tə ˈmembə
chartered => 'tʃɑ:tәd
charterer => 'tʃɑ:tәrә
Charterhouse => 'tʃɑ:tәhaus
chartering => 'tʃɑ:tәriŋ
charters => ˈtʃɑ:təz
chartism => 'tʃɑ:tizm
chartist => 'tʃɑ:tist
chartreuse => ʃɑ:'trә:z
charts => tʃɑ:ts
charwoman => 'tʃɑ:wumәn
charwomen => 'tʃɑ:wɪmɪn
chary => 'tʃєәri
Charybdis => kә'ribdis
chase => tʃeis
chaser => 'tʃeisә
chasers => ˈtʃeisəz
Chasid => 'hæsid
chasing => 'tʃeisiŋ
chasm => 'kæzәm
chasmic => 'kæzmik
chasms => ˈkæzəmz
chasse => ʃɑ:s
chasseur => ʃæ'sә:
Chassid => 'hæsid
chassis => 'ʃæsi
chaste => tʃeist
chastely => 'tʃeistli
chasten => 'tʃeisәn
chastened => 'tʃeɪsnd
chasteness => 'tʃeistnis
chastening => 'tʃeisniŋ
chastens => ˈtʃeɪsənz
chastise => tʃæ'staiz
chastised => tʃæsˈtaɪzd
chastisement => tʃæ'staizmәnt
chastiser => tʃæ'staizә(r)
chastises => tʃæsˈtaɪziz
chastising => tʃæsˈtaɪzɪŋ
chastity => 'tʃæstiti
chasuble => 'tʃæzjubl
chat => tʃæt
chat room => tʃæt ru:m
chat show => tʃæt ʃəu
chateau => ʃæ'tәu
chateaubriand => ʃɑ:tәubri:'ɒŋ
chateaux => 'ʃætәuz
chatelain => 'ʃætlein
chatelaine => 'ʃætәlein
chatham => 'tʃætәm
chatline => 'tʃætlain
chatoyancy => ʃә'tɔiәnsi
chatoyant => ʃә'tɒiәnt
chatted => tʃætid
chattel => 'tʃætәl
chattels => tʃætlz
chatter => 'tʃætә
chatterbox => 'tʃætәbɒks
chatterboxes => ˈtʃætəˌbɔksiz
chattered => ˈtʃætəd
chatterer => 'tʃætәrә
chattering => 'tʃætәriŋ
chatters => ˈtʃætəz
Chatterton => 'tʃætәtn
chattily => 'tʃætili
chattiness => t'ʃætɪnəs
chatty => 'tʃæti
chaucer => 'tʃɔ:sә
Chaucerian => tʃɔ:'siәriәn
chauffeur => 'ʃәufә
chauffeured => ˈʃəufəd
chauffeuring => ˈʃəufərɪŋ
chauffeurs => ˈʃəufəz
chauffeuse => ʃәu'fә:z
chaulmoogra => tʃɒ:l'mu:grә
chausses => ʃәus
chauvinism => 'ʃәuvinizm
chauvinist => 'ʃәuvinist
chauvinistic => .ʃәuvi'nistik
chauvinistically => ˊʃouvәnistikәli
chav => tʃæv
chaw => tʃɒ:
chawed => tʃɔ:d
chawing => tʃɔ:ɪŋ
chawl => tʃɔ:l
chaws => tʃɔ:z
Chay => tʃei, tʃai
chayote => tʃɑ:'jәuti
ChB => ,si: eitʃ 'bi:
cheap => tʃi:p
cheapen => 'tʃi:pәn
cheapened => ˈtʃi:pənd
cheapening => ˈtʃi:pənɪŋ
cheapens => ˈtʃi:pənz
cheaply => 'tʃipli
cheapness => 'tʃi:pnis
cheapo => 'tʃi:pәj
Cheapside => 'tʃi:p'said
cheapskate => 'tʃi:pskeit
cheat => tʃi:t
cheat sheet => tʃi:t ʃi:t
cheated => tʃi:tid
cheater => 'tʃi:tә
cheating => 'tʃi:tiŋ
Chechen => tʃə'tʃen
check => tʃek
check into => tʃek ˈɪntuː
check up on => tʃek ʌp ɔn
check-up => 'tʃekʌp
check-ups => t'ʃek'ʌps
checkbook => 'tʃekbuk
checkbox => ˈtʃekbɒks
checked => tʃekt
checker => 'tʃekә
checkerberry => 'tʃekәbәri
checkerboard => 'tʃekәbɔ:d
checkered => 'tʃekәd
checkers => 'tʃekәz
checking => 'tʃekiŋ
checkmark => 'tʃek,ma:k
checkmarks => 'tʃekmɑ:ks
checkmate => 'tʃekmeit
checkmated => ˈtʃekˌmeɪtid
checkmates => ˈtʃekˌmeɪts
checkmating => ˈtʃekˌmeɪtɪŋ
checkoff => 'tʃekɒf
checkout => 'tʃekaut
checkouts => ˈtʃekauts
checkpoint => 'tʃekpɒint
checkpoints => t'ʃekpɔɪnts
checkroom => 'tʃekru:m
checkup => 'tʃekʌp
checkups => ˈtʃekˌʌps
cheddar => 'tʃedә
cheder => 'keidә
cheechako => tʃi:'tʃɑ:kәu
cheek => tʃi:k
cheekbone => 'tʃi:kbәun
cheekbones => ˈtʃiːkˌbəʊnz
cheekier => ˈtʃi:ki:ə
cheekily => 'tʃi:kili
cheekiness => 'tʃi:kinis
cheekpiece => 'tʃi:kpi:s
cheeky => 'tʃi:ki
cheep => tʃi:p
cheeped => tʃi:pt
cheeping => tʃi:pɪŋ
cheeps => tʃi:ps
cheer => tʃiә
cheerer => 'tʃiərə
cheerful => 'tʃiәful
cheerfully => 'tʃiәfuli
cheerfulness => 'tʃiәfulnis
cheerier => ˈtʃɪəri:ə
cheering => 'tʃiәriŋ
cheerio => tʃiәri'әj
cheerleader => 'tʃiәli:dә
cheerleaders => ˈtʃɪəˌli:dəz
cheerleading => 'tʃɪəli:dɪŋ
cheerless => 'tʃiәlis
cheerly => 'tʃiәli
cheers => tʃiәz
cheery => 'tʃiәri
cheese => tʃi:z
cheeseboard => ˈtʃi:zbɔ:d
cheeseburger => 'tʃi:zbә:gә
cheeseburgers => ˈtʃi:zbə:ɡəz
cheesecake => 'tʃi:zkeik
cheesecakes => ˈtʃi:zˌkeɪks
cheesecloth => 'tʃi:zklɒ:θ
cheesed => tʃi:zd
cheesed off => ˌtʃiːzd 'ɒf
cheesemaker => 'tʃi:z,meikә(r)
cheesemonger => 'tʃi:z.mʌŋgә
cheeses => tʃi:ziz
cheesier => ˈtʃi:ziə
cheesy => 'tʃi:zi
cheetah => 'tʃi:tә
cheetahs => ˈtʃi:təz
chef => ʃef
Cheka => 'tʃekә
chekhov => 'tʃekɔf
Chekhovian => tʃe'kәjviәn
Chekiang => 'tʃe'kjæŋ
chela => 'ki:lә
chelate => 'ki:leit
chelated => ki:'ləted
chelates => ˈki:leits
chelation => ki:'leiʃәn
chelator => ki:'leitә
chelicera => kә'lisәrә
cheliceral => 'ʃelɪsrəl
chelicerate => -ә,reit, -әrit
Chellean => 'ʃeliәn, ʃe'liәn
Chelmsford => 'tʃelmsfəd
chelonian => ki'lәuniәn
chelsea => 'tʃelsi
Cheltenham => 'tʃeltәnәm
Chelyabinsk => tʃel'jɑ:binsk
chem => kem
chemi- => 'kemɪ
chemical => 'kemikl
chemical engineer => ˈkemikəl ˌendʒiˈniə
chemically => 'kemikli
chemiluminescence => ,kemi,lu:mi'nesns
chemiluminescent => ke'maɪlu:mɪnsnt
chemin de fer => ʃә'mændә'feә
chemise => ʃә'mi:z
chemisette => .ʃemi:'zet
chemisorb => 'kemisɒ:b
chemisorption => ,kemi'sɔ:pʃәn
chemist => 'kemist
chemist's => 'kemists
chemistry => 'kemistri
chemists => 'kemɪsts
Chemnitz => 'kemnits
chemo => ˈki:məʊ
chemo- => 'kemәj,'ki:mәj
chemoattractant => kɪməʊt'ræktænt
chemoautotroph => ,kimәu'ɔtәtrәuf
chemoautotrophic => ,kemәu,ɔtә'trɔfik
chemoautotrophy => -'tɔ:trәfi
chemoprophylactic => -'læktik
chemoprophylaxis => ,kemәu'prәufi'læksis
chemoreception => ,kemәjri'sepʃәn
chemoreceptor => ,kemәuri'septә
chemosensory => ,kemәj'sensәri
chemostat => 'kemәstæt
chemosynthesis => 'kemәu'sinθәsis
chemosynthetic => keməʊsɪn'θetɪk
chemotactic => ,kemәu'tæktik
chemotaxis => ,kemә'tæksis
chemotherapeutic => 'kemәj,θerә'pju:tik
chemotherapist => keməʊ'θerəpɪst
chemotherapy => .kemәu'θerәpi
chemurgy => 'kemә:dʒi
Chenab => tʃә'nɑ:b
chenar => 'tʃi'nɑ:
Cheney => 'tʃini
Chengchow => 'dʒʌŋ'dʒәj
chenille => ʃә'ni:l
cheongsam => 'tʃɔ:ŋ'sæm
Cheops => 'ki:ɔps
cheque => tʃek
cheque card => tʃek kɑ:d
chequebook => 'tʃekbuk
chequebooks => 'tʃekbuk
chequer => 'tʃekә
chequerboard => 'tʃekəbɔːd
chequering => 'tʃekə
Chequers => 'tʃekәz
cheques => t'ʃeks
Cherbourg => 'ʃeәbjә^
Cheremis => ,tʃεərə'mis
Cherenkov => tʃә'reŋkɔf
cherimoya => ,tʃeri'mɔiә
cherish => 'tʃeriʃ
cherished => ˈtʃeriʃt
cherishes => ˈtʃeriʃiz
cherishing => ˈtʃeriʃɪŋ
Chernobyl => tʃiә'nɔ:bil
chernozem => 'tʃeәnәzem
cherokee => ,tʃerә'ki:
cheroot => ʃә'ru:t
cherries => ˈtʃeri:z
cherry => 'tʃeri
cherry picker => ˈtʃeri: ˈpɪkə
cherry plum => ˈtʃeri: plʌm
cherry tomato => ˈtʃeri: təˈmɑ:təu
cherry-pick => ˈtʃeri: pik
cherrywood => 'tʃeriwjd
chert => tʃә:t
cherty => 'tʃә:ti
cherub => 'tʃerәb
cherubic => tʃe'ru:bik
cherubs => ˈtʃerəbz
chervil => 'tʃә:vil
cheryl => 'ʃeril
Cheshire => 'tʃeʃә
chess => tʃes
chessboard => 'tʃesbɒ:d
chessboards => ˈtʃesbɔ:dz
chessman => 'tʃesmәn
chest => tʃest
chest freezer => tʃest ˈfri:zə
chester => 'tʃestә
chesterfield => 'tʃestәfi:ld
Chesterton => 'tʃestәtәn
chestnut => 'tʃesnʌt
chestnuts => t'ʃesnʌts
chests => tʃests
chesty => 'tʃesti
Chetnik => 'tʃetnik
chetrum => 'tʃi:trәm
cheval => ʃә'væl
cheval glass => ʃəˈvæl ɡlɑ:s
chevalier => .ʃevә'liә
chevet => ʃә'vei
chevied => 'tʃevi
chevies => 'tʃevi
CHEVIOT => 'tʃeviәt
chevrolet => 'ʃevrәulei
chevron => 'ʃevrәn
chevroned => 'ʃevrənd
chevrons => ˈʃevrənz
chevrotain => 'ʃevrәtein
chevy => tʃevi
chevying => 'tʃevi
chew => tʃu:
chewed => tʃu:d
chewer => 'tʃu:ə
chewier => ˈtʃu:iə
chews => tʃu:z
chewy => 'tʃu:i
chez => ʃei
chi => kai, ki:
chi-chi => 'tʃi:tʃi
chi-rho => 'kai'rәj,'ki:-
chi-squared => t'ʃɪskw'eəd
chianti => ki'ænti
Chiapas => tʃi'ɑ:pɑ:s
chiaroscuro => ki.ɑ:rә'skjuәrәu
chiasma => kai'æzmә
chiasmus => kai'æzmәs
chiastic => -'æstik
chiastolite => kai'æstә,lait
Chibcha => 'tʃibtʃә
Chibchan => 'tʃibtʃәn
chibol => 'tʃibәl
chibouk => tʃi'bu:k
chic => ʃi:k
Chicago => ʃi'kɑ:gәu
chicane => ʃɑ'kein
chicaned => ʃiˈkeind
chicanery => ʃi'keinәri
chicanes => ʃiˈkeinz
chicaning => ʃiˈkeinɪŋ
chicha => 'ʃi:tʃә
Chichester => 'tʃitʃәstә(r)
chichi => 'ʃi:ʃi:
chick => tʃik
chick flick => tʃɪk flik
chick lit => tʃɪk lɪt
chickabiddy => 'tʃikәbidi
chickadee => 'tʃikәdi:
chickaree => 'tʃikәri:
chicken => 'tʃikin
chicken hawk => ˈtʃikin hɔ:k
chicken wire => ˈtʃikin ˈwaiə
chicken-and-egg => 'tʃikinənd'eɡ
chicken-breasted => 'tʃikin,brestid
chickened => 'tʃɪkɪn
chickening => 'tʃɪkɪn
chickens => ˈtʃikinz
chickenshit => 'tʃikinʃit
chickpea => 'tʃikpi:
chickpeas => tʃɪk'pi:z
chicks => tʃiks
chickweed => 'tʃikwi:d
chicle => 'tʃikl
chicly => 'ʃikli
chico => 'tʃi:kәu
chicory => 'tʃikәri
chide => tʃaid
chides => tʃaɪdz
chiding => tʃaɪdɪŋ
chief => tʃi:f
chief petty officer => tʃif ˈpɛti ˈɔfɪsɚ
chiefdom => 'tʃi:fdәm
chiefly => 'tʃi:fli
chiefs => tʃi:fs
chieftain => 'tʃi:ftәn
chieftaincy => 'tʃi:ftәnsi
chieftains => ˈtʃi:ftənz
chieftainship => 'tʃi:ftәnʃip
chiffchaff => 'tʃiftʃæf
chiffon => 'ʃifɔn
chiffonade => ,ʃifә'neid
chiffonier => .ʃifә'niә
chifforobe => 'ʃifәrәjb
chigger => 'tʃigә
chignon => 'ʃi:njɒŋ
chigoe => 'tʃigәu
chihuahua => tʃi'wɑ:wә; (?@) tʃi'wɑ:wɑ:
chihuahuas => tʃiˈwɑ:wɑ:z
chikungunya => ˌtʃɪkənˈgʌnjə
chilblain => 'tʃiblein
chilblains => t'ʃɪlbleɪnz
child => tʃaild
child benefit => tʃaild ˈbenifit
child prodigy => tʃaild ˈprɔdidʒi
child-centred => 'tʃaild,sentəd
child-mind => 'tʃaɪldmaɪnd
childbearing => 'tʃaildbєәriŋ
childbed => 'tʃaildbed
childbirth => 'tʃaildbә:θ
childcare => 'tʃaildkεә
childe => tʃaild
Childermas => 'tʃildәmæs
childhood => 'tʃaildhud
childhoods => ˈtʃaildhudz
childish => 'tʃaildiʃ
childishly => 'tʃaɪldɪʃlɪ
childishness => 'tʃaɪldɪʃnəs
childless => 'tʃaildlis
childlessness => 'tʃaildlisnis
childlike => 'tʃaillaik
Childline => 'tʃaildlain
childmind => 'tʃaildmaind
childminder => ˈtʃaɪldmaɪndə(r)
childproof => 'tʃaildpru:f
childrearing => 'tʃaildriəriŋ
children => 'tʃildrәn
Chile => 'tʃili
Chilean => 'tʃiliәn
chili => 'tʃili
chili dog => 'tʃilidɔɡ
chiliarch => 'kili,ɑ:k
chiliasm => 'kiliæzәm
chiliast => 'kiliæst
chiliastic => ,kili'æstik
chill => tʃil
chill-out => t'ʃɪl'aʊt
chillax => tʃɪ'læks
chilled => tʃild
chiller => 'tʃilә
chilli => 'tʃili
chillier => ˈtʃɪli:ə
chillies => t'ʃɪlɪz
chilliness => 'tʃilinis
chilling => 'tʃiliŋ
chillness => 'tʃilnis
chilly => 'tʃili
chilopod => 'kailәpɒd
chiltern => 'tʃiltә:n
Chiltern Hundreds => 'tʃilt(ә)n
chimaera => kai'miәrә
Chimborazo => ,tʃimbә'rɑ:zәj
chime => tʃaim
chimed => tʃaɪmd
chimera => kai'miәrә
chimeras => kaɪˈmɪərəz
chimeric => kai'merik
chimerical => kai'miәrikәl
chimes => tʃaɪmz
chimichanga => 'kɪmɪtʃæɡə
chiming => tʃaɪmɪŋ
chimney => 'tʃimni
chimney breast => ˈtʃimni brest
chimney swift => ˈtʃimni swift
chimneys => ˈtʃimniz
chimp => tʃimp
chimpanzee => .tʃimpәn'zi:
chimpanzees => ˌtʃimpənˈzi:z
chimps => tʃimps
chin => tʃin
chin up => tʃin ʌp
chin-chin => 'tʃintʃin
chin-up => 'tʃinʌp
China => 'tʃainә
chinaberry => 'tʃainәbәri
chinagraph => 'tʃainә^rɑ:f
Chinaman => 'tʃainәmәn
chinamen => 'tʃainəmən
chinar => tʃi'nɑ:
Chinatown => 'tʃainәtajn
chinch => tʃintʃ
chincherinchee => ,tʃintʃә'rintʃi
chinchilla => tʃin'tʃilә
Chindwin => 'tʃin'dwin
chine => tʃain
chined => tʃaɪn
Chinese => tʃai'ni:z
ching => tʃiŋ
chink => tʃiŋk
chinkapin => 'tʃiŋkәpin
chinked => tʃɪŋkt
chinking => tʃɪŋkɪŋ
chinks => tʃɪŋks
chinless => 'tʃinlis
chinning => 'tʃiniŋ
chino => 'tʃi:nәu
Chino- => 'tʃainәj
chinoiserie => ,ʃi:nwɑ:z(ә)'ri:
Chinook => tʃi'nu:k
chinquapin => 'tʃiŋkәpin
chinstrap => tʃɪnst'ræp
chintz => tʃints
chintzy => 'tʃintsi
chinwag => ˈtʃɪnwæg
chionodoxa => kai,ɔnә'dɔksә
Chios => 'kaiɔs
chip => tʃip
chip away => tʃip əˈwei
chip shop => tʃip ʃɔp
chip shot => tʃip ʃɔt
chipboard => 'tʃipbɒ:d
Chipewyan => ,tʃipi'waiәn
chipmaker => t'ʃɪpmeɪkə
chipmunk => 'tʃipmʌŋk
chipmunks => ˈtʃɪpˌmʌŋks
chipolata => ,tʃipә'lɑ:tә
chipotle => ʃɪpɒtlə
chipped => t'ʃɪpt
Chippendale => 'tʃipәndeil
Chippenham => 'tʃipənhæm
chipper => 'tʃipә
chippie => 'tʃipi
chipping => 'tʃipiŋ
chipping sparrow => ˈtʃipiŋ ˈspærəʊ
chippy => 'tʃipi
chips => tʃips
chipset => 'tʃɪpset
chiral => 'tʃirәl
chirality => 'tʃirәliti
chirimoya => ,tʃiәri'mɔiә
chirk => tʃә:k
chiro- => 'kaiәrәj
chirography => kaiә'rɒgrәfi
chiromancy => 'kaiәrәmænsi
chironomid => kai'rɔnәmid
chiropodist => ki'rɒpәdist
chiropodists => kiˈrɔpədists
chiropody => ki'rɒpәdi
chiropractic => .kaiәrә'præktik
chiropractor => 'kaiәrә.præktә
Chiroptera => kaiә'rɔptәrә
chiropteran => kai'rɔptәrәn
chirp => tʃә:p
chirped => tʃɜ:pt
chirpier => ˈtʃə:piə
chirpily => 'tʃә:pili
chirpy => 'tʃә:pi
chirr => tʃә:
chirrup => 'tʃirәp
chirruping => 'tʃɪrəp
chirrupy => 'tʃirәpi
chiru => 'tʃiru:
chisel => 'tʃizәl
chiseled => 'tʃɪzld
chiselling => 'tʃizәliŋ
chisels => ˈtʃɪzəlz
chit => tʃit
chit-chat => tʃit tʃæt
chital => 'tʃi:tәl
chitarrone => ,kitɑ:'rәjni
chitchat => 'tʃittʃæt
chitchats => ˈtʃittʃæts
chitchatted => ˈtʃittʃætid
chitchatting => ˈtʃittʃætɪŋ
chitin => 'kaitin
chitinous => 'kaitinәs
chitlins => 'tʃitlinz
chiton => 'kaitn
chitons => 'kaitәns
chits => tʃits
Chittagong => 'tʃitә^ɔŋ
chitter => 'tʃitә
chittered => 'tʃɪtə
chittering => 'tʃitәriŋ
chitterlings => 'tʃitәliŋz
chitters => 'tʃɪtə
chitty => 'tʃiti
chivalric => 'ʃivәlrik
chivalrous => 'ʃivәlrәs
chivalrously => 'ʃivәlrәsli
chivalry => 'ʃivәlri
chive => tʃaiv
chiver => tʃaɪv
chives => tʃaɪvz
chivvy => 'tʃivi
Chkalov => 'tʃkɑ:lɔf
chlamydia => klә'midiә
chlamydomonas => ,klæmidә'mәjnәs
chlamydospore => klә'midәspɔ:
chlamys => 'klæmis
chloasma => klәj'æzmә
chloe => 'klәji
chlor- => klɔ:(r)
chloracne => klɔ:'rækni
chloral => 'klɒ:rәl
chlorambucil => klɔ'ræmbjusil
chloramine => 'klɔ:rәmi:n
chloramphenicol => .klɒ:ræm'fenikɒl
chlorate => 'klɒ:reit
chlordane => 'klɒ:dein
chlordiazepoxide => ,klɔ:dai,eizi'pɔksaid
chlorella => klɒ:'relә
chlorhexidine => klɔ:'heksidain,-di:n
chloride => 'klɒ:raid
chlorides => ˈklɔ:raidz
chlorinate => 'klɒ:rineit
chlorinated => 'klɔ:rineitid
chlorination => .klɒ:ri'neiʃәn
chlorinator => 'klɔ:rineitә
chlorine => 'klɒ:ri:n
chlorite => 'klɒ:rait
chloritic => klɔ:'ritik
chloritoid => 'klɔ:ritɔid
chloro- => 'klɔ:rәj
chlorodyne => 'klɒrәdain
chlorofluorocarbon => ˌklɔ:rəʊˈflʊərəʊkɑ:bən
chlorofluorocarbons => ˌklɔ:rəʊˌflʊərəʊˈkɑ:bənz
chloroform => 'klɒrәfɒ:m
chloroformed => ˈklɔ:rəˌfɔ:md
chloroforming => ˈklɔ:rəˌfɔ:mɪŋ
chloromelanite => ,klәurә'melәnait
chloromycetin => ,klɔ(:)rәumai'si:tin
chlorophyll => 'klɔ:rәfil
chlorophyllous => ,klɔ:rә'filәs
chlorophyte => k'lɒrəfaɪt
chloroplast => 'klɒ:rәuplæst
chloroprene => 'klɒ:rәupri:n
chloroquine => 'klɒ:rәukwi:n
chlorosis => klә'rәusis
chlorothiazide => ,klɔ:rә'θaiәzaid
chlorotic => klә'rɒtik
chlorpromazine => klɒ:'prәumәzin
chlortetracycline => ,klɔ:,tetrә'saiklin
choanocyte => 'kәuәnәsait
chocho => 'tʃәjtʃәj
chock => tʃɒk
chock-full => 'tʃɔkfjl
chocked => tʃɔkt
chocks => tʃɔks
chockstone => t'ʃɒkstəʊn
chocoholic => ˌtʃɔkəˈhɔ:lik
chocolate => 'tʃɒkәlit
chocolatier => tʃɔkələˈtiə
chocolaty => tʃɒk'leɪtɪ
choice => tʃɒis
choicely => 'tʃɒisli
choiceness => 'tʃɒisnis
choir => 'kwaiә
choir school => ˈkwaiə sku:l
choirboy => 'kwaiәbɔi
choirgirl => 'kwaiә^\\\\:l
choirman => 'kwaɪəmən
choirmaster => 'kwaiәmɑ:stә
choirs => ˈkwaiəz
choke => tʃәuk
choke chain => tʃəuk tʃein
choke point => tʃəuk pɔint
chokeberry => 'tʃәukbәri
chokecherry => 'tʃәuk.tʃeri
choked => tʃәukt
chokehold => 'tʃəʊkˌhəʊld
choker => 'tʃәukә
chokers => ˈtʃəukəz
chokes => tʃəuks
chokey => 'tʃәuki
choking => 'tʃәukiŋ
choko => 'tʃәjkәj
choky => 'tʃәuki
Chola => 'kәulә
cholangiogram => kәu'lændʒiәu^ræm
cholangiography => kәu,lændʒi'ɔ^rәfi
cholangiopancreatography => kəʊlədʒaɪɒpæŋkr'ɪætɒɡər
cholangitis => ,kәulæn'dʒaitis
chole- => 'kɔli,'kәjli
cholecalciferol => ,kәulikæl'sifәrɔl
cholecystectomy => ,kɔlisis'tektәmi, ,kәuli-
cholecystitis => ,kɔlisis'taitis
cholecystography => ,kɔlisis'tɔ^rәfi
cholecystokinin => 'kɔli,sistә'kainin
cholelithiasis => ,kәulili'θaiәsis
choler => 'kɒlә
cholera => 'kɒlәrә
choleraic => kɒlә'reiik
choleric => 'kɒlәrik
cholesteatoma => ,kәulisti:ә'tәumә
cholesterol => kә'lestәrɒl
choli => 'tʃәuli
choliamb => 'kәuliæmb
choliambic => ,kəuli'æmbik
choline => 'kәuli:n
cholinergic => ,kәuli'nә:dʒik
cholinesterase => ,kɔli'nestәreis
cholla => 'tʃәuljɑ:
cholo => 'tʃəʊləʊ
chomp => tʃɒmp
chomped => tʃɔmpt
chomping => tʃɔmpɪŋ
chomps => tʃɔmps
Chomsky => 'tʃɔmski
chomskyan => 'tʃɔmskiən
chondrite => 'kɔndrait
chondritic => kɔn'dritik
chondro- => 'kɔndrәj
chondroitin => kәn'drәuitin
chondrosarcoma => ,kɔndrәusɑ:'kәumә
chondrule => 'kɔndru:l
Chongjin => 'tʃʌŋ'dʒi:n
Chongqing => 'tʃjŋ'kiŋ
choo-choo => 'tʃu:tʃu:
chook => tʃuk
choose => tʃu:z
chooser => 'tʃu:zә
choosers => 'tʃu:zə
chooses => tʃu:ziz
choosier => t'ʃu:zɪər
choosy => 'tʃu:zi
chop => tʃɒp
chop suey => ˌtʃɒp ˈsu:i
chop-chop => 'tʃɔp'tʃɔp
chophouse => 'tʃɒphaus
chopped => tʃɔpt
chopper => 'tʃɒpә
choppers => ˈtʃɔpəz
choppier => ˈtʃɔpi:ə
choppiness => 'tʃɔpinis
chopping => 'tʃɔpiŋ
chopping block => ˈtʃɔpiŋ blɔk
chopping board => ˈtʃɔpiŋ bɔ:d
choppy => 'tʃɒpi
chops => tʃɔps
chopsocky => 'tʃɔp,sɔki
chopstick => 'tʃɔpstik
chopsticks => 'tʃɒpstiks
choral => 'kɒ:rәl
chorale => kɒ'rɑ:l
chorally => 'kɒ:rәli
chord => kɒ:d
chordal => 'kɔ:dәl
chordate => 'kɒ:deit
chorded => kɔ:did
chording => kɔ:dɪŋ
chordophone => 'kɔ:dәjfәjn
chordotonal => ,kɔ:dә'tәunl
chore => tʃɒ:
chorea => kɒ'riә
choreograph => 'kɒriәgrɑ:f
choreographed => ˈkɔ(:)riəɡrɑ:ft
choreographer => .kɒri'ɒgrәfә
choreographers => ˌkɔri'ɔgrəfəz
choreographic => .kɒriә'græfik
choreographing => ˈkɔ(:)riəɡrɑ:fɪŋ
choreographs => ˈkɔ(:)riəɡrɑ:fs
choreography => .kɒriә'ɒgræfi
choreology => ,kɔri'ɔlәdʒi
chores => t'ʃɔ:z
choriambic => ,kɔri'æmbik
choriambus => 'kɔ(:)ri'æmbәs
choric => 'kɒrik
chorine => 'kɔ:ri:n
chorio- => 'kɔ:riәj
choriocarcinoma => ,kәuriәu,kɑ:si'nәumә
chorion => 'kɒ:riɒn
chorionic => ,kәuri'ɔnik
chorionic villus sampling => ˌkəuriˈɔnik ˈviləs ˈsæmplɪŋ
chorister => 'kɒristә
choristers => ˈkɔristəz
chorizo => tʃә:'ri:zәu
chorographer => kɔ:'rɔ^ræfә
chorographic => ,kɔ:rә'^ræfik
chorography => kә'rɒgrәfi
choroid => 'kɒ:rɒid
choroid coat => ˈkɔ:rɔid kəut
choroid plexus => ˈkɔ:rɔid ˈpleksəs
chorten => tʃɔ:'ten
chortle => 'tʃɒ:tl
chortled => ˈtʃɔ:tld
chortles => ˈtʃɔ:tlz
chortling => ˈtʃɔ:tlɪŋ
chorus => 'kɒ:rәs
chorused => ˈkɔ:rəst
choruses => ˈkɔ:rəsiz
chorusing => ˈkɔ:rəsɪŋ
chose => tʃәuz
chosen => 'tʃouzn
chou => dʒәj
choucroute => ʃu:'kru:t
chough => tʃʌf
choux pastry => ˌʃu: ˈpeɪstri
chow => ʃu:
chow chow => tʃau tʃau
chow mein => ˌtʃaʊ ˈmeɪn
chowder => 'tʃaudә
chowderhead => 'tʃajdәhed
chowhound => 'tʃajhajnd
chrestomathy => kre'stɒmәθi
chris => kris
chrism => 'krizәm
chrisom => 'krizәm
Chrissie => 'krisi
Christ => kraist
Christabel => 'kristәbel
Christadelphian => ,kristә'delfiәn
Christchurch => 'kraist-tʃә:tʃ
christen => 'krisәn
Christendom => 'krisәndәm
christened => ˈkrɪsənd
christening => 'krisәniŋ
christens => ˈkrɪsənz
Christhood => 'kraisthjd
Christian => 'kristʃәn
christiana => ,kristi'ænә
Christiania => 'kristi'ɑ:niә
christianise => 'kristjәnaiz
Christianity => .kristʃi'æniti
Christianization => ,kristjәnai'zeiʃәn;-ni'z-
Christianize => 'kristjәnaiz
christians => ˈkristʃənz
christie => 'kristi
christina => kris'ti:nә
christine => 'kristi:n
Christingle => 'kris,tiŋ^l
Christlike => 'kraistlaik
Christly => 'kraistli
Christmas => 'krismәs
christmassy => 'krismәsi
Christmastime => 'krismәstaim
Christo- => 'kristәj
Christocentric => ,kristә'sentrik
Christology => kris'tɔlәdʒi
christopher => 'kristәfә
chroma => 'krәumә
chromaffin => krә'mæfin
chromate => 'krәumeit
chromatic => krәu'mætik
chromatically => krәu'mætikli
chromaticism => krәj'mætisizəm
chromaticity => ,krәumә'tisiti
chromatics => krәu'mætiks
chromatid => 'krәumәtid
chromatin => 'krәumәtin
chromato- => 'krәjmәtәj,krәj'mætә
chromatogram => krәu'mætә^ræm
chromatograph => 'krәumәtәgrɑ:f
chromatographic => krəumætə'græfik
chromatography => .krәumә'tɒgrәfi
chromatopsia => ,krәumә'tɔpsiә
chrome => krәum
chrome yellow => krəʊm ˈjeləu
chromes => krəʊm
chromic => 'krәumik
chromide => 'krәumaid
chrominance => 'krәuminәns
chroming => 'krәumiŋ
chromite => 'krәumait
chromium => 'krәumiәm
chromo => 'krәumәu
chromo- => 'krәjmәj
chromodynamics => ,krәjmәdai'næmiks
chromogen => 'krәumәdʒәn
chromogenic => ,krәumә'dʒenik
chromolithograph => 'krәumәu'liθә^rɑ:f
chromolithographer => ,krәjmәjli'θɔ^rәfә( r)
chromolithographic => 'krәjmәj,liθә'^ræfik
chromolithography => ,krәjmәjli'θɔ^rәfi
chromophore => 'krәumәfɔ:
chromophoric => ,krәjmә'fɔrik
chromoplast => 'krәumәplɑ:st
chromosomal => ,krәumә'sәumәl
chromosome => 'krәumәsәum
chromosome number => ˈkrəʊməˌsəʊm ˈnʌmbə
chromosomes => k'rəʊməsəʊmz
chromosphere => 'krәumәsfiә
chromous => 'krәumәs
chron- => krɔn
chronic => 'krɒnik
chronically => 'krɒnikli
chronicity => krә'nisiti
chronicle => 'krɒnikl
chronicled => ˈkrɔnɪkəld
chronicler => 'krɔniklә(r)
chronicles => 'krɔniklz
chronicling => ˈkrɔnɪkəlɪŋ
chrono- => 'krɔnә,'krәjnә
chronobiologist => ˌkrɒnəbaɪ'ɒlədʒɪst
chronobiology => ,krɔnәubai'ɔlәdʒi
chronograph => 'krɒnәugrɑ:f
chronological => , krɔnә'lɔdʒikәl
chronologically => ˌkrɒnə'lɒdʒɪklɪ
chronologies => krəˈnɔlədʒi:z
chronologist => krә'nɔlәdʒist
chronology => krә'nɔlәdʒi
chronometer => krә'nɒmitә
chronometric => ,krɔnә'metrik
chronometrical => ,krɔnә'metrikәl
chronometry => krә'nɒmitri
chronostratigraphy => krɔnәstræ'ti^rәfi
chronotherapy => krənɒ'θerəpɪ
chrysalid => 'klisәlid
chrysalis => 'krisәlis
chrysanth => kri'sænθ
chrysanthemum => kri'sænθәmәm
chrysanthemums => kriˈsænθəməmz
chryselephantine => .kriseli'fæntain
chrysoberyl => 'krisәu.beril
chrysocolla => ,krisә'kɔlә
chrysolite => 'krisәulait
chrysomelid => ,krisәj'melid
chrysoprase => 'krisәupreiz
chrysotile => 'krɪsə(ʊ)taɪl
chthonic => 'θɔnik
chub => tʃʌb
CHUBB => tʃʌb
chubbier => ˈtʃʌbi:ə
chubbily => 'tʃʌbili
chubbiness => 'tʃʌbinis
chubby => 'tʃʌbi
chuck => tʃʌk
chuck-a-luck => 'tʃʌkәlʌk
chucked => tʃʌkt
chucker => 'tʃʌkә
chuckhole => 'tʃʌkhәul
chucking => 'tʃʌkiŋ
chuckle => 'tʃʌkl
chuckled => ˈtʃʌkld
chucklehead => 'tʃʌklhed
chuckles => ˈtʃʌklz
chucklesome => 'tʃʌklsəm
chuckling => ˈtʃʌklɪŋ
chucks => tʃʌks
chuckwalla => 'tʃʌk.wɒlә
chuddar => 'tʃʌdә
chuff => tʃʌf
chuffed => tʃʌft
chuffing => 'tʃʌfiŋ
chuffs => tʃʌf
chug => tʃʌg
chugged => t'ʃʌɡd
chugging => 'tʃʌ^iŋ
chugs => tʃʌɡz
chukar => tʃә'kɑ:
Chukchi => 'tʃjktʃi:
chukka => ˈtʃʌkə
chum => tʃʌm
chummed => tʃʌmd
chumminess => 'tʃʌminis
chumming => tʃʌmɪŋ
chummy => 'tʃʌmi
chump => tʃʌmp
chump change => tʃʌmp tʃeindʒ
chumps => tʃʌmps
chums => tʃʌmz
chunder => 'tʃʌndә(r)
chunk => tʃʌŋk
chunkier => ˈtʃʌŋki:ə
chunky => 'tʃʌŋki
chunnel => 'tʃʌnәl
chunter => ˈtʃʌntə(r)
chuppah => 'hjpә
church => tʃә:tʃ
church key => tʃə:tʃ ki:
church school => tʃə:tʃ sku:l
churches => tʃə:tʃiz
churchgoer => 'tʃә:tʃgәuә
churchgoers => ˈtʃə:tʃɡəuəz
churchgoing => 'tʃә:tʃgәuiŋ
Churchill => 'tʃә:tʃil
Churchillian => tʃ\\\\:'tʃiliәn
churching => 'tʃә:tʃiŋ
churchly => 'tʃә:tʃli
churchman => 'tʃә:tʃmәn
churchmen => t'ʃɜ:tʃmən
churchwarden => .tʃә:tʃ'wɒ:dn
churchwoman => 'tʃә:tʃwumәn
churchy => 'tʃә:tʃi
churchyard => 'tʃә:tʃjɑ:d
churchyards => ˈtʃə:tʃjɑ:dz
churidars => 'tʃu:ridɑ:z
churinga => tʃu:'riŋgә
churl => tʃә:l
churlish => 'tʃә:liʃ
churlishness => 'tʃə:liʃnis
churn => tʃә:n
churned => tʃɜ:nd
churning => 'tʃә:niŋ
churns => tʃɜ:nz
churr => tʃә:
Churrigueresque => ,tʃjәri^ә'resk
chut => tʃʌt
chute => ʃu:t
chuted => ʃu:tid
chutes => ʃu:ts
chuting => tʃ'tɪŋ
chutist => 'ʃu:tist
chutneys => ˈtʃʌtni:z
chutzpa => 'khutspә
chutzpah => 'khutspә
Chuvash => tʃu'va:ʃ
chyle => kail
chylomicron => ,kailәj'maikrɔn
chyme => kaim
chymotrypsin => ,kaimә'tripsin
chypre => 'ʃi:prә
ci-devant => ,si:dә'vɔŋ
ciabatta => tʃəˈbætə
ciao => tʃau
ciborium => si'bɒ:riәm
cicada => si'kɑ:dә
cicadas => siˈkeidəz
cicatrice => 'sikәtris
cicatricial => ,sikә'triʃәl
cicatrix => 'sikәtriks
cicatrization => .sikәtrai'zeiʃәn
cicatrize => 'sikәtraiz
cicatrizing => 'sɪkətraɪz
cicely => 'sisәli
cicero => 'sisәrәu
cicerone => .tʃitʃә'rәuni
cicerones => ˌtʃitʃəˈrəuniz
Ciceronian => ,sisә'rәunjәn, -niәn
cichlid => 'siklid
cicisbeo => ,tʃitʃiz'beiәu
CID => sid
cider => 'saidә
cider gum => ˈsaɪdə ɡʌm
ciel => si:l
cigar => si'gɑ:
cigaret => ,si^ә'ret,'si-
cigarette => .sigә'ret
cigarette butt => ˌsiɡəˈret bʌt
cigarette end => ˌsiɡəˈret end
cigarette lighter => ˌsiɡəˈret ˈlaɪtə
cigarettes => sɪɡə'rets
cigarillo => ,si^ә'rilәu
ciggy => 'si^i
cilantro => si'lɑ:ntrәj
cilia => 'siliә
ciliary => 'siliәri
ciliary body => ˈsiliəri ˈbɔdi
ciliate => 'siliit
ciliated => 'silieitid
ciliation => ,sili'eiʃәn
cilice => 'silis
Cilicia => si'liʃə
cilium => 'siliәm
cill => sɪl
cimbalom => 'simbәlәm
cimetidine => sai'metidi:n
cinch => sintʃ
cinched => sɪntʃt
cinches => sɪntʃiz
cinchona => siŋ'kәunә
cinchonine => 'sinkәni:n
Cincinnati => ,sinsi'næti
cincture => 'siŋktʃә
cinder => 'sindә
cinder block => ˈsɪndə blɔk
cinder cone => ˈsɪndə kəun
cinderella => sindә'relә
cindery => 'sindәri
cindy => 'sindi
cine => 'sini
cine- => 'sini
cine-camera => 'sɪnɪk'æmərə
cineaste => 'siniæst
cinema => 'sinәmә
cinematheque => ,sinimә'tek
cinematic => ,sini'mætik
cinematograph => .sinә'mætәgrɑ:f
cinematographer => .sinәmә'tɒgrәfә
cinematographic => 'sinә.mætә'græfik
cinematography => .sinәmә'tɒgrәfi
cinephile => 'sinifail
cineplex => 'sɪnəˌpleks
cineraria => .sinә'rєәriә
cinerarium => .sinә'rєәriәm
cinereous => si'niәriәs
Cingalese => ,siŋ^ә'li:z
cingulate => 'siŋ^jjlit,-leit
cingulum => 'siŋgjulәm
cinnabar => 'sinәbɑ:
cinnamon => 'sinәmәn
cinque => siŋk
cinquecento => ,tʃiŋkwi'tʃentәu
cinquefoil => 'siŋkfɒil
Cinzano => tʃin'zɑ:nәj
cion => 'saiәn
cipher => 'saifә
ciphered => 'saɪfə
ciphering => 'saɪfərɪŋ
ciphers => ˈsaɪfəz
cipolin => 'sipәlin
circa => 'sә:kә
circadian => sә:'keidiәn
Circassian => s\\\\:'kæsiәn
circe => 'sә:si
circinate => 'sә:sineit
Circinus => 'sә:sinәs
circle => 'sә:kl
circled => ˈsə:kld
circlet => 'sә:klit
circling => 'sә:kliŋ
circlip => 'sә:klip
circs => s\\\\:ks
circuit => 'sә:kit
circuit board => ˈsə:kit bɔ:d
circuit rider => ˈsə:kit ˈraɪdə
circuit training => ˈsə:kit ˈtreiniŋ
circuit-breaker => 'sә:kit'breikә
circuitous => sә'kju:itәs
circuitously => sə'kju:ɪtəslɪ
circuitousness => sɜ:k'ju:ɪtəsnəs
circuitry => 'sә:kitri
circular => 'sә:kjulә
circularity => .sә:kju'læriti
circularize => 'sә:kjulәraiz
circularized => ˈsə:kjuləraizd
circularizes => ˈsə:kjuləraiziz
circularizing => ˈsə:kjuləraizɪŋ
circularly => 'sә:kjulәli
circulars => 'sɜ:kjəlɚs
circulate => 'sә:kjuleit
circulates => ˈsə:kjuleits
circulating => .sә:kju'leitiŋ
circulation => .sә:kju'leiʃәn
circulations => ˌsə:kjuˈleiʃənz
circulative => 'sә:kjuleitiv
circulator => 'sә:kjuleitә
circulatory => 'sә:kjulәtәri
circum- => 's\\\\:kәm
circumambience => .sә:kәm'æmbiәns
circumambiency => -әnsi
circumambient => .sә:kәm'æmbiәnt
circumambulate => .sә:kәm'æmbjuleit
circumambulated => ˌsə:kəmˈæmbjuleitid
circumambulates => ˌsə:kəmˈæmbjuleits
circumambulating => ˌsə:kəmˈæmbjuleitɪŋ
circumcircle => 'sә:kәm'sә:kl
circumcise => 'sә:kәmsaiz
circumcised => ˈsə:kəmsaizd
circumcises => ˈsə:kəmsaiziz
circumcising => ˈsə:kəmsaizɪŋ
circumcision => ,sә:kәm'siʒәn
circumference => sә'kʌmfәrәns
circumferences => səˈkʌmfərənsiz
circumferential => sә.kʌmfә'renʃәl
circumflex => 'sә:kәmfleks
circumflexes => ˈsə:kəmfleksiz
circumfluence => sә'kʌmfluәns
circumfluent => sә'kʌmfluәnt
circumfuse => .sә:kәm'fju:z
circumfused => ˌsə:kəmˈfju:zd
circumfuses => ˌsə:kəmˈfju:ziz
circumfusing => ˌsə:kəmˈfju:zɪŋ
circumjacent => .sә:kәm'dʒeisәnt
circumlocution => .sә:kәmlә'kju:ʃәn
circumlocutions => ,sɜːkəmlə'kjuːʃ(ə)n
circumlocutory => .sә:kәm'lɒkjutәri
circumlunar => ,sәkәm'lu:nә
circumnavigate => .sә:kәm'nævigeit
circumnavigated => ˌsə:kəmˈnæviɡeitid
circumnavigates => ˌsə:kəmˈnæviɡeits
circumnavigating => ˌsə:kəmˈnæviɡeitɪŋ
circumnavigator => sә:kәmnævi'geitә
circumpolar => .sә:kәm'pәulә
circumscribe => 'sә:kәmskraib
circumscribes => ˈsɜ:kəmˌskraɪbz
circumscribing => ˈsɜ:kəmˌskraɪbɪŋ
circumscription => .sә:kәm'skripʃәn
circumsolar => .sә:kәm'sәulә
circumspect => 'sә:kәmspekt
circumspection => .sә:kәm'spekʃәn
circumspectly => 'sɜ:kəmspektlɪ
circumstance => 'sә:kәmstәns
circumstanced => 'sә:kәmstәnst
circumstantial => .sә:kәm'stænʃәl
circumstantiality => 'sә:kәm,stænʃi'æliti
circumstellar => ,s\\\\:kәm'stelә(r)
circumterrestrial => ,sә:kәmtә'restriәl
circumvallate => .sә:kәm'væleit
circumvallated => ,sɜːkəm'væleɪt
circumvallates => ,sɜːkəm'væleɪt
circumvallating => ,sɜːkəm'væleɪt
circumvent => .sә:kәm'vent
circumvented => ˌsɜ:kəmˈventid
circumventing => ˌsɜ:kəmˈventɪŋ
circumvention => .sә:kәm'venʃәn
circumvents => ˌsɜ:kəmˈvents
circumvolution => .sә:kәmvә'lu:ʃәn
circus => 'sә:kәs
circuses => ˈsə:kəsiz
cirque => sә:k
cirrhosis => si'rәusis
cirrhotic => si'rɒtik
cirriped => 'siriped
cirrocumulus => .sirәu'kju:mjulәs
cirrostratus => sirәu'strɑ:tәs
cirrus => 'sirәs
cis- => sis
cisalpine => sis'ælpain
cisatlantic => .sisәt'læntik
cisco => 'siskәu
cislunar => sis'lju:nә
cisplatin => sɪs'pleɪtn
cispontine => si'spɔntain
cissies => 'sɪsɪ
cissus => 'sisəs
cissy => 'sisi
cist => sist
Cistercian => sis'tә:ʃjәn
cistern => 'sistәn
cisterns => 'sɪstənz
cistron => 'sistrɔn
cistus => 'sistәs
CIT => sit
citable => 'saitәbl
citadel => 'sitәdәl
citadels => ˈsɪtədəlz
citation => sai'teiʃәn
citations => saɪ'teɪʃnz
cite => sait
cithara => 'siθәrә
Citicorp => 'sitikɔ:p
citified => 'sitifaid
citizen => 'sitizn
citizenry => 'sitizәnri
citizenship => 'sitizәnʃip
citole => si'tәjl
citral => 'sitrәl
citrate => 'sitreit
citric => 'sitrik
citriculture => 'sitri,kʌltʃә
citrine => 'sitrin
citron => 'sitrәn
citronella => ,sitrә'nelә
citrous => 'sitrәs
citrus => 'sitrәs
citrus fruit => ˈsɪtrəs fru:t
cittern => 'sit\\\\:n
city => 'siti
city center => ˈsiti ˈsentə
city desk => ˈsiti desk
city slicker => ˈsiti ˈslikə
city state => ˈsiti steit
cityfied => 'sitifaid
cityscape => 'sitiskeip
cityward => ˊsitiwɒːd
citywide => 'siti.waid
Ciudad Trujillo => sju:'ðɑ:ð tru'hi:jou
civet => 'sivit
civet cat => ˈsivit kæt
civic => 'sivik
civic centre => ˈsɪvɪk ˈsentə
civics => 'siviks
civies => 'siviz
civil => 'sivәl
civil defence => ˈsivl diˈfens
civil rights => ˈsivl raits
civil servant => ˈsivl ˈsə:vənt
civilian => si'viljәn
civilianization => sɪ,vɪljənɪ'zeʃən
civilianize => si'viljәnaiz
civilians => siˈviljənz
civilisation => ,sivilai'zeiʃən;-li'z-
civilisations => ,sɪvɪlaɪ'zeɪʃən
civilise => 'sivilaiz
civilised => 'sivilaizd
civilities => sɪˈvɪlɪti:z
civility => si'viliti
civilizable => sɪvɪ'laɪzəbl
civilization => si.vilai'zeiʃәn
civilizations => sɪvɪlaɪ'zeɪʃnz
civilize => 'sivilaiz
civilized => 'sivilaizd
civilizes => ˈsivilaiziz
civilizing => ˈsivilaizɪŋ
civilly => 'sivili
civvies => 'siviz
civvy => 'sivi
CJD => ,si: dʒei 'di:
clabber => 'klæbә
clabbered => ˈklæbəd
clabbering => ˈklæbərɪŋ
clabbers => ˈklæbəz
clachan => 'klɑ:khәn
clack => klæk
clacked => klækt
clacking => klækɪŋ
clacks => klæks
Clactonian => klæk'tәjniәn
clad => klæd
cladding => 'klædiŋ
clade => kleid
cladistic => klә'distik
cladistics => klæ'distiks
clado- => k'lədəʊ
cladoceran => klә'dɔsәrәn
cladode => 'klædәud
cladogenesis => ,klædәu'dʒenәsis
cladogram => 'klædәu,^ræm
claim => kleim
claim jumper => kleim ˈdʒʌmpə
claimable => 'kleimәbl
claimant => 'kleimәnt
claimants => ˈkleimənts
claiming => kleimɪŋ
clairaudience => klєәr'ɒ:diәns
clairaudient => klєәr'ɒ:diәnt
claire => kleә
clairvoyance => klєә'vɒiәns
clairvoyant => klєә'vɒiәnt
clairvoyants => klɛəˈvɔiənts
clam => klæm
clamant => 'kleimәnt
clambake => 'klæmbeik
clamber => 'klæmbә
clambered => ˈklæmbəd
clambering => ˈklæmbərɪŋ
clambers => ˈklæmbəz
clammed => klæmd
clammily => 'klæmili
clamming => k'læmɪŋ
clammy => 'klæmi
clamor => 'klæmә
clamored => ˈklæməd
clamoring => ˈklæmərɪŋ
clamorous => 'klæmәrәs
clamorously => 'klæmərəslɪ
clamors => ˈklæməz
clamour => 'klæmә
clamoured => ˈklæməd
clamouring => 'klæmərɪŋ
clamours => ˈklæməz
clamp => klæmp
clampdown => 'klæmdaun
clampdowns => ˈklæmpˌdaʊnz
clamped => klæmpt
clamper => 'klæmpә
clamping => 'klæmpiŋ
clamshell => 'klæmʃәl
clan => klæn
clandestine => klæn'destin
clandestinely => klæn'destɪnlɪ
clang => klæŋ
clanged => klæŋd
clanger => 'klæŋә
clangers => ˈklæŋəz
clanging => klæŋɪŋ
clangor => 'klæŋ^ә
clangorous => 'klæŋәrәs
clangour => 'klæŋ^ә
clangoured => 'klæŋɡə, 'klæŋə
clangouring => 'klæŋɡə, 'klæŋə
clangours => 'klæŋɡə, 'klæŋə
clangs => klæŋz
clank => klæŋk
clanked => klæŋkt
clanks => klæŋks
clannish => 'klæniʃ
clannishly => k'lænɪʃlɪ
clannishness => ˊklæniʃnis
clans => k'lænz
clanship => 'klænʃip
clansman => 'klænzmәn
clansmen => 'klænzmən
clanswoman => 'klænz,wjmәn
clap => klæp
clapboard => 'klæpbɒ:d
clapboards => ˈklæpbɔ:dz
Clapham => 'klæpәm
clapped => klæpt
clapped-out => k'læpt'aʊt
clapper => 'klæpә
clapper rail => ˈklæpə reil
clapperboard => ˈklæpəbɔ:d
clappers => k'læpəz
claps => klæps
claptrap => 'klæptræp
claque => klæk
claqueur => klæ'kә:
clara => 'kleәrә
clarabella => .klærә'belә
clare => kleә
clarence => 'klærәns
clarendon => 'klærәndәn
claret => 'klærәt
clarets => ˈklærəts
Clarice => 'klæris,klә'ri:s
clarification => .klærifi'keiʃәn
clarifications => ,klærɪfɪ'keɪʃ(ə)n
clarificatory => 'klærifi,keitәri
clarified => ˈklærifaid
clarifier => 'klærifaiә
clarify => 'klærifai
clarinet => klæri'net
clarinetist => ,klæri'netist
clarinets => ˌklærəˈnets
clarinettist => ˌklærəˈnetɪst
clarion => 'klæriәn
clarion call => ˈklæriən kɔ:l
clarioned => 'klærɪən
clarioning => 'klærɪən
clarions => 'klærɪən
Clarissa => klә'risә
clarity => 'klærәti
clarkia => 'klɑ:kjә
claro => 'klɑ:rәu
clart => klɑ:t
Clary => 'kleәri
clash => klæʃ
clasher => k'læʃər
clashes => klæʃiz
clashing => klæʃɪŋ
clasp => klɑ:sp
clasped => klɑ:spt
clasper => 'klɑ:spә
clasping => klɑ:spɪŋ
clasps => klɑ:sps
class => klɑ:s
class act => klɑ:s ækt
class consciousness => klɑ:s ˈkɔnʃəsnɪs
classic => 'klæsik
classical => 'klæsikl
classical conditioning => ˈklæsikəl kənˈdiʃəniŋ
classical music => ˈklæsikəl ˈmju:zik
classicalism => 'klæsikәlizәm
classicality => .klæsi'kæliti
classically => 'klæsikәli
classicism => 'klæsisizm
classicist => 'klæsist
classicists => ˈklæsisists
classicize => 'klæsisaiz
classier => ˈklɑ:siə
classifiable => 'klæsifaiәbl
classification => .klæsifi'keiʃәn
classifications => klæsɪfɪ'keɪʃnz
classificatory => 'klæsifikәtәri
classified => 'klæsifaid
classified ad => ˈklæsəˌfaɪd æd
classifier => 'klæsifaiә
classifies => ˈklæsifaiz
classify => 'klæsifai
classism => klɑ:'sɪzəm
classist => /'klæsist/
classless => 'klɑ:slis
classmate => 'klɑ:smeit
classmates => k'lɑ:smeɪts
classroom => 'klɑ:sru:m
classrooms => k'læsru:mz
classwork => 'klɑ:s,w\\\\:k
classy => 'klɑ:si
clast => klæst
clastic => 'klæstik
clathrate => 'klæθreit
clatter => 'klætә
clatters => ˈklætəz
Claud => klɔ:d
claude => klɔ:d
Claude Lorrain => lɔ'ræŋ
claudia => 'klɔ:djә
claudication => .klɒ:di'keiʃәn
Claudine => klɔ:'di:n
Claudius => 'klɔ:diәs
clausal => 'klɒ:zәl
clause => klɒ:z
claustral => 'klɒ:strәl
claustration => klɔ:'streiʃәn
claustrophobe => 'klɔ:strәfәjb
claustrophobia => klɒ:strә'fәubiә
claustrophobic => ,klɔ:strә'fәjbik
clavate => 'kleiveit
clave => kleiv
clavichord => 'klævikɔ:d
clavichords => k'lævɪkɔ:dz
clavicle => 'klævikl
clavicular => klә'vikjulә
clavier => 'klæviә
claviform => 'klævifɔ:m
claw => klɒ:
clawless => k'lɔ:les
claws => klɔ:z
clay => klei
clay mineral => klei ˈminərəl
clay pigeon => klei ˈpidʒin
clayey => 'kleii
claymore => 'kleimɒ:
claypan => 'kleipæn
clayton => 'kleitn
clean => kli:n
clean and jerk => kli:n ænd dʒə:k
clean slate => kli:n sleit
clean-living => 'kli:n'liviŋ
cleaned => kli:nd
cleaner => 'kli:nә
cleaning => 'kli:niŋ
cleaning lady => ˈkli:nɪŋ ˈleidi
cleanlier => ˊkliːnliә
cleanliest => ˊkliːnliist
cleanliness => 'klenlinis
cleanly => 'klenli
cleanness => 'kli:nnis
cleanse => klenz
cleansed => klenzd
cleanser => 'klenzә
cleansers => ˈklenzəz
cleanses => klenziz
cleansing => 'klenziŋ
cleanup => 'kli:nʌp
clear => kliә
clear-eyed => 'kliәr'aid
clear-out => ˈkli:əaut
clear-up => 'kliəʌp
clearance => 'kliәrәns
clearances => k'lɪərənsɪz
clearcole => 'kliәkәul
clearcut => k'lɪəkʌt
clearer => 'kliәrә
clearing => 'kliәriŋ
clearing bank => ˈklɪərɪŋ bæŋk
clearinghouse => 'kliәriŋhaus
clearly => 'kliәli
clearness => 'kliәnis
clears => kliəz
clearstory => 'kliәstәri
clearway => 'kliәwei
clearways => 'klɪəweɪ
clearwing => 'kliәwiŋ
cleat => kli:t
cleating => kliːt
cleats => kli:ts
cleavable => 'kli:vәbl
cleavage => 'kli:vidʒ
cleavages => ˈkli:vɪdʒz
cleave => kli:v
cleaver => 'kli:vә
cleavers => kli:vәz
cleaves => kli:vz
clef => klef
clefs => klefs
cleft => kleft
clefts => k'lefts
cleg => kleg
Cleisthenes => 'klaisθəni:z
cleistogamous => klai'stɒgәmәs
cleistogamy => klai'stɒgәmi
Clem => klem
clematis => 'klemәtis
clemency => 'klemәnsi
clemens => 'klemәnz
clement => 'klemәnt
clementina => ,klemәn'ti:nә
Clementine => 'klemәntain
clench => klentʃ
clenched => klentʃd
clenches => klentʃiz
clenching => klentʃɪŋ
Cleo => 'kli:әj
cleome => 'kliәumi
Cleopatra => kliә'pɑ:trә
clepsydra => 'klepsidrә
clerestory => 'kliәstәri
clergy => 'klә:dʒi
clergyman => 'klә:dʒimәn
clergywoman => 'klә:dʒiwumәn
cleric => 'klerik
clerical => 'klerikәl
clerical collar => ˈklerɪkəl ˈkɔlə
clericalism => 'klerikәlizәm
clericalist => 'klerikәlist
clerically => klerikәli
clerics => ˈkleriks
clerihew => 'klerihju:
clerisy => 'klerisi
clerk => klә:k
clerkess => 'klɑ:kis,klɑ:'kes
clerking => 'klɑ:kiŋ
clerkly => 'klә:kli
clerks => klɑ:ks
clerkship => 'klә:kʃip
Cleveland => 'kli:vlәnd
clever => 'klevә
clevis => 'klevis
clew => klu:
clewed => klu:d
clewing => klu:ɪŋ
clews => klu:z
clianthus => klai'ænpәs
cliche => 'kli:ʃei
click => klik
click stop => klik stɔp
click-clack => k'lɪkkl'æk
clickable => ˈklɪkəbl
clicked => klikt
clicker => 'klikә
client => 'klaiәnt
clientele => .kli:ɒn'tel
cliff => klif
cliffhanging => 'klifhæŋ
clifford => 'klifәd
cliffs => klɪfs
cliffside => klɪf'saɪd
clifftop => ˈklɪftɒp
cliffy => 'klifi
Clift => klift
clifton => 'kliftәn
climacteric => klai'mæktәrik
climactic => klai'mæktik
climate => 'klaimit
climate change => ˈklaimit tʃeindʒ
climates => k'laɪməts
climatic => klai'mætik
climatically => klai'mætikәli
climatological => ˌklaɪmətə'lɒdʒɪkl
climatologist => ˌklaɪməˈtɔlədʒɪst
climatology => .klaimә'tɒlәdʒi
climax => 'klaimæks
climaxes => ˈklaimæksiz
climb => klaim
climbable => 'klaimәbl
climbed => klaɪmd
climber => 'klaimә
climbing => 'klaimiŋ
climbing frame => ˈklaimiŋ freim
climbing iron => ˈklaimiŋ ˈaiən
climbing perch => ˈklaimiŋ pə:tʃ
climbing wall => ˈklaimiŋ wɔ:l
climbs => klaimz
clime => klaim
climes => klaimz
clinch => klintʃ
clinched => klintʃt
clincher => 'klintʃә
clinches => klintʃiz
clinching => k'lɪntʃɪŋ
clindamycin => ,klindә'maisin
cline => klain
clines => klaɪn
cling => kliŋ
cling film => kliŋ film
clingfilm => klɪŋ'fɪlm
clingfish => 'kliŋfiʃ
clinging => 'kliŋiŋ
clings => kliŋz
clingstone => 'kliŋstәun
clingy => 'kliŋi
clinic => 'klinik
clinical => 'klinikәl
clinical psychologist => ˈklɪnɪkəl saɪˈkɔlədʒɪst
clinical psychology => ˈklɪnɪkəl saiˈkɔlədʒi
clinician => kli'niʃәn
clinicians => kliˈniʃənz
clinics => k'lɪnɪks
clinique => kli'ni:k
clink => kliŋk
clinked => klɪŋkt
clinker => 'kliŋkә
clinkered => 'klɪŋkə
clinkers => 'klɪŋkə
clinking => 'kliŋkiŋ
clinks => k'lɪŋks
clinometer => klai'nɒmitә
clinopyroxene => ,klainә'pirәzi:n
clint => klint
clinton => 'klintәn
Clio => 'klaiәu
cliometric => ,klaiəu'metrik
cliometrics => ,klaiәj'metriks
clip => klip
clip art => klip ɑ:t
clip-clop => 'klipklɔp
clipboard => 'klipbɒ:d
clipboards => ˈklipbɔ:dz
clipped => klipt
clipper => 'klipә
clippie => 'klipi
clipping => 'klipiŋ
clique => kli:k
cliquey => 'kli:ki
cliquish => 'kli:kiʃ
clit => klit
clitic => ˈklɪtɪk
clitoris => 'klitәris
clitter => k'lɪtər
clive => klaiv
clivia => k'lɪvaɪə
clo => klәu
cloaca => klәu'eikә
cloak => klәuk
cloaked => kləukt
cloaking => 'kləʊkɪŋ
cloakroom => 'klәukrum
cloakrooms => ˈkləʊkˌru:mz
cloaks => kləuks
clobber => 'klɒbә
clobbered => ˈklɔbəd
clobbering => ˈklɔbərɪŋ
clobbers => ˈklɔbəz
clochard => klɔ'ʃɑ:
cloche => klɒʃ
clock => klɒk
clock radio => klɔk ˈreidiəu
clock tower => klɔk ˈtauə
clock-watcher => ˈklɔkˌwɔ:tʃə
clocker => 'klɔkә(r)
clockmaker => 'klɒkmeikә
clockwise => 'klɒkwaiz
clockwork => 'klɒkwә:k
clod => klɒd
cloddish => 'klɒdiʃ
clodhopper => 'klɔdhɔpә(r)
clodhoppers => ˈklɔdhɔpəz
clodhopping => 'klɒdhɒpiŋ
clods => klɔdz
clog => klɒg
clog dance => klɔɡ dɑ:ns
clog dancer => klɔɡ ˈdɑ:nsə
clogger => k'lɒɡər
clogging => 'klɔ^iŋ
cloggy => 'klɒgi
clogs => klɔɡz
cloisonne => klwɑ:zɒŋ'nei
cloister => 'klɒistә
cloistered => 'klɔistәd
cloistering => ˈklɔɪstərɪŋ
cloisters => ˈklɔɪstəz
cloistral => 'klɒistrәl
clomiphene => 'klɔmәfi:n
clomp => klɒmp
clon => klәun
clonal => 'klәjnәl
clone => klәun
cloned => kləund
clones => kləunz
clonic => 'klɒnik
clonidine => 'klɔnidi:n
cloning => 'klɔniŋ
clonk => klɔŋk
clonked => klɒŋk
clonking => klɒŋk
clonks => klɒŋk
clonus => 'klәunәs
clop => klɒp
clopped => klɒp
clopping => klɒp
clops => klɒp
close => klәuz
close harmony => ˌkləʊs ˈhɑ:məni
close shave => kləuz ʃeiv
close-mouthed => 'klәjs'majðd
close-out => 'kləʊzˌaʊt
close-run => ˌkləʊs ˈrʌn
close-up => 'klәuzʌp
closed => klәuzd
closed book => kləʊzd buk
closed syllable => kləʊzd ˈsiləbl
closed universe => kləʊzd ˈju:nivə:s
closed-door => 'klәjzd'dɔ:(r)
closed-end => 'klәjzd'end
closedown => 'klәuzdaun
closely => 'klәusli
closeness => 'klәusnis
closeout => ˈkləʊzaʊt
closer => 'klәuzә
closes => kləuziz
closet => 'klɒzit
closeted => 'klɒzɪtɪd
closets => ˈklɔzits
closing => 'klәuziŋ
clostridial => -iәl
clostridium => klɔs'tridiәm
closure => 'klәuʒә
closures => ˈkləʊʒəz
clot => klɒt
cloth => klɒ:θ. klɒθ
cloth cap => klɔθ kæp
cloth-eared => 'klɔθiəd
clothe => klәuð
clothes => klәuðz
clothes basket => kləuðz ˈbɑ:skit
clothes brush => kləuðz brʌʃ
clothes horse => kləuðz hɔ:s
clothes line => kləuðz lain
clothes moth => kləuðz mɔθ
clothes peg => kləuðz peɡ
clothesline => 'klәuðzlain
clothespin => 'klәjðzpin
clothier => 'klәuðiә
clothing => 'klәuðiŋ
Clotho => 'klәuθәu
clots => klɔts
clotted => 'klɒtid
clotted cream => ˈklɔtid kri:m
cloture => 'klәutʃә
clotured => 'kləʊtjʊə
clotures => 'kləʊtjʊə
cloturing => 'kləʊtjʊə
clou => klu:
cloud => klaud
cloud cover => klaud ˈkʌvə
cloud street => klaud stri:t
cloudbank => k'laʊdbæŋk
cloudberry => 'klaud.beri
cloudburst => 'klaudbә:st
cloudbursts => ˈklaʊdˌbɜ:sts
clouded => 'klaudid
clouded leopard => ˈklaʊdɪd
cloudier => 'klaudiә
cloudily => 'klaudili
cloudiness => 'klaudinis
cloudless => 'klaudlis
cloudlet => 'klaudlit
cloudlike => k'laʊdlaɪk
cloudscape => 'klaudskeip
cloudy => 'klaudi
clough => klʌf
clout => klaut
clout nail => klaʊt neil
clouted => k'laʊtɪd
clouting => klaʊtɪŋ
clouts => klaʊts
clove => klәuv
clove hitch => kləuv hitʃ
cloven => 'klәuvn
cloven hoof => 'klәjv(ә)n
cloven-footed => 'klәjvәn'fjtid
cloven-hoofed => k'ləʊvnh'u:ft
clover => 'klәuvә
cloverleaf => 'klәuvәli:f
clovers => ˈkləʊvəz
Clovis => 'kləuvis
clown => klaun
clownish => 'klauniʃ
clowns => klaunz
cloy => klɒi
cloying => 'klɔiiŋ
cloze => klәuz
cloze test => ˈkləʊz test
club => klʌb
club car => klʌb kɑ:
club class => klʌb klɑ:s
club sandwich => klʌb ˈsænwidʒ
club soda => klʌb ˈsəudə
clubbable => 'klʌbәb(ә)l
clubbed => klʌbd
clubber => 'klʌbә(r)
clubby => 'klʌbi
clubfoot => .klʌb'fut
clubhouse => 'klʌbhaus
clubhouses => ˈklʌbhausiz
clubland => 'klʌblænd
clubman => 'klʌbmәn
clubmoss => kləb'mɒs
clubroom => 'klʌbrjm
clubroot => 'klʌbru:t
cluck => klʌk
clucked => klʌkt
clucking => klʌkɪŋ
clucks => klʌks
clue => klu:
clueless => ˈklu:ləs
cluj => klu:ʒ
clumber => 'klʌmbә
clump => klʌmp
clumped => klʌmpt
clumps => klʌmps
clumpy => 'klʌmpi
clumsier => ˈklʌmziə
clumsily => 'klʌmzili
clumsiness => 'klʌmzinis
clumsy => 'klʌmzi
clunch => klʌntʃ
clung => klʌŋ
clunk => klʌnk
clunked => klʌŋkt
clunker => 'klʌnkә
clunking => klʌŋkɪŋ
clunks => klʌŋks
clunky => ˈklʌŋki
Cluny => 'klu:ni
clupeoid => 'klʌpiɔid
cluster => 'klʌstә
cluster bean => ˈklʌstə bi:n
cluster bomb => ˈklʌstə bɔm
cluster headache => ˈklʌstə ˈhedeik
clustering => 'klʌstәriŋ
clutch => klʌtʃ
clutch bag => klʌtʃ bæɡ
clutched => klʌtʃt
clutches => klʌtʃiz
clutching => klʌtʃɪŋ
clutter => 'klʌtә
cluttered => ˈklʌtəd
clutters => ˈklʌtəz
Clwyd => 'klu:id
clyde => klaid
clydesdale => 'klaidzdeil
clypeus => 'klipiәs
clyster => 'klistә
Clytemnestra => ,klaitəm'nestrə
cnidarian => nɑɪ'deəri:ən
Cnut => kә'nju:t
co- => 'kәj
co-authors => 'kəʊ'ɔ:θəz
co-belligerent => ,kəʊbə'lɪdʒərənt
co-education => ˌkəuedju:ˈkeiʃən
co-evolution => 'kəʊi:vəl'u:ʃn
co-occurrence => kəu ə'kʌrəns
co-op => 'kәuɔp, kәu'ɔp
co-opt => kәu'ɔpt
co-optation => ,kәuɔp'teiʃәn
co-own => ,kəu'əun
co-parent => kəu'pεərənt
co-produce => ,kəuprə'dju:s
co-religionist => 'kəʊrɪl'ɪdʒənɪst
co-star => ˈkəʊstɑ:
co-trimoxazole => 'kəʊtrɪm'ɒksəzəʊl
co-worker => 'kәu'wә:kә
coacervate => kәu'æsәveit
coach => kәutʃ
coach house => kəutʃ haus
coach station => kəutʃ ˈsteiʃən
coachbuilder => kəʊtʃ'bɪldər
coached => kəutʃt
coacher => 'kәutʃә
coaches => kəutʃiz
coaching => 'kәutʃiŋ
coachload => ˈkəʊtʃləʊd
coachloads => 'kəʊtʃləʊd
coachman => 'kәutʃmәn
coachmen => 'kəutʃmən
coachwhip => 'kәjtʃhwip
coachwood => 'kәjtʃwjd
coachwork => 'kәjtʃw\\\\:k
coadjutor => kәu'ædʒutә
coagulable => kәj'æ^jjlәbl
coagulant => kәu'ægjulәnt
coagulase => kәj'æ^jjleis
coagulate => kәu'ægjuleit
coagulated => kəʊˈægjəˌleɪtid
coagulates => kəʊˈægjəˌleɪts
coagulation => kәu.ægju'leiʃәn
coagulative => kәu'ægjuleitiv
coagulator => kәj'æ^jjleitә(r)
coagulum => kәu'ægjulәm
coal => kәul
coal measures => kəul 'meʒəz
coal scuttle => 'kәjlskʌt(ә)l
coal-black => 'kәjl'blæk
coal-hole => 'kəʊlh'əʊl
coaler => 'kәulә
coalesce => .kәuә'les
coalesced => ˌkəʊəˈlest
coalescence => .kәuә'lesns
coalescent => .kәuә'lesnt
coalesces => ˌkəʊəˈlesiz
coalface => ˈkəʊlfeɪs
coalfield => 'kәulfi:ld
coalfields => ˈkəulfi:ldz
coalfish => 'kәulfiʃ
coalhole => 'kәulhәul
coaling => 'kәuliŋ
coalite => 'kәulait
coalition => .kәuә'liʃәn
coalitions => ˌkəʊə'lɪʃənz
coalman => ˈkəʊlmən
coalmen => 'kəʊlmən
coalminer => 'kəulmainə
coalminers => 'kəulmainə
Coalport => 'kәjlpɔ:t
coals => kəulz
coaly => 'kәuli
coaming => 'kәumiŋ
coaptation => ,kәuæp'teiʃәn
coarctate => kәu'ɑ:kteit
coarctation => ,kәjɑ:k'teiʃәn
coarse => kɒ:s
coarse fish => kɔ:s fiʃ
coarsely => 'kɒ:sli
coarsen => 'kɒ:sәn
coarsened => ˈkɔ:snd
coarseness => 'kɒ:snis
coarsening => 'kɔ:snɪŋ
coarsens => ˈkɔ:snz
coast => kәust
coastal => 'kәustәl
coaster => 'kәustә
coaster brake => ˈkəʊstə breik
coasters => ˈkəʊstəz
coastguard => 'kәustgɑ:d
coastguards => ˈkəustɡɑ:dz
coasting => 'kәustiŋ
coastland => 'kәustlænd
coastline => 'kәustlain
coastlines => ˈkəʊstˌlaɪnz
coastwise => 'kәustwaiz
coat => kәut
coat dress => kəut dres
coat of arms => kəut ɔv ɑ:mz
coat of mail => kəut ɔv meil
coat-tail => 'kəʊtt'eɪl
Coatbridge => 'kəut,bridʒ
coated => 'kәutid
coatee => 'kәuti:
coathanger => 'kəut,hæŋə
coati => kәu'ɑ:ti
coatimundi => kәj,ɑ:ti'mʌndi
coating => 'kәutiŋ
coatless => 'kəʊtlɪs
coatrack => 'kәjtræk
coatroom => 'kәjtru:m
coattail => 'kәutteil
coax => kәuks
coaxed => kəukst
coaxes => kəuksiz
coaxial => .kәu'æksiәl
coaxingly => 'kәuksiŋli
cob => kɒb
cobalamin => kәu'bɔlәmin
cobalt => 'kәubɒ:lt
cobaltic => kәu'bɒ:ltik
cobaltous => kәu'bɔ:ltәs
cobber => 'kɒbә
cobble => 'kɒbl
cobbler => 'kɒblә
cobblers => 'kɒbləz
cobbles => ˈkɒblz
cobblestone => 'kɔblәstәjn
cobblestoned => 'kɒbəl,stəʊnd
cobblestones => ˈkɒblstəʊnz
cobbling => 'kɒbəlɪŋ
cobby => 'kɔbi
Cobden => 'kɔbdәn
Cobham => 'kɔbәm
cobia => 'kәubiә
coble => 'kәubl
cobnut => 'kɒbnʌt
COBOL => 'kәubәul
cobra => 'kәubrә
cobras => ˈkəubrəz
cobs => kɔbz
Coburg => 'kɔbә:^
cobweb => 'kɒbweb
cobwebbed => 'kɔbwebd
cobwebby => 'kɒbwebi
cobwebs => ˈkɔbˌwebz
coca => 'kәukә
cocaine => kә'kein
cocci => 'kɔksai
coccidia => kɔk'sidiә
coccidioidomycosis => kɔk,sidi,ɔidәumai'kәusis
coccidiosis => kɔk,sidi'әusis
coccidiostat => kɔk,sidiә'stæt
coccoid => 'kɔkɔid
coccolith => 'kɔkәliθ
coccus => 'kɒkәs
coccygeal => kɒk'sidʒiәl
coccyx => 'kɒksiks
Cochabamba => ,kotʃa'bambә
cochineal => 'kɒtʃini:l
cochlea => 'kɒkliә
cochlear => 'kɒkliә
cock => kɒk
cock-a-hoop => 'kɔkә'hu:p
cock-a-leekie => 'kɔkә'li:ki
cock-eyed => 'kɒk'aɪd
cockabully => 'kɔkә,bjli
cockade => kɒ'keid
cockalorum => kɒkә'lәurәm
cockamamie => 'kɒkə,meɪmɪ
cockapoo => kɒ'keɪpu:
cockatiel => ˌkɒkəˈti:l
cockatoo => kɒkә'tu:
cockatrice => 'kɔkәtrais
cockboat => 'kɒkbәut
cockchafer => 'kɒktʃeifә
cockcroft => 'kәukrɔft
cockcrow => 'kɔkkrәj
cocked => kɔkt
cocked hat => kɔkt hæt
cocker => 'kɒkә
cocker spaniel => ˈkɔkə ˈspænjəl
cockered => ˈkɔkəd
cockerel => 'kɒkәrәl
cockering => ˈkɔkərɪŋ
cockers => ˈkɔkəz
cockeyed => 'kɒkaid
cockfight => 'kɒkfait
cockfighting => 'kɒkfaitiŋ
cockfights => 'kɒkfaɪt
cockhorse => .kɒk'hɒ:s
cockier => ˈkɔki:ə
cockily => 'kɒkili
cockiness => 'kɒkinis
cocking => 'kɒkɪŋ
cockle => 'kɒkl
cocklebur => 'kɒklbә:
cockler => 'kɒklər
cockles => 'kɒklz
cockling => 'kɒklɪŋ
Cockney => 'kɒkni
cockneyism => 'kɔkniizәm
cockneys => ˈkɔkni:z
cockpit => 'kɒkpit
cockpits => 'kɒkpɪts
cockroach => 'kɒkrәutʃ
cockroaches => 'kɒkrəʊtʃɪz
cockscomb => 'kɒkskәum
cocksfoot => 'kɔksfut
cockspur => 'kɒkspә:
cocksuckers => 'kɔk,sʌkə
cocksure => .kɒk'ʃuә
cocktail => 'kɒkteil
cocktail dress => ˈkɔkteil dres
cocktail stick => ˈkɔkteil stik
cocky => 'kɒki
coco => 'kәukәu
cocoa => 'kәukәu
cocoanut => 'kәukәnʌt
cocobolo => 'kəʊkəʊbəʊləʊ
coconut => 'kәukәnәt
coconut butter => ˈkəukənʌt ˈbʌtə
coconut crab => ˈkəukənʌt kræb
coconut matting => ˈkəukənʌt ˈmætiŋ
coconut palm => ˈkəukənʌt pɑ:m
coconut shy => ˈkəukənʌt ʃai
cocoon => kә'ku:n
cocooned => kəˈku:nd
cocooning => kə'ku:nɪŋ
cocoons => kəˈku:nz
cocotte => kɒ'kɒt
cod => kɒd
cod-liver oil => ˈkɔdˈlɪvə
coda => 'kәudә
codas => ˈkəʊdəz
codding => 'kɒdɪŋ
coddle => 'kɒdl
coddled => ˈkɔdld
coddles => ˈkɔdlz
coddling => ˈkɔdlɪŋ
code => kәud
codebook => 'kəʊdbʊk
coded => 'kәudid
codeine => 'kәudi:in
codependence => kəudi'pendəns
codependency => ˌkəʊdɪˈpendənsi
coder => 'kәudә
codex => 'kәudeks
codfish => 'kɒdfiʃ
codger => 'kɒdʒә
codgers => ˈkɔdʒəz
codices => 'kәjdisi:z
codicil => 'kɒdisil
codicillary => .kɒdi'silәri
codicils => ˈkɔdəsɪlz
codicology => ,kәjdi'kɔlәdʒi
codification => .kәudifi'keiʃәn
codified => ˈkɔdɪˌfaɪd
codifies => ˈkɔdɪˌfaɪz
codify => 'kәudifai
coding => 'kәudiŋ
codling => 'kɒdliŋ
codling moth => ˈkɔdliŋ mɔθ
codomain => 'kɔdәu,mein
codon => 'kәudәn
codpiece => 'kɔd.pi:s
codswallop => 'kɔdz,wɔlәp
cody => 'kәudi
coecilian => si'siliәn
coed => 'kәu'ed
coeducation => .kәuedju'keiʃәn
coeducational => ,kәjedju:'keiʃәnәl
coefficient => kәui'fiʃәnt
coefficients => kəʊɪ'fɪʃənts
coelacanth => 'si:lәkænθ
coelacanths => 'siːləkænθ
coelenterate => si'lentәrit
coeliac => 'si:liæk
coeliac disease => ˈsi:liæk dɪzi:z
coelom => 'si:lәm
coelomate => 'si:lәmeit
coelostat => 'si:lә,stæt
coelurosaur => sɪˈljʊərəsɔ:(r)
coenobite => 'si:nәubait
coenocyte => 'si:nәusait
coenocytic => ,si:nә'sitik
coenzyme => kәu'enzaim
coequal => kәu'i:kwәl
coequality => kәui:'kwɒliti
coerce => kәu'ә:s
coerced => kəʊˈɜ:st
coerces => kəʊˈɜ:siz
coercible => kәu'ә:sibl
coercing => kəʊ'ɜ:sɪŋ
coercion => kәu'ә:ʃәn
coercive => kәu'ә:siv
coercively => kouˊәːsivli
coercivity => kәuә:'siviti
coeternal => .kәui'tә:nl
coeval => kәu'i:vәl
coevality => .kәui:'væliti
coevolution => ,kәji:vә'lju:ʃәn
coexist => .kәuig'zist
coexisted => ˈkəuiɡˈzistid
coexistence => .kәuig'zistәns
coexistent => kәuig'zistәnt
coexisting => ˈkəuiɡˈzistɪŋ
coexists => ˈkəuiɡˈzists
coextensive => .kәuik'stensiv
cofactor => kәu'fæktә
coffee => 'kɒfi
coffee bar => ˈkɔfi bɑ:
coffee break => ˈkɔfi breik
coffee essence => ˈkɔfi ˈesns
coffee grinder => ˈkɔfi ˈgraɪndə
coffee morning => ˈkɔfi ˈmɔ:niŋ
coffee table => ˈkɔfi ˈteibl
coffee-table book => ˈkɔ:fi:ˌteɪbəl, ˌkɔfi:-
coffeecake => 'kɔfikeik
coffeemaker => 'kɔfi,meikә(r)
coffeepot => 'kɑfipɔt
coffees => ˈkɔfiz
coffer => 'kɒfә
cofferdam => 'kɔfәdæm
coffered => 'kɒfə
cofferer => 'kɒfə
coffering => 'kɔfәriŋ
coffey => 'kɔfi
coffin => 'kɒfin
coffin nail => ˈkɔ:fɪn neil
coffins => ˈkɔ:fɪnz
coffle => 'kɔfl
coffret => 'kɔfrit
cog => kɒg
cog railway => kɔg ˈreilwei
cogency => 'kәudʒәnsi
cogeneration => kəʊˌdʒenə'reɪʃən
cogent => 'kәudʒәnt
cogently => 'kəʊdʒəntlɪ
cogged => kɒgd
cogging => 'kɔ^iŋ
cogitable => 'kɒdʒitәbl
cogitate => 'kɒdʒiteit
cogitated => ˈkɔdʒɪˌteɪtid
cogitates => ˈkɔdʒɪˌteɪts
cogitating => ˈkɔdʒɪˌteɪtɪŋ
cogitation => ,kɔdʒi'teiʃәn
cogitative => 'kɒdʒitәtiv
cogitator => 'kɒdʒiteitә
cogito => ˈkɔdʒitəu
cognac => 'kәunjæk
cognacs => ˈkəunjæks
cognate => 'kɔ^neit
cognateness => kɒɡ'neɪtenəs
cognisance => 'kɔ^nizәns
cognisant => 'kɔ^nizәnt
cognition => kɒg'niʃәn
cognitive => 'kɒgnitiv
cognitive dissonance => ˈkɔɡnitiv ˈdɪsənəns
cognitive scientist => ˈkɑɡnɪtɪv ˈsaɪəntɪst
cognitive therapy => ˈkɔɡnitiv ˈθerəpi
cognitivism => 'kɒɡnɪtɪvɪzəm
cognizable => 'kɔ^nizәbl
cognizance => 'kɒgnizәns
cognizant => 'kɒgnizәnt
cognize => 'kәugnaiz
cognized => kɔɡˈnaizd
cognizes => kɔɡˈnaiziz
cognizing => kɒɡ'naɪzɪŋ
cognomen => kɒg'nәumәn
cognoscenti => ˌkɒnjəˈʃenti
cogs => kɔgz
cogwheel => 'kɒghwi:l
cohabit => kәu'hæbit
cohabitant => kәj'hæbitәnt
cohabitation => ,kәuhæbi'teiʃәn
cohabited => kəʊˈhæbɪtid
cohabitee => kəu,hæbi'ti:
cohabiting => kəʊˈhæbɪtɪŋ
cohabits => kəʊˈhæbɪts
cohen => 'kәuin
cohere => kәu'hiә
cohered => kəʊˈhɪəd
coherence => kәu'hiәrәns
coherent => kәu'hiәrәnt
coherer => kәu'hiәrә
cohering => kəʊˈhɪərɪŋ
cohesion => kәu'hi:ʒәn
cohesive => kәu'hi:siv
cohesively => kəu'hi:sivli
coho => 'kәuhәu
cohort => 'kәuhɒ:t
cohorts => 'kəʊhɔ:ts
cohosh => 'kәjhɔʃ
cohune => kәu'hu:n
coif => kɒif
coiffed => k'wɑ:feɪd
coiffeur => kwɑ:'fә:
coiffeuse => kwɑ:'f\\\\:z
coiffing => kɔifɪŋ
coiffure => kwɑ:'fjuә
coiffures => kwɑ:ˈfjuəz
coifs => kɔifs
coign => kɒin
coil => kɒil
coiled => kɔild
coiling => 'kɔiliŋ
coils => kɔilz
Coimbatore => ,kɔimbә'tɔ:(r)
coin => kɒin
coin box => kɔin bɔks
coin-op => 'kɔinɔp
coinage => 'kɒinidʒ
coinages => ˈkɔɪnɪdʒz
coincide => .kәuin'said
coincided => ˌkəuinˈsaidid
coincidence => kәu'insidәns
coincidences => kə'ʊɪnsɪdənsɪz
coincident => kәu'insidәnt
coincidental => kәuinsi'dentәl
coincides => ˌkəuinˈsaidz
coinciding => ˌkəuinˈsaidɪŋ
coined => kɔind
coiner => 'kɒinә
coinfection => 'kɔɪnfekʃən
coining => 'kɔiniŋ
coinsurance => kәuin'ʃurәns
coinsure => kәuin'ʃuә
Cointreau => 'kwɑ:ntrәj
coir => 'kɒiә
coital => 'kәuitәl
coition => kәu'iʃәn
coitus => 'kәjitәs
coitus interruptus => ˌkɔɪtəs ɪntəˈrʌptəs
cojones => kəuˈhəunəs
coke => kәuk
coked => 'kəʊkt
coker => 'kәukә
cokes => kәuks
coking => 'kәukiŋ
col => kɒl
col- => 'kɒl
cola => 'kәulә
colander => 'kʌlәndә
colanders => ˈkʌləndəz
colas => 'kɔlәs
colcannon => kәl'kænәn
colchicine => 'kɒltʃisi:n
colchicum => 'kɒltʃikәm
cold => kәuld
cold call => kəuld kɔ:l
cold cash => kəuld kæʃ
cold chisel => kəuld ˈtʃɪzəl
cold frame => kəuld freim
cold front => kəuld frʌnt
cold fusion => kəuld ˈfju:ʒən
cold snap => kəuld snæp
cold store => kəuld stɔ:
cold turkey => kəuld ˈtə:ki
cold-blooded => kәjld'blʌdid
cold-hearted => kәjld'hɑ:tid
cold-heartedness => 'kəʊldh'ɑ:tɪdnəs
cold-short => 'kәjldʃɔ:t
coldish => 'kәuldiʃ
coldly => 'kәuldli
coldness => 'kәuldnis
cole => kәul
colectomy => kә'lektәmi
coleman => 'kәulmәn
colemanite => 'kәulmәnait
coleopteran => 'kɒlɪɒptərən
coleopterist => ,kɔli'ɔptәrist
coleopterous => kɒli'ɒptәrәs
coleoptile => ,kәuli'ɔptl, ,kɔli-
coleorhiza => ,kәuliә'raizә
Coleridge => 'kәulridʒ
coles => kәuls
coleseed => 'kәulsi:d
coleslaw => 'kәulslɒ:
colette => kәj'let
coleus => 'kәuliәs
colewort => 'kәulwә:t
coley => ˈkəʊli
coli => 'kәulai
colic => 'kɒlik
colic root => 'kɒlɪk,ruːt
colicin => 'kɔlisin
colicky => 'kɒliki
coliform => 'kɒlifɒ:m
colin => 'kɔlin
coliseum => ,kɔli'siәm
colitis => kәu'laitis
collaborate => kә'læbәreit
collaborated => kəˈlæbəˌreɪtid
collaborates => kəˈlæbəˌreɪts
collaboration => kә.læbә'ræʃәn
collaborationist => kә.læbә'reiʃәnist
collaborative => kә'læbәreitiv
collaboratively => kə'læbərətivli
collaborator => kә'læbәreitә
collaborators => kə'læbəreɪtəz
collage => kɒ'lɑ:ʒ
collagen => 'kɒlәdʒin
collages => kəʊˈlɑ:ʒz
collapsar => kә'læpsɑ:
collapse => kә'læps
collapsible => kә'læpsibl
collapsing => kә'læpsiŋ
collar => 'kɒlә
collarbone => 'kɒlәbәun
collarbones => ˈkɔləbəunz
collard => 'kɔlәd
collards => 'kɒlɑːd
collare => 'kɔlә
collaring => 'kɔlәriŋ
collarless => 'kɔlәlis
collate => kә'leit
collated => kəˈleɪtid
collateral => kә'lætәrәl
collateralize => kә'lætәrәlaiz
collateralized => kəˈlætərəlaizd
collateralizing => kəˈlætərəlaizɪŋ
collates => kəˈleɪts
collation => kɔ'leiʃәn
collator => kɒ'leitә
colleague => 'kɒli:g
collect => kә'lekt
collectable => kә'lektib(ә)l
collectanea => ,kɔlek'tɑ:njә
collected => kә'lektid
collectibles => kəˈlektəbəlz
collecting => kəˈlektɪŋ
collection => kә'lekʃәn
collective => kә'leiktiv
collective noun => kəˈlektiv naun
collective unconscious => kəˈlektiv ʌnˈkɔnʃəs
collectives => kəˈlektivz
collectivisation => kә,lektivai'zeiʃәn; - vi'z-
collectivism => kә'lektivizm
collectivist => kә'lektivist
collectivistic => kә.lekti'vistik
collectivity => .kɒlek'tiviti
collectivization => kә,lektivai'zeiʃәn; -vi'z-
collectivize => kә'lektivaiz
collectivized => kəˈlektəˌvaɪzd
collectivizes => kəˈlektəˌvaɪziz
collectivizing => kəˈlektəˌvaɪzɪŋ
collector => kә'lektә
collectorate => kә'lektәrit
collectors => kə'lektəz
collects => kəˈlekts
colleen => 'kɒli:n
colleens => kɒ'liːn; 'kɒliːn
college => 'kɒlidʒ
collegia => kә'li:dʒiә
collegial => kә'li:dʒiәl
collegiality => kә,li:dʒi'æliti
collegian => kә'li:dʒjәn
collegiate => kә'li:dʒiәt
collegiate church => kəˈli:dʒiit tʃə:tʃ
collegium => kә'li:dʒiәm
collembolan => kә'lembәulәn
collenchyma => kә'leŋkimә
collet => 'kɒlit
colliculus => kɔ'likjulәs
collide => kә'laid
collider => kəˈlaɪdə(r)
collides => kəˈlaidz
collie => 'kɒli
collied => 'kɒlɪ
collier => 'kɒljә
collieries => ˈkɔljəriz
colliery => 'kɒljәri
collies => ˈkɔliz
colligate => 'kɒligeit
colligated => ˈkɔliɡeitid
colligates => ˈkɔliɡeits
colligating => ˈkɔliɡeitɪŋ
colligation => kɒli'geiʃәn
colligative => 'kɔli^әtiv
collimate => 'kɒlimeit
collimated => ˈkɔlimeitid
collimates => ˈkɔlimeits
collimation => kɒli'meiʃәn
collimator => 'kɒlimeitә
collinear => kә'linjә
collinearity => ,kɔlini'æriti
collins => 'kɒlinz
collision => kә'liʒәn
collisional => kə'liʒənəl
collisions => kə'lɪʒnz
collocate => 'kɒlәkeit
collocates => ˈkɔləkeits
collocation => kɒlә'keiʃәn
collocutor => 'kɔlәkju:tә
collodion => kә'lәjdiәn
collogue => kә'lәug
collogued => kɒ'ləʊg
collogues => kɒ'ləʊg
colloguing => kɒ'ləʊg
colloid => 'kɒlɒid
colloidal => kә'lɒidl
collop => 'kɒlәp
colloquial => kә'lәukwiәl
colloquialism => kә'lәjkwiәliz(ә)m
colloquialisms => kəˈləukwiəliz(ə)mz
colloquially => kә'lәukwiәli
colloquies => ˈkɔləkwiz
colloquium => kә'lәukwiәm
colloquy => 'kɒlәkwi
collotype => 'kɒlәtaip
collude => kә'lu:d
colluded => kəˈlu:did
colludes => kəˈlu:dz
colluding => kəˈlu:dɪŋ
collusion => kә'lu:ʃәn
collusive => kә'lu:siv
colluvial => kә'lu:viәl
colluvium => kә'lu:viәm
colly => 'kɔli
collying => 'kɒlɪ
collyrium => kә'liriәm
collywobbles => 'kɒliwɒblz
Colman => 'kәulmәn
coloboma => kɔlә'bәumә
colobus => 'kɔlәbәs
colocynth => 'kɒlәsinθ
Cologne => kә'lәun
Colombia => kә'læmbiә
Colombian => kә'læmbiәn
colombians => kəˈlɔmbiənz
Colombo => kә'lʌmbәu
colon => 'kәulәn
colonel => 'kә:nәl
colonelcy => 'k\\\\:nәlsi
colonels => ˈkə:nlz
colonial => kә'lәunjәl
colonialism => kә'lәunjәlizm
colonialist => kә'lәjnjәlist
colonialists => kəˈləʊnjəlɪsts
colonials => kəˈləunjəlz
colonic => kә'lɒnik
colonic irrigation => kəˈlɔnik ˌiriˈɡeiʃən
colonies => ˈkɔləniz
colonisation => ,kɔlənai'zeiʃən
colonise => 'kɔlәnaiz
colonist => 'kɒlәnist
colonists => ˈkɔlənɪsts
colonization => ,kɔlәnai'zeiʃәn
colonize => 'kɒlәnaiz
colonized => ˈkɔləˌnaɪzd
colonizer => 'kɒlәnaizә
colonizes => ˈkɔləˌnaɪziz
colonizing => ˈkɔləˌnaɪzɪŋ
colonnade => .kɒlә'neid
colonnaded => .kɒlә'neidid
colonnades => ˌkɔləˈneɪdz
colonoscopy => ,kәjlә'nɔskәpi
colony => 'kɒlәni
colony-stimulating factor => ˈkɑləni ˈstɪmjəˌletɪŋ ˈfæktɚ
colophon => 'kɒlәfɒn
colophony => 'kɒlәfәuni
color => 'kʌlә
Coloradan => ,kɔlə'rɑ:dən
Colorado => ,kɔlә'rɑ:dәu
colorant => 'kʌlәrәnt
coloration => kʌlә'reiʃәn
coloratura => ,kɔlәrә'tuәrә
colorectal => ,kәjlә'rektәl
colored => 'kʌlәd
colorful => 'kʌlәful
colorific => .kʌlә'rifik
colorimeter => .kʌlә'rimitә
colorimetric => ,kʌlәri'metrik
colorimetry => ,kʌlә'rimitri
coloring => 'kʌlәriŋ
colorist => 'kʌlәrist
colorization => kɒləraɪ'zeɪʃən
colorize => 'kʌlәraiz
colorized => 'kʌlәraizd
colorless => 'kʌlәrlis
colossal => kә'lɒsәl
colossally => kə'lɔsəli
colosseum => ,kɔlә'siәm
colossian => kә'lɔʃәn
Colossians => kә'lɔʃәnz
colossus => kә'lɒsәs
colostomy => kә'lɔstәmi
colostrum => kә'lɒstrәm
colour => 'kʌlә