F => ef
f-number => 'ef,nʌmbә
FA => fɑ:
fab => fæb
fabian => 'feibiәn
Fabianist => 'feibiәnist
Fabius => 'feibjәs
fable => 'feibl
fabled => 'feibld
fables => ˈfeiblz
fabliau => 'fæbliәu
fabliaux => 'fɑ:bli:əʊz
Fabre => 'fɑ:bә
fabric => 'fæbrik
fabricate => 'fæbrikeit
fabricates => ˈfæbrikeits
fabricating => ˈfæbrikeitɪŋ
fabrication => .fæbri'keiʃәn
fabrications => ˌfæbrɪˈkeɪʃənz
fabricator => 'fæbrikeitә
Fabricius => fә'briʃәs
fabulist => 'fæbjulist
fabulosity => .fæbju'lɒsiti
fabulous => 'fæbjulәs
fabulousness => ˊfæbjulәsnis
facade => fә'sɑ:d
facades => fəˈsɑ:dz
face => feis
face cream => feis kri:m
face pack => feis pæk
face saver => feis ˈseɪvə
face time => feis taim
face value => feis ˈvælju
face-off => 'feisɔf
face-painting => 'feɪsp'eɪntɪŋ
face-saving => 'feis,seiviŋ
faced => feist
facedown => 'feis'dajn
faceless => 'feislis
facelessness => 'feislisnis
faceplate => 'feispleit
facer => 'feisә
facet => 'fæsit
facete => fә'si:t
faceted => 'fæsitid
facetiae => fә'si:ʃii:
faceting => 'fæsɪtɪŋ
facetious => fә'si:ʃәs
facetiously => fә'si:ʃәsli
facetiousness => fə'si:ʃəsnəs
facets => ˈfæsits
faceworker => 'feɪswɜːk
facia => 'feiʃә
facial => 'feiʃәl
facial nerve => ˈfeɪʃəl nə:v
facials => ˈfeɪʃəlz
facies => 'feiʃii:z
facile => 'fæsil
facilely => ˊfæsaili,  ˊfæsili
facilitate => fә'siliteit
facilitated => fəˈsiliteitid
facilitates => fəˈsiliteits
facilitating => fəˈsiliteitɪŋ
facilitation => fә,sili'teiʃәn
facilitator => fә'siliteitә
facility => fә'siliti
facing => 'feisiŋ
facings => ˈfeisiŋz
facsimile => fæk'simili
facsimiles => fækˈsɪməli:z
fact => fækt
fact sheet => fækt ʃi:t
fact-finding => 'fækt,faindiŋ
facticity => fæk'tisiti
faction => 'fækʃәn
factional => 'fækʃәnәl
factionalism => 'fækʃәnәlizm
factionalize => 'fækʃәnәlaiz
factions => 'fækʃnz
factious => 'fækʃәs
factiously => ˊfækʃәsli
factiousness => ˊfækʃәsnis
factitious => fæk'tiʃәs
factitiously => fækˊtiʃәsli
factitiousness => fækˊtiʃәsnis
factitive => 'fæktitiv
factoid => 'fæktɔid
factor => 'fæktә
factorage => 'fæktәridʒ
factorial => fæk'tɒ:riәl
factoring => 'fæktәriŋ
factorization => ,fæktәrai'zeiʃәn
factorize => 'fæktәraiz
factorizes => 'fæktəraɪz
factorizing => 'fæktəraɪz
factory => 'fæktәri
factory farming => ˈfæktəri ˈfɑ:miŋ
factory floor => ˈfæktəri flɔ:
factory ship => ˈfæktəri ʃip
factotum => fæk'tәutәm
factotums => fækˈtəʊtəmz
factsheet => 'fæktˌʃi:t
factual => 'fæktʃuәl
factuality => ,fæktju'æliti
factum => 'fæktәm
facture => 'fæktʃә
facula => 'fækjulә
facular => -lә(r)
facultative => 'fækәltәtiv
faculties => ˈfækəltiz
faculty => 'fækәlti
fad => fæd
faddish => 'fædiʃ
faddishness => 'fædiʃ
faddism => 'fædizәm
faddist => 'fædist
faddy => 'fædi
fade => feid
fade-in => 'feidin
fade-out => 'feidajt
fade-up => feid ʌp
fadeaway => 'feidә,wei
faded => 'feidid
fadeless => 'feidlis
fader => 'feidә
fades => feidz
fadge => fædʒ
fading => 'feidiŋ
fado => 'fɑ:du:
fads => fædz
faecal => 'fi:kәl
faeces => 'fi:si:z
faerie => 'feiәri
Faeroese => ,feәrә'i:z
faery => 'feiәri
faff => fæf
fag => fæg
fagging => 'fæ^iŋ
faggot => 'fægәt
faggoting => 'fæ^әtiŋ
faggots => ˈfæɡəts
faggoty => 'fæ^әti
faggy => 'fæ^i
fagin => 'feigin
fags => fægz
fah => fa:
fahlerz => feɪ'leəz
fahrenheit => 'færәnhait
faience => fai'ɑ:ns
fail => feil
failing => 'feiliŋ
faille => feil
failover => feɪl'əʊvər
fails => feilz
failsafe => 'feɪlˌseɪf
failure => 'feiljә
fain => fein
faint => feint
faint-hearted => ˈfeɪntˈhɑ:tɪd
fainter => feintə
faintest => 'feintist
fainting => 'feintiŋ
faintly => 'feintli
faintness => 'feintnis
faints => feints
fair => fєә
fair dinkum => fɛə ˈdiŋkəm
fair use => fɛə ju:z
fair-haired => 'feә'heәd
fair-minded => 'feә'maindid
fair-spoken => 'feә'spәjkәn
Fairbank => 'fεəbæŋk
Fairbanks => 'feәbæŋks
faired => f?әd
Fairfax => 'fεəfæks
Fairfield => 'fεəfi:ld
fairground => 'fєәgraund
fairgrounds => ˈfɛəɡraundz
fairies => ˈfɛəriz
fairing => 'feәriŋ
fairish => 'fєәriʃ
fairlead => 'feәli:d
fairly => 'fєәli
fairness => 'fєәnis
fairwater => 'feә,wɔ:tә
fairway => 'fєәwei
fairways => ˈfɛəweiz
fairy => 'fєәri
fairy cake => ˈfɛəri keik
fairy godmother => ˈfɛəri ˈgɔdˌmʌðə
fairy lights => ˈfɛəri laits
fairy ring => ˈfɛəri riŋ
fairy shrimp => ˈfɛəri ʃrimp
fairy story => ˈfɛəri ˈstɔ:ri
fairyland => 'fєәrilænd
fairylike => 'fєәrilaik
fairytale => 'feәriteil
Faisal => 'feisəl
fait accompli => 'feit ɑ:'kɔ:mpli
faith => feiθ
faith healer => feiθ ˈhi:lə
faithful => 'feiθful
faithfully => 'feiθfuli
faithfulness => 'feiθfulnis
faithfuls => ˈfeiθfulz
faithless => 'feiθlis
faithlessly => 'feɪθlɪslɪ
faithlessness => 'feɪθlɪsnɪs
fake => feik
faker => 'feikә
fakery => -kәri
fakir => 'fei.kiә
falafel => 'fælәfil
Falange => fә'læŋhei
falangist => fә'lændʒist
Falasha => fɑ:'lɑ:ʃә
falcate => 'fælkeit
falchion => 'fɒ:ltʃәn
falciform => 'fælsifɒ:m
falcon => 'fɒ:lkәn
falconer => 'fɒ:lkәnә
falconet => 'fɒ:lkәnit
falconry => 'fɒ:lkәnri
falderal => 'fældәræl
faldstool => 'fɒ:ldstu:l
Falk => fɔk
Falkirk => 'fɔ:lkək
fall => fɒ:l
fall by the wayside => fɔ:l bai ðə ˈweɪˌsaɪd
fall down => fɔ:l daun
fall for => fɔ:l fɔ:
fall into place => fɔ:l ˈɪntuː pleis
fall over => fɔ:l ˈəuvə
fall-off => 'fɒ:lɒf
fall-pipe => 'fɔ:lpaip
fallacies => ˈfæləsi:z
fallacious => fә'leiʃәs
fallaciously => fәˊleiʃәsli
fallaciousness => fәˊleiʃәsnis
fallacy => 'fælәsi
fallback => 'fɒ:lbæk
fallen => 'fɒ:lәn
faller => 'fɒ:lә
fallfish => 'fɔ:lfiʃ
fallibility => .fælә'biliti
fallible => 'fælәbl
fallibly => 'fæləblɪ
falling => 'fɒ:liŋ
falling-out => 'fɔ:liŋ'ajt
fallopian tube => fә'lәjpiәn
fallout => 'fɒ:laut
fallow => 'fælәu
fallowing => 'fæləʊɪŋ
falls => fɔ:ls
Falmouth => 'fɔ:lmauθ
false => fɒ:ls
false dawn => fɔ:ls dɔ:n
false fruit => fɔ:ls fru:t
false move => fɔ:ls mu:v
false rib => fɔ:ls rib
false start => fɔ:ls stɑ:t
false topaz => fɔ:ls ˈtəupæz
falsehood => 'fɒ:lshud
falsehoods => ˈfɔ:lsˌhʊdz
falsely => 'fɒ:lsli
falseness => 'fɒ:lsnis
falsetto => fɒ:l'setәu
falsework => 'fɒ:lswә:k
falsies => 'fɔ:lsi:z
falsifiability => ˌfɒsɪfaɪə'bɪlɪtɪ
falsifiable => 'fɔ:lsɪfaɪəbl
falsification => .fɒ:lsifi'keiʃәn
falsified => ˈfɔ:lsəˌfaɪd
falsify => 'fɒ:lsifai
falsities => ˈfɔ:lsitiz
falsity => 'fɒ:lsiti
falstaff => 'fɔ:lstɑ:f
Falstaffian => fɔ:l'stɑ:fiәn
falter => 'fɒ:ltә
faltered => ˈfɔ:ltəd
faltering => 'fɒ:ltәriŋ
falteringly => 'fɔ:ltərɪŋlɪ
falters => ˈfɔ:ltəz
fame => feim
famed => feimd
familial => fә'miljәl
familiar => fә'miljә
familiar with => fəˈmiljə wið
familiarisation => fə,miljərai'zeiʃən; -ri'z-
familiarise => fә'miljәraiz
familiarising => fə'miljəraiz
familiarities => fəˌmɪlˈjærɪti:z
familiarity => fә.mili'æriti
familiarize => fә'miljәraiz
familiarized => fəˈmɪljəˌraɪzd
familiarizes => fəˈmɪljəˌraɪziz
familiarizing => fəˈmɪljəˌraɪzɪŋ
familiars => fəˈmiljəz
familist => fə'mɪlɪst
familistic => ,fæmi'listik
family => 'fæmәli
family doctor => ˈfæmili ˈdɔktə
family man => ˈfæmili mæn
family practice => ˈfæmili ˈpræktis
famine => 'fæmin
famines => ˈfæminz
famish => 'fæmiʃ
famous => 'feimәs
famously => 'feimәsli
famulus => 'fæmjulәs
fan => fæn
fan club => fæn klʌb
fan palm => fæn pɑ:m
fan-like => fæn laik
fan-tan => 'fæntæn
fanatic => fә'nætik
fanatical => fә'nætikәl
fanatically => fә'nætәkәli
fanaticism => fә'nætisizm
fanaticize => fә'nætisaiz
fanatics => fə'nætɪks
fancied => 'fænsid
fancier => 'fænsiә
fanciers => ˈfænsiəz
fanciful => 'fænsiful
fancifully => 'fænsɪfəlɪ
fancifulness => ˊfænsifulnis
fancily => 'fænsili
fanciness => 'fænsinis
fancy => 'fænsi
fancywork => 'fænsiwә:k
fandangle => fæn'dæŋgl
fandango => fæn'dængәu
fandangos => fænˈdæŋɡəuz
fandom => 'fændәm
fane => fein
fanfare => 'fænfєә
fanfares => ˈfænˌfeəz
fanfaronade => ,fænfærә'nɑ:d
fang => 'fæŋ
fanged => fæŋd
fangs => fæŋz
fanlight => 'fænlait
fanner => 'fænә
fannies => 'fænɪz
fanning => 'fæniŋ
fanny => 'fæni
Fanon => 'fænәn
fantabulous => fæn'tæbjulәs
fantail => 'fænteil
fantasia => fæn'teizjә
fantasied => ˈfæntəsid
fantasies => ˈfæntəsiz
fantasise => 'fæntәsaiz
fantasist => 'fæntәsist
fantasize => 'fæntәsaiz
fantasized => ˈfæntəˌsaɪzd
fantasizes => ˈfæntəˌsaɪziz
fantasizing => ˈfæntəˌsaɪzɪŋ
fantastic => fæn'tæstik
fantastical => fæn'tæstikәl
fantasticality => fæn.tæsti'kæliti
fantastically => fæn'tæstɪklɪ
fantasticate => fæn'tæstikeit
fantasy => 'fæntәsi
fantasy football => ˈfæntəsi ˈfutbɔ:l
fantasying => ˈfæntəsiŋ
fantasyland => 'fæntəsɪlənd
fantod => 'fæntɒd
fanzine => 'fænzi:n
FAO => faj
faquir => 'fɑ:kiә, fә'kiә
far => fɑ:
far out => fɑ: aut
far-fetched => ˈfɑ:ˈfetʃt
far-off => 'fɑ:r'ɔf
far-seeing => 'fɑ:rs'i:ɪŋ
far-sighted => fɑ:'saitid
farad => 'færәd
faradaic => ,færә'deiik
faraday => 'færәdi
faradic => fә'rædik
farandole => 'færәndәjl
faraway => 'fɑ:rәwei
farce => fɑ:s
farced => fɑ:st
farces => fɑ:siz
farceur => fɑ:'sә:
farcical => 'fɑ:sikәl
farcicality => ,fɑ:si'kæliti
farcically => 'fɑ:sɪklɪ
farcing => fɑ:sɪŋ
farcy => 'fɑ:si
fardel => 'fɑ:dl
fare => fєә
fare-thee-well => ,feәði:'wel
farewell => 'fєә'wel
farewells => ˈfɛəˈwelz
farfalle => fɑ:'fæleɪ
farfetched => 'fɑ:'fetʃt
farina => fә'ri:nә
farinaceous => .færi'neiʃәs
farkleberry => 'fɑ:klbәri
farl => fɑ:l
farley => 'fɑ:li
farm => fɑ:m
farm team => fɑ:m ti:m
farmer => 'fɑ:mә
farmhouse => 'fɑ:mhaus
farmhouses => ˈfɑ:mˌhaʊsiz
farming => 'fɑ:miŋ
farmland => 'fɑ:mlænd
farmlands => 'fɑ:mlændz
farmstead => 'fɑ:msted
farmworker => fɑ:m'wɜ:kə
farmworkers => 'fɑːmwɜːkə
farmyard => 'fɑ:mjɑ:d
farmyards => ˈfɑ:mˌjɑ:dz
faro => 'fєәrәu
Faroese => ,feәrәj'i:z
farouche => fɑ:'ru:ʃ
farraginous => fә'rædʒinәs
farrago => fә'rɑ:gәu
Farrar => 'færә
farrell => 'færәl
farrier => 'færiә
farriers => ˈfæriəz
farriery => 'færiәri
farrow => 'færәu
farrowed => ˈfærəʊd
farrowing => 'færəʊɪŋ
farrows => ˈfærəʊz
farruca => fә'ru:kә
Farsi => 'fɑ:si
farside => 'fɑ:rsaɪd
farsighted => 'fɑ:'saitid
fart => fɑ:t
farted => fɑ:tid
farther => 'fɑ:ðә
farthermost => 'fɑ:ðәmәust
farthest => 'fɑ:ðist
farthing => 'fɑ:ðiŋ
farthingale => 'fɑ:ðiŋgeil
farthings => ˈfɑ:ðɪŋz
farting => fɑ:tɪŋ
fartlek => 'fɑ:tlek
farts => fɑ:ts
fasces => 'fæsi:z
fascia => 'feiʃiә
fascias => ˈfæʃi:əz
fasciated => 'fæʃieitid
fasciation => ,fæʃi'eiʃәn
fascicle => 'fæsikl
fascicled => 'fæsikld
fascicular => fә'sikjulә
fasciculate => fæ'sikjulit
fasciculation => fæ,sikju'leiʃәn
fascinate => 'fæsineit
fascinates => ˈfæsineits
fascinating => 'fæsineitiŋ
fascinatingly => 'fæsɪneɪtɪŋlɪ
fascination => .fæsi'neiʃәn
fascinations => ˌfæsəˈneɪʃənz
fascinator => 'fæsineitә
fascine => fæ'si:n
fascioliasis => fә,si:ә'laiәsis
fascism => 'fæʃizm
fascist => 'fæʃist
fascistic => fæ'ʃistik
fascists => ˈfæʃɪsts
fash => fæʃ
fashion => 'fæʃәn
fashion victim => ˈfæʃən ˈviktim
fashionable => 'fæʃәnәbl
fashionably => 'fæʃәnәbli
fashioner => 'fæʃәnә
fashioning => 'fæʃәniŋ
fashionista => ˌfæʃnˈi:stə
fast => fɑ:st
fast breeder => fɑ:st ˈbri:də
fast buck => fɑ:st bʌk
fast food => fɑ:st fu:d
fast forward => fɑ:st ˈfɔ:wəd
fast lane => fɑ:st lein
fast track => fɑ:st træk
fast-forward => fæstˈfɔ:wəd
fast-talk => 'fɑ:sttɔ:k;'fæs-
fast-track => fɑ:st træk
fastback => 'fɑ:stbæk
fastball => 'fɑ:stbɔ:l
fasten => 'fɑ:sәn
fastened => ˈfɑ:sənd
fastener => 'fɑ:sәnә
fasteners => 'fa:stnəz
fastening => 'fɑ:sәniŋ
fastens => ˈfɑ:sənz
fastidious => fæs'tidiәs
fastidiously => fæs'tidiәsli
fastigiate => fæs'tidʒiit
fasting => 'fɑ:stiŋ
fastness => 'fɑ:stnis
fastnesses => ˈfæstnɪsiz
fat => fæt
fat body => fæt ˈbɔdi
fat cat => fæt kæt
fat-free => fæt fri:
Fata Morgana => 'fɑ:tә mɔ:'^ɑ:nә
Fatah => fatʌh
fatal => 'feitәl
fatalism => 'feitәlizm
fatalist => 'feitәlist
fatalistic => .feitә'listik
fatalities => feɪˈtælɪti:z
fatality => fә'tæliti
fatally => 'feitәli
fatback => 'fætbæk
fate => feit
fated => 'feitid
fateful => 'feitful
fatefully => 'feitfuli
fathead => 'fæthed
father => 'fɑ:ðә
father-in-law => 'fɑ:ðәrinlɔ:
fatherhood => 'fɑ:ðәhud
fathering => ˈfɑ:ðərɪŋ
fatherland => 'fɑ:ðә'lænd
fatherlands => ˈfɑ:ðəˌlændz
fatherless => 'fɑ:ðәlis
fatherlike => 'fɑ:ðәlɑik
fatherliness => 'fɑ:ðәlinis
fatherly => 'fɑ:ðәli
fathers => ˈfɑ:ðəz
fathom => 'fæðәm
fathomable => 'fæðәmәbl
fathomed => ˈfæðəmd
fathoming => ˈfæðəmɪŋ
fathomless => 'fæðәmlis
fathoms => ˈfæðəmz
fatigability => ,fæti^ә'bilәti
fatigue => fә'ti:g
fatigued => fә'ti:ɡd
fatigues => fəˈti:ɡz
Fatiha => 'fɑ:tihɑ:
fatima => 'fætimә
fatling => 'fætliŋ
fatness => 'fætnis
fats => fæts
fatso => 'fætsәu
fatstock => fæts'tɒk
fatted => 'fætɪd
fatten => 'fætn
fattened => ˈfætnd
fattening => 'fætniŋ
fattens => ˈfætnz
fatter => 'fætә
fatties => ˈfæti:z
fattiness => 'fætinis
fatting => 'fætiŋ
fattish => 'fætiʃ
fattist => 'fætist
fatty => 'fæti
fatuity => fә'tju:әti
fatuous => 'fætjuәs
fatwa => 'fætwɑ:
faubourg => 'fәubuә^
fauces => 'fɔ:si:z
faucet => 'fɒ:sit
faucets => 'fɔ:sɪts
faucial => 'fɔ:ʃәl
faugh => fɒ:
fauld => fɔ:ld
faulkner => 'fɔ:knә
fault => fɒ:lt
faultier => ˊfɒːltiә
faultiest => ˊfɒːltiist
faultily => 'fɒ:ltili
faultiness => 'fɒ:ltinis
faulting => 'fɔ:ltiŋ
faultless => 'fɒ:ltlis
faultlessly => 'fɒ:ltlisli
faults => fɔ:lts
faulty => 'fɒ:lti
faun => fɒ:n
fauna => 'fɒ:nә
faunal => 'fɔ:nl
faunistic => fɔ:'nistik
fauns => fɔ:nz
Faunus => 'fɔ:nәs
Faure => fɔә
Faust => faust
Faustian => 'faustiən
faustus => 'fajstәs,'fɔ:-
faute de mieux => fәut dә'mjә:
fauteuil => 'fәutә:i
fauvism => 'fouvizm
fauvist => 'fәjvist
faux => fәu
faux pas => fәj'pɑ:
fava bean => ˈfɑ:və bi:n
fave => feiv
favela => fɑ:'velɑ:
favor => 'feivә
favorable => 'feivәrәbl
favorably => 'feivәrәbli
favored => 'feivәd
favorite => 'feivәrit
favoritism => 'feivәritizm
favour => 'feivә
favourable => 'feivәrәbl
favourableness => ˊfeivәrәblnis
favoured => 'feivәd
favourer => 'feivәrә(r)
favourite => 'feivәrit
favourites => ˈfeivərits
favours => ˈfeivəz
fawkes => 'fɔ:ks
fawn => fɒ:n
fawned => fɔ:nd
fawning => 'fɔ:niŋ
fawningly => 'fɒ:niŋli
fawns => fɔ:nz
FAX => fæks
faxed => fækst
faxes => 'fæksɪz
faxing => fæksɪŋ
fay => fei
fayalite => fai'ɑ:lait
faze => feiz
fazed => feizd
fazenda => feɪ'zendə
fazes => feiziz
fazing => feizɪŋ
FCO => ,ef si: 'əu
fealty => 'fi:әlti
fear => fiә
feared => fiəd
fearful => 'fiәful
fearfully => 'fiәfuli
fearfulness => 'fiәfulnis
fearing => fiərɪŋ
fearless => 'fiәlis
fearlessly => 'fɪələslɪ
fearlessness => 'fɪələsnəs
fearmonger => 'fɪəmʌŋɡər
fearsome => 'fiәsәm
fearsomely => 'fɪəsəmlɪ
feasibility => .fi:zә'biliti
feasible => 'fi:zәbl
feasibly => 'fi:zɪbəlɪ
feast => fi:st
feast day => fi:st dei
feasted => fiːst
feaster => 'fi:stə
feasts => fi:sts
feat => fi:t
feather => 'feðә
feather star => ˈfeðə stɑ:
feather-brain => 'feðərbr'eɪn
featherbed => 'feðәbed
featherbedding => 'feðә,bediŋ
featherbeds => 'feðəbed
featherbrained => 'feðәbreind
feathercut => 'feðәkʌt
feathered => 'feðәd
featheriness => 'feðәrinis
feathering => 'feðәriŋ
featherless => 'feðәlis
featherweight => 'feðәweit
feathery => 'feðәri
feats => 'fi:ts
feature => 'fi:tʃә
feature film => ˈfi:tʃə film
feature-length => 'fi:tʃә'leŋp
featured => 'fi:tʃәd
featureless => 'fi:tʃәlis
featuring => ˈfi:tʃərɪŋ
febrifugal => fi'brifju^әl, febri'fju:^әl
febrifuge => 'febrifju:dʒ
febrile => 'fi:brail
February => 'februәri
fecal => 'fi:kәl
feces => 'fi:'si:z
feck => fek
feckless => 'feklis
fecklessness => 'feklisnis
feculence => 'fekjulәns
feculent => 'fekjulәnt
fecund => 'fi:kәnd
fecundate => 'fi:kәndeit
fecundation => .fi:kәn'deiʃәn
fecundity => fi'kʌnditi
fed => fed
fed up => fed ʌp
fedayeen => fe'deɪi:n
federal => 'fedәrәl
federalism => 'fedәrәliz(ә)m
federalization => .fedәrәlai'zeiʃәn
federalize => 'fedәrәlaiz
federally => 'fedәrәli
federate => 'fedәrit
Federated => 'fɛdə,retɪd
federates => ˈfedərits
federating => ˈfedəritɪŋ
federation => fedә'reiʃәn
federations => ˌfedəˈreiʃənz
federative => 'fedәrәtiv
fedora => fi'dɒ:rә
fee => fi:
fee-paying => 'fi:p'eɪɪŋ
feeb => fi:b
feeble => fi:bl
feebleness => 'fi:blnis
feebler => ˈfi:blə(r)
feeblest => ˈfi:blɪst
feebly => 'fi:bli
feed => fi:d
feed back => fi:d bæk
feedback => 'fi:dbæk
feedbag => 'fi:dbæ^
feeder => 'fi:dә
feeders => ˈfi:dəz
feedforward => ,fi:d'fɔ:wәd
feeding => 'fi:diŋ
feeding bottle => ˈfi:diŋ ˈbɔtl
feedlot => 'fi:dlɒt
feedstock => 'fi:dstɔk
feedstocks => 'fiːdstɒk
feedstuff => 'fi:dstʌf
feel => fi:l
feel-good => fi:l ɡud
feeler => 'fi:lә
feelers => ˈfi:ləz
feeling => 'fi:liŋ
feelingless => ˊfiːliŋlis
feet => fi:t
feet first => fi:t fə:st
feh => fei
feign => fein
feigned => feind
feigning => feɪnɪŋ
feigns => feɪnz
feijoa => fei'dʒәjә
feint => feint
feinted => feɪntid
feinting => 'feɪntɪŋ
feints => feɪnts
feis => feʃ
feisty => 'faisti
felafel => fә'lɑ:fәl
feldspar => 'feldspɑ:
feldspathic => feld'spæθik
feldspathoid => feld'spæθɔid
felice => fә'li:s
felicific => .fi:li'sifik
felicitate => fә'lisiteit
felicitated => fɪˈlɪsɪˌteɪtid
felicitates => fɪˈlɪsɪˌteɪts
felicitating => fɪˈlɪsɪˌteɪtɪŋ
felicitation => fәlisi'teiʃ(ә)n
felicitations => fə,lisi'teiʃən
felicities => fɪˈlɪsɪti:z
felicitous => fә'lisitәs
felicitously => fə'lɪsɪtəslɪ
felicitousness => fə'lɪsɪtəsnəs
felicity => fә'lisiti
felid => 'fi:lid
feline => 'fi:lain
felines => ˈfi:ˌlaɪnz
felinity => fi'liniti
felix => 'fi:liks
fell => fel
fella => felә
fellah => 'felә
fellas => ˈfeləz
fellate => 'feleit,fә'leit
fellatio => fi'leiʃiәu
fellator => 'feleɪtə
felled => feld
feller => 'felә
felling => 'feliŋ
felloe => 'felәu
fellow => 'felәu
fellow traveller => ˈfeləu ˈtræv(ə)lə
fellowship => 'felәuʃip
fellowships => 'feləʊʃɪps
felon => 'felәn
felonies => ˈfeləni:z
felonious => fә'lәunjәs
feloniously => fiˊlounjәsli
felons => ˈfelənz
felony => 'felәni
felsic => 'felsik
felspar => 'felspɑ:
felt => felt
felt-tip => 'feltt'ɪp
felted => 'feltid
Felton => 'feltәn
felucca => fe'lʌkә
fem => fem
female => 'fi:meil
femaleness => 'fi:meɪlnes
females => 'fi:meɪlz
feminal => 'feminәl
feminality => ,femi'næliti
feminazi => 'feminəzi
femineity => .femi'ni:iti
feminine => 'feminin
femininely => 'femənɪni:lɪ
femininity => .femi'niniti
feminism => 'feminizm
feminist => 'feminist
feminists => ˈfeminists
feminity => fi'miniti
feminize => 'feminaiz
feminized => ˈfeminaizd
feminizes => ˈfeminaiziz
feminizing => ˈfeminaizɪŋ
femme => fem
femme fatale => fæm fæ'tɑ:l
femmes => femz
femoral => 'femәrәl
femoris => fe'məʊrɪz
femto- => 'femtәj
femtosecond => fem'təʊsi:kənd
femur => 'fi:mә
femurs => ˈfi:məz
fen => fen
fence => fens
fenced => fenst
fenceless => 'fenslis
fencer => 'fensә
fencerow => fens'rəʊ
fences => fensiz
fencible => 'fensәbl
fencing => 'fensiŋ
fend => fend
fended => fendid
fender => 'fendә
fender bender => ˈfendə ˈbendə
fenders => ˈfendəz
fending => fendɪŋ
fends => fendz
fenestella => .feni'stelә
fenestra => fi'nestrә
fenestrate => fi'nestreit
fenestrated => fi'nestreitid
fenestration => ,fenis'treiʃәn
feng shui => ˌfeŋ ˈʃu:i
Fenian => 'fi:njәn
Fenianism => 'fi:niәnizәm
fenland => 'fenlænd
fennec => 'fenek
fennel => 'fenәl
Fennoscandia => 'fenәu'skændiә
fenny => 'feni
fens => fenz
fentanyl => fen'tænil,'fentәnil
fenugreek => 'fenjugri:k
fenwick => 'fenik, 'fenwik
feoffee => fe'fi:
feoffment => 'fefmәnt
feoffor => 'fefә(r),'fi:-
feral => 'fiәrәl
ferberite => 'fә:bәrait
Ferdinand => 'fә:dinәnd
Fergus => 'fә:^әs
Ferguson => 'fə:ɡəsən
feria => 'fiәriә
ferial => 'fiәriәl
Fermanagh => fә'mænә
fermata => fә'mɑ:tә
ferment => 'fә:ment
fermentable => fә'mentәbl
fermentation => ,fә:men'teiʃәn
fermentative => fә:'mentәtiv
fermented => fəˈmentid
fermenter => fә:'mentә
fermenting => fəˈmentɪŋ
ferments => fəˈments
fermi => 'feәmi
fermion => 'fә:miɔn
fermions => 'fɜːmɪɒn
fermium => 'fєәmiәm
fern => fә:n
fernery => 'fә:nәri
ferny => 'fә:ni
ferocious => fә'rәuʃәs
ferociously => fə'rəʊʃəslɪ
ferociousness => fәˊrouʃәsnis
ferocity => fә'rɒsiti
ferox => 'ferɔks
Ferrara => fə'rɑ:rə
ferrate => 'fereit
ferrel => 'ferәl
ferret => 'ferit
ferreted => ˈferɪtid
ferreting => 'ferɪtɪŋ
ferrets => ˈferɪts
ferrety => 'ferәti
ferri- => 'feri,'ferai
ferriage => 'feriidʒ
ferric => 'ferik
ferricyanide => ,feri'saiәnaid
ferried => ˈferid
ferries => ˈferiz
ferrimagnetic => ,ferimæ^'netik
ferrimagnetism => ,feri'mæ^nitizәm
Ferris => 'feris
Ferris wheel => 'feris
ferrite => 'ferait
ferritic => fә'ritik
ferritin => 'feritәn
ferrocene => 'ferә,si:n
ferroconcrete => .ferәu'kɒnkri:t
ferrocyanide => ,ferәu'saiәnaid, -nid
ferroelectric => ,ferәui'lektrik
ferroelectricity => ,ferәi,lek'trisiti
ferrofluid => ,ferәu'flu:id
ferromagnesian => ,ferәumæ^'ni:ʃәn
ferromagnetic => .ferәumæg'netik
ferromagnetism => .ferәu'mægnәtizm
ferrous => 'ferәs
ferruginous => fe'ru:dʒinәs
ferrule => 'ferәl
ferrules => ˈferu:lz
ferry => 'feri
ferryboat => 'feribәjt
ferryboats => ˈferibəuts
ferrying => ˈferiŋ
ferryman => 'ferimәn
fertile => 'fә:tail
fertilised => 'fə:tilaiz
fertiliser => 'fә:tilaizә
fertilisers => 'fɜːtɪlaɪsə
fertility => fә'tiliti
fertilization => .fә:tilai'zeiʃәn
fertilize => 'fә:tilaiz
fertilizer => 'fә:tilaizә
fertilizers => 'fɜ:təlaɪzəz
fertilizes => ˈfɜ:tlˌaɪziz
fertilizing => 'fɜ:tɪlaɪzɪŋ
ferula => 'ferjulә
ferule => 'feru:l
fervency => 'fә:vәnsi
fervent => 'fә:vәnt
fervently => 'fɜ:vəntlɪ
fervid => 'fә:vid
fervidly => 'fɜ:vɪdlɪ
fervor => 'fә:vә
fervour => 'fә:vә
fescue => 'feskju:
fess => fes
festa => 'festә
festal => 'festәl
festally => 'festælaɪ
fester => 'festә
festered => ˈfestəd
festering => ˈfestərɪŋ
festers => ˈfestəz
festival => 'festәvәl
festivals => ˈfestəvəlz
festive => 'festiv
festivities => feˈstɪvɪti:z
festivity => fes'tiviti
festoon => fes'tu:n
festooned => fesˈtu:nd
festooning => fesˈtu:nɪŋ
festoons => fesˈtu:nz
festschrift => 'fest-ʃrift
feta => fetә
fetal => 'fi:tәl
fetal alcohol syndrome => ˈfi:tl ˈælkəˌhɔl ˈsindrəum
fetch => fetʃ
fetched => fetʃt
fetches => fetʃiz
fetching => 'fetʃiŋ
fete => feit
feted => feɪtid
fetes => feɪts
fetich => 'fi:tiʃ, 'fet-
feticide => 'fi:tisaid
fetid => 'fetid
feting => feɪtɪŋ
fetish => 'fi:tiʃ
fetishes => ˈfetɪʃiz
fetishism => 'fi:tiʃizm
fetishist => 'fi:tiʃist
fetishistic => .fi:ti'ʃistik
fetishize => ˈfetɪʃaɪz
fetishized => ˈfetɪˌʃaɪzd
fetishizes => ˈfetɪˌʃaɪziz
fetishizing => ˈfetɪˌʃaɪzɪŋ
fetlock => 'fetlɒk
fetor => 'fi:tә
fetta => 'fetә
fetter => 'fetә
fettering => ˈfetərɪŋ
fetterlock => 'fetәlɔk
Fettes => 'fetis
fettle => 'fetl
fettled => 'fet(ə)l
fettles => 'fet(ə)l
fettling => 'fetliŋ
fettuccine => ˌfetʊ'tʃi:nɪ
fetus => 'fi:tәs
feu => fju:
feud => fju:d
feudal => 'fju:dәl
feudalism => 'fju:dәlizәm
feudalist => 'fju:dәlist
feudalistic => .fju:dә'listik
feudality => fju:'dæliti
feudalization => .fju:dәlai'zeiʃәn
feudalize => 'fju:dәlaiz
feudally => 'fju:dәli
feudatory => 'fju:dәtәri
feudist => 'fu:dist
feuds => fju:dz
Feuerbach => 'fɔiәrba:k
feuilleton => 'fɔiitә:n
fever => 'fi:vә
fever tree => ˈfi:və tri:
fevered => 'fi:vәd
feverfew => 'fi:vәfju:
feverish => 'fi:vәriʃ
feverishly => 'fi:vәriʃli
feverishness => ˊfiːvәriʃnis
feverous => 'fi:vәrәs
fevers => ˈfi:vəz
few => fju:
fewer => 'fju:ә
fey => fei
Feynman => 'fainmәn
fez => fez
fezzed => fez
FI => fai
fiacre => fi:'ɑ:krә
fiance => fi'ɒnsei
fiancee => fi'ɒnsei
fianchetto => ,fi:әn'tʃetәj,-'ketәj
Fianna => 'fi:ænə
fiasco => fi'æskәu
fiascos => fi:ˈæskəʊz
fiat => 'faiæt
fiats => ˈfi:əts
fib => fib
fibbed => fɪbd
fibber => 'fibә
fibbing => fɪbɪŋ
fiber => 'faibә
fiberboard => bɒrd
fiberglass => 'faibә^lɑ:s
Fibonacci => ,fibә'nɑ:tʃi
fibre => 'faibә
fibre-optic => ˈfaibə ˈɔptɪk
fibreboard => 'faibәbɒ:d
fibrefill => 'faibәfil
fibres => 'faɪbəz
fibrescope => 'faibәskәjp
fibril => 'faibril
fibrillar => 'faibrilә(r)
fibrillary => 'faɪbrɪlərɪ
fibrillate => 'faibrileit
fibrillation => ,faibri'leiʃәn
fibrin => 'faibrin
fibrinogen => fai'brinәdʒәn
fibrinoid => 'faibri,nɔid
fibrinolysis => ,faibri'nɔlisis
fibrinolytic => ,faibrinəu'litik
fibrinous => 'faibrinәs
fibroblast => 'faibrәublɑ:st
fibroblasts => faɪbrɒb'lɑ:sts
fibrocystic => ,faibrәj'sistik
fibroid => 'faibrɒid
fibroin => 'faibrɒin
fibrolite => 'faibrәlait
fibroma => fai'brәumә
fibrosarcoma => ,faibrәjsɑ:'kәjmә
fibrosis => fai'brәusis
fibrositis => ,faibrәu'saitis
fibrous => 'faibrәs
fibs => fɪbz
fibula => 'fibjulә
fibular => 'fibjulә
fibulas => ˈfibjuləz
fice => fais
fiche => fi:ʃ
Fichte => 'fiktә
fichu => 'fi:ʃu:
fickle => 'fikl
fickleness => 'fɪklnəs
fictile => 'fiktail
fiction => 'fikʃәn
fictional => 'fikʃәnl
fictionalize => 'fikʃәnәlaiz
fictionalized => ˈfikʃənəlaizd
fictionalizes => ˈfikʃənəlaiziz
fictionalizing => ˈfikʃənəlaizɪŋ
fictionist => 'fikʃәnist
fictitious => fik'tiʃәs
fictitiously => fɪk'tɪʃəslɪ
fictive => 'fiktiv
fid => fid
fiddle => 'fidl
fiddle around => ˈfidl əˈraund
fiddle-faddle => 'fid(ә)lfæd(ә)l
fiddleback => 'fidlbæk
fiddled => ˈfidld
fiddlehead => 'fidlhed
fiddler => 'fidlә
fiddler crab => ˈfɪdlə(r) kræb
fiddlers => ˈfidləz
fiddles => ˈfidlz
fiddlestick => 'fidlstik
fiddlesticks => 'fid(ә)lstiks
fiddling => 'fidliŋ
fiddly => 'fidli
fide => 'fide
Fidei Defensor => 'faidiaidi'fensə:
fideism => 'fi:dei,izm, 'fai-
fidel => fi'del
fidelity => fi'deliti
fidget => 'fidʒit
fidgeted => ˈfɪdʒɪtid
fidgeting => ˈfɪdʒɪtɪŋ
fidgets => ˈfɪdʒɪts
fidgety => 'fidʒiti
fido => faidәu
fiducial => fi'dju:ʃәl
fiduciaries => fiˈdju:ʃəriz
fiduciary => fi'dju:ʃjәri
fidus Achates => 'faidәsә'keiti:z
fie => fai
Fiedler => 'fi:dlә
fief => fi:f
fiefdom => 'fi:fdәm
fiefs => 'fi:fs
field => fi:ld
field bean => fi:ld bi:n
field corn => fi:ld kɔ:n
field cricket => fi:ld ˈkrikit
field glasses => fi:ld ˈglɑ:sɪz
field goal => fi:ld ɡəul
field guide => fi:ld ɡaid
field hand => fi:ld hænd
field mushroom => fi:ld ˈmʌʃrum
field pea => fi:ld pi:
field trip => fi:ld trip
fieldcraft => ˈfi:ldkrɑ:ft
fielder => 'fi:ldә(r)
fielders => ˈfi:ldəz
fieldfare => 'fi:ldfєә
fielding => 'fi:ldiŋ
fieldmouse => 'fiːld.maʊs
fieldsman => 'fi:ldsmәn
fieldstone => 'fi:ldstәun
fieldwork => 'fi:ldwә:k
fiend => fi:nd
fiendish => 'fi:ndiʃ
fiendishly => 'fi:ndiʃli
fiendishness => ˊfiːndiʃnis
fiends => fi:ndz
fierce => fiәs
fiercely => 'fiәsli
fierceness => fɪəsnəs
fiercer => fiəsə
fieri facias => 'faiәrai'feiʃiæs
fierier => ˈfaiəriə
fierily => 'fairili
fieriness => 'fairinis
fiery => 'faiәri
fiesta => fi'estә
fiestas => fɪ'estə
fif => 'fɪf
FIFA => 'fi:fә
fife => faif
fifer => 'faifә
fifes => faifs
fifteen => 'fif'ti:n
fifteenth => 'fif'ti:nθ
fifth => fifθ
fifth column => fɪfθ ˈkɔləm
fifth columnist => fɪfθ ˈkɔləmnist
fifth wheel => fɪfθ hwi:l
fifthly => 'fifθli
fifths => 'fɪfθs
fifties => 'fɪftɪz
fiftieth => 'fiftiiθ
fifty => 'fifti
fifty-fifty => 'fifti'fifti
fiftyfold => ˊfiftifould
fig => fig
fig wasp => fɪg wɔsp
fight => fait
fightback => 'faitbæk
fighter => 'faitә
fighters => ˈfaɪtəz
fighting => 'faitiŋ
fighting chance => ˈfaɪtɪŋ tʃɑ:ns
fighting fit => ˈfaɪtɪŋ fit
fights => faits
figment => 'figmәnt
figments => 'fɪgm(ə)nt
figural => 'fi^jurәl
figurant => 'fi^jurәnt
figurante => ,fi^ju'rɑ: nt
figuration => .figju'reiʃәn
figurative => 'figjurәtiv
figurativeness => ˊfigjurәtivnis
figure => 'figә
figure of eight => ˈfiɡə ɔv eɪt
figure skating => ˈfiɡə ˈskeɪtɪŋ
figure-ground => 'fɪɡərɡr'aʊnd
figured => 'fi^әd
figured bass => ˈfiɡəd beis
figurehead => 'figәhed
figureheads => ˈfɪgjəˌhedz
figureless => 'fɪɡərləs
figurine => 'figjuri:n
figurines => ˌfɪgjəˈri:nz
figuring => 'fi^әriŋ
figwort => 'figwә:t
Fiji => fi:'dʒi:, 'fi:dʒi:
Fijian => fi:'dʒi:әn
fil => fil
filagree => 'filә^ri:
filament => 'filәmәnt
filamentary => .filә'mentәri
filamentous => .filә'mentәs
filaments => ˈfɪləmənts
filaria => fi'lєәriә
filarial => fi'lєәriәl
filariasis => filә'raiәsis
filature => 'filәtʃә
filbert => 'filbәt
filberts => 'fɪlbət
filch => filtʃ
filched => fɪltʃt
filches => fɪltʃiz
filching => fɪltʃɪŋ
file => fail
file cabinet => fail ˈkæbinit
filefish => 'failfiʃ
filename => fail'neim
filer => 'failә
filers => 'failə
filet => fi'lei, 'fi:lei
filial => 'filiәl
filially => 'fɪlɪəlɪ
filiation => .fili'eiʃәn
filibeg => 'filibe^
filibuster => 'filibʌstә
filibustered => ˈfɪləˌbʌstəd
filibustering => ˈfɪləˌbʌstərɪŋ
filibusters => ˈfɪləˌbʌstəz
filicide => 'filisaid
filiform => 'filifɔ: m
filigree => 'filә^ri:
filigreed => 'fɪlɪɡri:d
filing => 'failiŋ
Filipina => filə'pi:nə
Filipino => .fili'pi:nәu
fill => fil
fill-up => fil ʌp
fille => fi:jә
filled => fild
filler => 'filә
filler cap => ˈfilə kæp
fillet => 'filit
filleter => 'filitә
fillies => 'fɪlɪ
filling => 'filiŋ
fillip => 'filip
filliped => 'fɪlɪp
filliping => 'fɪlɪp
fillis => 'filis
filly => 'fili
film => film
film festival => film ˈfestəvəl
film noir => ˌfɪlm ˈnwɑ:(r)
film-maker => ˈfɪlmˈmeɪkə
filmic => 'filmik
filmily => ˊfilmili
filminess => fɪl'maɪnɪs
filming => 'filmiŋ
filmmaker => 'film,meikә(r)
filmmaking => 'film.meikiŋ
filmography => fil'mɔ^rәfi
filmset => 'filmset
filmstrip => 'filmstrip
filmy => 'filmi
filo => 'failәu
filofax => ˈfaɪləʊfæks
filopodium => ,filә'pәudiәm, ,failә-
filoselle => ,filә'sel
filovirus => fi:ləʊ'vaɪrəs
fils => fi:ls. fi（:）ls
filter => 'filtә
filter-feeder => 'fɪltərf'i:dər
filterable => 'filtәrәbl
filtering => 'filtәriŋ
filth => filθ
filthily => 'filθili
filthiness => 'filθinis
filthy => 'filθi
filtrable => 'filtrәbl
filtrate => 'filtreit
filtrated => ˈfiltreitid
filtrates => ˈfiltreits
filtrating => ˈfiltreitɪŋ
filtration => fil'treiʃәn
FIMBRA => 'fimbrə
fimbria => 'fimbriә
fin => fin
fin keel => fin ki:l
fin whale => fin hweil
finagle => fi'neigl
finagled => fəˈneɪgəld
finagles => fəˈneɪgəlz
finagling => fəˈneɪgəlɪŋ
final => 'fainl
final solution => ˈfainəl səˈlu:ʃən
finale => fi'nɑ:li
finalist => 'fainәlist
finalists => 'faɪn(ə)lɪst
finality => fai'næliti
finalize => 'fainәlaiz
finally => 'fainәli
finance => fai'næns
financial => fai'nænʃәl
financial year => faɪˈnænʃ(ə)l jə:
financier => fai'nænsiә
financing => fai'nænsiŋ
finback => 'finbæk
finca => 'fiŋkɑ:
finch => fintʃ
finches => fɪn(t)ʃ
Finchley => 'fintʃli
find => faind
find-spot => 'faindspɔt
findable => 'faɪndeɪbl
finder => 'faindә
finders => ˈfaindəz
finderscope => 'faɪndəskəʊp
finding => 'faindiŋ
finds => faindz
fine => fain
fine art => fain ɑ:t
fine champagne => 'fi:nəʃɔŋ'pɑ:njә
fine print => fain print
fine-grained => 'fain'^reind
fine-tooth comb => fain tu:θ kəum
fine-tuned => tju:nd
fineable => 'fainәbl
finely => 'fainli
fineness => 'fainnis
finer => 'fainә
finery => 'fainәri
fines => fainz
fines herbes => fi:nˈzerb, fi:nˈerb
finesse => fi'nes
finest => fi'nest
finfish => 'finfiʃ
fing => 'fɪŋ
finger => 'fiŋgә
finger alphabet => ˈfiŋɡə ˈælfəbit
finger bowl => ˈfiŋɡə bəul
finger food => ˈfiŋɡə fu:d
finger wave => ˈfiŋɡə weiv
finger-paint => 'fɪŋɡərp'eɪnt
fingerboard => 'fiŋ^әbɔ:d
fingered => 'fiŋ^әd
fingerfish => 'fiŋ^әfiʃ
fingering => 'fiŋgәriŋ
fingerling => 'fiŋgәliŋ
fingermark => ˈfɪŋgəmɑ:k
fingernail => 'fiŋgәneil
fingernails => 'fɪŋgəneɪls
fingerplate => 'fiŋgәpleit
fingerpost => 'fiŋ^әpәjst
fingerprint => 'fiŋgәprint
fingerprinted => ˈfɪŋgəˌprɪntid
fingerprints => ˈfɪŋgəˌprɪnts
fingerstall => 'fiŋgәstɒ:l
fingertip => 'fiŋgәtip
fingertips => 'fɪŋɡətɪps
finial => 'fainiәl
finical => 'finikәl
finically => ˊfinikәli
finicalness => fini'kæliti
finicking => 'finikiŋ
finicky => 'finiki
fining => 'fainiŋ
finis => 'fainis
finish => 'finiʃ
finished => 'finiʃt
finisher => 'finiʃә
finishers => 'finiʃə
finishes => ˈfiniʃiz
finishing => 'finiʃiŋ
finishing line => ˈfiniʃiŋ lain
finishing school => ˈfiniʃiŋ sku:l
finishing touch => ˈfiniʃiŋ tʌtʃ
finite => 'fainait
finitism => 'fainaitizəm
finitist => 'fainaitist
finitude => 'fainitju:d
fink => fiŋk
fink out => fiŋk aut
finks => 'fɪŋks
Finland => 'finlәnd
Finlandization => ,finlәndi'zeiʃәn
Finlandize => 'finlәndaiz
finless => 'fɪnləs
Finn => fin
finned => find
finnesko => fi'neskәj
Finnic => 'finik
finning => 'finiŋ
Finnish => 'finiʃ
finns => finz
finny => 'fini
fino => 'fi:nәu
finocchio => fi'nәukiәu
Finsbury => 'fɪnzbərɪ
fiord => fjɔ:d
fioritura => ,fjɔri:'tu:rɑ:
fipple => 'fip(ә)l
fipple flute => ˈfip(ə)l flu:t
fir => fә:
fir tree => fɜ: tri:
fire => 'faiә
fire and brimstone => ˈfaiə ænd ˈbrimstəun
fire ant => ˈfaiə ænt
fire chief => ˈfaiə tʃi:f
fire fighting => ˈfaiə ˈfaɪtɪŋ
fire hose => ˈfaiə həuz
fire irons => ˈfaiə ˈaiəns
fire sale => ˈfaiə seil
fire service => ˈfaiə ˈsɜːvɪs
fire trap => ˈfaiə træp
fire truck => ˈfaiə trʌk
fire warden => ˈfaiə ˈwɔ:dn
firearm => 'faiә'ɑ:m
fireback => 'faiәbæk
fireball => 'faiәbɒ:l
fireballer => 'faiә,bɔ:lә(r)
fireballing => 'faiә,bɔ:liŋ
fireballs => ˈfaiəbɔ:lz
firebase => 'faiәbeis
firebird => 'faiәbә:d
fireboat => 'faiәbәut
firebomb => 'faiәbɔm
firebombed => ˈfaiəbɔmd
firebombing => ˈfaiəbɔmɪŋ
firebombs => ˈfaiəbɔmz
firebox => 'faiәbɒks
firebrand => 'faiәbrænd
firebrands => ˈfaiəbrændz
firebrat => 'faiәbræt
firebreak => 'faiәbreik
firebrick => 'faiәbrik
firebug => 'faiәbʌg
fireclay => 'faiәklei
firecracker => 'faiәkrækә
firecrackers => 'faɪəkrækərz
firecrest => 'faiәkrest
firedamp => 'faiәdæmp
firedog => 'faiәdɔ^
firedrake => 'faiәdreik
firefight => 'faiәfait
firefighter => ˈfaɪəfaɪtə(r)
firefighters => 'faɪəˌfaɪtəz
firefighting => 'faɪəfaɪtɪŋ
fireflies => ˈfaɪəˌflaɪz
firefly => 'faiәflai
fireguard => 'faiә^ɑ:d
firehouse => 'faiәhaus
fireless => 'faiәlis
firelight => 'faiәlait
firelighter => ˈfaɪəlaɪtə(r)
firelock => 'faiәlɒk
fireman => 'faiәmәn
firemen => 'faiәmәn
Firenze => fi'rendze
fireplace => 'faiәpleis
fireplaces => ˈfaiəpleisiz
fireplug => 'faiәplʌg
firepower => 'faiәpauә
fireproof => 'faiәpru:f
fireproofed => ˈfaɪəˌpru:ft
fireproofing => 'faiәpru:fiŋ
fireproofs => ˈfaɪəˌpru:fs
firer => 'fairә
fireside => 'faiәsaid
firesides => ˈfaɪəˌsaɪdz
firestone => 'faiәstәun
firestorm => 'faiәstɔ:m
firethorn => 'faiәθɔ:n
firetrap => 'faiәtræp
firetruck => faɪərt'rʌk
firewatcher => 'faiәwɔtʃә(r)
firewater => 'faiәwɒ:tә
fireweed => 'faiәwi:d
firewood => 'faiәwud
fireworks => 'faiәwә:ks
firing => 'faiәriŋ
firing line => ˈfaiəriŋ lain
firing squad => ˈfaiəriŋ skwɔd
firkin => 'fә:kin
firm => fә:m
firmament => 'fә:mәmәnt
firmamental => .fә:mә'mentәl
firman => 'fә:mәn
firmer => 'fә:mә
firmly => 'fә:mli
firmness => 'fә:mnis
firmware => 'fә:m,weә
firn => fә:n
firry => 'fә:ri
first => fә:st
first base => fə:st beis
first down => fə:st daun
first edition => fə:st iˈdiʃən
first floor => fə:st flɔ:
first gear => fə:st ɡiə
first lieutenant => fə:st lefˈtenənt
first light => fə:st lait
first night => fə:st nait
first off => fə:st ɔf
first officer => fə:st ˈɔfisə
first refusal => fə:st riˈfju:zəl
first school => fə:st sku:l
first sergeant => fə:st ˈsɑ:dʒənt
first strike => fə:st straik
first thing => fə:st θiŋ
first up => fə:st ʌp
first-day cover => fə:st dei ˈkʌvə
first-ever => fə:st ˈevə
first-foot => fə:st fut
first-footer => 'fə:st'futə
first-nighter => 'fɜ:stn'aɪtər
first-order => 'fɜ:st'ɔ:dər
firstborn => 'fә:st'bɒ:n
firsthand => 'fә:st'hænd
firstling => 'fә:stliŋ
firstly => 'fә:stli
firsts => fә:sts
firth => fә:θ
fisc => fisk
fiscal => 'fiskәl
fiscal year => ˈfiskəl jə:
Fischer => 'fiʃə
fish => fiʃ
fish and chips => fiʃ ænd tʃips
fish cake => fiʃ keik
fish finger => fiʃ ˈfiŋɡə
fish hawk => fiʃ hɔ:k
fish knife => fiʃ naif
fish ladder => fiʃ ˈlædə
fish louse => fiʃ laʊs
fish stick => fiʃ stik
fish-hook => 'fɪʃh'ʊk
fishable => 'fiʃәbl
fishbone => 'fiʃbәun
fishbowl => 'fiʃbәul
fished => fiʃt
fisher => 'fiʃә
fisherfolk => fɪʃə'fəʊk
fisheries => ˈfɪʃəri:z
fisherman => 'fiʃәmәn
fisherwoman => ˈfɪʃəwʊmən
fishery => 'fiʃәri
fishes => 'fiʃiz
fisheye => 'fiʃai
fishhook => 'fiʃhuk
fishily => 'fiʃili
fishiness => 'fiʃinis
fishing => 'fiʃiŋ
fishing pole => ˈfɪʃɪŋ pəul
fishlike => 'fiʃlaik
fishmeal => 'fɪʃmi:l
fishmonger => 'fiʃ.mʌŋgә
fishmongers => ˈfɪʃˌmʌŋgəz
fishplate => 'fiʃpleit
fishpond => 'fiʃpɒnd
fishtail => 'fiʃteil
fishtailed => ˈfɪʃˌteɪld
fishtailing => ˈfɪʃˌteɪlɪŋ
fishtails => ˈfɪʃˌteɪlz
fishway => 'fiʃwei
fishwife => 'fiʃwaif
fishy => 'fiʃi
fisk => fisk
fissile => 'fisail
fissility => fi'siliti
fission => 'fiʃәn
fissionable => 'fiʃәnәbl
fissiparity => fi'sipәriti
fissiparous => fi'sipәrәs
fissure => 'fiʃә
fissures => 'fɪʃəz
fissuring => 'fiʃәriŋ
fist => fist
fisted => 'fistid
fistfight => 'fistfait
fistful => 'fistfjl
fistfuls => ˈfistfulz
fisticuff => 'fistikʌf
fistula => 'fistjulә
fistular => 'fistjulә
fistulous => 'fistjulәs
fit => fit
fit in => fit in
fit the bill => fit ðə bil
fitch => fitʃ
fitched => fɪtʃ
fitchew => 'fɪtʃu:
fitful => 'fitful
fitly => 'fitli
fitment => 'fitmәnt
fitness => 'fitnis
fitted => 'fitid
fitter => 'fitә
fittest => fitist
fitting => 'fitiŋ
fitting room => ˈfitiŋ ru:m
fittingly => 'fɪtɪŋlɪ
fitzgerald => fits'dʒerәld
fitzroy => fits'rɔi
Fiume => 'fju:mei
five => faiv
five-and-dime => 'faivәn'daim
five-spot => 'faivspɔt
fivefold => 'faivfәuld
fivepence => 'faifpәns
fiver => 'faivә(r)
fivers => ˈfaivəz
fives => faivz
fix => fiks
fixable => 'fiksәbl
fixate => 'fikseit
fixated => fɪkˈseɪtɪd
fixates => ˈfikseits
fixating => ˈfikseitɪŋ
fixation => fik'seiʃәn
fixations => fɪkˈseɪʃənz
fixative => 'fiksәtiv
fixatives => 'fɪksətɪvz
fixed => fikst
fixed star => fɪkst stɑ:
fixedly => 'fiksidli
fixedness => 'fiksidnis
fixer => 'fiksә
fixer-upper => ˈfɪksəˈʌpə
fixing => 'fiksiŋ
fixity => 'fiksәti
fixture => 'fikstʃә
fiz => fiz
fizgig => 'fiz^i^
fizz => fiz
fizzed => fɪzd
fizzes => fɪziz
fizzier => ˈfiziə
fizzing => fɪzɪŋ
fizzle => 'fizl
fizzled => ˈfizld
fizzles => ˈfizlz
fizzling => ˈfizlɪŋ
fizzy => 'fizi
fjord => fjɔ:d
fjords => fjɔ:dz
flab => flæb
flabbergast => 'flæbәgæst
flabbergasting => ˈflæbəˌgæstɪŋ
flabbergasts => ˈflæbəˌgæsts
flabbier => ˈflæbi:ə
flabbily => 'flæbili
flabbiness => 'flæbinis
flabby => 'flæbi
flaccid => 'flæksid
flaccidity => flæk'siditi
flack => flæk
flackery => 'flækәri
flacon => 'flækn
flag => flæg
flag day => flæɡ dei
flag officer => flæɡ ˈɔfisə
flag-waver => 'flæ^,weivә(r)
flagellant => 'flædʒilәnt
flagellate => 'flædʒәleit
flagellated => 'flædʒәleitid
flagellates => f'lædʒəleɪtz
flagellating => ˈflædʒəˌleɪtɪŋ
flagellation => .flædʒә'leiʃәn
flagellator => 'flædʒeleitә
flagellatory => 'flædʒәlәtəri
flagellum => flә'dʒelәm
flageolet => .flædʒә'let
flagfish => 'flæ^fiʃ
flagged => flæɡd
flagger => 'flæ^ә
flagging => 'flægiŋ
flagitious => flә'dʒiʃәs
flagman => 'flægmәn
flagon => 'flægәn
flagons => ˈflæɡənz
flagpole => 'flægpәul
flagpoles => f'læɡpəʊlz
flagrancy => 'fleigrәnsi
flagrant => 'fleigrәnt
flagrantly => 'fleɪɡrəntlɪ
flagship => 'flægʃip
flagships => ˈflæɡˌʃips
flagstaff => 'flægstæf
flagstaffs => 'flæɡstæf
flagstick => 'flæ^stik
flagstone => 'flægstәun
flagstones => ˈflægˌstəʊnz
flail => fleil
flailed => fleɪld
flailing => fleɪlɪŋ
flails => fleɪlz
flair => fleә
flak => flæk
flak jacket => flæk ˈdʒækit
flake => fleik
flaked => fleikt
flakily => ˊfleikili
flakiness => 'fleɪkɪnəs
flaking => 'fleikiŋ
flaky => 'fleiki
flam => flæm
flambeau => 'flæmbәu
flambeaus => 'flæmbəʊ
flamboyance => flæm'bɒiәns
flamboyancy => flæmˊbɒiәnsi
flamboyant => flæm'bɒiәnt
flame => fleim
flame-thrower => ˈfleɪmˌθrəʊə
flamed => fleimd
flamen => 'fleimen
flamenco => flә'meŋkәu
flameout => 'fleimaut
flameproof => 'fleimpru:f
flamer => 'fleimә
flaming => 'fleimiŋ
flamingo => flә'miŋgәu
flamingos => fləˈmɪŋgəʊz
flammability => .flæmә'biliti
flammable => 'flæmәbl
flamy => 'fleimi
flan => flæn, flɑ:n
Flanagan => 'flænә^әn
flanders => 'flɑ:ndәz
flange => flændʒ
flanged => flændʒd
flanger => 'flændʒә
flanges => flændʒz
flanging => 'flændʒiŋ
flank => flæŋk
flanker => 'flæŋkә
flannel => 'flænl
flannelboard => 'flænəlbɔ:d
flannelette => flænә'let
flannelled => flænl'led
flannelmouth => 'flænəl'majθ
flans => flænz
flap => flæp
flapdoodle => 'flæpdu:dl
flapjack => 'flæpdʒæk
flapjacks => ˈflæpdʒæks
flapped => flæpt
flapper => 'flæpә
flappy => 'flæpi
flaps => flæps
flare => 'flєә
flare path => flɛə pɑ:θ
flare star => flɛə stɑ:
flares => flεәs
flaring => 'flєәriŋ
flash => flæʃ
flash bulb => flæʃ bʌlb
flash drive => flæʃ draiv
flash flood => flæʃ flʌd
flash in the pan => flæʃ in ðə pæn
flashback => 'flæʃbæk
flashbacks => ˈflæʃbæks
flashboard => 'flæʃbɒ:d
flashbulb => 'flæʃbʌlb
flashbulbs => ˈflæʃˌbʌlbz
flashcard => 'flæʃ.kɑ:d
flashcards => 'flæʃ,kɑːd
flashcube => 'flæʃkju:b
flashed => flæʃt
flasher => 'flæʃә
flashgun => ˈflæʃgʌn
flashier => ˈflæʃiə
flashiness => 'flæʃɪnɪs
flashing => 'flæʃiŋ
flashlight => 'flæʃlait
flashlights => ˈflæʃˌlaɪts
flashover => 'flæʃ,әuvә
flashpoint => ˈflæʃpɔɪnt
flashpoints => 'flæʃpɔɪnt
flashy => 'flæʃi
flask => flæsk
flasks => flɑ:sks
flat => flæt
flat racing => flæt ˈreisiŋ
flat spin => flæt spin
flat-chested => flæt ˈtʃestɪd
flat-footed => 'flætfutid
flat-iron => f'læt'aɪən
flat-top => flæt tɔp
flatbed => 'flæt.bed
flatboat => 'flætbәut
flatbread => flætb'red
flatcar => 'flætkɑ:
flatfish => 'flætfiʃ
flatfoot => 'flætfut
flathead => 'flæthed
flatiron => 'flæt.aiәn
flatland => f'lætlænd
flatlander => 'flæt,lændə
flatlet => 'flætlit
flatlets => 'flætlɪt
flatline => 'flætlain
flatliner => 'flætlainə
flatly => 'flætli
flatmate => ˈflætmeɪt
flatness => 'flætnis
flats => flæts
flatscreen => flætsk'ri:n
flatten => 'flætn
flattened => 'flætnd
flattener => 'flætnә
flattening => 'flætniŋ
flattens => ˈflætnz
flatter => 'flætә
flatterer => 'flætәrә
flatterers => ˈflætərəz
flatteries => ˈflætəri:z
flattering => 'flætәriŋ
flatteringly => 'flætəriŋli
flattery => 'flætәri
flattie => 'flæti
flatting => f'lættɪŋ
flattish => 'flætiʃ
flatulency => ˊflætjulәnsi
flatulent => 'flætʃәlәnt
flatus => 'fleitәs
flatware => 'flætwєә
flatworm => 'flætwә:m
Flaubert => flәu'ber
flaunching => 'flɔ:ntʃiŋ
flaunt => flaunt
flaunted => flɔ:ntid
flaunts => flɔ:nts
flaunty => 'flɔ:nti
flautist => 'flɒ:tist
flavescent => flә'vesәnt
flavin => 'fleivin
flavone => 'fleivәun
flavonoid => 'fleivәnɔid
flavoprotein => ,fleivәu'prәuti:n
flavor => 'fleivә
flavored => ˈfleɪvəd
flavorful => 'fleivәfjl
flavoring => 'fleivәriŋ
flavorless => 'fleɪvəlɪs
flavorous => 'fleivәrәs
flavors => ˈfleɪvəz
flavour => 'fleivә
flavourful => 'fleivәfjl
flavouring => 'fleivәriŋ
flavours => ˈfleivəz
flavoursome => ˈfleɪvəsəm
flaw => flɒ:
flawing => f'lɔ:ɪŋ
flawless => 'flɒ:lis
flawlessly => 'flɔ:lisli
flaws => flɔ:z
flax => flæks
flaxen => 'flæksn
Flaxman => 'flæksmәn
flaxseed => 'flækssi:d
flay => flei
flayed => fleɪd
flaying => f'leɪɪŋ
flays => fleɪz
flea => fli:
flea beetle => fli: ˈbi:tl
flea bite => fli: bait
flea-bitten => 'fli:bitn
fleabag => 'fli:bæg
fleabane => 'fli:bein
fleabite => 'fli:bait
fleapit => 'fli:pit
fleas => fli:z
fleck => flek
flecked => 'flekt
flecking => flek
flecks => fleks
fled => fled
fledge => fledʒ
fledged => fledʒd
fledgeling => 'fledʒliŋ
fledges => fledʒz
fledging => 'fledʒɪŋ
fledgling => 'fledʒliŋ
fledglings => ˈfledʒlɪŋz
flee => fli:
fleece => fli:s
fleeces => fli:siz
fleeciness => 'fli:sinis
fleecing => fli:sɪŋ
fleecy => 'fli:si
fleeing => fli:ɪŋ
fleer => fliә
fleered => fliəd
fleering => fliərɪŋ
fleers => fliəz
flees => fli:z
fleet => fli:t
fleet admiral => fli:t ˈædmərəl
fleeted => fliːt
fleetingly => 'fli:tɪŋlɪ
fleetly => 'fli:tli
fleetness => 'fli:tnis
fleets => fli:ts
Fleetwood => 'fli:twud
Fleming => 'flemiŋ
flemish => 'flemiʃ
flense => flens
flensed => flenst
flenser => 'flensә
flenses => flensiz
flensing => 'flensiŋ
flesh => 'fleʃ
flesh out => fleʃ aut
fleshed => fleʃt
flesher => 'fleʃә
fleshes => fleʃiz
fleshiness => 'fleʃinis
fleshing => 'fleʃiŋ
fleshings => f'leʃɪŋz
fleshless => 'fleʃlis
fleshly => 'fleʃli
fleshpot => 'fleʃpɒt
fleshpots => 'fleʃpɒts
fleshy => 'fleʃi
fletch => fletʃ
fletched => fletʃt
fletcher => 'fletʃә
fletching => ˈfletʃiŋ
fleur => flә:
fleur-de-lis => ,flә:dә'li:s
fleuron => 'flurɔn
Fleury => 'fluri
flew => flu:
flews => flu:z
flex => 'fleks
flexed => flekst
flexes => fleksiz
flexibility => .fleksi'biliti
flexible => 'fleksәbl
flexibly => 'fleksәbli
flexile => 'fleksail
flexility => ,flek'silәti
flexing => 'fleksiŋ
flexion => 'flekʃәn
flexitime => 'fleksitaim
flexographic => flek'səuɡræfik
flexography => flek'sɔ^rәfi
flexor => 'fleksә
flextime => 'flekstaim
flexuosity => .fleksju'ɒsiti
flexuous => 'fleksjuәs
flexural => 'flekʃәrәl
flexure => 'flekʃә
flibbertigibbet => .flibәti'dʒibit
flibbertigibbets => ,flɪbətɪ'dʒɪbɪt
flic => fli:k
flick => flik
flick knife => flik naif
flicked => flikt
flicker => 'flikә
flickered => ˈflikəd
flickering => 'flikәriŋ
flicks => fliks
flier => 'flaiә
fliers => ˈflaɪəz
flight => flait
flight attendant => flait əˈtendənt
flight bag => flait bæɡ
flight crew => flait kru:
flight deck => flait dek
flight engineer => flait ˌendʒiˈniə
flight feather => flait ˈfeðə
flight lieutenant => flait lefˈtenənt
flight plan => flait plæn
flight recorder => flait riˈkɔ:də
flight sergeant => flait ˈsɑ:dʒənt
flightier => ˈflaɪti:ə
flightily => 'flaitili
flightiness => 'flaitinis
flighting => flaitɪŋ
flightless => 'flaitlis
flightline => f'laɪtlaɪn
flights => flaits
flighty => 'flaiti
flimflam => 'flimflæm
flimsier => ˈflɪmzi:ə
flimsily => 'flimzili
flimsiness => 'flimzinis
flimsy => 'flimzi
flinch => flintʃ
flinched => flɪntʃt
flinches => flɪntʃiz
flinching => flɪntʃɪŋ
flinders => 'flindәz
fling => fliŋ
flinger => f'lɪnɡər
flinging => fliŋɪŋ
flings => fliŋz
flint => flint
flint corn => flɪnt kɔ:n
flintily => 'flintili
flintiness => 'flintinis
flintlock => 'flintlɒk
flintlocks => ˈflintlɔks
flints => flɪnts
Flintshire => 'flint-ʃә(r)
flintstone => 'flintstәjn
flintstones => 'flintstəun
flinty => 'flinti
flip => flip
flip chart => flip tʃɑ:t
flip side => flip said
flip-flop => 'flipflɔp
flip-top => f'lɪpt'ɒp
flippancy => 'flipәnsi
flippant => 'flipәnt
flippantly => 'flɪpəntlɪ
flipped => flipt
flipper => 'flipә
flippers => f'lɪpəz
flipping => 'flipiŋ
flippy => f'lɪpɪ
flips => flips
flirt => flә:t
flirtation => flә:'teiʃәn
flirtatious => flә:'teiʃәs
flirtatiously => flə:'teiʃəsli
flirtatiousness => flə:'teiʃəs
flirted => flə:tid
flirting => flə:tɪŋ
flirts => flə:ts
flirty => 'flә:ti
flit => flit
flitch => flitʃ
flitches => flɪtʃ
flits => flits
flitted => flitid
flitter => 'flitә
flittered => ˈflitəd
flittering => ˈflitərɪŋ
flitters => ˈflitəz
flivver => 'flivә
flo => flәj
float => flәut
floatable => 'flәutәbl
floatation => fl әu'teiʃәn
floater => 'flәutә
floaters => f'ləʊtəz
floating => 'flәutiŋ
floating voter => ˈfləʊtɪŋ ˈvəʊtə
floating-point => 'flәjtiŋ'pɔint
floatplane => 'flәutplein
floaty => ˈfləʊti
floc => flɔk
floccinaucinihilipilification => ,flɔksi,nɔ:si,naihili,pailifi'keiʃәn
floccose => 'flɒkәus
flocculant => 'flɔkjulənt
flocculate => 'flɔkjuleit
flocculated => ˈflɔkjuleitid
flocculates => ˈflɔkjuleits
flocculating => f'lɒkjʊleɪtɪŋ
flocculation => flɔkju'leiʃən
floccule => 'flɔkju:l
flocculence => 'flɒkjulәns
flocculent => 'flɒkjulәnt
flocculus => 'flɒkjulәs
floccus => 'flɔkәs
flock => flɒk
flocked => flɔkt
flocking => 'flɒkiŋ
flockmaster => 'flɔk,mɑ:stә(r)
flocky => 'flɒki
Flodden => 'flɔdn
floe => flәu
flog => flɒg
flogged => flo:gɪd
flogging => 'flɒgiŋ
flogs => flɔgz
flokati => 'flɔkәti
flood => flʌd
flood plain => flʌd plein
floodgate => 'flʌdgeit
floodgates => f'lʌdɡeɪts
flooding => 'flʌdiŋ
floodlight => 'flʌdlait
floodlighting => 'flʌdlaɪtɪŋ
floodlights => ˈflʌdˌlaɪts
floodlit => 'flʌdlit
floodplain => 'flʌdplein
floodplains => 'flʌdplein
floods => flʌdz
floodwall => 'flʌdwɔ:l
floodwater => 'flʌdwɒ:tә
floor => flɒ:
floor exercise => flɔ: ˈeksə
floor plan => flɔ: plæn
floor-length => 'flɔ:leŋθ
floorboard => 'flɔ:bɔ:d
floorboards => f'lɔ:bɔ:dz
floorcloth => 'flɒ:klɒθ
floored => flɔːd
flooring => 'flɒ:riŋ
floors => flɔ:z
floorwalker => 'flɒ:wɒ:kә
floozie => 'flu:zi
floozies => ˈflu:zi:z
floozy => 'flu:zi
flop => flɒp
flophouse => 'flɔphajs
flopped => flɔpt
floppier => ˈflɔpi:ə
floppily => ˊflɒpili
floppiness => ˊflɒpinis
flopping => 'flɔpiŋ
floppy => 'flɒpi
flops => flɔps
flor => flɔ
flora => 'flɒ:rә
floral => 'flɒ:rәl
floreat => 'flɔ:riæt
Florence => 'flɒ:rәns
Florentine => 'flɒ:rәnti:n
flores => 'flɔ:riz
florescence => flɒ:'resәns
florescent => flɒ:'resәnt
floret => 'flɒ:rit
Florey => 'flɔ:ri
floriated => 'flɒ:rieitid
floribunda => ,fl ɔ:ri'bʌndә
florican => 'flɔ:rikәn
floricultural => .flɒ:ri'kʌltʃәrәl
floriculture => 'flɒ:rikʌltʃә
floriculturist => ,flɔ:ri'kʌltʃərist
florid => 'flɒrid
Florida => 'flɒridә
floridity => flɒ'rɪdɪtɪ
floridly => 'flɔridli
floriferous => flɒ:'rifәrәs
florilegium => .flɒ:ri'li:dʒiәm
florin => 'flɒrin
florins => ˈflɔrinz
florist => 'flɒrist
floristic => flɒ'ristik
floristics => flɔ:'ristiks
floristry => 'flɔristri
florists => ˈflɔ:rɪsts
Florrie => 'flɔri
floruit => 'flɒ:ruit
flory => 'flɔ:ri
floss => flɒs
flossed => flɔst
flosses => flɔsiz
flossing => flɔsɪŋ
flossy => 'flɒsi
flotation => flәu'teiʃәn
flotation tank => fləuˈteiʃən tæŋk
flotations => fləuˈteiʃənz
flotel => f'ləʊtel
flotilla => flәu'tilә
flotillas => fləuˈtiləz
flotsam => 'flɒtsәm
flounce => flauns
flounced => flaʊnst
flounces => flaʊnsiz
flouncing => 'flajnsiŋ
flouncy => 'flaunsi
flounder => 'flaundә
floundered => ˈflaʊndəd
floundering => ˈflaʊndərɪŋ
flounders => ˈflaʊndəz
flour => 'flauә
flour beetle => ˈflauə ˈbi:tl
flouring => f'laʊərɪŋ
flourish => 'flʌriʃ
flourished => ˈflʌriʃt
flourishes => ˈflʌriʃiz
flourishing => 'flʌriʃiŋ
flours => ˈflauəz
floury => 'flajәri
flout => flaut
flouted => flaʊtid
flouting => flaʊtɪŋ
flouts => flaʊts
flow => flәu
flow from => fləu frɔm
flowchart => flәu'tʃɑ:t
flowed => fləud
flower => 'flauә
flower bed => ˈflauə bed
flower people => ˈflauə ˈpi:pl
flower power => ˈflauə ˈpauə
flowerbed => 'flajәbed
flowerbeds => ˈflauəbedz
flowered => 'flauәd
flowerer => 'flauәrә
floweret => 'flauәrit
floweriness => 'flauәrinis
flowering => 'flauәriŋ
flowering plant => ˈflaʊərɪŋ plɑ:nt
flowerless => 'flajәlis
flowerpot => 'flauәpɒt
flowerpots => ˈflauəpɔts
flowery => 'flauәri
flowing => flәuiŋ
flowmeter => 'flәumi:tә
flown => flәun
flowsheet => flәu'ʃi:t
flowstone => 'flәjstәjn
Floyd => flɒid
flu => flu:
flu-like => flu: laik
flub => flʌb
flubbed => flʌbd
flubbing => flʌbɪŋ
flubs => flʌbz
fluconazole => flu:'kənəzəʊl
fluctuant => 'flʌktʃuәnt
fluctuate => 'flʌktʃueit
fluctuated => ˈflʌktjueitid
fluctuates => ˈflʌktjueits
fluctuation => .flʌktʃu'eiʃәn
flue => flu:
flue pipe => flu: paip
fluence => fluәns
fluency => 'flu:әnsi
fluent => 'flu:әnt
flues => flu:z
fluey => 'flu:i
fluff => flʌf
fluffed => flʌft
fluffier => ˈflʌfi:ə
fluffs => flʌfs
fluffy => 'flʌfi
flugelhorn => 'flu:^(ә)lhɔ:n
fluid => 'flu:id
fluid drachm => ˈflu:ɪd dræm
fluidic => flu:'idik
fluidics => flu:'idiks
fluidity => flu:'iditi
fluidization => ,flu:idai'zeiʃәn
fluidize => 'flu:idaiz
fluidized => 'flu:idaizd
fluidram => 'flu:idræ m
fluke => flu:k
flukes => f'lu:ks
fluky => 'flu:ki
flume => flu:m
flummery => 'flʌmәri
flummox => 'flʌmәks
flummoxed => ˈflʌməkst
flummoxes => ˈflʌməksiz
flummoxing => ˈflʌməksɪŋ
flump => flʌmp
flumped => flʌmpt
flumping => flʌmpɪŋ
flung => fl ʌŋ
flunk => flʌŋk
flunked => flʌŋkt
flunkey => 'flʌŋki
flunkeys => ˈflʌŋkiz
flunking => flʌŋkɪŋ
flunks => flʌŋks
fluoresce => .fluә'res
fluoresced => fluəˈrest
fluorescein => ,fluә'resi:in
fluorescence => .fluә'resәns
fluorescent => .fluә'resәnt
fluoresces => fluəˈresiz
fluorescing => fluəˈresɪŋ
fluoridate => 'flu(:)әrideit
fluoridated => ˈflu(:)ərideitid
fluoridates => ˈflu(:)ərideits
fluoridating => ˈflu(:)ərideitɪŋ
fluoridation => ,fljәri'deiʃən
fluoride => 'flu(:)әraid
fluorinate => 'flu(:)әrineit
fluorination => ,flu:әri'neiʃәn
fluorine => 'fljәri:n; (?@) 'fljәr-
fluorite => 'flu:әrait
fluoro- => f'lu:ɔ:rəʊ
fluorocarbon => ,flu(:)әrә'kɑ:bәn
fluorochrome => 'flu:әrә,krәum
fluorograph => 'flu:әrә^rɑ:f
fluorography => ,fljә'rɔ^rәfi
fluorometer => flu(:)ә'rɔmitә
fluorometric => ,fljәrәj'metrik
fluorometry => ,fljә'rɔmitri
fluoropolymer => fluә(:)rә'pɔlimә
fluoroscope => 'fluәrәskәup
fluoroscopic => ,flu(:)әrә'skɔpik
fluoroscopy => .fluә'rɒskәpi
fluorosis => flu(:)ә'rәusis
fluorspar => 'flu(:)әspɑ:
fluoxetine => flʊaksətən
flurries => ˈflɜ:ri:z
flurry => 'flә:ri
flurrying => 'flʌrɪ
flush => flʌʃ
flusher => 'flʌʃә
flushes => flʌʃiz
flushing => 'flʌʃiŋ
flushness => f'lʌʃnes
fluster => 'flʌstә
flustered => 'flʌstəd
flustering => ˈflʌstərɪŋ
flusters => ˈflʌstəz
flute => flu:t
fluted => 'flu:tid
flutes => flu:ts
fluting => 'flu:tiŋ
flutist => 'flu:tist
flutter => 'flʌtә
fluttered => ˈflʌtəd
fluttering => ˈflʌtərɪŋ
flutters => ˈflʌtəz
fluty => 'flu:ti
fluvial => 'flu:vjәl
fluviatile => 'flu:viәtail
fluvioglacial => ,flu:viәj'^leisjәl
fluviometer => ,flu:vi'ɔmitә
flux => flʌks
fluxes => flʌksiz
fluxing => 'flʌksiŋ
fluxion => 'flʌkʃәn
fluxional => 'flʌkʃənәl
fly => flai
fly ball => flai bɔ:l
fly half => flai hɑ:f
fly orchid => flai ˈɔ:kɪd
fly whisk => flai hwisk
fly-by => flai bai
fly-by-wire => f'laɪb'aɪw'aɪər
fly-drive => flai draiv
fly-in => f'laɪ'ɪn
fly-post => flai pəust
fly-tip => flai tip
flyable => 'flaiәbl
flyaway => 'flaiә.wei
flyback => 'flaibæk
flyblow => 'flaiblәu
flyblown => 'flaiblәun
flyboy => 'flaibɔi
flybridge => f'laɪbrɪdʒ
flyby => 'flaibai
flycatcher => 'flaikætʃә
flyer => 'flaiә
flying => 'flaiiŋ
flying bomb => ˈflaɪɪŋ bɔm
flying bridge => ˈflaɪɪŋ bridʒ
flying buttress => ˈflaɪɪŋ ˈbʌtrɪs
flying doctor => ˈflaɪɪŋ ˈdɔktə
flying fish => ˈflaɪɪŋ fiʃ
flying fox => ˈflaɪɪŋ fɔks
flying jacket => ˈflaɪɪŋ ˈdʒækit
flying lemur => ˈflaɪɪŋ ˈli:mə
flying picket => ˈflaɪɪŋ ˈpikit
flying squirrel => ˈflaɪɪŋ ˈskwirəl
flying start => ˈflaɪɪŋ stɑ:t
flying suit => ˈflaɪɪŋ sju:t
flyleaf => 'flaili:f
flyman => 'flaimәn
Flynn => flin
flyover => 'flaiәjvә(r)
flyovers => ˈflaiˌəuvəz
flypaper => 'flaipeipә
flypast => 'flaipɑ:st
flypasts => ˈflaipɑ:sts
flysch => 'flaiʃ
flysheet => 'flaiʃi:t
flysheets => 'flaiʃi:t
flyspeck => 'flaispek
flyswatter => 'flaiswɒtә
Flyte => flait
flytrap => 'flaitræp
flyway => 'flaiwei
flyweight => 'flaiweit
flywheel => 'flaihwi:l
flywheels => flaɪ'wi:lz
foal => fәul
foaled => fəʊld
foaling => fəʊlɪŋ
foals => fəʊlz
foam => fәum
foamed => fom
foaming => 'fәumiŋ
foams => fəumz
foamy => 'fәumi
FOB => fɒb
fobbed => 'fɒbd
fobbing => 'fɔbiŋ
fobs => fɔbz
focaccia => fəʊ'kækʃɪɑ:
focal => 'fәukl
focal point => ˈfəʊkəl pɔint
focalization => .fәukәlai'zeiʃәn
focalize => 'fәukәlaiz
focalized => ˈfəukəlaizd
focalizes => ˈfəukəlaiziz
focalizing => ˈfəukəlaizɪŋ
foci => 'fәusai
focus => 'fәukәs
focus group => ˈfəukəs ɡru:p
focus on => ˈfəukəs ɔn
focus puller => ˈfəukəs ˈpulə
focused => 'fәukәst
focuser => 'fəʊkəsər
focusing => 'fәukәsiŋ
focussed => 'fəʊkəs
fodder => 'fɒdә
foddered => 'fɒdə
foe => fou
foehn => fein, fә:n
foes => fəuz
foetal => 'fi:tl
foeticide => 'fi:tisaid
foetid => 'fiːtɪd
foetus => 'fi:tәs
fog => fɒg
fog lamp => fɔɡ læmp
fogbound => 'fɔ^bajnd
fogbow => 'fɒgbәu
fogey => 'fәu^i
fogeys => ˈfəuɡiz
fogged => fɔɡd
Foggia => 'fɔɡɡiɑ:
foggier => ˈfɔ:gi:ə
fogging => 'fɔ^iŋ
foggy => 'fɒgi
foghorn => 'fɒghɒ:n
foghorns => ˈfɔɡˌhɔ:nz
fogies => 'fəʊdʒɪz
fogs => fɔɡz
fogy => 'fәugi
foible => 'fɒibl
foibles => ˈfɔɪbəlz
foie gras => 'fwɑ:'ɡrɑ:
foil => fɒil
foiled => fɒild
foiling => 'fɔiliθ
foils => fɔilz
foist => fɒist
foisted => fɔɪstid
foisting => fɔɪstɪŋ
foists => fɔɪsts
fokker => 'fɔkə
folacin => 'fɔlәsin
folate => 'fәuleit
fold => fәuld
fold-out => 'fəʊld'aʊt
foldaway => 'fәuldәwei
folder => 'fәuldә
folderol => 'fɒldәrɒl
folding => 'fәuldiŋ
folding door => ˈfəʊldɪŋ dɔ:
foley => 'fәuli
folia => 'fәuliә
foliaceous => .fәuli'eiʃәs
foliage => 'fәuliidʒ
foliar => 'fәuliә
foliar feed => ˈfəuliə fi:d
foliate => 'fәulieit
foliated => 'fəʊlɪˌeɪtɪd
foliates => ˈfəulieits
foliating => ˈfəulieitɪŋ
foliation => .fәuli'eiʃәn
folie => fɔ'li:
folie de grandeur => fәu,li:dә^rɑ:n'dә:
folio => 'fәuliәu
folios => ˈfəuliəuz
foliose => 'fәuliәus
folium => 'fәuliәm
folivore => 'fәjlivɔ:(r)
folk => fәuk
folk etymology => fəuk ˌetəˈmɔlədʒi:
folk memory => fəuk ˈmeməri
folk music => fəuk ˈmju:zik
Folkestone => 'fәukstәun
folkie => 'fәjki
folkish => 'fəʊkɪʃ
folklife => 'fəuk,laif
folklore => 'fәuklɒ:
folkloric => fәuk'lɔ:rik
folklorist => 'fәjk,lɔ:rist
folkloristic => fəʊk'lɔːrɪstɪk
folksy => 'fәuksi
folktale => 'fәukteil
folkway => 'fәukwei
folkways => 'ʃeʊkˌweɪz
folky => 'fəuki
follicle => 'fɒlikl
follicles => ˈfɔlɪkəlz
follicular => fә'likjulә
folliculitis => fә,likju'laitis
follies => 'fɔli:z
follow => 'fɒlәu
follow-my-leader => ˈfɔləu mai ˈli:də
follow-on => ˈfɔləʊˌɔn, -ˌɔ:n
follow-the-leader => ,fɔlәjðә'li:dә(r)
follow-ups => 'fɒləʊ'ʌps
follower => 'fɒlәuә
following => 'fɒlәuiŋ
folly => 'fɒli
Fomalhaut => 'fәumәl,hɔ:t
foment => fәu'ment
fomentation => .fәumen'teiʃәn
fomented => fəʊˈmentid
fomenting => fəʊˈmentɪŋ
foments => fəʊˈments
fomite => 'fәumait
fon => fɔn
fond => fɒnd
fonda => 'fɔndɑ:
fondant => 'fɔndәnt
fondants => 'fɒnd(ə)nt
fondle => 'fɒndl
fondled => ˈfɔndld
fondles => ˈfɔndlz
fondling => 'fɒndliŋ
fondly => 'fɒndli
fondness => 'fɔndnis
fondu => 'fɔndu:
fondue => 'fɔndu:
fondues => ˈfɔndu:z
font => fɒnt
Fontainebleau => 'fɔntinblәu
fontal => 'fɒntәl
fontanelle => ,fɔntә'nel
fontina => fɔn'ti:nә
foo yong => ˌfu: ˈjɒŋ
Foochow => 'fu:'tʃao
food => fu:d
food court => fu:d kɔ:t
food fish => fu:d fiʃ
food poisoning => fu:d ˈpɔɪznɪŋ
food processor => fu:d ˈprɔsˌesə
food stamp => fu:d stæmp
food web => fu:d web
foodborne => 'fu:dbɔ:n
foodie => ˈfu:di
foodstuff => 'fu:dstæf
fool => fu:l
fooled => fu:ld
foolery => 'fu:lәri
foolhardiness => 'fu:lhɑ:dinis
foolhardy => 'fu:lhɑ:di
fooling => 'fu:liŋ
foolish => 'fu:liʃ
foolishly => 'fu:liʃli
foolproof => 'fu:lpru:f
foolscap => 'fu:lzkæp
foosball => 'fuzbɔl
foot => fut
foot fault => fut fɔ:lt
foot rot => fut rɔt
foot soldier => fut ˈsəuldʒə
foot-dragging => 'fʊtdr'æɡɪŋ
foot-pound => 'fjtpajnd
footage => 'futidʒ
football => 'futbɒ:l
footballer => 'futbɒ:lә
footballers => ˈfʊtˌbɔ:ləz
footballing => ˈfʊtbɔ:lɪŋ
footballs => 'fʊtbɔ:lz
footbath => 'fjtbɑ:θ
footboard => 'futbɒ:d
footbridge => 'futbridʒ
footbridges => ˈfutbridʒz
footed => 'futid
footer => 'futә
footfall => 'futfɒ:l
footfalls => ˈfutfɔ:lz
footgear => 'futgiә
foothill => 'futhil
foothills => 'fʊthɪlz
foothold => 'futhәuld
footholds => ˈfʊtˌhəʊldz
footing => 'futiŋ
footle => 'fu:tl
footled => ˈfu:tld
footles => ˈfu:tlz
footless => 'futlis
footlights => 'futlaits
footling => 'fu:tliŋ
footlocker => 'futlɒkә
footloose => 'futlu:s
footman => 'futmәn
footmark => 'futmɑ:k
footmarks => 'fʊtmɑːk
footmen => 'formən
footnote => 'futnәut
footpad => 'futpæd
footpath => 'futpæθ
footpaths => ˈfʊtˌpæθs
footplate => 'futpleit
footplates => ˈfutpleits
footprint => 'futprint
footrace => 'fjtreis
footrest => 'futrest
footsie => 'futsi
footslog => 'futslɒg
footslogger => 'fjt,slɔ^ә(r)
footsore => 'futsɒ:
footstalk => 'futstɒ:k
footstep => 'futstep
footstool => 'futstu:l
footstools => ˈfutstu:lz
footsure => 'futʃuә
footswitch => fʊts'wɪtʃ
footwall => 'fjtwɔ:l
footway => 'futwei
footwear => 'fjtweә(r)
footwell => 'fjtwel
footwork => 'futwә:k
footy => 'futi
foozle => 'fu:zl
fop => fɒp
foppery => 'fɒpәri
foppish => 'fɒpiʃ
foppishly => ˊfɒpiʃli
for => fɒ:
for dear life => fɔ: dɪə(r)，dɪr laif
for some reason => fɔ: sʌm ˈri:zən
for the asking => fɔ: ðə ˈɑ:skiŋ
for- => fɔ:(r), fә(r)
for-profit => 'fɔ:rpr'ɒfɪt
fora => 'fɔ:rә
forage => 'fɒridʒ
foraged => ˈfɔ:rɪdʒd
forager => 'fɒridʒә
foragers => 'fɔridʒə
forages => ˈfɔ:rɪdʒz
foraging => 'fɒrɪdʒɪŋ
foramen => fә'reimәn
foramen magnum => fəˈreimen ˈmæɡnəm
foraminifer => .fɒrә'minifә
foraminiferal => fә,ræmi'nifәrәl
foraminiferan => fә,ræmi'nifәrәn
foraminiferous => fә,ræmi'nifәrәs
forasmuch as => fərəzˈmʌtʃ æz
foray => 'fɒrei
forayed => ˈfɔ:rˌeɪd
forayer => 'fɔreiə
foraying => ˈfɔ:rˌeɪŋ
forays => ˈfɔ:rˌeɪz
forb => fɔ:b
forbade => fә'bæd, -'beid
forbear => fɒ:'bєә
forbearance => fɒ:'bєәrәns
forbearing => fɔ:'beәrinŋ
forbes => 'fɔ:bz, 'fɔ:bis
forbid => fә'bid
forbidden => fә'bidn
forbidding => fә'bidiŋ
forbiddingly => fə'bidiŋli
forbids => fəˈbidz
forbore => fɔ:'bɔ:
forbye => fɔ:'bai
force => fɒ:s
force feedback => fɔ:s ˈfi:dbæk
force-fed => fɔ:s fed
force-land => 'fɔ:slænd
force-landed => 'fɔ:slænd
force-landing => 'fɔ:slænd
force-lands => 'fɔ:slænd
force-out => 'fɔ:sajt
forced => fɒ:st
forced landing => fɔ:st ˈlændɪŋ
forced march => fɔ:st mɑ:tʃ
forceful => 'fɒ:sful
forcefulness => 'fɔ:sflnəs
forcemeat => 'fɔ:smi:t
forcep => fɔ:'sep
forceps => 'fɒ:seps
forcer => 'fɔ:sә
forcible => 'fɒ:sәbl
forcibly => 'fɒ:sәbli
forcing => 'fɔ:siŋ
ford => fɒ:d
Forde => fɔ:d
forded => fɔ:did
fording => fɔ:dɪŋ
Fordism => 'fɔ:dizm
fordless => 'fɔ:dlis
fordo => fɒ:'du:
fords => fɔ:dz
fore => fɒ:
fore- => fɔ:(r)
forearm => 'fɒ:rɑ:m
forearmed => fɔː'ɑːmd
forearms => fɔ:rˈɑ:mz
forebear => 'fɒ:bєә
forebears => ˈfɔ:ˌbeəz
forebode => fɒ:'bәud
foreboding => fɒ:'bәudiŋ
forebodings => fɔ:ˈbəʊdɪŋz
forebrain => 'fɒ:brein
forecabin => 'fɒ:kæbin
forecaddie => 'fɔ:,kædi
forecast => 'fɒ:kɑ:st
forecaster => 'fɔ:kɑ:stә
forecasters => ˈfɔ:kɑ:stəz
forecasting => 'fɔ:kɑ:stiŋ
forecastle => 'fәuksl
forecasts => ˈfɔ:-kɑ:sts
forecheck => 'fɔ:tʃek
foreclose => fɒ:'klәus
foreclosed => fɔ:ˈkləʊzd
forecloses => fɔ:ˈkləʊziz
foreclosing => fɔ:ˈkləʊzɪŋ
foreclosure => fɔ:'klәjʒә(r)
foreclosures => fɔ:ˈkləuʒəz
forecourt => 'fɒ:kɒ:t
forecourts => ˈfɔ:kɔ:ts
foredeck => 'fɔ:dek
foredo => fɔ:'du:
foredoom => fɒ:'du:m
foredoomed => fɔ:ˈdu:md
foredune => 'fɔ:,dju:n
forefather => 'fɒ:fɑ:ðә
forefathers => 'fɔ:
forefend => fɔ:'fend
forefinger => 'fɒ:fiŋgә
forefingers => ˈfɔ:ˌfɪŋgəz
forefoot => 'fɒ:fut
forefront => 'fɒ:frʌnt
foregather => fɔ:'^æðә
forego => fɒ:'gәu
foregoer => fɔ:'^әuә
foregoes => fɔ:ˈɡəuz
foregoing => 'fɒ:'gәuiŋ
foregone => fɒ:'gʌn
foregone conclusion => 'fɔ:^ɔn
foreground => 'fɒ:graund
foregrounded => ˈfɔ:ɡraundid
foregrounds => ˈfɔ:ɡraundz
foregut => 'fɔ:^ʌt
forehand => 'fɒ:hænd
forehanded => 'fɒ:'hændid
forehands => ˈfɔ:ˌhændz
forehead => 'fɒ:rid
foreheads => ˈfɔridz
forehock => 'fɔ:hɔk
foreign => 'fɒ:rin
foreigner => 'fɒ:rinә
foreigners => 'fɒrənəz
foreknow => fɒ:'nәu
foreknowing => fɔ:ˈnəuɪŋ
foreknowledge => 'fɒ:nɒlidʒ
foreknows => fɔ:ˈnəuz
foreland => 'fɒ:lәnd
foreleg => 'fɒ:leg
forelegs => fɔ:lezɡ
forelimb => 'fɒ:lim
forelock => 'fɒ:lɒk
forelocks => ˈfɔ:lɔks
foreman => 'fɒ:mәn
foremast => 'fɒ:mæst
foremost => 'fәumәust
foremother => 'fɒ:mʌðә
forename => 'fɒ:neim
forenames => ˈfɔ:neimz
forenoon => 'fɒ:nu:n
forensic => fә'rensik
forensically => fɔ'rensik
foreordain => .fɒ:rɒ:'dein
foreordained => ˌfɔ:rɔ:ˈdeɪnd
foreordaining => ˌfɔ:rɔ:ˈdeɪnɪŋ
foreordains => ˌfɔ:rɔ:ˈdeɪnz
foreordination => .fɒ:rɒ:di'neiʃәn
forepart => 'fɒ:pɑ:t
forepaw => 'fɒ:pɒ:
forepeak => 'fɒ:pi:k
foreperson => 'fɔ:pə:sən
foreplay => ˈfɔ:pleɪ
forequarter => 'fɒ:kwɒ:tә
forerun => fɒ:'rʌn
forerunner => fɒ:'rʌnә
forerunners => 'fɔ:rʌnəz
foresail => 'fɒ:seil
foresaw => fɒ: 'sɒ:
foresee => fɒ:'si:
foreseeable => 'fɒ:'si:әbl
foreseeing => fɔ:ˈsi:ɪŋ
foreseen => fɒ:'si:n
foreseer => 'fɒ:si:ә
foresees => fɔ:ˈsi:z
foreshadow => fɒ:'ʃædәu
foreshadowed => fɔ:ˈʃædəud
foreshadowing => fɔ:'ʃædəʊɪŋ
foreshadows => fɔ:ˈʃædəuz
foresheet => 'fɒ:ʃi:t
foreshock => 'fɔ:ʃɔk
foreshore => 'fɒ:ʃɒ:
foreshores => ˈfɔ:ʃɔ:z
foreshorten => fɒ:'ʃɒ:tn
foreshortened => fɔ:ˈʃɔ:tnd
foreshortening => fɔ:'ʃɔ:tnɪŋ
foreshortens => fɔ:ˈʃɔ:tnz
foreshow => fɒ:'ʃәu
foreshowing => fɔ:ˈʃəuɪŋ
foreshows => fɔ:ˈʃəuz
foresight => 'fɒ:sait
foresighted => 'fɒ:saitid
foresightedness => ˊfɒːsaitidnis
foreskin => 'fɔ:skin
foreskins => ˈfɔ:skinz
forest => 'fɒrist
forestall => fɒ:'stɒ:l
forestalled => fɔ:ˈstɔ:ld
forestalls => fɔ:ˈstɔ:lz
forestation => .fɒri'steiʃәn
forestay => 'fɒ:stei
forester => 'fɔristә
forestland => 'fɔ:ristlәnd
forestry => 'fɒristri
forests => ˈfɔrists
foretaste => fɒ:'teist
foretell => fɒ:'tel
foretelling => fɔ:telɪŋ
foretells => fɔ:ˈtelz
forethought => 'fɒ:θɒ:t
foretoken => 'fɒ:tәukәn
foretold => fɔ:'tәuld
foretop => 'fɒ:tɒp
foretopmast => fɔ:'tɔpmɑ:st
foretriangle => 'fɔ:trai,æθ^l
forever => fә'revә
forewarn => fɒ:'wɒ:n
forewarned => fɔ:ˈwɔ:nd
forewarning => fɔ:'wɔ:nɪŋ
forewarns => fɔ:ˈwɔ:nz
forewent => fɔ:'went
forewing => 'fɔ:wiŋ
forewoman => 'fɒ:wumәn
foreword => 'fɒ:wә:d
forewords => ˈfɔ:wədz
foreyard => 'fɒ:jɑ:d
Forfarshire => 'fɔ:fәʃә(r)
forfeit => 'fɒ:fit
forfeited => ˈfɔ:fitid
forfeiting => 'fɔ:rfɪt
forfeiture => 'fɒ:fitʃә
forfeitures => ˈfɔ:fɪˌtʃʊəz
forfend => fɒ:'fend
forgather => fɒ:'gæðә
forgathered => fɔ:ˈɡæðəd
forgathering => fɔ:ˈɡæðərɪŋ
forgathers => fɔ:ˈɡæðəz
forgave => fә'geiv
forge => fɒ:dʒ
forgeable => 'fɔ:dʒәbl
forger => 'fɒ:dʒә
forgeries => ˈfɔ:dʒəriz
forgers => 'fɔːdʒə(r)
forgery => 'fɒ:dʒәri
forges => fɔ:dʒz
forget => fә'get
forget-me-not => fә'^etminɔt
forgetful => fә'getful
forgetfully => fə'ɡetfəlɪ
forgets => fəˈɡets
forgettable => fә'getәbl
forgetter => fә'^etә
forgetting => fә'^etiŋ
forging => 'fɒ:dʒiŋ
forgivable => fә'givәbl
forgive => fә'giv
forgiveness => fә'givnis
forgives => fəˈɡivz
forgiving => fә'giviŋ
forgivingly => fə'gɪvi:ŋlɪ
forgo => fɒ:'gәu
forgoes => fɔ:ˈgəʊz
forgoing => fɔ:'gəʊɪŋ
forgone => fɔ:ˈgɒn
forgot => fә'gɒt
forgotten => fә'gɒtn
forint => 'fɒ:rint
fork => fɒ:k
forked => fɒ:kt
forked lightning => fɔ:kt ˈlaitniŋ
forkful => 'fɔ:kfjl
forking => 'fɔkiŋ
forklift => 'fɔ:klift
forks => fɔ:ks
forktail => 'fəkteɪl
forlorn => fә'lɒ:n
forlorn hope => fəˈlɔ:n həup
forlornly => fə'lɔ:nli
form => fɒ:m
form class => fɔ:m klɑ:s
form genus => fɔ:m ˈdʒi:nəs
formability => fɔ:mә'biliti
formal => 'fɒ:mәl
formaldehyde => fɒ:'mældihaid
formalin => 'fɒ:mәlin
formalisation => ,fɔ:məlai'zeiʃən
formalise => 'fɔ:məlaɪz
formalism => 'fɒ:mәlizm
formalist => 'fɒ:mәlist
formalistic => .fɒ:mә'listik
formalities => fɔ:ˈmælɪti:z
formality => fɒ:'mæliti
formalization => .fɒ:mәlai'zeiʃәn
formalize => 'fɒ:mәlaiz
formalized => 'fɔ:məlaizd
formalizes => ˈfɔ:məlaiziz
formalizing => ˈfɔ:məlaizɪŋ
formally => 'fɒ:mәli
formant => 'fɔ:mәnt
format => 'fɒ:mæt
formate => 'fɒ:meit
formation => fɒ:'meiʃәn
formative => 'fɒ:mәtiv
formatting => 'fɔ:mætiŋ
forme => fɒ:m
former => 'fɒ:mә
formerly => 'fɒ:mәli
formic => 'fɒ:mik
formica => fɔ:'maikә
formicarium => ,fɔ:mi'keәriәm
formication => ,fɔ:mi'keiʃәn
formidable => 'fɒ:midәbl
formidably => 'fɒ:midәbli
forming => 'fɔ:miŋ
formless => 'fɒ:mlis
formol => 'fɔ:mɔl
formosa => fɔ:'mәusә
formula => 'fɒ:mjulә
formulable => 'fɔ:mjjlәbl
formulae => 'fɒ:mjuli:
formulaic => -'leiik
formularies => ˈfɔ:mjuləriz
formularize => 'fɔ:mjulәraiz
formulary => 'fɒ:mjulәri
formulate => 'fɒ:mjuleit
formulated => ˈfɔ:mjuleitid
formulates => ˈfɔ:mjuleits
formulating => 'fɔ:mjuleitiŋ
formulation => .fɒ:mju'leiʃәn
formulations => fɔ:mjʊ'leɪʃnz
formwork => 'fɔ:mwә:k
formyl => 'fɔ:mil
Fornax => 'fɔ:næks
fornent => 'fɜːnɪnst
fornicate => 'fɒ:nikeit
fornicated => ˈfɔ:nɪˌkeɪtid
fornicates => ˈfɔ:nɪˌkeɪts
fornicating => ˈfɔ:nɪˌkeɪtɪŋ
fornication => .fɒ:ni'keiʃәn
fornicator => 'fɒ:nikeitә
fornix => 'fɔ:niks
forrader => 'fɔrәdә
forsake => fә'seik
forsaken => fә'seikәn
forsakes => fəˈseiks
forsaking => fəˈseikɪŋ
forseeable => fɔ:'si:əbl
forsook => fә'suk
forsooth => fә'su:θ
Forster => 'fɔ:stә
forsterite => 'fɔ:stә,rait
forswear => fɒ:'swєә
forswearing => fɔ:'sweərɪŋ
forswears => fɔ:ˈsweəz
forsworn => fɒ:'swɒ:n
forsythia => fɒ:'saiθjә
fort => fɒ:t
Fortaleza => ,fɔ:tә'leizә
fortalice => 'fɔ:tәlis
forte => fɔ:t
fortepiano => fɔ:tipi'ænәj
fortes => ˈfɔ:tisiz
Fortescue => 'fɔ:tә,skju:
forth => fɒ:θ
forthcoming => 'fɒ:θ'kʌmɑŋ
forthright => fɒ:θ'rait
forthrightly => 'fɔ:θraitli
forthrightness => ˈfɔ:θˈraɪtnɪs
forthwith => 'fɒ:θ'wiθ
forties => ˈfɔ:ti:z
fortieth => 'fɒ:tiiθ
fortifiable => 'fɔ:tifaiәbl
fortification => .fɒ:tifi'keiʃәn
fortified => 'fɒ:tifaid
fortifier => 'fɒ:tifaiә
fortifies => ˈfɔ:tifaiz
fortify => 'fɒ:tifai
fortifying => ˈfɔ:tifaiŋ
fortis => 'fɔ:tis
fortissimo => fɔ:'tisimәu
fortitude => 'fɒ:titju:d
fortnight => 'fɒ:tnait
fortnightly => 'fɒ:tnaitli
fortnights => ˈfɔ:tnaits
Fortran => 'fɔ:træn
fortress => 'fɒ:tris
fortresses => ˈfɔ:trisiz
fortuitous => fɒ:'tju:itәs
fortuitously => fɔ:'tju:ɪtəslɪ
fortuity => fɔ:'tjuiti
fortuna => fɔ:'tju:nә
fortunate => 'fɒ:tʃәnit
fortunately => 'fɒitʃәnitli
fortune => 'fɒ:tʃәn
fortune cookie => ˈfɔ:tʃən ˈkuki
fortune teller => ˈfɔ:tʃən ˈtelə
fortune telling => 'fɔ:tʃən,teliŋ
fortunes => ˈfɔ:tʃənz
forty => 'fɒ:ti
forty-niner => ,fɔ:ti'nainə
fortyfold => ˊfɒːtifould
fortyish => 'fɔ:tiiʃ
forum => 'fɒ:rәm
forward => 'fɒ:wәd
forwarder => 'fɔ:wәdә
forwarding => 'fɔ:wәdiŋ
forwardly => 'fɒ:wәdli
forwardness => 'fɒ:wәdnis
forwards => 'fɔ:wәdz
forwent => fɔ:'went
Fosbury => 'fɔzbәri
foss => fɔs
fossa => 'fɒsә
fosse => fɒs
fossick => 'fɒsik
fossil => 'fɒsәl
fossil fuel => ˈfɔsl fjuəl
fossiliferous => .fɒsi'lifәrәs
fossilise => 'fɔsilaiz
fossilised => 'fɔsilaiz
fossilization => .fɒsilai'zeiʃәn
fossilize => 'fɒsilaiz
fossilized => 'fɔsilaizd
fossilizes => ˈfɔsəˌlaɪziz
fossilizing => ˈfɔsəˌlaɪzɪŋ
fossils => 'fɒslz
fossorial => fɒ'sɒ:riәl
foster => 'fɒstә
foster- => 'fɒstə
fosterage => 'fɒ:stәridʒ
fostered => ˈfɔstəd
fosterer => 'fɔstәrә(r)
fosterling => 'fɔstәliθ
fosters => ˈfɔstəz
fou => fu:
Foucault => fu:'kəu
fought => fɒ:t
foul => faul
foul ball => faul bɔ:l
foul line => faul lain
foulard => fu:'lɑ:d
fouled => fauld
fouler => faulə
fouling => 'fauliŋ
foully => 'fauli
foulness => faʊlnəs
fouls => faulz
foumart => 'fu:mɑ:t
found => faund
foundation => faun'deiʃәn
foundation course => faunˈdeiʃən kɔː(r)s
foundation garment => faunˈdeiʃən ˈɡɑ:mənt
founder => 'faundә
founder effect => ˈfaʊndə iˈfekt
founder member => ˈfaʊndə ˈmembə
foundered => ˈfaʊndəd
founders => ˈfaʊndəz
founding => 'faundiŋ
founding father => ˈfaundiŋ ˈfɑ:ðə
foundling => 'faundliŋ
foundlings => ˈfaundliŋz
foundress => 'faundris
foundries => ˈfaʊndri:z
foundry => 'faundri
fount => faunt
fountain => 'fauntin
fountainhead => 'fauntinhed
fountains => ˈfauntinz
four => fɒ:
four hundred => fɔ: ˈhʌndrəd
four-dimensional => 'fɔ:di'menʃәnәl
four-eyes => 'fɔ:r'aɪz
four-flush => 'fɔ:flʌʃ
four-flusher => 'fɒ:flʌʃә
four-in-hand => 'fɔ:rin'hænd
four-letter word => ˈfɔ:ˌletə, ˈfəʊr-
four-square => fɔ: skwɛə
four-star => 'fɔ:'stɑ:(r)
four-stroke => fɔ: strəuk
four-wheel drive => ˈfɔ:ˈhwi:l draiv
fourchette => fuә'ʃet
fourfold => 'fɒ:fәuld
fourier => 'furiei
Fourierism => 'furiәrizәm
fourpence => 'fɒ:pәns
fourpenny => 'fɔ:pәni
fours => fɔ:z
fourscore => 'fɒ:'skɒ:
foursome => 'fɒ:sәm
foursomes => ˈfɔ:səmz
foursquare => 'fɒ:'skwєә
fourteen => 'fɒ:'ti:n
fourteenth => 'fɒ:'ti:nθ
fourth => fɒ:θ
fourth dimension => fɔ:θ diˈmenʃən
fourth estate => fɔ:θ isˈteit
fourthly => 'fɔ:θli
fourths => fɔ:θs
fovea => 'fәuviә
fowl => faul
fowl pest => faʊl pest
fowler => 'faulә
fowling => 'fauliŋ
fowls => faʊlz
fox => fɒks
fox terrier => fɔks ˈteri:ə
fox-hunting => fɔks ˈhʌntɪŋ
Foxe => fɔks
foxed => fɒkst
foxes => fɔksiz
foxfire => 'fɔks^faiә(r)
foxglove => 'fɒksglʌv
foxgloves => ˈfɔksˌɡlʌvz
foxhole => 'fɒkshәul
foxhound => 'fɒkshaund
foxhunt => fɒks'hʌnt
foxhunter => 'fɔks,hʌntә(r)
foxier => ˈfɔksiə
foxiness => 'fɒksinis
foxing => 'fɔksiŋ
foxtail => 'fɒksteil
foxtrot => 'fɔkstrɔt
foxy => 'fɒksi
foy => fɒi
foyer => 'fɔiei
foyers => ˈfɔɪəz
fra => frɑ:
fracas => 'frækɑ:
fractal => 'fræktәl
fraction => 'frækʃәn
fractional => 'frækʃәnәl
fractionalization => ,frækʃənəlai'zeiʃən; -li'z-
fractionalize => 'frækʃәnәlaiz
fractionate => 'frækʃәneit
fractionated => ˈfrækʃəneitid
fractionates => ˈfrækʃəneits
fractionating => 'frækʃәneitiŋ
fractionation => .frækʃә'neiʃәn
fractions => f'rækʃnz
fractious => 'frækʃәs
fracture => 'fræktʃә
fractures => ˈfræktʃəz
fracturing => 'fræktʃәriŋ
frae => frei
frag => fræɡ
fragile => 'frædʒail
fragility => frә'dʒiliti
fragment => 'frægmәnt
fragmental => fræ^'mentәl
fragmentary => 'fræ^mәntәri
fragmentation => .frægmәn'teiʃәn
fragmentation bomb => ˌfræɡmenˈteiʃən bɔm
fragmented => 'fræɡmentid
fragments => ˈfræɡmənts
fragrance => 'freigrәns
fragrances => ˈfreiɡrənsiz
fragrancy => 'freɪgrənsɪ
fragrant => 'freigrәnt
fragrantly => ˊfreigrәntli
frail => freil
frailer => freilə
frailly => 'freili
frailness => 'freɪlnɪs
frailties => ˈfreɪlti:z
frailty => 'freilti
fraise => freiz
fram => fræm
framboesia => fræm'bi:ziә
framboise => frɔ:n'bwɑ:z
frame => freim
frame of mind => freim ɔv maind
framer => 'freimә
frameset => f'reɪmi:set
framework => 'freimwә:k
frameworks => ˈfreimwə:ks
framing => 'freimiŋ
fran => fræn
franc => fræŋk
Franca => 'fra:ŋka:
France => frɑ:ns
frances => 'frɑ:nsis
francesca => fræn'seskә, -'tʃeskә
franchise => 'fræntʃaiz
franchised => ˈfrænˌtʃaɪzd
franchisee => .fræntʃai'zi:
franchiser => 'fræntʃai'zә(r)
franchises => ˈfrænˌtʃaɪziz
franchising => 'fræntʃaɪzɪŋ
franchisor => ,fræntʃai'zɔ:(r)
francine => frɑ:n'si:n, fræn'si:n
francis => 'frɑ:nsis
Franciscan => fræn'siskәn
francisco => fræn'siskәu
francium => 'frænsiәm
Franck => frɑ:ŋk, fræŋk
franco => 'fræŋkәu
francolin => 'fræŋkәulin
Franconia => fræŋ'kəuni:ə
Franconian => fræŋ'kәuniәn
francophile => ˈfræŋkəˌfaɪl
francophone => 'fræŋkәufәun
frangible => 'frændʒibl
frangipane => 'frændʒipein
frangipani => 'frændʒipæni
frank => fræŋk
franked => fræŋkt
frankenstein => 'fræŋkәnstain
franker => fræŋkə
Frankfort => 'fræŋkfәt
frankfurt => 'fræŋkfәt
frankfurters => ˈfræŋkfə:təz
frankincense => 'fræŋkin.sens
franking => 'fræŋkiŋ
franking machine => ˈfræŋkiŋ məˈʃi:n
Frankish => 'fræŋkiʃ
Franklin => 'fræŋklin
frankly => 'fræŋkli
frankness => 'fræŋknis
FRANKS => fræŋks
frantic => 'fræntik
frantically => 'fræntikli
franz => frɑ:nts
frap => fræp
frapped => fræp
frapping => f'ræpɪŋ
Frascati => fræ'skɑ:ti
frass => fræs
frat => fræt
frate => 'frɑ:tei
frater => 'freitә, 'frɑ:tә
fraternal => frә'tә:nl
fraternise => 'frætәnaiz
fraternities => frəˈtə:nitiz
fraternity => frә'tә:niti
fraternization => .frætәnai'zeiʃәn
fraternize => 'frætәnaiz
fraternized => ˈfrætəˌnaɪzd
fraternizes => ˈfrætəˌnaɪziz
fraternizing => ˈfrætəˌnaɪzɪŋ
fratricidal => .freitri'saidl
fratricide => 'freitrisaid
frau => frau
fraud => frɒ:d
fraud squad => frɔ:d skwɔd
frauds => f'rɔ:dz
fraudster => ˈfrɔ:dstə(r)
fraudulence => 'frɒ:djulәns
fraudulent => 'frɒ:djulәnt
fraudulently => 'frɔ:djələntlɪ
fraught => frɒ:t
fraxinella => .fræksi'nelә
fray => frei
frayed => freɪd
frays => freɪz
frazil => 'freizil
frazzle => 'fræzl
frazzled => 'fræzld
frazzles => ˈfræzlz
frazzling => ˈfræzlɪŋ
freak => fri:k
freak show => fri:k ʃəu
freakier => ˈfri:kiə
freakiness => 'friːkɪnɪs
freaking => ˈfri:kɪŋ
freakish => 'fri:kiʃ
freakishly => 'fri:kiʃli
freakishness => 'fri:kɪʃnɪs
freaky => 'fri:ki
freckle => 'frekl
freckling => f'reklɪŋ
freckly => 'frekli
fred => fred
Freda => 'fri:dә
freddie => 'fredi
frederic => 'fredәrik
Frederica => ,fredә'ri:kә
Fredericton => 'fredәriktәn
free => fri:
free agent => fri: ˈeidʒənt
free climbing => fri: ˈklaimiŋ
free enterprise => fri: ˈentəpraiz
free fall => fri: fɔ:l
free house => fri: haus
free kick => fri: kik
free love => fri: lʌv
free safety => fri: ˈseifti
free spirit => fri: ˈspirit
free throw => fri: θrəu
free vote => fri: vəut
free-associate => ,fri:ə'səuʃi,eit
free-fall => f'ri:f'ɔ:l
free-floating => ˈfri:ˈfləʊtɪŋ
free-range => ˈfri:ˌreɪndʒ
free-to-air => fri: tu: eə(r)
freebase => 'fri:beis
freebie => 'fri:bi:
freebies => f'ri:bɪz
freeboard => 'fri:bɒ:d
freeboot => 'fri:bu:t
freebooter => 'fri:bu:tә
freeborn => 'fri:'bɒ:n
freeby => 'fri:bi
freedman => 'fri:dmæn
freedmen => f'ri:dmən
freedom => 'fri:dәm
freedom rider => ˈfri:dəm ˈraɪdə
freedoms => ˈfri:dəmz
freefall => f'ri:fɔ:l
Freefone => 'fri:fəun
freehand => 'fri:hænd
freehold => 'fri:hәuld
freeing => 'fri:iŋ
freelanced => ˈfri:lɑ:nst
freelances => ˈfri:lɑ:nsiz
freelancing => ˈfri:lɑ:nsɪŋ
freeload => 'fri:'lәjd
freeloaded => 'fri:ləud
freeloader => ˈfri:ləʊdə(r)
freeloading => 'fri:ləʊdɪŋ
freeloads => 'fri:ləud
freely => 'fri:li
freeman => 'fri:mәn
Freemans => 'friːmən
freemartin => 'fri:mɑ:tin
freemason => 'fri:meisn
freemasonry => 'fri:meisәnri
freemen => ˈfri:mən
freemium => 'friːmɪəm
freeness => 'fri:nis
freephone => 'frɪ:fəʊn
Freepost => 'fri:pəust
freer => 'fri:ә(r)
freesia => 'fri:ziә
freesias => ˈfri:ʒiəz
freest => ˈfri:ɪst
freestanding => 'fri:stændiŋ
freestone => 'fri:stәjn
freestyle => 'fri:stail
freestyler => f'ri:staɪlər
freethinker => 'fri:'θiŋkә
freethinkers => friː'θɪŋkə
freethinking => 'fri:'θiŋkiŋ
Freetown => 'fri:taun
freeway => 'fri:wei
freeways => ˈfri:ˌweɪz
freewheel => 'fri:'hwi:l
freewheeled => f'ri:wi:ld
freewheeling => 'fri:'hwi:liŋ
freewheels => ˈfri:ˈhwi:lz
freeze => fri:z
freeze-dried => fri:z draid
freeze-dries => fri:z drais
freeze-frame => ˈfri:zˌfreɪm
freeze-ups => 'fri:z,ʌp
freezer => fri:zә
freezers => 'fri:zəz
freezing => 'fri:ziŋ
Freiburg => 'fraibə:ɡ
freight => 'freit
freightage => 'freitidʒ
freighter => 'freitә
freighters => ˈfreɪtəz
freightliner => f'reɪtlaɪnər
freights => freits
Fremantle => 'fri:mæntl
French => frentʃ
Frenchify => 'frentʃifai
Frenchman => 'frentʃmәn
Frenchness => 'frentʃnis
Frenchwoman => 'frentʃwumәn
Frenchy => 'frentʃi
frenemy => f'renəmɪ
frenetic => fri'netik
frenetically => frə'netikli
frenulum => 'frenjulәm
frenum => 'fri:nәm
frenzied => 'frenzid
frenziedly => 'frenzidli
frenzy => 'frenzi
freon => 'fri:ɒn
frequency => 'fri:kwәnsi
frequent => 'fri:kwәnt
frequentation => .fri:kwen'teʃәn
frequentative => fri'kwentәtiv
frequented => ˈfri:kwəntid
frequenter => fri'kwentә
frequenting => ˈfri:kwəntɪŋ
frequently => 'fri:kwәntli
frequents => ˈfri:kwənts
fresco => 'freskәu
frescoed => 'freskəʊ
frescoes => ˈfreskəʊz
frescos => ˈfreskəʊz
fresh => freʃ
fresh breeze => freʃ bri:z
fresh gale => freʃ ɡeil
fresh-run => 'freʃrʌn
freshen => 'freʃn
freshened => ˈfreʃənd
freshener => 'freʃәnә(r)
freshening => f'reʃnɪŋ
freshens => ˈfreʃənz
freshet => 'freʃit
freshly => 'freʃli
freshmen => 'freʃmən
freshness => 'freʃnis
freshwater => 'freʃwɔ:tә(r)
Fresnel => frei'nel
fret => fret
fretful => 'fretful
fretfully => 'fretflɪ
fretfulness => 'fretfəlnɪs
frets => frets
fretsaw => 'fretsɒ:
fretted => 'fretid
fretwork => 'fretwә:k
freud => frɔid
Freudian => 'frɒidiәn
Frey => frei
Freya => 'freiә
friability => fraiә'biliti
friable => 'fraiәbl
friableness => ˊfraiәblnis
friar => 'fraiә
friarbird => 'fraibә:d
friars => ˈfraɪəz
friary => 'fraiәri
fribble => 'fribl
Fribourg => fri:'bu:
fricandeau => 'frikәndәu
fricassee => .frikә'si:
fricasseed => ˌfrikəˈsi:d
fricasseeing => frɪkə'si:ɪŋ
fricassees => ˌfrikəˈsi:z
fricative => 'frikәtiv
Frick => frik
friction => 'frikʃәn
frictional => 'frikʃәnәl
frictionless => f'rɪkʃnles
frictions => f'rɪkʃnz
Friday => 'fraidi
fridge => fridʒ
fridge-freezer => fridʒ ˈfri:zə
fridges => fridʒz
fried => fraid
Frieda => 'fri:dә
friend => frend
friendless => 'frendlis
friendlies => 'fren(d)lɪ
friendliness => 'frendlinis
friendly => 'frendli
friendly fire => ˈfrendli ˈfaiə
friendly society => ˈfrendli səˈsaiəti
friendship => 'frendʃip
friendships => f'rendʃɪps
frier => 'fraiә
friesian => 'fri:ʒәn
Friesland => 'fri:zlәnd
frieze => fri:z
friezes => fri:ziz
frig => fridʒ
frigate => 'frigit
frigate bird => ˈfrɪgɪt bə:d
frigates => ˈfrɪgɪts
frigged => fridʒ
frigging => 'frigiŋ
fright => frait
frighted => fraɪt
frighten => 'fraitn
frightened => 'frait(ә)nd
frightening => 'fraitәniŋ
frighteningly => 'fraɪtnɪŋlɪ
frightens => ˈfraitənz
frightful => 'fraitful
frightfulness => 'fraitfulnis
frights => fraɪts
frigid => 'frigid
frigidarium => fridʒi'dæriәm
frigidity => fri'dʒiditi
frigidly => 'fridʒidli
frijole => 'fri:hәul
frill => fril
frilling => 'friliŋ
frills => frils
frilly => 'frili
Frimaire => fri:'meә(r)
fringe => frindʒ
fringe benefit => frindʒ ˈbenifit
fringed => frindʒd
fringes => frindʒz
fringing => 'frindʒiŋ
fringy => 'frindʒi
frippery => 'fripәri
frippet => 'fripit
frisbee => 'frizbi:
Frisch => friʃ
Frisian => 'friziәn
frisk => frisk
frisked => frɪskt
frisket => 'friskit
friskier => ˈfrɪski:ə
friskily => 'friskili
frisking => f'rɪskɪŋ
frisks => frɪsks
frisky => 'friski
frisson => fri'sɔn
frissons => friˈsɔnz
frit => frik
frites => fri:t
frith => friθ
fritillary => 'fritilәri
frittata => fri'tɑ:tә
fritter => 'fritә
frittered => ˈfrɪtəd
frittering => ˈfrɪtərɪŋ
fritters => ˈfrɪtəz
fritto misto => 'fri:təu'mistəu
fritz => frits
Friuli-Venezia Giulia => fri:'ju:live'netsjə:'dʒuljə
frivol => 'frivl
frivolities => frɪˈvɔlɪti:z
frivolity => fri'vɒliti
frivolled => ˈfrivəld
frivolling => ˈfrivəlɪŋ
frivolous => 'frivәlәs
frivolously => 'frɪvələslɪ
frivolousness => f'rɪvələsnəs
frivols => ˈfrivəlz
frizz => friz
frizzed => frɪzd
frizzes => frɪziz
frizzier => ˈfriziə
frizziness => f'rɪzɪnəs
frizzing => f'rɪzɪŋ
frizzle => 'frizl
frizzled => ˈfrizld
frizzles => ˈfrizlz
frizzling => f'rɪzlɪŋ
frizzly => 'frizli
frizzy => 'frizi
fro => frәu
frock => frɒk
frock coat => frɔk kəut
frocked => frɒk
frocking => f'rɒkɪŋ
frocks => f'rɒks
froe => frәu
Froebel => 'frә:bәl
frog => frɒg
frog kick => frɔɡ kik
frogbit => f'rɒɡbɪt
frogfish => 'frɒgfiʃ
frogged => frɒg
frogging => 'frɔ^iŋ
froggy => 'frɒgi
froghopper => 'frɔ^,hɔpә(r)
froglet => 'frɔ^lit
frogman => 'frɒgmәn
frogmarch => ˈfrɒgmɑ:tʃ
frogmen => 'frɒɡmən
frogmouth => f'rɒɡmaʊθ
frogspawn => ˈfrɒgspɔ:n
frolic => 'frɒlik
frolicked => ˈfrɔlɪkt
frolicking => f'rɒlɪkɪŋ
frolics => ˈfrɔlɪks
frolicsome => 'frɒliksәm
from => frɒm
from pillar to post => frɔm ˈpilə tu: pəust
from scratch => frɔm skrætʃ
fromage frais => ˌfrɒmɑ:ʒ ˈfreɪ
frond => 'frɒnd
frondage => 'frɒndidʒ
frondose => 'frɒndәus
fronds => frɔndz
frons => frɔnz
front => frʌnt
front bench => frʌnt bentʃ
front desk => frʌnt desk
front matter => frʌnt ˈmætə
front money => frʌnt ˈmʌni
front room => frʌnt ru:m
front runner => frʌnt ˈrʌnə
front-end loader => ˈfrʌntˌend ˈləudə
front-load => 'frʌntləud; 'frɔnt'ləud
front-running => frʌnt ˈrʌnɪŋ
front-wheel drive => ˈfrʌntˌhwi:l, -ˌwi:l
frontage => 'frʌntidʒ
frontage road => ˈfrʌntidʒ roʊd
frontages => ˈfrʌntidʒz
frontal => 'frʌntәl
frontal lobe => ˈfrʌntl ləʊb
frontality => frʌn'tæliti
frontbencher => ˌfrʌntˈbentʃə(r)
frontcourt => 'frʌnt'kɔ:t
fronted => 'frɔntid
frontier => 'frʌntjә
frontiers => ˈfrʌnˌtiəz
frontiersman => 'frʌn,tiәzmәn
frontiersmen => 'frʌntjəzmən
frontispiece => 'frʌntispi:s
frontispieces => ˈfrʌntispi:siz
frontless => 'frʌntlis
frontlet => 'frʌntlit
frontline => 'frʌntlɑɪn
frontman => ˈfrʌntmæn
fronton => 'frʌntɔn;frәun'tәun
frontrunner => 'aʊt,rʌnɚ
fronts => frʌnts
frore => frɔ:, frɔә
frosh => frɒʃ
frost => frɒst
frost heave => frɔst hi:v
frost heaving => frɔst ˈhi:viŋ
frostbite => 'frɒstbait
frostbitten => 'frɒstbitn
frosted => 'frɔstid
frostier => ˈfrɔ:sti:ə
frostily => 'frɒstɪlɪ
frostiness => frɒs'tɪnəs
frosting => 'frɒstiŋ
frosts => frɔsts
frosty => 'frɒsti
froth => frɒθ
froth at the mouth => frɔ:θ æt ðə mauθ
frothed => frɔ:θt
frothier => ˈfrɔθiə
frothily => 'frɒθili
frothiness => f'rɒθɪnəs
frothing => 'frɔθiŋ
froths => frɔ:θs
frothy => 'frɒθi
frottage => 'frɔtidʒ
froufrou => 'fru:fru:
frounce => 'frauns
frow => frau
froward => 'frәuwәd
frowardly => ˊfrouәdli
frown => fraun
frowned => fraund
frowning => fraunɪŋ
frowns => fraunz
frowst => fraust
frowsty => 'frausti
frowsy => 'frauzi
frowziness => 'frauzinis
frowzy => 'frauzi
froze => frәuz
frozen => 'frәuzn
Fructidor => ,frju:kti:'dɔ:r
fructification => .frʌktifi'keiʃәn
fructified => ˈfrʌktəˌfaɪd
fructify => 'frʌktifai
fructifying => ˈfrʌktəˌfaɪŋ
fructose => 'frʌktәus
fructuous => 'frʌktjuәs
frug => fru:^
frugal => 'fru:gәl
frugality => fru:'gæliti
frugally => frʊ'ɡəlɪ
frugivore => 'fru:dʒivɔ:(r)
frugivorous => fru:'dʒivәrәs
fruit => fru:t
fruit bat => fru:t bæt
fruit cake => fru:t keik
fruit cocktail => fru:t ˈkɔkteil
fruit cup => fru:t kʌp
fruit machine => fru:t məˈʃi:n
fruit salad => fru:t ˈsæləd
fruitage => 'fru:tidʒ
fruitarian => fru:'tєәriәn
fruitcake => 'fru:tkeik
fruitcakes => ˈfru:tˌkeɪks
fruiter => 'fru:tә
fruiterer => 'fru:tәrә
fruitful => 'fru:tful
fruitier => ˈfru:ti:ə
fruiting => f'ru:tɪŋ
fruiting body => ˈfru:tɪŋ
fruition => fru:'iʃәn
fruitless => 'fru:tlis
fruitlessness => ˊfruːtlisnis
fruitlet => 'fru:tlit
fruitwood => 'fru:twud
fruity => 'fru:ti
frumenty => 'fru:mәnti
frump => frʌmp
frumpish => 'frʌmpiʃ
frumpy => 'frʌmpi
Frunze => 'frunze
frusemide => 'fru:sәmid
frustrate => 'frʌstreit
frustrated => frʌ'streitid
frustrates => ˈfrʌstreits
frustrating => frʌ'streitiŋ
frustratingly => 'frʌstreitiŋli
frustration => frʌs'treiʃәn
frustrations => frʌst'reɪʃnz
frustule => 'frʌstju:l
frustum => 'frʌstәm
fruticose => 'fru:tikәus
fry => frai
fry-up => frai ʌp
frye => frai
fryer => fraiә
frying => 'fraɪɪŋ
fubsy => 'fʌbzi
fuchsia => fju:ʃә
fuchsias => ˈfju:ʃəz
fuchsin => 'fu:ksin
fuck => fʌk
fuck all => fʌk ɔ:l
fuck off => fʌk ɔf
fucked => fʌkt
fucker => 'fʌkә
fuckers => ˈfʌkəz
fucking => 'fʌkiŋ
fucoid => 'fju:kɔid
fucoxanthin => ,fju:kә'zænθin
fucus => 'fju:kәs
fuddle => 'fʌdl
fuddles => ˈfʌdlz
fuddling => ˈfʌdlɪŋ
fuddy-duddy => 'fʌdi,dʌdi
fudge => fʌdʒ
fudged => fʌdʒd
fudges => fʌdʒz
fudging => fʌdʒɪŋ
fuel => 'fjuәl
fuel injection => fjuəl inˈdʒekʃən
fuelled => 'fjuːəld
fuels => fjuәlz
fuelwood => f'ju:əlwʊd
fug => fʌg
fugacious => fju:'geiʃәs
fugacity => fju:'gæsiti
fugal => 'fju:gәl
fugato => fu:'^ɑ:tәj
fuggy => 'fʌgi
fugitive => 'fju:dʒitiv
fugitives => 'fjʊdʒətɪv
fugleman => 'fju:glmæn
fugu => 'fu:gu:
fugue => fju:g
fugues => fju:ɡz
fuguist => fju:'ɡɪst
Fuhrer => 'fjuərə
Fujairah => fju'dʒairə
Fuji => 'fu:dʒi:
Fujian => 'fu:'dʒjen
Fukuoka => ,fu:kә'әukә
Fukuyama => ,fuku'jɑ:mә
ful => ful
Fula => 'fu:lɑ:
Fulani => 'fu:lɑ:ni
Fulbe => 'fu:lbei
Fulbright => 'fu:lbrait
fulcrum => 'fʌlkrәm
fulfil => ful'fil
fulfill => ful'fil
fulfilled => fʊlˈfɪld
fulfillment => ful'filmәnt
fulfills => fulˈfilz
fulfils => fulˈfilz
fulgent => 'fʌldʒәnt
fulgurant => 'fʌl^jjәrәnt
fulgurate => 'fʌlgjureit
fulguration => ,fʌl^jjә'reiʃәn
fulgurite => 'fʌlgjurait
fulgurous => 'fʌl^juәrәs
Fulham => 'fulәm
fuliginous => fju:'lidʒinәs
full => ful
full beam => ful bi:m
full board => ful bɔ:d
full bore => ful bɔ:
full face => ful feis
full house => ful haus
full measure => ful ˈmeʒə
full moon => ful mu:n
full nelson => ful ˈnelsn
full of => ful ɔv
full point => ful pɔint
full professor => ful prəˈfesə
full toss => ful tɔs
full-bottomed => 'fjl'bɔtәmd
full-face => 'fʊlf'eɪs
full-fledged => 'fjl'fledʒd
full-frontal => ful ˈfrʌntl
full-grown => 'fjl'^rәjn
full-on => ful ɔn
full-rigged => 'fjl'ri^d
full-size => 'fjl'saiz
fullback => 'fulbæk
fuller => 'fulә
fullerenes => 'fʊləri:nz
Fullerton => 'fʊlətən
fulling => 'fʊlɪŋ
fullness => 'fulnis
fulltime => fu:ltaɪm
fully => 'fuli
fulmar => 'fulmә
fulminant => 'fʌlminәnt
fulminate => 'fʌlmineit
fulminated => ˈfʊlməˌneɪtid
fulminates => ˈfʊlməˌneɪts
fulminating => 'fʌlmineitiŋ
fulmination => .fʌlmi'neiʃәn
fulness => 'fjlnis
fulsome => 'fulsәm
fulsomely => 'fulsəmli
fulsomeness => 'fʊlsəmnɪs
fulton => 'fultәn
fulvous => 'fʌlvәs
fumarate => 'fju:mәreit
fumarole => 'fju:mәrәul
fumble => 'fʌmbl
fumbled => ˈfʌmbld
fumbles => ˈfʌmblz
fumbling => ˈfʌmblɪŋ
fume => fju:m
fumed => fju:md
fumet => 'fju:mit
fumigant => 'fju:migәnt
fumigate => 'fju:migeit
fumigated => ˈfju:mɪˌgeɪtid
fumigates => ˈfju:mɪˌgeɪts
fumigating => 'fju:mɪˌgeɪtɪŋ
fumitory => 'fu:mitәri
fumy => 'fju:mi
fun => fʌn
fun fur => fʌn fə:
fun house => fʌn haus
fun run => fʌn rʌn
Funafuti => ,fju:nә'fju:ti
funambulist => fju:'næmbjulist
funboard => ˈfʌnbɔ:d
Funchal => fun'ʃɑ:l
function => 'fʌŋkʃәn
functional => 'fʌŋkʃәnәl
functional food => ˈfʌŋkʃənəl fu:d
functionalism => 'fʌŋkʃәnәlizm
functionalist => 'fʌŋkʃәnәlist
functionality => ,fʌŋkәʃә'næliti
functionally illiterate => ˈfʌŋkʃənəli ɪˈlɪtərɪt
functionaries => ˈfʌŋkʃəˌneri:z
functionary => 'fʌŋkʃәnәri
functioning => 'fʌŋkʃәniŋ
functor => 'fʌŋktә
fund => fʌnd
fund-raiser => ˈfʌndˌreɪzə
fundament => 'fʌndәmәnt
fundamental => .fʌndә'mentәl
fundamentalism => .fʌndә'mentәlizm
fundamentalist => .fʌndә'mentәlist
fundamentalists => ˌfʌndəˈmentlˌɪzəmz
fundamentality => .fʌndәmen'tæliti
fundamentally => fʌndә'mentәli
funder => ˈfʌndə(r)
fundholder => 'fʌndhәuldә
fundi => 'fʌndai
fundic => 'fʌndik
funding => 'fʌndiŋ
fundraise => 'fʌnd,reiz
fundraiser => 'fʌndˌreɪzə
fundraising => 'fʌndˌreɪzɪŋ
fundus => 'fʌndәs
funeral => 'fju:nәrәl
funeral home => ˈfju:nərəl həum
funeral parlour => ˈfju:nərəl ˈpɑ:lə
funerals => ˈfju:nərəlz
funerary => 'fju:nәrәri
funereal => fju:'niәriәl
funfairs => ˈfʌnfeəz
fungal => 'fʌŋ^әl
fungi => 'fʌndʒai, 'fʌŋ^ai
fungible => 'fʌndʒibl
fungicidal => .fʌndʒi'saidl
fungicide => 'fʌndʒisaid
fungicides => 'fʌndʒɪsaɪdʒ
fungiform => 'fʌndʒifɒ:m
fungistatic => ,fʌndʒi'stætik
fungivorous => fʌn'dʒivәrәs
fungo => 'fʌŋgәu
fungoid => 'fʌŋ^ɔid
fungous => 'fʌŋgәs
fungus => 'fʌŋgәs
fungus gnat => ˈfʌŋɡəs næt
funicle => 'fju:nikl
funicular => fju:'nikjulә
funiculus => fju(:)'nikjulәs
funk => fʌŋk
funked => 'fʌŋkt
funkia => 'fʌŋkjә
funkier => ˈfʌŋki:ə
funkiness => 'fʌŋkɪnɪs
funking => fʌŋkɪŋ
funks => fʌŋks
funky => 'fʌŋki
funnel => 'fʌnl
funnel cloud => ˈfʌnəl klaud
funnelling => 'fʌnnelɪŋ
funnels => ˈfʌnəlz
funnies => ˈfʌniz
funnily => 'fʌnili
funniosity => ,fʌni'ɔsәti
funny => 'fʌni
funny farm => ˈfʌni fɑ:m
funny money => ˈfʌni ˈmʌni
funnyman => 'fʌnimæn
funster => 'fʌnstә
fur => fә:
fur seal => fə: si:l
furan => 'fjuәræn
furball => 'fə:bɔ:l
furbelow => 'fә:bilәu
furbish => 'fә:biʃ
furbished => ˈfɜ:bɪʃt
furbisher => 'fɜ:bɪʃər
furbishes => ˈfɜ:bɪʃiz
furbishing => 'fɜ:bɪʃɪŋ
furcal => 'fә:kәl
furcate => 'fә:kit
furcated => fɜ:'keɪtɪd
furcation => fә:'keiʃәn
furcula => 'fә:kjulә
furcular => 'f:kjulə
furfuraceous => ,fә:fju'reiʃәs
furfural => 'fә:fәræl
furies => 'fjuәriz
furioso => 'fjuri,әusәu
furious => 'fjuәriәs
furiousness => ˊfjuәriәsnis
furl => fә:l
furled => fə:ld
furling => fə:lɪŋ
furlong => 'fә:lɒŋ
furlongs => ˈfə:lɔŋz
furlough => 'fә:lәu
furloughed => ˈfɜ:ləʊd
furloughing => ˈfɜ:ləʊɪŋ
furloughs => ˈfɜ:ləʊz
furls => fə:lz
furmety => 'fә:mәti, -mәn-
furnace => 'fә:nis
furnaces => ˈfə:nisiz
furnish => 'fә:niʃ
furnisher => 'fә:niʃә
furnishes => ˈfə:niʃiz
furnishing => 'fә:niʃiŋ
furnishings => 'fә:niʃiŋz
furniture => 'fәnitʃә
furniture beetle => ˈfə:nitʃə ˈbi:tl
furor => 'fjuәrɒ:
furore => fju:'rɔ:ri
furosemide => fjuә'rәusәmaid
furred => fә:d
furrier => 'fә:riә
furriery => 'fә:riәri
furriness => 'fә:rinis
furring => 'fә:riŋ
furrow => 'fʌrәu
furrowed => 'fʌrəʊd
furrowing => 'fʌrəʊɪŋ
furrows => ˈfɜ:rəʊz
furry => 'fә:ri
further => 'fә:ðә
further education => ˈfə:ðə ˌedju:ˈkeiʃən
furtherance => 'fә:ðәrәns
furthermore => 'fә:ðә'mɒ:
furthermost => 'fә:ðәmәust
furthest => 'fә:ðist
furtive => 'fә:tiv
furtively => 'fɜ:tɪvlɪ
furtiveness => 'fə:tivnis
furuncle => 'fjuәrʌŋkl
furuncular => fjjә'rʌŋkjjlә(r)
furunculosis => fju,rʌŋkju'lәusis
furunculous => fjjә'rʌŋkjjlәs
fury => 'fjuri
furze => fә:z
furzy => 'fә:zi
fusain => fju'zein
fusarium => fju:'zæriәm
fuscous => 'fʌskәs
fuse => fju:z
fused => fju:zd
fusee => fju:'zi:
fuselage => 'fju:zilɑ:dʒ
fuselages => f'ju:zəlɑ:ʒɪz
fuses => fju:ziz
fusibility => .fju:zi'biliti
fusible => 'fju:zibl
fusiform => 'fju:zifɒ:m
fusil => 'fju:zil
Fusilier => ,fju:zi'liə
Fusiliers => ,fju:zi'liə
fusillade => .fju:zi'leid
fusilladed => ˈfju:səˌlɑ:did
fusillades => ˈfju:səˌlɑ:dz
fusillading => ˈfju:səˌlɑ:dɪŋ
fusimotor => 'fju:zimәjtә(r)
fusing => 'fju:ziŋ
fusion => 'fju:ʒәn
fusion bomb => ˈfju:ʒən bɔm
fusional => 'fju:ʒәnәl
fusionism => 'fju:ʒәnizәm
fusionist => 'fju:ʒәnist
fusions => ˈfju:ʒənz
fuss => fʌs
fussbudget => 'fʌsbʌdʒit
fussed => fʌst
fusses => fʌsiz
fussier => 'fʌsɪər
fussily => 'fʌsili
fussing => fʌsɪŋ
fusspot => 'fʌspɒt
fusspots => 'fʌspɒt
fussy => 'fʌsi
fustanella => ,fʌstә'nelә
fustian => 'fʌstiәn
fustic => 'fʌstik
fustier => ˈfʌstiə
fustiness => 'fʌstinis
fusty => 'fʌsti
futhark => 'fu:θɑ:k
futile => 'fju:tail
futilitarian => ,fju:tili'teәriәn
futility => fju:'tiliti
futon => ˈfu:tɒn
futtock => 'fʌtәk
future => 'fju:tʃә
future perfect => ˈfju:tʃə ˈpə:fikt
future shock => ˈfju:tʃə ʃɔk
futureless => 'fju:tʃәlis
futurism => 'fju:tʃәrizm
futurist => 'fju:tʃәrist
futuristic => .fju:tʃә'ristik
futuristically => ,fju:tʃə'ristikəli
futurities => fjuˈtjuəritiz
futurity => fju:'tjuәriti
futurological => fjuːtʃərə'lɒdʒɪkəl
futurologist => ˌfju:tʃəˈrɒlədʒɪst
futurology => .fju:tʃә'rɒlәdʒi
futz => fʌts
fuze => fju:z
fuzee => fju:'zi:
fuzz => fʌz
fuzzbox => 'fʌzbɔks
fuzzed => fʌzd
fuzzier => ˈfʌzi:ə
fuzzily => 'fʌzili
fuzzy => 'fʌzi
fuzzy-wuzzy => 'fʌzi'wʌzi
fyke => faik
fylfot => 'faikfɒk
fynbos => 'finbɔs
fyrd => 'fəd
fytte => fit