slash => slæʃ
slash pine => slæʃ pain
slashed => slæʃt
slasher => 'slæʃә
slashes => slæʃiz
slashing => 'slæʃiŋ
slat => slæt
slate => sleit
slated => ˈsleɪtɪd
slater => 'sleitә
slates => s'leɪts
slather => 'slæðә
slathered => ˈsleiðəd
slathering => ˈsleiðərɪŋ
slathers => ˈsleiðəz
slating => 'sleitiŋ
slats => slæts
slatted => 'slætid
slattern => 'slætәn
slatternly => 'slætәnli
slatterns => ˈslætə:nz
slatting => s'lætɪŋ
slaty => 'sleiti
slaughter => 'slɒ:tә
slaughtered => ˈslɔ:təd
slaughterhouse => 'slɒ:tәhaus
slaughterhouses => ˈslɔ:təhausiz
slaughtering => 'slɔ:tərɪŋ
slaughterous => 'slɒ:tәrәs
slaughters => ˈslɔ:təz
slav => slɑ:v, slæv
slave => sleiv
slave trader => sleiv ˈtreɪdə
slave-drive => 'sleivdraiv
slave-driver => sleiv ˈdraivə
slave-making ant => 'sleiv,meikiŋ
slaved => sleivd
slaveholder => 'sleiv.hәuldә
slaveholding => 'sleiv,hәjldiŋ
slaver => 'sleivә
slavered => ˈslævəd
slavering => ˈslævərɪŋ
slavers => ˈslævəz
slavery => 'sleivәri
slavey => 'sleivi
Slavic => 'slævik, 'slɑ:v-
slaving => 'sleiviŋ
slavish => 'sleiviʃ
slavishly => 'sleɪvɪʃlɪ
Slavonic => slә'vɔnik
Slavophile => 'slævәfil
slavs => slɑ:vz
slaw => slɒ:
slay => slei
slaying => sleɪŋ
sleaze => sli:z
sleazeball => 'sli:zbɔ:l
sleazier => ˈsli:zi:ə
sleazy => 'sleizi
sled => sled
sledded => sledid
sledding => 'slediŋ
sledge => sledʒ
sledged => sledʒd
sledgehammer => 'sledʒ.hæmә
sledgehammers => ˈsledʒˌhæməz
sledges => sledʒz
sledging => 'sledʒɪŋ
sleds => sledz
sleek => sli:k
sleeked => sli:kt
sleeker => 'sli:kә
sleekit => 'sli:kit
sleekly => sli:klɪ
sleekness => sli:knəs
sleeks => sli:ks
sleeky => s'li:kɪ
sleep => sli:p
sleep tight => sli:p tait
sleep-out => 'sli:pajt
sleeper => 'sli:pә
sleepier => ˈsli:pi:ə
sleepily => 'sli:pili
sleepiness => 'sli:pinis
sleeping => 'sli:piŋ
sleeping bag => 'sli:piŋ
sleeping car => ˈsli:pɪŋ kɑ:
sleeping policeman => ˈsli:pɪŋ pəˈli:smən
sleepless => 'sli:plis
sleepover => ˈsli:pəʊvə(r)
sleeps => sli:ps
sleepwalk => 'sli:pwɔ:k
sleepwalked => ˈsli:pˌwɔ:kt
sleepwalker => 'sli:pwɒ:kә
sleepwalking => 'sli:pwɒ:kiŋ
sleepwalks => ˈsli:pˌwɔ:ks
sleepwear => 'sli:pwєә
sleepy => 'sli:pi
sleepyhead => 'sli:pihed
sleet => sli:t
sleeted => sli:tid
sleeting => sli:tɪŋ
sleets => sli:ts
sleety => 'sli:ti
sleeve => sli:v
sleeve note => sli:v nəut
sleeveen => 'sli:vi:n, sli:'vi: n
sleeveless => 'sli:vlis
sleeving => 'sli:viŋ
sleigh => slei
sleighed => sleɪd
sleighing => 'sleiiŋ
sleighs => sleɪz
sleight => slait
sleight of hand => ˌslaɪt əv ˈhænd
slender => 'slendә
slender loris => ˈslendə ˈlɔ:ris
slenderize => 'slendәraiz
slenderly => 'slendəlɪ
slenderness => 'slɛndɚnɪs
slept => slept
sleuth => slu:θ
sleuthing => ˈslu:θɪŋ
sleuths => slu:θs
slew => slu:
slewed => s'lu:d
slewing => 'slu:iŋ
slews => slu:z
sley => slei
slice => slais
sliceable => 'slaisәbl
sliced => slaist
slicer => 'slaisә
slices => slaisiz
slicing => 'slaisiŋ
slick => slik
slicked => slikt
slickenside => 'slikәn,said
slicker => 'slikә
slicking => 'slikiŋ
slickly => 'slikli
slickness => 'sliknis
slicks => sliks
slid => slid
slide => slaid
slide projector => slaid prəˈdʒektə
slider => 'slaidә
slideshow => slaid'ʃəu
sliding => 'slaidiŋ
sliding door => ˈslaidiŋ dɔ:
sliding scale => 'slaidiŋ
sliding seat => ˈslaidiŋ si:t
slight => slait
slighted => slaitid
slighter => slaitə
slighting => 'slaitiŋ
slightingly => s'laɪtɪŋlɪ
slightly => 'slaitli
slightness => 'slaitnis
slights => slaits
slily => 'slaili
slim => slim
slime => slaim
slime mould => slaɪm məuld
slimeball => ˈslaɪmbɔ:l
slimed => slaɪmd
slimes => slaɪmz
slimier => ˈslaɪmi:ə
sliminess => 'slaiminis
sliming => 'slaimiŋ
slimline => ˈslɪmlaɪn
slimmed => slimd
slimmer => 'slimә(r)
slimming => 'slimiŋ
slimness => 'slimnis
slimy => 'slaimi
sling => sliŋ
slingback => 'sliŋbæk
slinger => 'sliŋә
slings => sliŋz
slingshot => 'sliŋʃɒt
slink => sliŋk
slinkier => ˈsliŋkiə
slinking => slɪŋkɪŋ
slinks => slɪŋks
slinky => 'slinki
slip => slip
slip case => slip keis
slip cover => slip ˈkʌvə
slip form => slip fɔ:m
slip road => slip roʊd
slip-slop => 'slipslɔp
slipcover => 'slip.kʌvә
slipcovered => 'slɪp,kʌvə(r)
slipcovers => ˈslipˌkʌvəz
slipknot => 'slipnɒt
slipover => 'slip.әuvә
slipovers => 'slɪpəʊvə
slippage => 'slipidʒ
slipper => 'slipә
slippery => 'slipәri
slippery slope => ˈslipəri sləup
slipping => 'slipiŋ
slippy => 'slipi
slipshod => 'slipʃɒd
slipstone => 'slipstәjn
slipstream => 'slipstri:m
slipware => 'slipweә(r)
slipway => 'slipwei
slipways => ˈslipweiz
slit => slit
slit trench => slit trentʃ
slit-eyed => 'slitaid
slither => 'sliðә
slithered => ˈslɪðəd
slithering => ˈslɪðərɪŋ
slithers => ˈslɪðəz
slithery => 'sliðri
slits => slits
slitted => slɪt
slitter => 'slitә
slitting => 'slitiŋ
slitty => s'lɪtɪ
sliver => 'slivә
slivering => 'slivәriŋ
slivers => ˈslɪvəz
slivovitz => 'slivә,vits
slo-mo => ˈsləʊ məʊ
sloan => slәun
slob => slɒb
slobber => 'slɒbә
slobbered => ˈslɔbəd
slobbers => ˈslɔbəz
slobbery => 'slɔbәri
slobs => slɔbz
sloe => slәu
sloe gin => sləu dʒɪn
sloe-eyed => 'slәjaid
sloes => sləuz
slog => slɒg
slogan => 'slәugәn
sloganeer => .slәugә'niә
sloganeering => ˌsləʊgəˈnɪərɪŋ
slogans => s'ləʊɡənz
slogged => slɔgd
slogger => 'slɔ^ә(r)
slogging => 'slɔ^iŋ
slogs => slɔgz
sloop => slu:p
sloops => slu:ps
sloot => slu:t
slop => slɒp
slop basin => slɔp ˈbeisn
slop out => slɔp aut
slope => slәup
slopes => sləups
sloping => 'slәjpiŋ
slopped => slɔpt
sloppier => ˈslɔpi:ə
sloppily => 'slɒpɪlɪ
slopping => s'lɒpɪŋ
sloppy => 'slɒpi
slosh => slɒʃ
sloshes => slɔʃiz
sloshing => slɒʃɪŋ
sloshy => s'lɒʃɪ
slot => slɒt
slot car => slɔt kɑ:
slotback => 'slɔtbæk
sloth => slәuθ
sloth bear => slɔ:θ bɛə
slothful => 'slәuθful
slothfully => ˊslouθfuli
slothfulness => ˊslouθfulnis
sloths => slɔ:θs
slotting => 'slɔtiŋ
slouch => slautʃ
slouch hat => slaʊtʃ hæt
slouched => slaʊtʃt
slouches => slaʊtʃiz
slouching => 'slautʃiŋ
slouchy => 'slautʃi
slough => slau
sloughed => s'lʌft
sloughs => slu:z
sloughy => 'slaui
Slovak => 'slәuvæk
Slovakia => slәu'vækiә
Slovakian => slәu'vækiәn
sloven => 'slʌvn
slovene => 'slәuvi:n
slovenes => 'sləuvi:n; sləu'vi:n
Slovenia => slәu'vi:njә
Slovenian => slәu'vi:njәn
slovenliness => 'slʌvnlinis
slovenly => 'slʌvәnli
slow => slәu
slow handclap => ˌsləʊ ˈhændklæp
slow loris => sləu ˈlɔ:ris
slow-witted => 'slәj'witid
slowcoaches => 'sləukəutʃ
slowdown => 'slәudaun
slowdowns => 'sləʊdəʊn
slowed => sləud
slowish => 'slәjiʃ
slowly => 'slәuli
slowness => 'slәunis
slowpoke => 'slәupәuk
slub => slʌb
slubbed => slʌbd
sludge => slʌdʒ
sludges => slʌdʒz
sludgy => 'slʌdʒi
slue => slu:
slued => s'lu:d
slues => slu:z
slug => slʌg
slugabed => 'slʌgәbed
slugfest => 'slʌgfest
sluggard => 'slʌgәd
sluggardly => 'slʌ^әdli
slugged => slʌɡd
slugger => 'slʌgә
slugging => 'slʌ^iŋ
sluggish => 'slʌgiʃ
sluggishness => 'slʌɡɪʃnəs
slugs => slʌ^z
sluice => slu:s
sluiced => slu:st
sluices => slu:siz
sluicing => s'lu:sɪŋ
sluing => slu:ɪŋ
sluit => slu:t
slum => slʌm
slumber => 'slʌmbә
slumber party => ˈslʌmbə ˈpɑ:ti
slumberland => 'slʌmbәlænd
slumberous => 'slʌmbәrәs
slumbers => ˈslʌmbəz
slumgullion => slʌm'^ʌljәn
slumlord => 'slʌmlɒ:d
slummer => 'slʌmә
slummock => 'slʌmәk
slummy => 'slʌmi
slump => slʌmp
slumped => slʌmpt
slumping => s'lʌmpɪŋ
slumps => slʌmps
slums => slʌmz
slung => slʌŋ
slunk => slʌŋk
slur => slә:
slurp => slә:p
slurped => slə:pt
slurping => slə:pɪŋ
slurps => slə:ps
slurred => slə:d
slurry => 'slә:ri. 'slʌ-
slurs => slə:z
slush => slʌʃ
slush fund => slʌʃ fʌnd
slushed => slʌʃ
slushes => slʌʃiz
slushier => ˈslʌʃiə
slushiness => s'lʌʃɪnəs
slushy => 'slʌʃi
slut => slʌt
sluts => s'lʌts
sluttish => 'slʌtiʃ
slutty => slʌtɪ
sly => slai
slyboots => 'slaibu:ts
slyly => 'slaili
slyness => 'slainis
slype => slaip
smack => smæk
smacked => smækt
smacker => 'smækә
smackers => 'smækə
smacking => 'smækiŋ
smacks => smæks
small => smɒ:l
small forward => smɔ:l ˈfɔ:wəd
small print => smɔ:l print
small slam => smɔ:l slæm
small-bore => 'smɔ:lbɔ:(r)
small-minded => smɔ:l'maindid
small-mindedly => 'smɔ:l'maindidli
small-time => 'smɔ:l'taim
small-town => 'smɔ:l'tajn
smallholder => 'smɒ:l.hәuldә
smallholding => 'smɒ:l.hәuldiŋ
smallish => 'smɒ:liʃ
smallmouth => 'smɔ: lmajθ
smallness => 'smɒ:lnis
smallpox => 'smɒ:lpɒks
smalls => s'mɔ:lz
smalt => smɒ:lt
smaltite => 'smɔ:ltait
smarm => smɑ:m
smarmier => ˈsmɑ:mi:ə
smarmy => 'smɑ:mi
smart => smɑ:t
smart alec => smɑ:t ˈælik
smart aleck => ˈælɪk
smart bomb => smɑ:t bɔm
smarted => smɑ:tid
smarten => 'smɑ:tn
smartened => ˈsmɑ:tnd
smartening => ˈsmɑ:tnɪŋ
smartens => ˈsmɑ:tnz
smarting => 'smɑ:tiŋ
smartish => 'smɑ:tiʃ
smartly => 'smɑ:ti
smartness => 'smɑ:tnis
smartweed => 'smɑ:twi:d
smarty => 'smɑ:ti
smarty-pants => 'smɑ:tipænts
smash => smæʃ
smashed => smæʃt
smasher => 'smæʃә
smashers => 'smæʃə
smashes => smæʃiz
smashing => 'smæʃiŋ
smatter => 'smætә
smattering => 'smætәriŋ
smaze => smeiz
smear => smiә
smear test => smiə test
smeared => smiəd
smearer => 'smiәrә
smearing => 'smiәriŋ
smears => smiəz
smeary => 'smiәri
smectic => 'smektik
smectite => 'smektait
Smedley => 'smedli
smegma => 'sme^mә
smell => smel
smell blood => smel blʌd
smeller => 'smelә
smellier => ˈsmeli:ə
smelling => smelɪŋ
smelling salts => ˈsmelɪŋ
smelly => 'smeli
smelt => smelt
smelter => 'smeltә
smelters => ˈsmeltəz
smelting => 'smeltiŋ
smew => smju:
smidgen => 'smidʒin
smilax => 'smailæks
smile => smail
smiling => 'smailiŋ
smirch => smә:tʃ
smirched => smɜ:tʃt
smirching => smɜ:tʃɪŋ
smirk => smә:k
smirked => smɜ:kt
smirking => smɜ:kɪŋ
smirks => smɜ:ks
smite => smait
smites => smaɪts
smith => smiθ
smithereen => ,smiðә'ri:n
smithereens => 'smiðә'ri:nz
Smithers => 'smiðәz
smithery => 'smiθәri
Smithson => 'smiθsn
smithsonite => 'smiθsә,nait
smithy => 'smiði
smiting => smaɪtɪŋ
smitten => 'smitn
smock => smɒk
smocked => smɒkt
smocking => 'smɒkiŋ
smocks => smɔks
smog => smәug
smoggy => 'smɔ^i,'smɔ:-
smogs => smɔɡz
smokable => 'smәjkәbl
smoke => smәuk
smoke alarm => sməuk əˈlɑ:m
smoke signal => sməuk ˈsiɡnəl
smoke tree => sməuk tri:
smoke-free => sməuk fri:
smokebox => 'smәjkbɔks
smoked => smәukt
smokehouse => 'smәukhaus
smokejumper => 'sməuk,dʒʌmpə
smokeless => 'smәuklis
smoker => 'smәukә
smokers => ˈsməʊkəz
smokes => s'məʊks
smokestack => 'smәukstæk
smokestacks => ˈsməʊkˌstæks
smokey => 'smәuki
smokie => 'smәuki
smokier => ˈsməʊki:ə
smokily => 'smәukili
smokiness => s'məʊkɪnəs
smoking => 'smәukiŋ
smoking gun => ˈsməʊkɪŋ ɡʌn
smoking jacket => ˈsməʊkɪŋ ˈdʒækit
smoko => 'smәukәu
smoky => 'smәuki
smolder => 'smәuldә
smoldered => ˈsməʊldəd
smoldering => 'sməʊdərɪŋ
smolders => ˈsməʊldəz
smolensk => 'smɔlensk,smɔ'l-
Smollett => 'smɔlit
smolt => smәult
smooch => smu:tʃ
smooched => smu:tʃt
smooches => smu:tʃiz
smooching => smu:tʃɪŋ
smoochy => s'mu:tʃaɪ
smoodge => smu:dʒ
smooth => smu:ð
smooth hound => smu:ð haund
smooth-faced => 'smu:ðfeist
smoothbore => 'smu:ðbɒ:
smoother => 'smu:ðә
smoothie => 'smu:ði
smoothies => s'mu:ðɪz
smoothing => 'smu:ðiŋ
smoothly => 'smu:ðli
smoothness => 'smu:ðnis
smoothy => 'smu:ði
smorgasbord => 'smɔ:^әsbɔ:d
smorzando => 'smɔrtsɑ:ndәu
smote => smәut
smother => 'smʌðә
smothered => ˈsmʌðəd
smothers => ˈsmʌðəz
smoulder => 'smәuldә
smouldered => ˈsməʊldəd
smouldering => 'smәuldәriŋ
smoulders => ˈsməʊldəz
smudge => smʌdʒ
smudged => smʌdʒd
smudges => s'mʌdʒɪz
smudgier => ˈsmʌdʒiə
smudgily => 'smʌdʒili
smudginess => 'smʌdʒinis
smudgy => 'smʌdʒi
smug => smʌg
smugger => smʌgə
smuggle => 'smʌgl
smuggled => ˈsmʌɡld
smuggler => 'smʌglә
smugglers => ˈsmʌɡ(ə)lərs
smuggles => ˈsmʌɡlz
smut => smʌt
smuts => smʌts
smutted => smʌtid
smuttier => ˈsmʌtɪə
smuttily => s'mʌtɪlɪ
smuttiness => ˊsmʌtinis
smutting => smʌtɪŋ
smutty => 'smʌti
Smyrna => 'smә:nә
Smyth => smiθ, smaiθ
snack => snæk
snackette => snæ'ket
snaffle => 'snæfl
snaffled => ˈsnæfld
snaffles => ˈsnæflz
snaffling => ˈsnæflɪŋ
snafu => snæ'fu:
snafued => snæˈfu:d
snafuing => snæˈfu:ɪŋ
snag => snæg
snagged => 'snæ^id
snagging => 'snægɪŋ
snaggle-toothed => 'snægltu:θt
snaggy => 'snæ^i
snags => snægz
snail => sneil
snail-paced => 'sneilpeist
snailfish => 'sneilfiʃ
snake => sneik
snake charmer => sneik ˈtʃɑ:mə
snake dance => sneik dɑ:ns
snake fence => sneik fens
snake oil => sneik ɔil
snakebird => 'sneikbә:d
snakebite => 'sneikbait
snakefish => s'neɪkfɪʃ
snakehead => 'sneikhed
snakeroot => 'sneikru:t
snakes => sneiks
snakeskin => 'sneikskin
snakewood => 'sneikwud
snaking => 'sneikiŋ
snaky => 'sneiki
snap => snæp
snap bean => snæp bi:n
snap fastener => snæp ˈfɑ:sənə
snap roll => snæp rəul
snap-brim => 'snæpbrim
snapdragon => 'snæpdræ^әn
snapdragons => ˈsnæpˌdrægənz
snapper => 'snæpә
snappier => ˈsnæpi:ə
snappily => 'snæpili
snappish => 'snæpiʃ
snappy => 'snæpi
snapshot => 'snæpʃɒt
snapshots => ˈsnæpˌʃɔts
snare => snєә
snare drum => sneə drʌm
snared => sneəd
snares => sneəz
snarf => snɑ:f
snaring => sneərɪŋ
snark => snɑ:k
snarky => ˈsnɑ:ki
snarl => snɑ:l
snarled => snɑ:rld
snarler => 'snɑ:lә
snarling => snɑ:lɪŋ
snarlingly => 'snɑ:liŋli
snarls => snɑ:lz
snarly => 'snɑ:li
snash => snæʃ
snatch => snætʃ
snatch squad => snætʃ skwɔd
snatched => snætʃt
snatcher => 'snætʃә
snatchers => 'snætʃə
snatchy => 'snætʃi
snazzier => ˈsnæzi:ə
snazzy => 'snæzi
sneak => sni:k
sneaked => sni:kt
sneaker => 'sni:kә
sneakier => ˈsni:kiə
sneakily => ˈsni:kɪlɪ
sneaking => 'sni:kiŋ
sneakingly => s'ni:kɪŋlɪ
sneaks => sni:ks
sneaky => 'sni:ki
sneck => s'nek
sneer => sniә
sneered => sniəd
sneering => 'sniәriŋ
sneeringly => 'sniәriŋli
sneers => sniəz
sneeze => sni:z
sneezed => sni:zd
sneezer => 'sni:zə
sneezeweed => sni:z'wi:d
sneezewort => s'ni:zwɜ:t
sneezy => 'sni:zi
snell => snel
snib => snib
snick => snik
snicked => snikt
snicker => 'snikә
snickered => ˈsnɪkəd
snickering => ˈsnɪkərɪŋ
snickers => ˈsnɪkəz
snicket => 'snikit
snicking => snikɪŋ
snicks => sniks
snide => snaid
sniff => snif
sniffed => snift
sniffer => 'snifә
sniffer dog => s'nɪfər dɔɡ
sniffle => 'snifl
sniffled => ˈsnɪfəld
sniffles => ˈsnɪfəlz
sniffling => ˈsnɪfəlɪŋ
sniffs => snifs
sniffy => 'snifi
snifter => 'sniftә
snifters => ˈsniftəz
snig => sni^
snigger => 'snigә
sniggered => ˈsnɪgəd
sniggering => ˈsnɪgərɪŋ
sniggers => ˈsnɪgəz
sniggle => 'snigl
snip => snip
snipe => snaip
sniped => snaɪpt
sniper => 'snaipә
snipers => 'snaipəz
snipes => snaɪps
sniping => snaɪpɪŋ
snipped => snɪpt
snippet => 'snipit
snippets => ˈsnipits
snippety => 'snipiti
snipping => 'snipiŋ
snippy => 'snipi
snit => snit
snitch => snitʃ
snitched => snitʃt
snitches => snitʃiz
snitching => snitʃɪŋ
snivel => 'snivl
sniveling => 'snɪv(ə)l
snivelled => ˈsnɪvəld
snivelling => ˈsnɪvlɪŋ
snivels => ˈsnɪvəlz
sno-cone => 'snəukəun
snob => snɒb
snobbery => 'snɒbәri
snobbish => 'snɒbiʃ
snobbism => 'snɔbizәm
snobby => 'snɔbi
SNOBOL => 'snәjbɔl
snobs => snɔbz
snoek => snu:k
snog => snɒg
snogged => snɔgd
snogging => snɔgɪŋ
snogs => snɔgz
snood => snu:d
snook => snu:k. snuk
snooker => 'snu:kә
snookered => ˈsnʊkəd
snookering => ˈsnʊkərɪŋ
snookers => ˈsnʊkəz
snoop => snu:p
snooped => snu:pt
snooper => 'snu:pә
snoopers => 'snu:pə
snooperscope => 'snu:pәskәup
snooping => snu:pɪŋ
snoops => snu:ps
snoopy => 'snu:pi
snoot => snu:t
snootful => 'snu:tfjl
snootier => ˈsnu:ti:ə
snooty => 'snu:ti
snooze => snu:z
snoozed => snu:zd
snoozes => snu:ziz
snoozing => snu:zɪŋ
snore => snɒ:
snored => snɔ:d
snorer => 'snɒ:rә
snores => snɔ:z
snoring => snɔ:ɪŋ
snorkel => 'snɔ:kl
snorkeling => ˈsnɔ:klɪŋ
snorkelling => ˈsnɔ:kəlɪŋ
snorkels => ˈsnɔ:kəlz
snort => snɒ:t
snorted => snɔ:tid
snorter => 'snɔ:tә
snorting => snɔ:tɪŋ
snorts => snɔ:ts
snot => snɒt
snot-nosed => 'snɔtnəuzd
snots => snɒt
snotter => 'snɔtә
snotty => 'snɒti
snotty-nosed => 'snɔti,nəuzd
snout => snaut
snout beetle => snaʊt ˈbi:tl
snouts => snaʊts
snouty => 'snauti
snow => snәu
snow cone => snəu kəun
snow goose => snəu ɡu:s
snow gun => snəu ɡʌn
snow job => snəu dʒɔb
snow pea => snəu piː
snow tire => snəu ˈtaiə
snow-capped => ˈsnəʊkæpt
snow-in-summer => 'snəuin'sʌmə
snowball => 'snәubɒ:l
snowballed => ˈsnəʊˌbɔ:ld
snowballing => ˈsnəʊˌbɔ:lɪŋ
snowballs => ˈsnəʊˌbɔ:lz
snowbank => 'snәubæŋk
snowbell => 'snәjbel
snowberry => 'snәubәri
snowbird => 'snәubә:d
snowblink => 'snәjbliŋk
snowblower => ˈsnəʊbləʊə(r)
snowboard => 'snәubɔ:d
snowboarded => ˈsnəʊˌbɔ:did
snowboarding => ˈsnəʊbɔ:dɪŋ
snowboards => ˈsnəʊˌbɔ:dz
snowbound => 'snәjbajnd
snowcap => 'snәukæp
snowcat => 'snәjkæt
Snowden => 'snәudn
Snowdon => 'snәjdәn
snowdrift => 'snәudrift
snowdrifts => ˈsnəʊˌdrɪfts
snowdrop => 'snәjdrɔp
snowdrops => ˈsnəudrɔps
snowed => snəud
snowfall => 'snәufɒ:l
snowfalls => ˈsnəʊˌfɔ:lz
snowfield => 'snәjfi:ld
snowflake => 'snәufleik
snowflakes => 'snəʊfleɪks
snowier => ˈsnəʊi:ə
snowline => ˈsnəʊlaɪn
snowmaking => 'snәj,meikiŋ
snowman => 'snәumæn
snowmelt => 'snәjmelt
snowmen => 'snəumen
snowmobile => 'snәumәubi:l
snowmobiled => ˈsnəuməˌbi:ld
snowmobiles => ˈsnəuməˌbi:lz
snowmobiling => ˈsnəuməˌbi:lɪŋ
snowpack => 'snәupæk
snowplow => 'snәjplaj
snows => snəuz
snowscape => 'snәjskeip
snowshoe => 'snәuʃu:
snowshoed => ˈsnəuʃu:d
snowshoeing => ˈsnəuʃu:ɪŋ
snowshoes => s'nəʊʃu:z
snowslide => 'snәuslaid
snowstorm => 'snәustɒ:m
snowstorms => ˈsnəʊˌstɔ:mz
snowsuit => 'snәusju:t
snowy => 'snәui
snub => snʌb
snub-nosed => 'snʌbnәjzd
snubbed => snʌbd
snubber => 'snʌbә
snubbing => snʌbɪŋ
snubs => snʌbz
snuck => snʌk
snuff => snʌf
snuffbox => 'snʌfbɒks
snuffed => snʌft
snuffer => 'snʌfә
snuffers => s'nʌfəz
snuffing => snʌfɪŋ
snuffle => 'snʌfl
snuffled => ˈsnʌfəld
snuffling => 'snʌfliŋ
snuffs => snʌfs
snuffy => 'snʌfi
snug => snʌg
snugged => snʌgd
snugger => snʌgə
snuggle => 'snʌgl
snuggled => ˈsnʌgəld
snuggles => ˈsnʌgəlz
snuggling => ˈsnʌgəlɪŋ
snugly => 'snʌgli
snugness => 'snʌgnis
snugs => snʌgz
so => sәu
so much as => səʊ mʌtʃ æz
so-and-so => 'sәu, әn(d)sәu
so-so => 'sәusәu
soak => sәuk
soakage => 'sәukidʒ
soakaway => 'səʊkəweɪ
soaker => 'sәukә
soaking => 'sәukiŋ
soaks => səuks
soap => sәup
soapberry => 'sәupbәri
soapbox => 'sәupbɒks
soapboxes => ˈsəupbɔksiz
soapfish => 'səʊpfɪʃ
soapier => ˈsəʊpi:ə
soapily => 'səʊpɪlɪ
soapiness => 'səʊpɪnəs
soaping => 'sәupiŋ
soapstone => 'sәupstәun
soapsuds => 'sәjpsʌdz
soapy => 'sәupi
soar => sɒ:
soaraway => 'sɔ:rә,wei
soared => sɔ:d
soaring => 'sɔ:riŋ 'sɔәr-
soars => sɔ:z
sob => sɒb
sobbed => 'sɒbd
sobbing => 'sɔbiŋ
sobbingly => 'sɔbiŋli
sober => 'sәubә
sobered => ˈsəubəd
soberer => ˈsəubəə
sobering => ˈsəʊbərɪŋ
sobers => ˈsəubəz
sobersided => 'səubə,saidid
sobersides => 'sәubәsaidz
sobriety => sә'braiiti
sobriquet => 'sәubrikei
sobs => 'sɒbz
socage => 'sɔkidʒ
soccer => 'sɒkә
soccer mom => ˈsɔkə mɔm
Sochi => 'sәutʃi
sociability => .sәuʃә'biliti
sociable => 'sәuʃәbl
sociably => 'sәuʃәbli
social => 'sәuʃәl
social anthropology => ˈsəuʃəl ˌænθrəˈpɔlədʒi:
social assistance => ˈsəuʃəl əˈsistəns
social climber => ˈsəuʃəl ˈklaɪmə
social climbing => ˈsəuʃəl ˈklaimiŋ
social democracy => ˈsəuʃəl diˈmɔkrəsi
social democrat => ˈsəuʃəl ˈdeməkræt
social engineering => ˈsəuʃəl ˌendʒiˈniəriŋ
social fund => ˈsəuʃəl fʌnd
social gospel => ˈsəuʃəl ˈɡɔspəl
social housing => ˈsəuʃəl ˈhauziŋ
social networking => ˈsəuʃəl ˈnetwə:kiŋ
social psychologist => ˈsəuʃəl saɪˈkɔlədʒɪst
social science => ˈsəuʃəl ˈsaiəns
social scientist => ˈsəuʃəl ˈsaiəntist
social security => ˈsəuʃəl siˈkjuəriti
social services => ˈsəuʃəl /ˈsɜːvɪsis/
social work => ˈsəuʃəl wə:k
social worker => ˈsəuʃəl ˈwə:kə
socialisation => ,səuʃəlai'zeiʃən, -li'z-
socialise => 'sәjʃәlaiz
socialised => 'səʊʃəlaɪz
socialising => 'səʊʃəlaɪz
socialism => 'sәuʃәlizm
socialist => 'sәuʃәlist
socialist realism => ˈsəuʃəlist ˈri:əˌlɪzəm
socialistic => .sәuʃә'listik
socialists => ˈsəuʃəlists
socialite => 'sәuʃәlait
socialites => ˈsəʊʃəˌlaɪts
sociality => ,sәuʃi'æliti
socialization => .sәuʃәlai'zeiʃәn
socialize => 'sәuʃәlaiz
socializes => ˈsəʊʃəˌlaɪziz
socially => 'sәuʃәli
societal => sә'saiәtl
societies => səˈsaiətiz
society => sә'saiәti
socio- => ˈsəʊsiəʊ
socio-political => səʊsi':əʊpəl'ɪtɪkl
sociobiologist => səʊsi:əʊba'ɪɒlədʒɪst
sociobiology => ,sәuʃiәu,bai'ɔlәdʒi
sociocultural => .sәuʃiәu'kʌltʃrәl
sociodemographic => səʊsi'ːəʊˌdeməˈɡræfɪk
socioecology => ,sәjsiәji:'kɔlәdʒi, -ʃi-
socioeconomic => 'sәuʃiәu,i:kә'nɔmik
sociolect => 'sәjsiәjlekt, -ʃi-
sociolinguist => ˌsəusiəuˈliŋɡwist
sociolinguistic => ,sәuʃiәuliŋ^'wistik
sociolinguistics => ,sәjsiәjliŋ'^wistiks, -ʃi-
sociological => .sәusiә'lɒdʒikl
sociologically => ˌsəʊsɪə'lɒdʒɪklɪ
sociologist => .sәusi'ɒlәdʒist
sociologists => ,səʊsɪ'ɒlədʒɪst
sociology => .sәusi'ɒlәdʒi
sociometric => səʊsi:əʊ'metrɪk
sociometry => .sәusi'ɒmitri
sociopath => 'sәusiәpæθ
sociopathic => sәusiәu'pæθik
sociopolitical => .sәusiәupә'litikl
socioreligious => ,sәjsiәjri'lidʒәs, -ʃi-
sock => sɒk
sockdolager => sɒk'dɒlәdʒә
socked => sɒk
sockeroo => .sɒkә'ru:
socket => 'sɒkit
socket wrench => ˈsɔkit rentʃ
sockeye => 'sɒkai
socking => ˈsɒkɪŋ
socko => 'sɒkәu
socle => 'sɒkl
Socotra => sәj'kәjtrә, 'sɔkә-
Socrates => 'sɒkrәti:z
Socratic => sɔ'krætik
Socred => 'sɔkred
sod => sɒd
sod all => sɔd ɔ:l
soda => 'sәudә
soda bread => ˈsəudə bred
soda cracker => ˈsəudə ˈkrækə
soda lake => ˈsəudə leik
soda pop => ˈsəudə pɔp
soda siphon => ˈsəʊdə ˈsaɪfən
sodalite => 'sәjdәlait
sodalities => səuˈdælitiz
sodality => sәu'dæliti
sodas => ˈsəudəz
sodbuster => 'sɒdbʌstə
sodded => sɔdid
sodden => 'sɒdn
sodding => ˈsɒdɪŋ
sodic => 'sәjdik
sodium => 'sәudiәm
Sodom => 'sɒdәm
sodomite => 'sɒdәmait
sodomize => 'sɔdәmaiz
sodomy => 'sɔdәmi
sods => sɔdz
soever => sәu'evә
sofa => 'sәufә
sofa bed => ˈsəufə bed
sofas => ˈsəufəz
soffit => 'sɒfit
sofia => 'sәufjә
soft => sɒft
soft drink => sɔft driŋk
soft focus => sɔft ˈfəukəs
soft fruit => sɔft fru:t
soft furnishings => sɔft ˈfə:niʃiŋz
soft hyphen => sɔft ˈhaifən
soft option => sɔft ˈɔpʃən
soft porn => sɔft pɔ:n
soft roe => sɔft rəʊ
soft rot => sɔft rɔt
soft sell => sɔft sel
soft shoulder => sɔft ˈʃəuldə
soft target => sɔft ˈtɑ:ɡit
soft top => sɔft tɔp
soft toy => sɔft tɔi
soft wheat => sɔft hwi:t
soft-core => sɔft kɔ:
soft-focus => 'sɒftf'əʊkəs
soft-shoe => 'sɔft'ʃʊ
soft-top => 'sɔft,tɔp, 'sɔ:ft-
softa => 'sɒftə
softback => 'sɔftbæk, 'sɔ:-
softball => 'sɒftbɒ:l
softcover => sɒft'kʌvər
soften => 'sɒftn
softener => 'sɔfnә
softeners => 'sɒfnəz
softening => 'sɔfniŋ
softens => ˈsɔ:fənz
softhearted => 'sɒft'hɑ:tid
softie => 'sɔ(:)fti
softies => ˈsɔ:fti:z
softish => 'sɒftiʃ
softly => 'sɒftli
softly-softly => ˈsɔftlɪ ˈsɔftlɪ
softness => 'sɒftnis
software => 'sɒftwєә
softwood => 'sɒftwud
softwoods => ˈsɔftwudz
softy => 'sɒfti
soggier => 'sɔɡiə
soggy => 'sɒgi
soho => sәu'hәu
soi-disant => ,swɑ:di:'zɔŋ
soil => sɒil
soil science => sɔil ˈsaiəns
soiling => sɔilɪŋ
soils => sɔilz
soiree => swɑ:'rei
soirees => ˈswɑ:reiz
sojourn => 'sɒdʒә:n
sojourned => 'sɒdʒɜːn
sojourning => 'sɒdʒɜːn
sojourns => ˈsəʊˌdʒɜ:nz
Soka Gakkai => ,soukәˊgaːkai
soke => sәuk
Sokol => 'sәjkɔ:l
Sol => sәul
sol-fa => .sɒl'fɑ:
sola => 'sәulә
sola topi => ˌsəʊlə ˈtəʊpi
solace => 'sɒlis
solaced => ˈsɔlɪst
solaces => ˈsɔlɪsiz
solacing => ˈsɔlɪsɪŋ
solan => 'sәulәn
solanaceous => ,sɔlә'neiʃәs,,sәj-
solander => sәj'lændә(r)
solanine => 'sәulә,ni:n, -nin
solanum => sәu'leinәm
solar => 'sәulә
solar day => ˈsəulə dei
solar flare => ˈsəulə flɛə
solar mass => ˈsəulə mæs
solar plexus => ˌsəʊlə ˈpleksəs
solar pond => ˈsəulə pɔnd
solar year => ˈsəulə jə:
solarium => sәu'lєәriәm
solariums => səuˈlɛəriəmz
solarization => .sәulәrai'zeiʃәn
solarize => 'sәulәraiz
solarizes => 'səʊləraɪz
solarizing => 'səʊləraɪz
solatium => sәu'leiʃiәm
sold => sәuld
sold-out => 'səʊld'aʊt
soldanella => ,sɔldә'nelә
solder => 'sɒldә
solderable => 'sɔldәrәbl;'sɔdә-
soldered => ˈsɔdəd
solderer => 'sɒldərər
soldering => 'sɔldәriŋ
soldering iron => 'sәjldәriŋ
solders => ˈsɔdəz
soldi => 'sɔldi:,'sɔ:-
soldier => 'sәuldʒә
soldiered => 'səʊldʒə
soldierfish => 'səuldʒə,fiʃ
soldiering => 'sәuldʒәriŋ
soldierly => 'sәuldʒәli
soldiership => 'sәuldʒәʃip
soldiery => 'sәuldʒәri
soldo => 'sɒldәu
sole => sәul
solebar => 'sәjlbɑ:(r)
solecism => 'sɒlisizm
solecisms => 'sɒlɪsɪz(ə)m
solecistic => .sɒli'sistik
solely => 'sәulli
solemn => 'sɒlәm
solemnities => səˈlemnɪti:z
solemnity => sә'lemniti
solemnization => .sɒlәmnai'zeiʃәn
solemnize => 'sɒlәmnaiz
solemnized => ˈsɔləmnaizd
solemnizes => ˈsɔləmnaiziz
solemnizing => ˈsɔləmnaizɪŋ
solemnness => 'sɒləmnɪs
solenodon => sә'li:nәdɔn, -'le-
solenoid => 'sәulinɒid
solenoidal => ˌsəʊlə'nɔɪdəl
soleplate => 'sәulpleit
soles => 'sɔːles
soleus => 'sәjliәs
solfatara => ,sәulfә'tɑ:rә
solfeggio => sɒl'fedʒәu
soli => 'sәuli:
solicit => sә'lisit
solicitation => sә.lisi'teiʃәn
solicitations => səˌlɪsɪˈˈteɪʃənz
soliciting => sə'lɪsɪtɪŋ
solicitor => sә'lisitә
solicitors => səˈlisitəz
solicitous => sә'lisitәs
solicitously => sə'lɪsɪtəslɪ
solicits => səˈlisits
solicitude => sә'lisitju:d
solid => 'sɒlid
solidago => ,sɔli'dei^әu
solidarity => .sɒli'dæriti
solidary => 'sɔlidәri
solidi => 'sɔlidai
solidification => sә.lidifi'keiʃәn
solidifies => sə'lɪdɪfaɪz
solidify => sә'lidifai
solidity => sә'liditi
solidness => 'sɒlɪdnɪs
solids => 'sɒlɪdz
solidus => 'sɒlidәs
solifluction => ,sɔli'flʌkʃәn, ,sәj-
soliloquies => səˈlɪləkwi:z
soliloquist => sә'lilәkwist
soliloquize => sә'lilәkwaiz
soliloquized => səˈliləkwaizd
soliloquizes => səˈliləkwaiziz
soliloquizing => səlɪlək'waɪzɪŋ
soliloquy => sә'lilәkwi
soling => 'sɔliŋ
solipsism => 'sɒlipsizm
solitaire => .sɒli'tєә
solitarily => 'sɒlitәrili
solitariness => 'sɔlitərinis
solitary => 'sɒlitәri
solitary wave => ˈsɔlitəri weiv
soliton => 'sɔlitɔn
solitude => 'sɒlitju:d
solmizate => 'sɔlmizeit
solmization => ,sɔlmi'zeiʃәn
solo => 'sәulәu
soloist => 'sәulәuist
soloists => ˈsəʊləʊɪsts
Solomon => 'sɒlәmәn
Solomonic => ,sɔlə'mɔnik
solon => 'sɔlәn. -lɔn
solstice => 'sɒlstis
solstices => 'sɒlstɪsɪz
solstitial => sɒl'stiʃәl
solubilities => ,sɒljʊ'bɪlətɪ
solubility => .sɒlju'biliti
solubilization => ,sɔljjbilai'zeiʃәn; -li'z-
solubilize => 'sɔljjbilaiz
soluble => 'sɒljubl
soluble glass => ˈsɔljubl ɡlɑ:s
solunar => sә'lu:nә
solus => 'sәulәs
solute => 'sɒlju:t
solution => sә'lu:ʃәn
Solutrean => sә'lju:triәn
solvable => 'sɒlvәbl
solvate => 'sɔlveit
solvated => sɒl'veɪt
solvates => sɒl'veɪt
solvating => sɒl'veɪt
solvation => sɔl'veiʃən
solve => sɒlv
solvency => 'sɒlvәnsi
solvent => 'sɒlvәnt
solvent abuse => ˈsɔlvənt əˈbju:s
solvents => 'sɒlvənts
solver => 'sɔlvә
solves => sɔlvz
soma => 'sәumә
Somali => sәu'mɑ:li
Somalia => sәu'mɑ:liә
somalis => səuˈmɑ:liz
somatic => sәu'mætik
somatic cell => səʊˈmætɪk sel
somatization => ,sәumәtai'zeiʃәn
somatomedin => ,sәumә'tɔmәdin
somatopleure => 'sәumәtә'pluә
somatosensory => ,sәumәtә'sensәri
somatostatin => sәumætәu'stætin
somatotrophin => səmətət'rɒfɪn
somatotype => 'sәumәtәtaip
somatotyping => 'sәumәtәtaipiŋ
somber => 'sɒmbә
somberly => 'sɒmbəlɪ
sombre => 'sɔmbә(r)
sombrely => 'sɔmbəli
sombrero => sɒm'brerәu
sombreros => sɔmˈbrɛərəuz
some => sʌm
somebody => 'sʌmbɒdi
someday => 'sʌmdei
somehow => 'sʌmhau
someone => 'sʌmwʌn
someplace => 'sʌmpleis
somersault => 'sʌmәsɒ:lt
somersaulted => ˈsʌməˌsɔ:ltid
somersaulting => ˈsʌməˌsɔ:ltɪŋ
somersaults => ˈsʌməˌsɔ:lts
somerset => 'sʌmәsit. -set
Somerville => 'sʌmәvil
somesthetic => ,sәjmes'θetik
something => 'sʌmθiŋ
something fierce => ˈsʌmθiŋ fiəs
sometime => 'sʌmtaim
sometimes => 'sʌmtaimz
someway => 'sʌmwei
somewhat => 'sʌmhwɒt
somewhen => 'sʌm(h)wen
somewhere => 'sʌmhwєә
somewheres => 'sʌmweə
somite => 'sәumait
Somme => sɔm; sʌm
sommelier => .sʌmә'ljei
somnambulant => sɔm'næmbjjlәnt, sәm-
somnambulism => sɒm'næmbjulizm
somnambulist => sɔm'næmbjjlist, sәm-
somnambulistically => sɒm'næmbjʊlɪstɪklɪ
somnambulists => sɔm'næmbjulist, səm-
somniferous => sɒm'nifәrәs
somnolence => 'sɔmnәlәns
somnolent => 'sɒmnәlәnt
son => sʌn
son of a bitch => sʌn ɔv ə bɪtʃ
sonar => 'sәunɑ:
sonata => sә'nɑ:tә
sonatas => sə'nɑ:təz
sonatina => .sɒnә'ti:nә
sonde => sɔnd
sone => sәun
song => sɒŋ
song thrush => sɔŋ θrʌʃ
songbird => 'sɒŋbә:d
songbirds => ˈsɔŋbə:dz
songbook => 'sɒŋbuk
songcraft => 'sɔŋkrɑ:ft; 'sɔ:ŋkræft
songsmith => 'sɒŋsmiθ
songster => 'sɒŋstә
songstress => 'sɒŋstris
songwriters => ˈsɔ:ŋˌraɪtəz
sonic => 'sɒnik
sonicate => 'sɔnikeit
sonics => 'sɔniks
sonnet => 'sɒnit
sonneteer => sɒni'tiә
sonnets => ˈsɔnɪts
sonny => 'sʌni
sonobuoy => 'sɒnәbɒi
sonogram => 'sɔnә,^ræm
sonograph => 'sɔnә^rɑ:f
sonography => sә'nɔ^rәfi
sonoluminescence => ,sɔnә,lu:mi'nesns
sonometer => sәu'nɒmitә
sonorant => sә'nɔ:rәnt, sәu-
sonority => sәu'nɒriti
sonorous => sәu'nɒ:rәs
sonorously => 'sɒnərəslɪ
sonorousness => sәˊnɒːrәsnis
sonship => 'sʌnʃip
sonsy => 'sɒnsi
Sontag => 'sɔntæ^
Soochow => 'su:'tʃaj
sook => suk
sool => sul
soon => su:n
sooner => 'su:nә
soonest => su:nɪst
soot => sut
sooted => sʊtid
sooth => su:θ
soothe => su:ð
soothed => su:ðd
soother => 'su:ðә
soothes => su:ðz
soothing => 'su:ðiŋ
soothingly => su:ðɪŋlɪ
soothsayer => 'su:θseiә
soothsaying => 'su:θseiiŋ
sootily => 'sutili
sootiness => 'sutinis
sooting => sʊtɪŋ
soots => sʊts
sooty => 'suti
sop => sɒp
sopaipilla => ,sәjpai'pi:ljә
SOPER => 'sәjpә(r)
sophia => sә'faiә
sophie => 'sәufi
sophism => 'sɒfizm
sophist => 'sɒfist
sophistical => sә'fistikәl
sophisticate => sә'fistikeit
sophisticated => sә'fistikeitid
sophisticatedly => sәˊfistikeitidli
sophisticates => səˈfɪstɪˌkeɪts
sophisticating => sə'fɪstɪkeɪt
sophistication => sә.fisti'keiʃәn
sophistries => ˈsɔfɪstri:z
sophistry => 'sɒfistri
Sophocles => 'sɔfəkli:z
sophomore => 'sɒfәmɒ:
sophomoric => ,sɔfә'mɔ:rik, -'mɔ-
sophy => 'sәufi
soporific => .sәupә'rifik
sopped => sɔpt
soppier => ˈsɔpi:ə
sopping => 'sɒpiŋ
soppy => 'sɒpi
sopranino => 'sәuprә'ni:nәu
soprano => sә'prænәu
sopranos => səˈprænəʊz
sops => 'sɒps
sora => 'sәurә. 'sɔ:-
sorb => sɒ:b
sorbent => 'sɒ:bәnt
sorbet => 'sɔ:bәt
sorbets => ˈsɔ:bəts
Sorbian => 'sɔ:biәn
sorbitan => 'sɔ:bitәn
sorbitol => 'sɔ:bitәl, 'sɔ:bitәul
Sorbonne => sɔ:'bɔn
sorbus => 'sɔ:bәs
sorcerer => 'sɒ:sәrә
sorcerers => 'sɔ:sərəz
sorceress => 'sɔ:sәris
sorceresses => ˈsɔ:sərisiz
sorceries => 'sɔːs(ə)rɪ
sorcerous => 'sɔ:sərəs
sorcery => 'sɒ:sәri
sordid => 'sɒ:did
sordidly => 'sɔ:dɪdlɪ
sordidness => 'sɔ:dɪdnɪs
sordino => sɔ:'di:nәu
sordor => 'sɔ:dә
sore => sɒ:
sorehead => 'sɒ:hed
sorel => 'sɔrәl
sorely => 'sɒ:li
soreness => 'sɒ:nis
sorghum => 'sɒ:gәm
sori => 'sɔ:rai
sororal => sә'rɒ:rәl
sorority => sә'rɒ:riti
sorosis => sә'rәusis
sorption => 'sɒ:pʃәn
sorrel => 'sɒ:rәl
sorrel tree => ˈsɔrəl tri:
Sorrento => sə'rentəu
sorrily => 'sɒrili
sorriness => 'sɒrinis
sorrow => 'sɒrәu
sorrowful => 'sɒrәuful
sorrowfully => 'sɒrəʊfəlɪ
sorrowing => 'sɒrəʊ
sorrows => 'sɔrəuz
sorry => 'sɒri
sort => sɒ:t
sort-out => sɔ:t aut
sorta => 'sɔ:tә
sorte => 'sɔ:teɪ
sorted => 'sɔ:tid
sorter => 'sɒ:tә
sortes => 'sɔ:ti:z
sortie => 'sɒ:ti:
sorties => ˈsɔ:ti:z
sortilege => 'sɒ:tilidʒ
sorting => 'sɔ:tiŋ
sorting office => ˈsɔ:tiŋ ˈɔfis
sortition => sɒ:'tiʃәn
sorus => 'sәurәs
SOS => esәj'es
sostenuto => sɔstә'nu:tәu
sot => sɒt
soteriology => sәtiәri'ɔlәdʒi
Sothic => 'sәuθik
Sotho => 'sәuθәu
sotol => 'sәjtәjl, sәj't-
sots => sɔts
sottish => 'sɒtiʃ
sotto voce => 'sɔtәu'vәutʃi
sou => su:
sou'wester => sau'westә
soubise => su:'bi:z
soubresaut => ,su:brә'sәj
soubrette => su:'bret
soubriquet => 'sәubrikei
souchong => 'su:'ʃɔŋ, -tʃɔŋ
souffle => 'su:fl
souffles => 'suːf(ə)l
sough => sau
soughed => saud
soughing => sauɪŋ
soughs => sauz
sought => sɒ:t
sought after => sɔ:t ˈɑ:ftə
sought-after => 'sɔ:tɑ:ftə
souk => su:k
soukous => 'saʊkəs
soul => sәul
soul food => səul fu:d
soulful => 'sәulful
soulfully => 'səulfuli
soulfulness => 'səulfulnis
soulless => 'sәullis
soulmate => ˈsəʊlmeɪt
soulster => 'səʊlstə
sound => saund
sound bite => saund bait
sound card => saund kɑ:d
sound effect => saund iˈfekt
sound engineer => saund ˌendʒiˈniə
sound shift => saund ʃift
sound spectrograph => saund ˈspektrəuˌɡrɑ:f
sound stage => saund steidʒ
sound system => saund ˈsistəm
soundalike => ˈsaʊndəlaɪk
soundbite => 'saʊndbaɪt
soundboard => 'saʊndbɔ:d
soundbox => ˈsaʊndbɒks
sounder => 'saundә
Soundex => 'sajndeks
sounding => 'saundiŋ
sounding line => ˈsaundiŋ lain
soundings => 'saʊndɪŋz
soundless => 'saundlis
soundlessly => 'saundlisli
soundly => 'saundli
soundman => 'saʊndmæn
soundness => 'saundnis
soundproof => 'saundpru:f
soundproofed => ˈsaʊndˌpru:ft
soundproofing => saʊndp'ru:fɪŋ
soundproofs => ˈsaʊndˌpru:fs
soundscape => 'saundskeip
soundtracks => ˈsaʊndˌtræks
soup => su:p
soup plate => su:p pleit
soupcon => su:p'sɒŋ
souping => 'su:pɪŋ
soups => su:ps
soupy => 'su:pi
sour => 'sauә
sour cream => ˈsauə kri:m
sour grass => ˈsauə ɡrɑ:s
sour mash => ˈsauə mæʃ
source => sɒ:s
sourcebook => 'sɔ:sbjk
sourced => sɔ:st
sourdough => 'sajәdәj
soured => ˈsauəd
sourish => 'sauәriʃ
sourly => 'sauәli
sourness => 'sauәnis
sourpuss => 'sauәpus
sours => ˈsauəz
soursop => 'sajәsɔp
sousaphone => 'su:zәfәun
souse => saus
soused => saʊst
souses => saʊsiz
sousing => saʊsɪŋ
souslik => 'su:slik
Sousse => su:s
soutache => su:'tɑ:ʃ
soutane => su:'tɑ:n
Souter => 'su:tә(r)
souterrain => su:tә'rein
south => sauθ
south-east => sauθ iːst
south-easterly => sauθ ˈi:stəli:
south-eastern => sauθ ˈi:stən
south-south-east => sauθ sauθ iːst
south-south-west => sauθ sauθ west
south-west => sauθ west
south-westerly => sauθ ˈwestəli:
south-western => sauθ ˈwestən
south-westward => ,saʊθ'westwəd
southampton => sauθ'æmptәn
southbound => 'sajθbajnd
Southdown => 'sauθdaun
southeast => sauθ'i:st
southeaster => sauθ'i:stә
southeasterly => sauθ'i:stәli
southeastern => sauθ'i:stәn
southeastward => sauθ'i:stwәd
Southend-on-Sea => 'sauθ,endɔn'si:
southerly => 'sʌðәli
southern => 'sʌðәn
southern hemisphere => ˈsʌðən ˈhemiˌsfiə
southerner => 'sʌðәnә
southerners => ˈsʌðənəz
southernmost => 'sʌð(ә)nmәjst
southernwood => 'sʌðәnwud
southey => 'sauði, 'sʌði
Southgate => 'sauθɡeit
southing => 'sauðiŋ
southland => 'sajθlәnd, -lænd
southpaw => 'sauθpɒ:
southward => 'sauθwәd
southwardly => 'sajθwәdli
southwards => 'sajθwәdz
Southwark => 'sʌðək
Southwell => 'sauθwәl
southwest => sauθ'west
southwester => sajθ'westә(r)
southwesterly => sauθ'westәli
southwestern => sauθ'westәn
southwestward => sauθ'westwәd
souvenir => .su:vә'niә
souvenirs => su:və'nɪəz
souvlaki => su:v'lɑ:ki
sov => sɔv
sovereign => 'sɒvrin
sovereigns => ˈsɔvrinz
sovereignties => ˈsɔvərɪnti:z
sovereignty => 'sɒvrәnti
Soviet => 'sәuviәt
Sovietologist => ,sәuvie'tɔlәdʒist
Sovietology => ,sәjviә'tɔlәdʒi, ,sɔ-
sovkhoz => sɔv'kɔz
sow => sau. sәu
sow bug => 'saubʌɡ
sowback => 'saubæk
sowbread => 'saubred
sower => 'sәuә
Soweto => sɔ:'wetj
sowing => 'sәuiŋ
sown => sәun
sows => səuz
sox => sɔks
soy => sɒi
soy sauce => sɔi
soya => 'sɔiә
soya milk => ˈsɔiə milk
soybean => 'sɒibi:n
soybeans => 'sɔɪbi:nz
soymilk => 'sɔimilk
sozzle => 'sɔzl
sozzled => 'sɒzld
spa => spɑ:
space => speis
space cadet => speis kəˈdet
space frame => speis freim
space heating => speis ˈhi:tɪŋ
space opera => speis ˈɔpərə
space-age => speis eidʒ
space-time => 'speis'taim
spacecraft => 'speiskræft
spaced => speist
spacefarer => 'speis,feәrә(r)
spaceflight => 'speisflait
spaceman => 'speismæn
spacemen => 'speɪsmen
spaceplane => 'speisplein
spaceport => 'speispɔ:t
spacer => 'speisә
spaceship => 'speisʃip
spaceships => ˈspeɪsˌʃɪps
spacesuits => 'speɪssuːt; -sjuːt
spacewalk => 'speiswɒ:k
spacewalked => 'speɪswɔːk
spacewalker => speɪswɔ:k:ɜ
spacewalking => speɪswɔ:'kɪŋ
spacewalks => 'speɪswɔːk
spacewoman => 'speiswumәn
spacey => ˈspeɪsi
spacial => 'speiʃәl
spacing => 'speisiŋ
spacious => 'speiʃәs
spackle => 'spækl
spade => speid
spaded => speɪd
spadefish => s'peɪdi:fɪʃ
spadefoot => 'speidfjt
spadeful => 'speidful
spadework => 'speidwә:k
spadille => spә'dil
spading => s'peɪdɪŋ
spadix => 'speidiks
spae => spei
spaetzle => 'spetslә
spaewife => 'speiwaif
spaghetti => spә'geti
spaghetti squash => spəˈɡeti skwɔʃ
spaghettini => ,spæ^ә'ti:ni, spә,^e-
spagyric => spә'dʒirik
spahi => 'spɑ:hi:
Spain => spein
spake => speik
spalding => 'spɔ:ldiŋ
spall => spɒ:l
spallation => spɒ:'leʃәn
spalling => 'spɔ:liŋ
spalpeen => spæl'pi:n
spammed => spæmd
spammer => 'spæmә
spams => spæmz
span => spæn
spanakopita => ˌspɑ:nəˈkəupitə
spandau => 'spændɔ:
spandex => 'spændeks
spandrel => 'spændrәl
spang => spæŋ
spangle => 'spæŋgl
spangled => 'spæŋgəld
spangles => s'pæŋɡlz
spangling => ˈspæŋgəlɪŋ
Spanglish => 'spæn^liʃ
spangly => 'spæŋgli
Spaniard => 'spænjәd
spaniards => ˈspænjədz
spaniel => 'spænjәl
spaniels => ˈspænjəlz
Spanish => 'spæniʃ
Spanish-American => 'spæniʃə'merikən
spank => spæŋk
spanked => spæŋkt
spanking => 'spæŋkiŋ
spanks => spæŋks
spanned => spænd
spanner => 'spænә
spanners => ˈspænəz
spanning => 'spæniŋ
spans => spænz
spansule => ˊspænsjuːl
spar => spɑ:
spar buoy => spɑ: ˈbu:i:
sparable => 'spærәbl
sparaxis => spә'ræksis
spare => spєә
spare rib => spɛə rib
spare time => spɛə taim
spare tyre => spɛə ˈtaiə
spared => spɛəd
sparely => 'spєәli
spareness => 'spєәnis
spareribs => 'speərɪbz
sparge => spɑ:dʒ
sparged => spɑ:dʒd
sparging => 'spɑ:dʒiŋ
sparid => 'spærid
sparing => 'speәriŋ
spark => spɑ:k
sparker => s'pɑ:kər
sparking => 'spɑ:kiŋ
sparkish => 'spɑ:kiʃ
sparkle => 'spɑ:kl
sparkled => ˈspɑ:kld
sparkler => 'spɑ:klә(r)
sparklers => ˈspɑ:kləz
sparkles => ˈspɑ:klz
sparkless => 'spɑ:klis
sparkling => 'spɑ:liŋ
sparklingly => ˊspaːkliŋli
sparkly => 'spɑ:klɪ
sparks => spɑ:ks
sparky => ˈspɑ:ki
sparling => 'spɑ:liŋ
sparred => s'pɑ:d
sparring => 'spɑ:riŋ
sparrow => 'spærәu
sparrows => ˈspærəʊz
sparry => 'spɑ:ri
spars => s'pɑ:z
sparse => 'spɑ:s
sparsely => spɑ:slɪ
sparseness => spɑ:snəs
sparser => spɑ:sə
sparsity => 'spɑ:siti
sparta => 'spɑ:tә
Spartacist => 'spɑ:tәsist
Spartacus => 'spɑ:tәkәs
Spartan => 'spɑ:tәn
spas => spɑ:z
spasm => 'spæzm
spasmodic => spæz'mɔdik
spasmodically => spæz'mɒdikli
spasmolytic => ,spæzmә'litik
spasmophilia => ,spæzmә'filiә
spasms => ˈspæzəmz
spastic => 'spæstik
spastically => 'spæstik
spastics => ˈspæstɪks
spat => spæt
spatchcock => 'spætʃkɒk
spatchcocked => ˈspætʃkɔkt
spatchcocking => ˈspætʃkɔkɪŋ
spatchcocks => ˈspætʃkɔks
spate => speit
spates => speɪts
spathe => speið
spathulate => 'spæθjulit
spatial => 'speiʃәl
spatiality => ,speʃi'æliti
spatialize => 'speiʃәlaiz
spatted => 'spætid
spatter => 'spætә
spatterdash => 'spætәdæʃ
spatterdock => 'spætәdɒk
spattered => ˈspætəd
spatters => s'pætəz
spatterware => 'spætәweә(r)
spatting => 'spætiŋ
spatula => 'spætʃәlә
spatulas => ˈspætʃələz
spatulate => 'spætʃәlit
spavin => 'spævin
spavined => 'spævind
spawn => spɒ:n
spawner => s'pɔ:nər
spawning => 'spɔ:niŋ
spawns => spɔ:nz
spay => spei
spayed => speid
spays => speiz
spaz => spæz
speak => spi:k
speakable => 'spi:kәbl
speakeasy => 'spi:k.i:zi
speaker => 'spi:kә
speakerphone => 'spi:kәfәun
speakership => 'spi:kәʃip
speaking => 'spi:kiŋ
speaking of => ˈspi:kɪŋ ɔv
speaking tube => ˈspi:kɪŋ tju:b
speaks => spi:ks
spear => spiә
spear-carrier => 'spiə,kæriə
spearfish => 'spiә,fiʃ
spearhead => 'spiәhed
spearheaded => ˈspɪəˌhedid
spearheading => ˈspɪəˌhedɪŋ
spearheads => ˈspɪəˌhedz
spearing => 'spiәriŋ
spearman => 'spiәmәn
spearmint => 'spiәmint
spearwort => s'pɪəwɜ:t
spec => spek
special => 'speʃәl
special education => ˈspeʃəl ˌedju:ˈkeiʃən
special effects => ˈspeʃəl ɪˈfekts
special needs => ˈspeʃəl ni:dz
special school => ˈspeʃəl sku:l
specialisation => ,speʃәlai'zeiʃәn
specialise => 'speʃә,laiz
specialising => ˈspeʃəlaizɪŋ
specialism => 'speʃәlizm
specialisms => ˈspeʃəlizəmz
specialist => 'speiʃәlist
specialities => ˌspeʃiˈælitiz
speciality => .speʃi'æliti
specialization => .speʃәlai'zeiʃәn
specialize => 'speʃәlaiz
specializes => ˈspeʃəlaiziz
specially => 'speʃәli
specialty => 'speʃәlti
speciate => 'spi:ʃieit
speciation => .spi:ʃi'eiʃәn
specie => 'spi:ʃi
species => 'spi:ʃiz
species barrier => ˈspi:ʃi:z ˈbæriə
speciesism => ˈspi:ʃi:zɪzəm
specifiable => 'spesifaiәbl
specific => spi'sifik
specific epithet => spiˈsifik ˈepəˌθet
specifically => spi'sifikli
specification => .spesifi'keiʃәn
specificity => ,spesi'fisiti
specifics => spi'sifiks
specify => 'spesifai
specimen => 'spesimәn
specimens => ˈspesimənz
specious => 'speiʃәs
speciously => s'pi:ʃəslɪ
speck => spek
specking => s'pekɪŋ
speckle => 'spekl
speckled => 'spekld
speckles => s'peklz
speckless => 'speklis
speckling => ˈspeklɪŋ
specks => speks
specky => 'speki
specs => speks
spectacle => 'spektәkl
spectacled => 'spektәkld
spectacular => spek'tækjulә
spectaculars => spekˈtækjuləz
spectate => 'spekteit
spectated => ˈspekteitid
spectates => ˈspekteits
spectating => ˈspekteitɪŋ
spectator => spek'teitә
spectator sport => spekˈteitə spɔ:t
spectatorial => spekteɪ'tɔ:rɪəl
specter => 'spektә
spectinomycin => ,spektinә'maisin
spectral => 'spektrәl
spectrally => 'spektrəli
spectre => 'spektә
spectres => ˈspektəz
spectrogram => 'spektrәugræm
spectrograph => 'spektrәgrɑ:f
spectrographic => spektrəʊɡ'ræfɪk
spectrography => spek'trɔ^rәfi
spectroheliograph => ,spektrә'hi:liә,^rɑ:f, -,^ræf
spectrohelioscope => ,spektrә'hi:liә,skәup
spectrometer => spek'trɒmitә
spectrometric => ,spektrәj'metrik
spectrometry => spek'trɔmitri
spectrophotometer => ,spektrәufә'tɔmitә
spectrophotometric => ,spektrəufəu'tɔmitrik
spectrophotometry => ,spektrəufəu'tɔmitri
spectroscope => 'spektrәskәup
spectroscopic => .spektrә'skɒpik
spectroscopically => spektrəs'kɒpɪklɪ
spectroscopy => spek'trɒskәpi
spectrum => 'spektrәm
specula => 'spekjulә
specular => 'spekjulә
speculate => 'spekjuleit
speculated => ˈspekjuleitid
speculates => ˈspekjuleits
speculating => ˈspekjuleitɪŋ
speculation => .spekju'leiʃәn
speculations => ˌspekjəˈleɪʃənz
speculative => 'spekjuleitiv
speculativeness => s'pekjʊlətɪvnəs
speculator => 'spekjuleitә
speculators => ˈspekjəˌleɪtəz
speculum => 'spekjulәm
sped => sped
speech => spi:tʃ
speech community => spi:tʃ kəˈmju:niti
speech day => spi:tʃ dei
speech sound => spi:tʃ saund
speech synthesis => spi:tʃ ˈsinθisis
speech therapist => spi:tʃ ˈθerəpɪst
speech therapy => spi:tʃ ˈθerəpi
speeches => s'pi:tʃɪz
speechifier => 'spi:tʃifaiә(r)
speechify => 'spi:tʃifai
speechifying => ˈspi:tʃɪfaɪɪŋ
speechless => 'spi:tʃlis
speechlessly => ˈspi:tʃlɪslɪ
speechlessness => 'spi:tʃlisnis
speechread => 'spi'tʃ,ri:d
speechreading => 'spi:tʃri:diŋ
speechwriter => 'spi:tʃ,raitә(r)
speed => spi:d
speed bump => spi:d bʌmp
speed camera => spi:d ˈkæmərə
speedboat => 'spi:dbәut
speedboats => ˈspi:dˌbəʊts
speeder => 'spi:dә
speedily => 'spi:dili
speediness => 'spi:dinis
speeding => 'spi:diŋ
speedometer => spi:'dɒmitә
speedometers => spɪˈdɔmɪtəz
speeds => spi:dz
speedster => 'spi:dstә
speedway => 'spi:dwei
speedwell => 'spi:dwel
speedy => 'spi:di
Speight => speit
speiss => spais
spekboom => 'spekbu:m
speleology => ,spili'ɔlәdʒi
speleothem => 'spi:liә,θem
spell => spel
spellbind => 'spelbaind
spellbinder => 'spel.baindә
spellbinding => ˈspelbaɪndɪŋ
spellbound => 'spelbaund
spellchecker => ˈspeltʃekə(r)
speller => 'spelә
spelling => 'speliŋ
spelt => spelt
spelter => 'speltә
spelunk => spi'lʌŋk
spelunker => spi:lʌŋkә
spelunking => spɪˈlʌŋkɪŋ
spence => spens
spencer => 'spensә
Spencerian => spen'siәriәn
Spencers => 'spensə
spend => spend
spendable => 'spendәbl
spender => 'spendә
spenders => ˈspendəz
spending => 'spendiŋ
spending money => ˈspendɪŋ ˈmʌni
spends => s'pendz
spendthrift => 'spendθrift
spendthrifts => ˈspendˌθrɪfts
spenser => 'spensә
Spenserian => spen'siәriәn
spent => spent
sperm => spә:m
sperm bank => spɜ:m bæŋk
sperm count => spɜ:m kaunt
sperm whale => spɜ:m hweil
spermaceti => .spә:mә'seti
spermatheca => ,spә:mә'θi:kә
spermatic => spә:'mætik
spermatid => 'spә:mәtid
spermatocyte => spә'mætәsait
spermatogenesis => ,spә:mәtәu'dʒenisis
spermatogonium => ,spә:mәtә'^әuniәm
spermatophore => 'spә:mәtәfɔ:
spermatophyte => 'spә:mәtәfait
spermatozoid => spә,mætә'zәuid
spermatozoon => .spә:mәtә'zәuɒn
spermicide => 'spә:mi,said
spermidine => 'spә:mi,di:n
spermine => 'spә:mi:n
sperms => spɜ:mz
spew => spju:
spewed => spju:d
spewing => sp'ju:ɪŋ
spews => spju:z
sphagnum => 'sfægnәm
sphalerite => 'sfeili,rait
sphene => sfi:n
sphenoid => 'sfi:nɒid
sphenopalatine => ,sfi:nәu'pælәtain
sphenopsid => sfi'nɔpsid
spheral => 'sfiәrәl
sphere => sfiә
spheres => sfiəz
spheric => 'sferik
spherical => 'sferikl
spherical angle => ˈsfɪərɪkəl ˈæŋɡl
spherical triangle => ˈsfɪərɪkəl ˈtraiæŋɡl
spherical trigonometry => ˈsfɪərɪkəl ˌtrɪgəˈnɔmɪtri:
spherically => 'sferɪklɪ
sphericity => .sfiә'risiti
spheroid => 'sfiәrɒid
spheroidicity => ,sfiәrɔi'disiti
spheroplast => 'sfiәrә,plɑ:st
spherular => 'sferjulә
spherule => 'sferu:l
spherulite => 'sferju,lait,'sfiә-
spherulitic => sfe'ru:lɪtɪk
sphincter => 'sfiŋktә
sphingid => 'sfindʒid
sphingolipid => ,sfiŋ^әj'lipid,-'lai-
sphingomyelin => ,sfiŋ^әu'maiәlin
sphingosine => 'sfiŋ^әusi(:)n
sphinx => sfiŋks
sphygmograph => 'sfigmәgrɑ:f
sphygmomanometer => ,sfi^mәumә'nɔmitә
spic => spik
spica => spik
spiccato => spi'kɑ:tәu
spice => spais
spicebush => 'spaisbuʃ
spicier => ˈspaɪsi:ə
spicily => 'spaisili
spiciness => 'spaisinis
spick => spik
spick-and-span => 'spikәnd'spæn
spiculate => 'spikju:leit
spiculation => spɪkʊ'leɪʃn
spicule => 'spikju:l
spicy => 'spaisi
spider => 'spaidә
spider crab => ˈspaidə kræb
spider mite => ˈspaidə maɪt
spider monkey => ˈspaidə ˈmʌŋki
spider plant => ˈspaidə plɑ:nt
spiderish => s'paɪdərɪʃ
spiderlike => 'spaidәlaik
spiderling => 'spaidәliŋ
spiderman => 'spaidәmæn
spiderweb => s'paɪdəweb
spiderwort => 'spaidәwә:t
spidery => 'spaidәri
spied => spaɪd
spiegel => 'spi:^әl
spiegeleisen => 'spi:gәlaizәn
spiel => 'spi:l
spieled => ʃpiːl; spiːl
spieler => 'spi:lә
spieling => ʃpiːl; spiːl
spiels => spi:lz
Spiers => 'spaiə
spiff => spif
spiffing => 'spifiŋ
spifflicate => 'spiflikeit
spiffy => 'spifi
spignel => 'spi^nәl
spigot => 'spigәt
spik => spik
spike => spaik
spikelet => 'spaiklit
spikenard => 'spaiknɑ:d
spiking => 'spaikiŋ
spiky => 'spaiki
spile => spail
spiling => 'spailiŋ
spilite => 'spailait
spill => spil
spillage => 'spilidʒ
spillages => ˈspilidʒz
spiller => 'spilә
spillikin => 'spilikin
spilling => 'spiliŋ
spillover => 'spil.әuvә
spillway => 'spilwei
spilt => spilt
spilth => spilθ
spin => spin
spin doctor => spin ˈdɔktə
spin dryer => spin ˈdraɪə
spin-down => s'pɪnd'aʊn
spin-dried => spin draid
spin-out => 'spinaut
spinach => 'spinitʃ
spinach beet => ˈspinidʒ bi:t
spinachy => 'spinidʒi,-itʃi
spinal => 'spainl
spinal canal => ˈspaɪnəl kəˈnæl
spinal tap => ˈspaɪnəl tæp
spinally => 'spainәli
spindle => 'spindl
spindle cell => ˈspɪndl sel
spindle-shanked => 'spindlʃæŋkt
spindles => ˈspɪndlz
spindling => 'spindliŋ
spindly => 'spindli
spindrift => 'spindrift
spine => spain
spine-chiller => spain ˈtʃilə
spine-chilling => ˈspaɪnˌtʃɪlɪŋ
spined => 'spaind
spinel => spi'nel,'spinәl
spineless => 'spainlis
spines => spainz
spinet => 'spinit
spinetail => spaɪ'nɪteɪl
spinifex => 'spini,feks
spininess => 'spaininis
spinmeister => 'spinmaistə
spinnaker => 'spinәkә
spinner => 'spinә
spinneret => 'spinәret
spinners => ˈspinəz
spinney => 'spini
spinneys => ˈspɪni:z
spinning => 'spiniŋ
spinning jenny => 'spiniŋ
spinoff => 'spin,ɔ:f
spinose => 'spainәus
spinous => 'spainәs
Spinoza => spi'nәuzә
Spinozism => 'spi'nәjzizәm
spins => spinz
spinster => 'spinstә
spinsterhood => 'spinstәhud
spinsterish => s'pɪnstərɪʃ
spinsters => ˈspɪnstəz
spinthariscope => spin'θæriskәup
spinto => 'spi:ntәu
spinulose => 'spainjulәus
spiny => 'spaini
spiny anteater => ˈspaɪni: ˈæntˌi:tə
spiny dogfish => ˈspaɪni: ˈdɔɡˌfiʃ
spiny lobster => ˈspaɪni: ˈlɔbstə
spiracle => 'spairәkl
spiracular => spaiә'rækjulә
spiraea => spai'ri(:)ә
spiral => 'spairәl
spiral galaxy => ˈspaiərəl ˈɡæləksi
spiral staircase => ˈspaiərəl ˈstɛəkeis
spiral-bound => 'spaiərəlbaund
spiraling => ˈspaiərəlɪŋ
spiralled => ˈspaiərəld
spiralling => 'spaiәrәliŋ
spirals => ˈspaiərəlz
spirant => 'spaiәrәnt
spirantization => ,spaɪərotɪ'zeʃən
spire => spaiә
spirea => 'spairiә
spires => spaɪəz
spirillum => spai'rilәm
spiring => spaɪərɪŋ
spirit => 'spirit
spirit gum => ˈspirit ɡʌm
spirited => 'spiritid
spiritedly => 'spɪrɪtɪdlɪ
spiriting => 'spɪrɪt
spiritism => 'spiritizm
spiritless => 'spiritlis
spiritous => 'spiritәs
spiritual => 'spiritʃuәl
spiritualism => 'spiritjjәlizәm,-tʃjә-
spiritualist => 'spiritjjәlist,-tʃjә-
spiritualistic => .spiritʃuә'listik
spiritualities => ˌspiritjuˈælitiz
spirituality => ,spiritju'æliti
spiritualize => 'spiritjuәlaiz
spiritualized => ˈspɪrɪtʃuəlaɪzd
spirituals => spɪ'rɪtʃʊəlz
spirituous => 'spiritjuәs
spirochaete => 'spaiәrәki:t
spirochete => 'spaiәrәki:t
spirograph => 'spairәgrɑ:f
spirogyra => .spairә'dʒaiәrә
spirometer => spai'rɒmitә
spirometry => ,spaiә'rɔmitri
spironolactone => ,spaiәrә'læktәun
spirt => spә:t
spiry => 'spairi
spit => spit
spit and polish => spit ænd ˈpɔliʃ
spit up => spit ʌp
spit-roast => ˈspɪt rəʊst
spitball => 'spitbɒ:l
spitchcock => 'spitʃkɒk
spite => spait
spiteful => 'spaitful
spitefully => 'spaɪtfəlɪ
spitefulness => 'spaitfəlnis
spites => spaits
spitfire => 'spitfaiә
spitfires => 'spɪtfaɪə
Spitsbergen => 'spits,bə:ɡən
spitter => 'spitә
spitting => 'sptiŋ
spitting cobra => ˈspitiŋ ˈkəubrə
spitting image => ˈspitiŋ ˈimidʒ
spittle => 'spitl
spittlebug => 'spitlbʌ^
spittoon => spi'tu:n
spitz => spits
Spitzbergen => 'spits,bə:ɡən
spiv => spiv
spivvy => 'spivi
splake => spleik
splanchnic => 'splæŋknik
splanchnopleure => 'splæŋknәpljә(r)
splash => splæʃ
splashback => ˈsplæʃbæk
splashboard => 'splæʃbɒ:d
splashdown => 'splæʃdaun
splashed => sp'læʃt
splashes => splæʃiz
splashy => 'splæʃi
splat => splæt
splatter => 'splætә
splattered => ˈsplætəd
splattering => ˈsplætərɪŋ
splatters => ˈsplætəz
splay => splei
splay-footed => splei ˈfutid
splayed => spleid
splaying => spleiŋ
splays => spleiz
spleen => spli:n
spleenful => 'spli:nful
spleens => spli:nz
spleenwort => 'spli:nwә:t
splendent => 'splendәnt
splendid => 'spendid
splendidly => 'splendɪdlɪ
splendiferous => splen'difәrәs
splendor => 'splendә
splendour => 'splendә
splendours => ˈsplendəz
splenectomy => spli'nektәmi
splenetic => spli'netik
splenial => 'spli:niәl
splenic => 'splenik
splenitis => spli'naitis
splenium => 'spli:niәm
splenius => 'spli:niәs
splenomegaly => ,spli:nә'me^әli, splenә-
splice => splais
spliced => splaist
splicer => 'splaisә
splices => splaɪsiz
splicing => 'splaisiŋ
spliff => splɪf
spline => splain
splint => splint
splint bone => splɪnt bəun
splinted => splɪnt
splinter => 'splintә
splinter group => ˈsplɪntə ɡru:p
splintered => ˈsplɪntəd
splintering => sp'lɪntərɪŋ
splinters => ˈsplɪntəz
splintery => 'splintәri
splints => splɪnts
split => split
split decision => split diˈsiʒən
split end => split end
split infinitive => split ɪnˈfɪnɪtɪv
split pea => split pi:
split shift => split ʃift
split ticket => split ˈtikit
split-second => split ˈsekənd
splits => splits
splitsville => 'splɪtsvɪl
splitter => 'splitә
splitting => 'splitiŋ
splittism => 'splitizm
splittist => sp'lɪtɪst
splodge => splɔdʒ
splosh => splɒʃ
sploshed => splɔʃ
sploshes => splɔʃ
sploshing => splɔʃ
splotch => splɒtʃ
splotched => splɔtʃt
splotches => splɔtʃiz
splotching => splɔtʃɪŋ
splotchy => 'splɔtʃi
splurge => splә:dʒ
splurged => splɜ:dʒd
splurges => splɜ:dʒz
splurging => splɜ:dʒɪŋ
splutter => 'splʌtә
spluttered => ˈsplʌtəd
spluttering => sp'lʌtərɪŋ
splutters => ˈsplʌtəz
spode => spәud
spodosol => 'spɔdәsɔl
spodumene => 'spɔdju,mi:n
spoil => spɒil
spoilage => 'spɒilidʒ
spoils system => spɔilz ˈsistəm
spoilsman => 'spɔilzmәn
spoilsport => 'spɒilspɒ:t
spoke => spәuk
spoked => spəʊk
spoken => 'spәukәn
spokeshave => 'spәukʃeiv
spokesman => 'spәuksmәn
spokesmodel => 'spɔksmɔdl
spokespeople => 'spәjks,pi:pl
spokesperson => 'spәukspә:sn
spokeswoman => 'spәuks,wumәn
spoliation => .spәuli'eiʃәn
spoliator => 'spәjlieitә(r)
spondaic => spɒn'deiik
spondee => 'spɒndi:
spondylitis => .spɒndi'laitis
spondylosis => spɔndi'lәusis
sponge => spʌndʒ
sponge bag => spʌndʒ bæɡ
sponge pudding => spʌndʒ ˈpudiŋ
sponge-like => s'pʌndʒl'aɪk
spongeable => 'spʌndʒәbl
sponger => 'spʌndʒә
spongers => ˈspʌndʒəz
spongier => 'spʌn(d)ʒɪ
spongiest => 'spʌn(d)ʒɪ
spongiform => 'spʌŋdʒifɔ:m
spongin => 'spʌndʒin
sponginess => 'spʌndʒinis
sponging => 'spʌndʒiŋ
spongy => 'spʌndʒi
sponson => 'spɒnsn
sponsor => 'spɒnsә
sponsored => ˈspɔnsəd
sponsors => ˈspɔnsəz
sponsorship => 'spɔnsәʃip
spontaneity => .spɒntә'ni:iti
spontaneous => spɒn'teiniәs
spoof => spu:f
spoofed => spuːf
spoofery => 'spuːfərɪ
spoofs => spu:fs
spook => spu:k
spooked => spu:kt
spookier => ˈspu:ki:ə
spookily => 'spu:kili
spooks => spu:ks
spooky => 'spu:ki
spool => spu:l
spooled => s'pu:ld
spools => spu:lz
spoon => spu:n
spoonbill => 'spu:nbil
spooned => s'pu:nd
Spooner => 'spu:nə
spoonerism => 'spu:nәrizm
spoonerisms => ˈspu:nərizəmz
spoonful => 'spu:nful
spoonfuls => ˈspu:nˌfʊlz
spoons => spu:nz
spoonworm => 'spu:nwə:m
spoony => 'spu:ni
spoor => spuә
Sporades => 'spɔ:rәdi:z,spɔ:'rɑ:ðes
sporadic => spәu'rædik
sporangial => spɔ:'rændʒiәl
sporangiophore => spɔ:'rændʒiәufɔ:
sporangium => spә'rændʒiәm
spore => spɒ:
spores => spɔ:z
spork => s'pɔ:k
sporocyst => 'spɔ:rә,sist
sporogenesis => ,spɔ:rә'dʒenisis
sporogony => spɔ:'rɔ^әni
sporophore => 'spɔ:rә,fɔ:
sporophyte => 'spɒ:rәfait
Sporozoa => spɔ:rә'zәuә
sporozoan => ,spɔ:rә'zәuәn
sporozoite => ,spɔ:rә'zәuait
sporran => 'spɒrәn
sport => spɒ:t
sport car => spɔ:t kɑ:
sport coat => spɔ:t kəut
sporter => 'spɔ:tә(r)
sportfisherman => 'spɔːt,fɪʃəmən
sportif => spɔ:ˈtif
sporting => 'spɒ:tiŋ
sporting chance => ˈspɔ:tɪŋ tʃɑ:ns
sportive => 'spɒ:tiv
sportively => s'pɔ:tɪvlɪ
sports => spɔ:ts
sports bar => spɔ:ts bɑ:
sports coat => spɔ:ts kəut
sports jacket => spɔ:ts ˈdʒækit
sports shirt => spɔ:ts ʃə:t
sportscar => spɔ:ts'kɑ:
sportscast => 'spɒ:tskɑ:st
sportscaster => 'spɒ:tskɑ:stә
sportsman => 'spɒ:tsmәn
sportsmanlike => 'spɔ:tsmәnlaik
sportsmanship => 'spɒ:tsmәnʃip
sportsperson => ˈspɔ:tspɜ:sn
sportster => 'spɔːtstə
sportswear => 'spɒ:tswєә
sportswoman => 'spɒ:tswumәn
sportswomen => 'spɔ:tswɪmɪn
sportswriter => 'spɔ:ts,raitә(r)
sportswriters => 'spɔːts,raɪtə
sporty => 'spɔ:ti
sporulate => 'spɔrjuleit
sporulated => ˈspɔrjuleitid
sporulates => ˈspɔrjuleits
sporulating => ˈspɔrjuleitɪŋ
sporulation => ,spɔ:rjj'leiʃәn,,spɔ-
spot => spɒt
spot kick => spɔt kik
spot weld => spɔt weld
spot-on => s'pɒt'ən
spot-weld => s'pɒtw'eld
spot-welder => s'pɒtw'eldər
spot-welding => s'pɒtw'eldɪŋ
spotless => 'spɒtlis
spotlessly => 'spɔtlisli
spotlight => 'spɒtlait
spotlighted => ˈspɔtlaitid
spotlighting => s'pɒtlaɪtɪŋ
spotlights => 'spɒtlaɪts
spotlit => ˈspɒtlɪt
spotted => 'spɒtid
spotted dick => ˈspɔtɪd dik
spotted dog => ˈspɔtɪd dɔɡ
spotted flycatcher => ˈspɑtɪd ˈflaɪˌkætʃɚ
spottedness => spɒ'tɪdnəs
spotter => 'spɒtә
spotters => ˈspɔtəz
spottier => ˈspɔti:ə
spottiness => 'spɒtinis
spotting => 'spɔtiŋ
spotty => 'spɒti
spousal => 'spauzl
spouse => spauz
spouses => spauziz
spout => spaut
spouted => 'spautid
spouting => 'spautiŋ
spoutless => 'spajtlis
spouts => spaʊts
spraddle => 'sprædl
sprag => spræg
spragged => spræg
sprain => sprein
sprained => spreɪnd
spraining => spreɪnɪŋ
sprains => spreɪnz
sprang => spræŋ
sprat => spræt
sprats => spræts
sprawl => sprɒ:l
sprawled => sprɔ:ld
sprawls => sprɔ:lz
spray => sprei
spray can => sprei kæn
spray-dry => 'spreidrai
spray-paint => 'spreipeint
sprayable => sp'reɪeɪbl
sprayer => 'spreiә
sprayers => sp'reɪəz
spraying => 'spreiiŋ
sprays => spreiz
spread => spred
spread out => spred aut
spreadable => 'spredәbl
spreadeagled => ˌspredˈi:gld
spreader => 'spredә
spreading => 'sprediŋ
spreadsheet => 'spredʃi:t
spreadsheets => 'spredʃi:ts
spree => spri:
sprig => sprig
sprigged => sprɪɡd
sprigging => sp'rɪɡɪŋ
spriggy => 'sprigi
sprightlier => ˈspraɪtli:ə
sprightliness => 'spraitlinis
sprightly => 'spraitli
sprigs => sprɪgz
spring => spriŋ
spring break => spriŋ breik
spring equinox => spriŋ ˈi:kwinɔks
spring fever => spriŋ ˈfi:və
spring onion => spriŋ ˈʌnjən
spring roll => spriŋ rəul
spring tide => spriŋ taid
spring-cleaning => 'spriŋ'kli:niŋ
spring-loaded => ˈsprɪŋˈləʊdɪd
springboard => 'spriŋbɒ:d
springboards => ˈsprɪŋˌbɔ:dz
springbok => 'spriŋbɒk
springboks => ˈspriŋbɔks
springe => sprindʒ
springer => 'spriŋә
Springfield => 'spriŋfi:ld
springhare => 'spriŋheә(r)
springhouse => 'spriŋhajs
springiness => 'spriŋinis
springing => 'spriŋiŋ
springtail => 'spriŋteil
springtide => 'spriŋtaid
springtime => 'spriŋtaim
springwater => 'spriŋwɒtә
springy => 'spriŋi
sprinkle => 'spriŋkl
sprinkled => ˈspriŋkld
sprinkler => 'spriŋklә
sprinklers => ˈsprɪŋkləz
sprinkles => ˈsprɪŋklz
sprinkling => 'spriŋkliŋ
sprint => sprint
sprinted => sprɪntid
sprinter => 'sprintә
sprinters => sp'rɪntəz
sprit => 'sprit
sprite => sprait
spritsail => 'spritseil
spritz => sprits
spritzed => spritst
spritzer => ˈsprɪtsə(r)
spritzes => spritsiz
spritzing => spritsɪŋ
sprocket => 'sprɒkit
sprockets => ˈsprɔkits
sprog => sprɔ^
sprout => spraut
sprouts => spraʊts
spruce => spru:s
spruce budworm => spru:s ˈbʌdˌwɜ:m
spruced => spru:st
spruces => spru:siz
sprucing => spru:sɪŋ
sprue => spru:
spruik => 'spru:ik
spruit => spreit, spru:t
sprung => sprʌŋ
sprung rhythm => sprʌŋ ˈriðəm
spry => sprai
spryest => spraɪ
spud => spʌd
spudded => spʌdid
spudding => s'pʊdɪŋ
spuds => spʌdz
spue => spju:
spued => spju:d
spuing => spju:ɪŋ
spumante => sp'ju:mənti:
spume => spju:m
spumed => spju:md
spumes => spju:mz
spuming => spju:mɪŋ
spumoni => spә'mәuni
spumous => 'spju:mәs
spumy => 'spju:mi
spun => spʌn
spun yarn => spʌn jɑ:n
spunk => spʌŋk
spunkier => ˈspʌŋkiə
spunky => 'spʌŋki
spur => spә:
spur wheel => spə: hwi:l
spurge => spә:dʒ
spurge laurel => spə:dʒ ˈlɔ:rəl
spurging => 'spә:dʒiŋ
spurious => 'spjuriәs
spuriously => 'spjʊərɪəslɪ
spurn => spә:n
spurned => spɜ:nd
spurning => spɜ:nɪŋ
spurns => spɜ:nz
spurrier => 'spә:riә
spurring => spə:ɪŋ
spurs => spə:z
spurt => spә:t
spurted => spɜ:tid
spurts => spɜ:ts
sputnik => 'sputnik
sputter => 'spʌtә
sputtered => ˈspʌtəd
sputtering => 'spʌtәriŋ
sputters => ˈspʌtəz
sputum => 'spju:tәm
spy => spai
spyglass => 'spaiglæs
spyhole => 'spaihәul
spymaster => 'spai,mɑ:stә(r); -,mæs-
squab => skwɒb
squabble => 'skwɒbl
squabbled => ˈskwɔbəld
squabbles => ˈskwɔbəlz
squabbling => ˈskwɔbəlɪŋ
squad => skwɒd
squaddie => ˈskwɒdi
squadron => 'skwɒdrәn
squadron leader => ˈskwɔdrən ˈli:də
squadrons => ˈskwɔdrənz
squads => skwɔdz
squalamine => skwæ'læmaɪn
squalene => 'skweili:n
squalid => 'skwɒlid
squalidness => skwɒ'lɪdnəs
squall => skwɒ:l
squall line => skwɔ:l lain
squalled => skwɔ:ld
squalling => skwɔ:lɪŋ
squalls => skwɔ:lz
squally => 'skwɒ:li
squalor => 'skwɒlә
squamate => 'skweimit
squamosal => skwә'mәusl
squamous => 'skweimәs
squamule => 'skweimju:l
squamulose => 'skwæmju,lәus, 'skwei-
squander => 'skwɒndә
squandered => ˈskwɔndəd
squanderer => 'swɒndәrә
squandering => ˈskwɔndərɪŋ
squanders => ˈskwɔndəz
square => skwєә
square dance => skwɛə dɑ:ns
square knot => skwɛə nɔt
square measure => skwɛə ˈmeʒə
square off => skwɛə ɔf
square root => skwɛə ru:t
square sail => skwɛə seil
square-built => 'skweәbilt
square-rigger => 'skweә'ri^ә(r)
square-shouldered => 'skweә'ʃәjldәd
square-toed => 'skweә'tәjd
squarehead => 'skwєәhed
squarely => 'skwєәli
squareness => 'skwєәnis
squarer => 'skweәrә
squaring => 'skweәriŋ
squarish => 'skwєәriʃ
squark => sk'wɔ:k
squash => skwɒʃ
squash bug => skwɔʃ bʌɡ
squashed => skwɔʃd
squashes => skwɔʃiz
squashy => 'skwɒʃi
squat => skwɒt
squat thrust => skwɔt θrʌst
squats => skwɔts
squatted => skwɔtid
squatter => 'skwɒtә
squatters => ˈskwɔtəz
squatting => 'skwɔtiŋ
squaw => 'skwɒ:
squaw man => skwɔ: mæn
squawfish => 'skwɔ:fiʃ
squawk => skwɒ:k
squawked => skwɔ:kt
squawking => skwɔ:kɪŋ
squawks => skwɔ:ks
squawroot => skwɔ:'ru:t
squaws => skwɔ:z
squeak => skwi:k
squeaked => skwi:kt
squeaker => 'skwi:kә
squeaks => skwi:ks
squeaky => 'skwi:ki
squeaky clean => ˈskwi:ki kli:n
squeal => skwi:l
squealed => skwi:ld
squealing => 'skwi:liŋ
squeals => skwi:lz
squeamish => 'skwi:miʃ
squeegee => 'skwi:dʒi:
squeegeed => ˈskwi:dʒi:d
squeegeeing => ˈskwi:dʒi:ɪŋ
squeegees => ˈskwi:dʒi:z
squeezable => 'skwi:zәbl
squeeze => skwi:z
squeezebox => 'skwi:zbɔks
squeezed => skwi:zd
squeezer => 'skwi:zә
squeezes => skwi:ziz
squelch => 'skweltʃ
squelched => skweltʃt
squelcher => 'skweltʃә
squelches => skweltʃiz
squelching => skweltʃɪŋ
squelchy => 'skweltʃi
squib => skwib
squibbed => sk'wɪbbed
squibbing => sk'wɪbɪŋ
squibs => skwibz
squid => skwid
squids => skwɪdz
squiffed => 'skwift
squiffy => 'skwifi
squiggle => 'skwigl
squiggles => ˈskwɪgəlz
squiggly => 'skwɪɡlɪ
squill => skwil
squinch => skwintʃ
squint => skwint
squint-eyed => 'skwintaid
squinted => skwɪntid
squints => skwɪnts
squinty => 'skwinti
squire => skwaiә
squirearch => 'skwaiәrɑ:k
squirearchy => 'skwaiә.rɑ:ki
squired => skwaɪə
squireen => .skwaiә'ri:n
squires => skwaɪəz
squiring => skwaɪə
squirm => skә:m
squirmed => skwɜ:md
squirming => skwɜ:rmɪŋ
squirms => skwɜ:mz
squirmy => 'skә:mi
squirrel => 'skwә:rәl
squirrel monkey => ˈskwirəl ˈmʌŋki
squirrels => ˈskwirəlz
squirt => skwә:t
squirted => skwɜ:tid
squirter => skwɜ:tə
squirts => skwɜ:ts
squish => skwiʃ
squished => skwiʃt
squishes => skwiʃiz
squishing => skwiʃɪŋ
squishy => 'skwiʃi
squit => skwit
squiz => skwiz
Sranan => 'srɑ:nən
sri => sri
Sri Lanka => sri'læŋkә
Srinagar => ,sri:'nʌ^ә(r)
stab => stæb
Stabat Mater => 'stɑ:bæt 'mɑ:tә
stabber => 'stæbә
stabbing => 'stæbiŋ
stabile => 'steibil
stabilisation => ˌsteɪbɪlaɪ'zeɪʃən
stabilise => 'steibilaiz
stabilised => 'steɪbɪlaɪz
stabilising => 'steɪbɪlaɪz
stabilities => stəˈbilitiz
stability => stә'biliti
stabilization => .steibilai'zeiʃәn
stabilize => 'steibilaiz
stabilizer => 'steibilaizә
stabilizers => s'teɪbəlaɪzəz
stabilizes => ˈsteibəlaiziz
stabilizing => 'steibә,laiziŋ
stable => 'steibl
stable boy => ˈsteibl bɔi
stable companion => ˈsteibl kəmˈpænjən
stable door => ˈsteibl dɔ:
stableboy => 'steiblbɔi
stableman => 'steiblmәn
stables => ˈsteiblz
stabling => 'steibliŋ
stablish => 'stæbliʃ
stably => 'steibli
stabs => stæbz
staccato => stә'kɑ:tәu
stack => stæk
stackable => 'stækәbl
stacker => 'stækә
stacking => 'stækiŋ
stackyard => 'stækjɑ:d
staddle => 'stædl
stadia => 'steidiә
stadium => 'steidiәm
stadtholder => 'stæt,hәjldә(r)
staff => stɑ:f
staff nurse => stɑ:f nə:s
staff officer => stɑ:f ˈɔfisə
staff sergeant => stɑ:f ˈsɑ:dʒənt
Staffa => 'stæfə
staffage => 'stɑ:fidʒ
staffed => stɑ:ft
staffer => 'stɑ:fә
staffers => ˈstɑ:fə(r),ˈstæ-
staffing => 'stɑ:fiŋ
Staffordshire => 'stæfәdʃiә(r)
staffs => stɑ:fs
stag => stæg
stag beetle => stæg ˈbi:tl
stag night => stæg nait
stag party => stæg ˈpɑ:ti
stage => steidʒ
stage direction => steidʒ diˈrekʃən
stage management => steidʒ ˈmænidʒmənt
stage name => steidʒ neim
stage-dive => 'steidʒ,daiv
stage-manage => steidʒ'mænidʒ
stage-struck => steidʒ strʌk
stagecoach => 'steidʒkәutʃ
stagecoaches => ˈsteidʒkəutʃiz
stagecraft => 'steidʒkrɑ:ft; -kræft
staged => steidʒd
stagehand => 'steidʒhænd
stagehands => ˈsteidʒhændz
stager => 'steidʒә
stagestruck => 'steidʒstrʌk
stagey => 'steidʒi
stagflation => stæg'fleiʃәn
stagged => stægd
stagger => 'stægә
staggerer => 'stæ^әrә(r)
staggering => 'stægәriŋ
staggeringly => 'stæɡərɪŋlɪ
stagging => stægɪŋ
staghorn => 'stæghɒ:n
staghorn fern => ˈstæɡhɔ:n fɜ:n
staghound => stæɡ'haʊnd
staging => 'steidʒiŋ
stagnancy => 'stægnәnsi
stagnant => 'stægnәnt
stagnantly => s'tæɡnəntlɪ
stagnate => 'stægneit
stagnated => ˈstæɡneitid
stagnates => ˈstæɡneits
stagnating => ˈstæɡneitɪŋ
stagnation => stæg'neiʃәn
stags => stægz
stagy => 'steidʒi
staid => steid
staidness => 'steidnis
stain => stein
stained => steind
stained glass => steind ɡlɑ:s
stainer => 'steinә
staining => 'steiniŋ
stainless => 'steinlis
stair => stєә
staircase => 'stєәkeis
staircases => s'teəkeɪsɪz
stairclimber => steək'laɪmər
stairhead => 'steәhed
stairlift => ˈsteəlɪft
stairway => 'stєәwei
stairways => ˈsteəˌweɪz
stairwells => ˈstɛəwelz
stake => steik
stakeholder => 'steikhәuldә
stakeholder pension => ˈstekˌholdɚ ˈpɛnʃən
stakeholders => s'teɪkhəʊldəz
stakeout => 'steikaut
staker => 'steikә
Stakhanovism => stә'kɑ:nәvizәm, stɑ:'hɑ:nɔ-
Stakhanovite => stәkɑ:nәvait
staking => 'steikiŋ
stalactite => 'stælәktait
stalactites => s'tæləktaɪts
stalactitic => .stælәk'titik
stalagmite => 'stælәgmait
stalagmites => stæ'ləɡmaɪts
stalagmitic => .stælәg'mitik
stale => steil
stalemate => 'steilmeit
stalemated => s'teɪlmeɪtɪd
stalemates => ˈsteɪlˌmeɪts
stalemating => ˈsteɪlˌmeɪtɪŋ
staleness => 'steilnis
stales => steilz
stalin => 'stɑ:lin
Stalinabad => ,stɑ:linɑ:'bɑ:t
Stalingrad => 'stɑ:lin^ræd
Stalinism => 'stɑ:liniz(ә)m
Stalinist => 'stalinist
Stalino => 'stɑ:linɔ:, -nәj, 'stæ-
stalk => stɒ:k
stalked => 'stɔ:kt
stalkless => s'tɔ:kles
stalks => stɔ:ks
stalky => s'tɔ:kɪ
stall => stɒ:l
stall-feed => 'stɔ:lfi:d
stallage => 'stɒ:lidʒ
stallholder => ˈstɔ:lhəʊldə(r)
stallion => 'stæljәn
stallions => ˈstæljənz
stalwart => 'stɒ:lwәt
stalwarts => ˈstɔ:lwəts
stamen => 'steimәn
stamford => 'stæmfәd
stamina => 'stæminә
staminate => 'stæminit
staminode => 'stæmi,nәud
stammer => 'stæmә
stammered => ˈstæməd
stammerer => 'stæmәrә
stammers => ˈstæməz
stamp => stæmp
stamp collector => stæmp kəˈlektə
stamped => stæmpt
stampede => stæm'pi:d
stampeded => stæmˈpi:did
stampedes => stæmˈpi:dz
stampeding => stæmˈpi:dɪŋ
stamper => 'stæmpә
stamping => 'stæmpiŋ
stamping ground => ˈstæmpiŋ ɡraund
stan => stæn
stance => stæns
stances => stænsiz
stanch => stænʃ
stanched => stɔ:ntʃt
stanches => stɔ:ntʃiz
stanching => stɔ:ntʃɪŋ
stanchion => 'stɑ:nʃәn
stanchioned => 'stænʃ(ə)n
stanchions => ˈstɑ:nʃənz
stand => stænd
stand at => stænd æt
stand-alone => 'stændә,lәjn
stand-down => 'stænddajn
stand-off => stænd ɔf
stand-off half => stænd ɔf hɑ:f
stand-offish => ˌstænd ˈɒfɪʃ
stand-to => 'stændtu:
standalone => 'stændəˌləʊn
standard => 'stændәd
standard lamp => ˈstændəd læmp
standard of living => ˈstændəd ɔv ˈliviŋ
standardisation => ,stændədai'zeiʃən, -di'z-
standardised => 'stændədaiz
standardization => ,stændәdai'zeiʃәn
standardize => 'stændәdaiz
standardized => 'stændә,daizd
standardizes => ˈstændəˌdaɪziz
standardly => 'stændəd
standby => 'stændbai
standbys => ˈstændˌbaɪz
standee => stæn'di:
stander => 'stændə
standing => 'stændiŋ
standing crop => ˈstændɪŋ krɔp
standing ovation => ˈstændɪŋ əʊˈveɪʃən
standing room => ˈstændɪŋ ru:m
standing stone => ˈstændɪŋ stəun
standings => s'tændɪŋz
standish => 'stændiʃ
standoff => 'stændɒf
standoffish => 'stændɒfiʃ
standout => 'stændaut
standpipe => 'stændpaip
standpipes => ˈstændpaips
standpoint => 'stændpɒint
standpoints => s'tændpɔɪnts
standstill => 'stændstil
stanford => 'stænfәd
stanhope => 'stænhәup
Stanislaus => 'stænislɔ:s, -lajs
Stanislav => 'stænəslɑ:f
Stanislavsky => ,stæni'slɑ:vski; -slɑ:f-
stank => stæŋk
stanley => 'stænli
Stanleyville => 'stænli:vil
stannary => 'stænәri
stannic => 'stænik
stannous => 'stænәs
Stanton => 'stɑ:ntәn, 'stæntәn
stanza => 'stænzә
stanzas => s'tænzəz
stapedectomy => ,steipi'dektәmi
stapedial => stә'pi:diәl
stapedotomy => s'teɪpdəʊtəmɪ
stapelia => stә'pi:liә, -jә
stapes => 'steipi:z
staph => stæf
staphylinid => ,stæfi'linid, -'lai-
staphylococcal => ,stæfilәj'kɔkәl
staphylococcus => .stæfilәu'kɒkәs
staple => 'steipl
staple gun => ˈsteipl ɡʌn
stapled => ˈsteipld
stapler => 'steiplә
staplers => ˈsteɪpləz
stapling => 'steipliŋ
star => stɑ:
star apple => stɑ: ˈæpl
star route => stɑ: ru:t
star sapphire => stɑ: ˈsæfˌaɪə
star sign => stɑ: sain
star turn => stɑ: tə:n
starboard => 'stɑ:bɒ:d
starboarded => ˈstɑ:bədid
starboarding => ˈstɑ:bədɪŋ
starboards => ˈstɑ:bədz
starburst => ˈstɑ:bɜ:st
starch => stɑ:tʃ
starched => stɑ:tʃt
starcher => 'stɑːtʃə
starches => stɑ:tʃiz
starchier => ˈstɑ:tʃi:ə
starchiness => 'stɑ:tʃinis
starching => s'tɑ:tʃɪŋ
starchy => 'stɑ:tʃi
stardom => 'stɑ:dәm
stardust => 'stɑ:dʌst
stare => stєә
stare decisis => 'stɑ:ri di'saisis
stares => stɛəz
starfish => 'stɑ:fiʃ
starflower => 'stɑ:.flauә
starfruit => ˈstɑ:fru:t
stargaze => 'stɑ:geiz
stargazer => 'stɑ:geizә
staring => 'stєәriŋ
stark => stɑ:k
stark naked => stɑ:k ˈneikid
starker => stɑ:kə
starkers => ˈstɑ:kəz
starkness => 'sta:knis
starless => 'stɑ:lis
starlet => 'stɑ:lit
starlets => ˈstɑ:lɪts
starlight => 'stɑ:lait
starlike => 'stɑ:laik
starling => 'stɑ:liŋ
starlings => ˈstɑ:liŋz
starlit => 'stɑ:lit
starred => stɑ:d
starriness => 'stɑ:rinis
starry => 'stɑ:ri
starship => ˈstɑ:ʃɪp
start => stɑ:t
start over => stɑ:t ˈəuvə
started => s'tɑ:tɪd
starter => 'stɑ:tә
starting => 'stɑ:tiŋ
starting gate => ˈstɑ:tiŋ ɡeit
starting handle => ˈstɑ:tiŋ ˈhændl
starting pistol => ˈstɑ:tiŋ ˈpistl
starting post => ˈstɑ:tiŋ pəust
starting price => ˈstɑ:tiŋ prais
startle => 'stɑ:tl
startler => 'stɑ:tlә
startles => ˈstɑ:tlz
startling => 'stɑ:tliŋ
startlingly => 'sta:tliŋli
starvation => stɑ:'veiʃәn
starve => stɑ:v
starved => stɑ:vd
starveling => 'stɑ:vliŋ
starves => stɑ:vz
starwort => s'tɑ:rwɜ:t
stash => stæʃ
stashed => stæʃt
stashes => stæʃiz
stashing => stæʃɪŋ
Stasi => 'stæsi:
stasis => 'steisis
stat => stæt
statable => 'steitəbl
statant => 'steitәnt
state => steit
state attorney => steit əˈtə:ni
state house => steit haus
state of grace => steit ɔv ɡreis
state school => steit sku:l
state university => steit ˌjuːnɪˈvɜː(r)səti
statecraft => 'steitkræft
stated => 'steitid
statehood => 'steithud
statehouse => s'teɪthaʊs
stateless => 'steitlis
statelet => ˈsteɪtlət
stateliness => 'steitlinis
stately => 'steitli
stately home => ˈsteɪtli: həum
statement => 'steitmәnt
stater => 'steitә
stateroom => 'steitru:m
staterooms => ˈsteɪtˌru:mz
statesman => 'steitsmәn
statesmanlike => 'steitsmәnlaik
stateswoman => 'steitswumәn
statewide => 'steitwaid
static => 'stætik
static line => ˈstætik lain
statice => 'stætisi
statics => 'stætiks
statin => 'stætɪn
station => 'steiʃәn
station-keeping => 'steiʃən,ki:piŋ
stationary => 'steiʃ(ә)nәri
stationary bicycle => ˈsteiʃənəri ˈbaisikl
stationer => 'steiʃәnә
stationers => ˈsteɪʃənəz
stationery => 'steiʃәnәri
stationmaster => 'steiʃәn.mɑ:stә
stationmasters => ˈsteiʃ(ə)nmɑ:stəz
statism => 'steitizm
statist => 'steitist
statistic => stә'tistik
statistical => stә'tistikl
statistician => .stæti'stiʃәn
statisticians => ˌstætɪˈstɪʃənz
statistics => stә'tistiks
stative => 'steitiv
stato- => s'teɪtəʊ
statoblast => 'stætә,blɑ:st
statocyst => 'stætә,sist
statolith => 'stætә,liθ
stator => 'steitә
statoscope => 'stætәskәup
statuary => 'stætjuәri
statue => 'stætju
statued => 'stætjud
statues => s'tætʃu:z
statuesque => .stætju'esk
statuette => .stætju'et
statuettes => ˌstætʃu:ˈets
stature => 'stætʃә
statured => 'stætʃəd
status => 'steitәs
status quo => steitәs 'kwәj
status symbol => ˈsteitəs ˈsimbəl
statute => 'stætju:t
statute mile => ˈstætju:t mail
statutorily => 'stætjutərili
statutory => 'stætjutәri
statutory instrument => ˈstætjutəri ˈinstrumənt
statutory offence => ˈstætjutəri əˈfens
staunch => stɒ:ntʃ
staunched => stɔ:ntʃt
staunches => stɔ:ntʃiz
staunching => stɔ:ntʃɪŋ
staunchly => 'stɔ:ntʃli
Staunton => 'stæntən
staurolite => 'stɔ:rә,lait
Stavanger => stә'væŋә
stave => steiv
staves => steivz
stavesacre => 'steivz,eikә
staving => 'steiviŋ
stay => stei
staycation => ˌsteɪ'keɪʃn
stayer => 'steiә
staying => 'steiiŋ
staying power => ˈsteiiŋ ˈpauə
staysail => 'steiseil, 'steis(ә)l
stead => sted
steadfast => 'stedfәst
steadfastly => 'stedfɑ:stlɪ
steadfastness => s'tedfɑ:stn'es
steadied => ˈstedid
steadier => 'stediә
steadies => ˈstediz
steadily => 'stedili
steadiness => 'stedinis
steading => 'stediŋ
steady => 'stedi
steady state theory => ˈstedi steit ˈθiəri
steadying => ˈstediŋ
steak => steik
steak knife => steik naif
steak tartare => ˌsteɪk tɑ:ˈtɑ:(r)
steakhouse => 'steikhaus
steaks => steiks
steal => sti:l
stealing => 'sti:liŋ
steals => sti:lz
stealth => stelθ
stealthier => ˈstelθi:ə
stealthily => 'stelθili
stealthy => 'stelθi
steam => sti:m
steam heat => sti:m hi:t
steam iron => sti:m ˈaiən
steam shovel => sti:m ˈʃʌvl
steam table => sti:m ˈteibl
steamboat => 'sti:mbәut
steamboating => 'stiːmbəʊt
steamer => 'sti:mә
steamers => s'ti:məz
steaminess => stɪə'mɪnɪs
steaming => 'sti:miŋ
steamroll => 'sti:mrɒl
steamroller => 'sti:mrәjlә(r)
steamrollered => ˈsti:mˌrəʊləd
steamrollering => ˈsti:mˌrəʊlərɪŋ
steamrollers => ˈsti:mˌrəʊləz
steams => sti:mz
steamship => 'sti:mʃip
steamy => 'sti:mi
stearate => 'sti:әreit
stearic => sti'ærik
stearin => 'sti:әrin
steatite => 'sti:әtait
steatitic => .sti:ә'titik
steatopygia => ,stiәtәu'pidʒiә
steatosis => sti:ә'tәusis
steed => sti:d
steeds => sti:dz
steel => sti:l
steel blue => sti:l blu:
steel drum => sti:l drʌm
steel engraving => sti:l enˈgreɪvɪŋ
steel grey => sti:l ɡrei
steel wool => sti:l wul
steele => sti:l
steelhead => 'sti:l'hed
steeliness => 'sti:linis
steeling => 'sti:liŋ
steelmaker => 'sti:lˌmeɪkə
steelworker => 'sti:lwә:kә
steely => 'sti:li
steelyard => 'sti:ljɑ:d
steen => sti:n. stein
steenbok => s'ti:nbɒk
steep => sti:p
steeped => 'sti:pt,'stipt
steepen => 'sti:pәn
steepened => ˈsti:pənd
steepening => ˈsti:pənɪŋ
steepens => ˈsti:pənz
steeper => 'sti:pә
steeping => 'sti:piŋ
steepish => s'ti:pɪʃ
steeple => 'sti:pl
steeplechase => 'sti:p(ә)ltʃeis
steeplechaser => ˈsti:pltʃeɪsə(r)
steeplechases => ˈsti:pltʃeisiz
steeplechasing => sti:plt'ʃeɪsɪŋ
steepled => 'sti:pld
steeplejack => 'sti:pljæk
steeplejacks => 'stiːp(ə)ldʒæk
steeples => ˈsti:pəlz
steeply => 'sti:pli
steepness => 'sti:pnis
steeps => sti:ps
steer => stiә
steerage => 'stiәridʒ
steered => stiəd
steering => 'stiәriŋ
steering column => ˈstiəriŋ ˈkɔləm
steering wheel => 'stiәriŋ
steers => stiəz
steersman => 'stiәzmәn
steeve => sti:v
stegosaur => 'ste^ә,sɔ:
stegosaurus => .stegә'sɒ:rәs
Steiermark => 'ʃtaiə,mɑ:k
stein => stain
steinbeck => 'stainbek
steinbock => s'taɪnbɒk
steinbok => 'staɪnbɒk
stela => 'sti:lә
stelar => 'sti:lә
stele => 'sti:li
stellar => 'stelә
stellarator => 'steləreɪtə
stellate => 'stelit
stellated => 'steleitid
stellenbosch => 'stelәnbɒʃ
stelliform => 'stelifɒ:m
stem => stem
stem cell => stem sel
stem turn => stem tə:n
stem-winder => s'temw'aɪndər
stemma => 'stemә
stemmed => stemd
stemming => 'stemiŋ
stemple => 'stempl
stemware => 'stemwєә
stemwinder => 'stem'waində
sten => sten
stench => stentʃ
stenches => stentʃiz
stencil => 'stensil
stenciled => ˈstensəld
stencilled => ˈstensəld
stencilling => sten'səlɪŋ
stencils => ˈstensəlz
Stendhal => stæŋ'dɑ:l
steno => 'stenәu
stenographer => stә'nɒgrәfә
stenographers => stəˈnɔgrəfəz
stenographic => .stenә'græfik
stenography => stә'nɒgrәfi
stenohaline => ,stenә'heilain, -'hælain
stenose => sti'nәus
stenosed => stә'nәust, -'nәuzd
stenosing => sti'nәusiŋ
stenosis => sti'nәusis
stenotopic => ,stenә'tɔpik
stenotype => 'stenәtaip
stenter => 'stentә
stenting => s'tentɪŋ
stentor => 'stentә
stentorian => sten'tɒ:riәn
step => step
step back => step bæk
step forward => step ˈfɔ:wəd
step- => step-
stepbrother => 'stepbrʌðә
stepbrothers => ˈstepˌbrʌðəz
stepchild => 'steptʃaild
stepchildren => ˈsteptʃɪldrən
stepdaughter => 'step,dɔ:tә
stepfamily => ˈstepfæməli
stepfather => 'step,fɑ:ðә
stepfathers => ˈstepˌfɑ:ðəz
stephanotis => .stefә'nәutis
stephen => 'sti:vn
stephenson => 'sti:vnsn
stepladder => 'step.lædә
stepladders => s'teplædərz
stepmother => 'step.mʌðә
stepmothers => ˈstepˌmʌðəz
stepney => 'stepni
stepparent => 'steppeәrәnt
steppe => step
stepped => stept
stepper => 'stepә
steppes => s'teps
stepping => 'stepiŋ
stepping stone => ˈstepiŋ stəun
stepping-stone => 'stepiŋ,stәun
stepsister => 'stepsistә
stepsisters => ˈstepˌsistəz
stepson => 'stepsʌn
stepsons => ˈstepsʌnz
Steptoe => 'step,təʊ
stepwise => 'stepwaiz
steradian => stә'reidjәn
stercoraceous => ,stә:kә'reiʃәs
stere => 'stiә
stereo => 'stiәriәu
stereobate => 'steriәbeit
stereochemistry => .stiәriә'kemistri
stereognosis => ,steriɔ^'nәusis
stereogram => 'stiәriә,^ræm
stereograph => 'stiәriәgrɑ:f
stereographic => .stiәriә'græfik
stereography => .stiәri'ɒgrәfi
stereoisomer => ,stiәriәu'aisәmә
stereometry => .stiәri'ɒmitri
stereomicroscope => ,stiәriә'maikrәskәup
stereophonic => .stiәriә'fɒnik
stereophony => ,stiәri'ɔfәni
stereopsis => ,stiәri'ɔpsis
stereopticon => .stiәri'ɒptikәn
stereos => ˈstiəriəuz
stereoscope => 'stiәriәskәup
stereoscopic => .stiәriә'skɒpik
stereoscopically => stɪərɪəskɒ'pɪklɪ
stereoscopy => ,stiәri'ɔskәpi
stereoselectivity => ,stiәriә,silek'tiviti
stereospecific => ,stiәriәuspi'sifik
stereospecificity => ,stiәriәu,spesi'fisiti
stereotaxis => ,stiәriәu'tæksis
stereotype => 'stiәriәtaip
stereotyped => 'steriәjtaipt
stereotypes => ˈsteriəˌtaɪps
stereotypic => ,sterɪəʊ'tɪpɪk
stereotypical => ,steriə'tipikl
stereotyping => ˈsteriəˌtaɪpɪŋ
stereotypy => 'stiәriә,taipi
steric => 'stiәrik, 'sterik
sterically => s'terɪklɪ
sterilant => 'sterilәnt
sterile => 'sterail
sterilisation => ˌsterɪlaɪ'zeɪʃən
sterilise => 'sterɪlaɪz
steriliser => sterɪ'laɪzə
sterility => ste'riliti
sterilization => .sterәlai'zeiʃәn
sterilize => 'sterәlaiz
sterilized => s'terəlaɪzd
sterilizer => 'sterilaizә
sterilizes => ˈsterɪlaɪziz
sterilizing => s'terəlaɪzɪŋ
sterlet => 'stә:lit
sterling => 'stә:liŋ
sterling silver => ˈstə:liŋ ˈsilvə
stern => stә:n
sternal => 'stә:nl
sterned => stə:n
sterner => stɜ:n
sternite => s'tɜ:naɪt
sternly => 'stә:nli
sternmost => 'stә:nmәust
sternness => 'stә:nnis
sternpost => 'stә:npәust
sterns => stə:nz
sternum => 'stә:nәm
sternutation => .stә:nju'teiʃәn
sternutator => 'stә:njuteitә
sternutatory => stә:'nju:tәtәri
sternway => 'stә:nwei
steroid => 'stiәrɒid
steroids => 'stɪərɔɪdz
sterol => 'sterәul
stertorous => 'stә:tәrәs
stet => stet
stethoscope => 'steθәskәup
stethoscopes => ˈsteθəˌskəʊps
stethoscopic => .steθә'skɒpik
stets => stets
stetson => 'stetsәn
stetted => stetid
Stettin => 'stetin
stetting => stetɪŋ
stevedore => 'sti:vәdɒ:
stevedores => ˈsti:vidɔ:z
steven => 'sti:vn
Stevenage => 'sti:vənidʒ
Stevengraph => ˊstiːvngraːf
stevens => 'sti:vnz
stevenson => 'sti:vnsn
stevia => s'ti:vɪə
stevioside => 'sti:viә,said
stew => stju:
steward => 'stju:wәd
stewardess => 'stju:wәdis
stewardesses => ˈstu:ədɪsiz
stewards => stjuədz
stewardship => 'stju:wәdʃip
stewart => 'stjuәt
stewbum => 'stju:bæm
stewed => stju:d
stewing => 'stju:iŋ
stewpot => 'stju:pɒt
stews => stju:z
sthenic => 'sθenik
stibnite => 'stibnait
Stich => stik
stichomythia => .stikәu'miθiә
stick => stik
stick with => stik wið
stickability => ,stikә'biliti
stickball => ˈstɪkbɔ:l
sticker => 'stikә
sticker price => ˈstɪkə prais
sticker shock => ˈstɪkə ʃɔk
stickers => ˈstɪkəz
stickier => ˈstikiə
stickily => 'stikili
stickiness => 'stikinis
sticking => 'stikiŋ
sticking plaster => 'stikiŋ
stickleback => 'stiklbæk
sticklebacks => ˈstik(ə)lbæks
stickler => 'stiklә
sticklers => ˈstɪkləz
stickpin => 'stikpin
stickseed => 'stɪksiːd
stickum => 'stikәm
stickweed => s'tɪkwi:d
sticky => 'stiki
sticky end => ˈstiki end
sticky tape => ˈstiki teip
stickybeak => 'stikibi:k
sties => staɪz
stiff => stif
stiffen => 'stifn
stiffened => ˈstɪfənd
stiffener => 'stifnә
stiffening => 'stifniŋ
stiffens => ˈstɪfənz
stiffly => 'stifli
stiffness => 'stifnis
stiffs => stɪf
stifle => 'staifl
stifler => 'staiflә
stifles => ˈstaiflz
stifling => 'staifliŋ
stigma => 'stigmә
stigmas => s'tɪɡməz
stigmatic => stig'mætik
stigmatise => 'stɪgmətaɪz
stigmatised => 'stiɡmətaiz
stigmatist => 'stiɡmətist
stigmatize => 'stigmәtaiz
stigmatized => ˈstɪgməˌtaɪzd
stigmatizes => ˈstɪgməˌtaɪziz
stigmatizing => ˈstɪgməˌtaɪzɪŋ
stilb => stilb
stilbene => 'stilbi:n
stile => 'stail
stiletto => sti'letәu
stilettos => stɪˈletəʊz
still => stil
stillage => 'stilidʒ
stillbirth => 'stilbә:θ
stillbirths => ˈstɪlˌbɜ:θs
stillborn => 'stilbɒ:n
stilling => 'stiliŋ
stillness => 'stilnis
stills => stilz
stilly => 'stili
stilt => stilt
stilted => 'stiltid
Stilton => 'stiltәn
stilts => stɪlts
Stimson => 'stimsn
stimulant => 'stimjulәnt
stimulate => 'stimjuleit
stimulates => ˈstimjuleits
stimulating => 'stimjuleitiŋ
stimulation => .stimju'leiʃәn
stimulative => 'stimjulәtiv
stimulator => 'stimjuleitә
stimulus => 'stimjulәs
sting => stiŋ
stingaree => 'stiŋ^әri:
stinger => 'stiŋә
stingers => 'stɪŋə
stingier => ˈstɪndʒi:ə
stinging => 'stiŋiŋ
stinging nettle => ˈstiŋiŋ ˈnetl
stingray => 'stiŋrei
stingrays => ˈstiŋreiz
stingy => 'stindʒi
stink => stiŋk
stink bomb => stiŋk bɔm
stinker => 'stiŋkә
stinkhorn => s'tɪŋkhɔ:n
stinking => 'stiŋkiŋ
stinking smut => ˈstiŋkiŋ smʌt
stinko => 'stiŋkәu
stinks => stɪŋk
stinkweed => 'stiŋkwi:d
stinky => 'stiŋki
stint => stint
stints => stɪnts
stipe => staip
stipend => 'staipend
stipendiaries => ˈstaipendjəriz
stipendiary => stai'pendiәri
stipends => ˈstaɪˌpendz
stipes => 'staipi:z
stipitate => 'stipәteit
stipple => 'stipl
stippled => ˈstɪpəld
stipples => ˈstɪpəlz
stipular => 'stipjulә
stipulate => 'stipjuleit
stipulated => ˈstipjuleit
stipulates => ˈstɪpjəˌleɪts
stipulating => ˈstɪpjəˌleɪtɪŋ
stipulation => .stipju'leiʃәn
stipulator => 'stipjuleitә
stipule => 'stipju:l
stir => stә:
stir-crazy => ˈstɜ:ˌkreɪzi:
stir-fries => stə: fraɪz
stir-fry => ˈstɜ:ˌfraɪ
stirabout => 'stә:rәbaut
stirk => stә:k
stirling => 'stә:liŋ
Stirlingshire => 'stə:liŋʃiə
stirred => stə:d
stirrer => 'stә:rә
stirrers => ˈstə:rəz
stirring => 'stә:riŋ
stirrup => 'stә:rәp
stirrup cup => ˈstɜ:rəp kʌp
stirrup iron => ˈstɜ:rəp ˈaiən
stirrup leather => ˈstɜ:rəp ˈleðə
stirrup pump => ˈstɜ:rəp pʌmp
stirrups => s'tɪrəps
stirs => stə:z
stishovite => 'stiʃә,vait
stitch => stitʃ
stitch-up => stitʃ ʌp
stitched => stitʃt
stitcher => 'stitʃә
stitchery => 'stitʃәri
stitching => 'stitʃiŋ
stiver => 'staivә
stoa => 'stәuә
stoat => stәut
stoats => stəuts
stochastic => stәu'kæstik
stock => stɒk
stock car => stɔk kɑ:
stock cube => stɔk kju:b
stockade => stɒ'keid
stockaded => stɒ'keɪd
stockades => stɔˈkeɪdz
stockading => stɒ'keɪd
stockbreeder => 'stɔkbri:dә(r)
stockbreeding => 'stɒkbri:diŋ
stockbroker => 'stɒk.brәukә
stockbroker belt => ˈstɔkˌbrəʊkə belt
stockbrokers => ˈstɔkˌbrəʊkəz
stocker => 'stɔkә
stockfish => 'stɒkfiʃ
stockholder => 'stɒkhәuldә
stockholding => 'stɔk.hәuldiŋ
Stockholm => 'stɒkhәulm
stockier => ˈstɔki:ə
stockily => 'stɒkili
stockinet => .stɒki'net
stockinette => ,stɒkə'net
stocking => 'stɒkiŋ
stocking filler => ˈstɔkiŋ ˈfilə
stockist => 'stɔkist
stockists => ˈstɔkists
stockjobber => 'stɒkdʒɒbә
stockjobbing => 'stɒkdʒɒbiŋ
stocklist => s'tɒklɪst
stockman => 'stɔkmәn
stockmarket => s'tɒkmɑ:kɪt
stockpile => 'stɒkpail
stockpiled => ˈstɔkˌpaɪld
stockpiles => ˈstɔkˌpaɪlz
Stockport => 'stɔkpɔ:t
stockpot => 'stɒkpɒt
stockroom => 'stɔkru:m. -rum
stockrooms => ˈstɔkˌru:mz
stocktake => 'stɔkteik
stocktaker => 'stɔkteik
stocktaking => 'stɒkteikiŋ
Stockton => 'stɔktən
stocky => 'stɒki
stockyard => 'stɒkjɑ:d
Stoddard => 'stɔdәd
stodge => stɒdʒ
stodgier => ˈstɔdʒi:ə
stodginess => ˊstɒdʒinis
stodgy => 'stɒdʒi
stoep => stu:p
Stoic => 'stәuik
stoical => 'stәuikәl
stoically => 'stəuikli
stoichiometric => ,stɒɪkɪə(ʊ)'metrɪk
stoichiometry => ,stɔiki'ɔmitri
Stoicism => 'stәuisizәm
stoics => ˈstəʊɪks
stoke => stәuk
Stoke-on-Trent => 'stəukɔn'trent; -ɔ:n-
stoked => stəʊkt
stokehole => 'stәukhәul
stoker => 'stәukә
stoking => stəʊkɪŋ
stole => stәul
stolen => 'stәulәn
stolid => 'stɒlid
stolidity => stә'liditi
stolidly => 'stɒlidli
stollen => 'stәulәn
stolon => 'stәulɒn
stolonate => 'stәulәnit
stoloniferous => ,stәu'nifәrәs
stoma => 'stәumә
stomach => 'stʌmәk
stomach pump => ˈstʌmək pʌmp
stomachache => 'stʌmәkeik
stomached => 'stʌmək
stomacher => 'stʌmәkә
stomaches => ˈstʌməkiz
stomachic => stәu'mækik
stomaching => 'stʌmək
stomate => 'stәumeit
stomatitis => .stәumә'taitis
stomatogastric => ,stәumәtә'^æstrik
stomp => stɒmp
stomped => stɔmpt
stomping => stɔmpɪŋ
stomps => stɔmps
stone => stәun
stone china => stəun ˈtʃainə
stone dead => stəun ded
stone deaf => stəun def
stone marten => stəun ˈmɑ:tin
stone pine => stəun pain
stone-faced => s'təʊnf'eɪst
stonechat => s'təʊntʃæt
stonecrop => 'stәunkrɒp
stonecutter => 'stәunkʌtә
stoned => stәund
stonefish => s'təʊnfɪʃ
stonefly => s'təʊnflaɪ
stoneground => ˈstəʊngraʊnd
Stonehenge => 'stәunhendʒ
stonemason => 'stәunmeisn
stonemasonry => s'təʊnmeɪsənrɪ
stonemasons => s'təʊnmeɪsnz
stoner => 'stəʊnə
stonewall => stәun'wɒ:l
stonewalled => ˈstəʊnˌwɔ:ld
stonewalling => stәun'wɒ:liŋ
stonewalls => ˈstəʊnˌwɔ:lz
stoneware => 'stәunwєә
stonewash => 'stəunwɔ:ʃ; -wɔf
stonewort => 'stәunwә:t
stoney => 'stәuni
stonier => ˈstəʊni:ə
stonily => ˈstəʊnɪli
stoniness => stəʊ'naɪnəs
stonk => stɒŋk
stonker => 'stɒŋkә
stony => 'stәuni
stony broke => ˈstəʊni: brəʊk
stony coral => ˈstəʊni: ˈkɔrəl
stood => stud
stooge => stu:dʒ
stooges => stu:dʒz
stook => stuk
stooked => stʊk; stuːk
stooking => stʊk; stuːk
stool => stu:l
stoolball => 'stu:lbɒ:l
stoolie => 'stuːlɪ
stooling => s'tu:lɪŋ
stoop => stu:p
stooped => stu:pt
stooping => ˈstu:piŋ
stoops => stu:ps
stop => stɒp
stop knob => stɔp nɔb
stop light => stɔp lait
stop press => stɔp pres
stop volley => stɔp ˈvɔli
stop-go => stɔp ɡəu
stop-motion => stɔp ˈməuʃən
stopcock => 'stɒpkɒk
stopcocks => ˈstɔpkɔks
stope => stәup
stopgap => 'stɒpgæp
stopgaps => ˈstɔpˌgæps
stoplight => 'stɒplait
stopover => 'stɒp.әuvә
stopovers => ˈstɔpˌəʊvəz
stoppable => 'stɔpәbl
stoppage => 'stɔpidʒ
stoppages => ˈstɔpɪdʒz
stopped => stɔpt
stopper => 'stɒpә
stoppered => 'stɒpə
stoppers => ˈstɔpəz
stopping => 'stɔpiŋ
stopping train => ˈstɔpiŋ trein
stopple => 'stɒpl
stoppled => ˈstɔpld
stoppling => ˈstɔplɪŋ
stopwatch => 'stɒpwɒtʃ
storable => 'stɔ:rәbl
storage => 'stɒ:ridʒ
storage heater => ˈstɔ:ridʒ ˈhi:tə
storax => 'stɔ:ræks
store => stɒ:
storefront => 'stɒ:frʌnt
storefronts => ˈstɔ:ˌfrʌnts
storehouse => 'stɒ:haus
storehouses => ˈstɔ:ˌhaʊsiz
storekeeper => 'stɒ:.ki:pә
storekeepers => ˈstɔ:ˌki:pəz
storer => s'tɔ:rər
storeroom => 'stɒ:rum
storerooms => ˈstɔ:ˌru:mz
storey => 'stɔ:ri
storeys => ˈstɔ:riz
storiated => 'stɔ:rieitid
storied => 'stɒ:rid
storing => 'stɔ:riŋ
stork => stɒ:k
storks => stɔ:ks
storm => stɒ:m
storm cellar => stɔ:m ˈselə
storm centre => stɔ:m ˈsentə
storm cone => stɔ:m kəun
storm door => stɔ:m dɔ:
storm lantern => stɔ:m ˈlæntən
storm petrel => stɔ:m ˈpetrəl
storm signal => stɔ:m ˈsiɡnəl
storm trooper => stɔ:m ˈtru:pə
storm water => stɔ:m ˈwɔ:tə
storm window => stɔ:m ˈwindəu
stormbound => 'stɔ:mbajnd
stormcock => 'stɒ:mkɒk
stormier => ˈstɔ:mi:ə
stormily => stɔ:'mɪlɪ
stormproof => 'stɒ:mpru:f
stormwater => stɔ:m'wɔ:tə
stormy => 'stɒ:mi
stormy petrel => ˈstɔ:mi: ˈpetrəl
Stornoway => 'stɔ:nəwei
story => 'stɒ:ri
story editor => ˈstɔ:ri ˈeditə
story line => ˈstɔ:ri lain
storyboard => 'stɔ:ribɔ:d
storybook => 'stɒ:ribuk
storybooks => ˈstɔ:ribuks
storyteller => 'stɒ:ritelә
storytellers => ˈstɔ:ri:ˌteləz
storytelling => 'stɒ:riteliŋ
stot => s'tɒt
stotinka => stɔ:'tiŋkә
Stott => stɔt
stotty => 'stɔti
Stoughton => 'stɔ:tn
stoup => stu:p
stour => stuә
stoush => stauʃ
stout => staut
stouter => stautə
stouthearted => 'staut'hɑ:tid
stoutly => 'stautli
stoutness => 'stautnis
stouts => stauts
stove => stәuv
stovepipe => 'stәuvpaip
stoves => s'təʊvz
stow => stәu
stowage => 'stәuidʒ
stowaway => 'stәuә.wei
stowaways => s'təʊəweɪz
Stowe => stəu
stowed => s'təʊd
stowing => s'təʊɪŋ
stows => stəʊz
strabismic => strә'bizmik
strabismus => strә'bizmәs
stracciatella => ,strɑ:tʃiɑ:'telә
Strad => stræd
straddle => 'strædl
straddled => ˈstrædld
straddles => ˈstrædlz
straddling => 'strædlɪŋ
Stradivari => ,strædi'veәri
Stradivarius => ,strɑ:di'veәriәs
strafe => streif
strafed => strɑ:ft
strafes => strɑ:fs
Strafford => 'stræfәd
strafing => strɑ:fɪŋ
straggle => strægl
straggled => ˈstrægəld
straggler => 'stræglә
stragglers => 'stræɡlɚ
straggles => ˈstrægəlz
straggling => 'stræ^liŋ
straggly => 'stræ^li
straight => streit
straight away => streit əˈwei
straight chair => streit tʃɛə
straight edge => streit edʒ
straight flush => streit flʌʃ
straight man => streit mæn
straight shooter => streit ˈʃu:tə
straight ticket => streit ˈtikit
straight-arm => 'streitɑ:m
straight-arrow => st'reɪt'ærəʊ
straight-cut => 'streitkʌt
straightaway => 'streitә.wei
straightedge => 'streitedʒ
straighten => 'streitn
straightened => ˈstreɪtnd
straightener => 'streitәnә
straightening => 'streitniŋ
straightens => ˈstreɪtnz
straightforward => streit'fɒ:wәd
straightforwardly => ˌstreɪt'fɔ:wədlɪ
straightjacket => 'streit,dʒækit
straightly => st'reɪtlɪ
straightness => 'streitnis
straightway => 'streitwei
strain => strein
strained => 'streind
strainer => 'streinә
strainers => st'reɪnəz
straining => 'streiniŋ
strains => streinz
strait => streit
strait-laced => ˌstreɪt ˈleɪst
straiten => 'streitn
straitened => ˈstreɪtnd
straitjacket => 'streitdʒækit
straitjackets => ˈstreitdʒækits
straitlaced => 'streit'leist
straitly => 'streitli
straitness => 'streitnis
strake => streik
Straker => streɪk
Stralsund => 'ʃtrɑ:lzjnt
stramash => strә'mæʃ, 'stræmәʃ
stramonium => strә'mәuniәm
strand => strænd
Strandloper => 'strænt,lәjpә(r)
strands => strændz
Strang => s'traŋ
strange => streindʒ
strange attractor => streindʒ əˈtræktə
strange particle => streindʒ ˈpɑ:tikl
Strangelove => 'streindʒlʌv
strangely => 'streindʒli
strangeness => 'streindʒnis
stranger => 'streindʒә
strangle => 'stræŋgl
strangled => ˈstræŋgld
stranglehold => 'stræŋglhәuld
strangler => 'stræŋ^lә
stranglers => 'stræŋɡlə
strangles => 'stræŋ^lz
strangling => ˈstræŋɡlɪŋ
strangulate => 'stræŋgjuleit
strangulated => ˈstræŋgjuleɪtɪd
strangulates => ˈstræŋɡjuleits
strangulating => ˈstræŋɡjuleitɪŋ
strangulation => .stræŋgju'leiʃәn
strangury => 'stræŋ^juri
strap => stræp
strap hinge => stræp hindʒ
straphanger => 'stræphæŋә
strapless => 'stræplis
strappado => strә'peidәu
strapped => stræpt
strapper => 'stræpә
strapping => 'stræpiŋ
strappy => 'stræpi
strata => 'streitә
stratagem => 'strætidʒәm
stratagems => ˈstrætədʒəmz
stratal => 'streitl
strategic => strә'ti:dʒik
strategical => strә'ti:dʒikl
strategically => strә'ti:dʒikәli
strategies => ˈstrætidʒiz
strategist => 'strætidʒist
strategists => st'rætɪdʒɪsts
strategize => 'strætidʒaiz
strategy => 'strætidʒi
stratford => 'strætfәd
strath => stræθ
Strathclyde => stræθ'klaid
strathspey => .stræθ'spei
stratification => .strætifi'keiʃәn
stratified => 'strætifaid
stratified sample => ˈstrætifaid ˈsɑ:mpl
stratiform => 'stræti,fɔ:m
stratify => 'strætifai
stratifying => ˈstrætəˌfaɪŋ
stratigrapher => strә'tigrәfә
stratigraphic => ,stræti'^ræfik
stratigraphical => ,stræti'^ræfikәl
stratigraphy => strә'tigrәfi
stratocracy => strә'tɒkrәsi
stratocumulus => ,strætәu'kju:mjulәs
stratopause => 'strætә,pɔ:z
stratosphere => 'strætәsfiә
stratospheric => .strætәu'sferik
stratovolcano => ,strætәvɔl'keinәu
stratum => 'streitәm
stratum corneum => ˈstreɪtəm ˈkɔniəm
stratus => 'streitәs
straw => strɒ:
straw boss => strɔ: bɔs
straw mushroom => strɔ: ˈmʌʃrum
straw poll => strɔ: pəul
straw-coloured => st'rɔ:k'ʌləd
strawberries => st'rɔ:brɪz
strawberry => 'strɒ:bәri
strawberry blonde => ˈstrɔ:bəri blɔnd
strawberry tree => ˈstrɔ:bəri tri:
strawboard => 'strɒ:bɒ:d
strawed => strɔː
straws => st'rɔ:z
strawy => 'strɒ:i
stray => strei
strayed => streid
straying => streiŋ
streak => stri:k
streaked => stri:kt
streaker => ˈstri:kə(r)
streakier => ˈstri:kiə
streakily => ˊstriːkili
streakiness => ˊstriːkinis
streaking => 'stri:kiŋ
streaky => 'stri:ki
stream => stri:m
stream of consciousness => stri:m ɔv ˈkɔnʃəsnɪs
streambed => 'stri:mbed
streamer => 'stri:mә
streamers => ˈstri:məz
streamflow => 'stri:mflәu
streaming => 'stri:miŋ
streamlet => 'stri:mlit
streamline => 'stri:mlain
streamlined => 'stri:mlaind
streamliner => 'stri:mlainә
streamlines => ˈstri:mlainz
streel => st'ri:l
street => stri:t
street credibility => stri:t ˌkredəˈbɪlɪti:
street furniture => stri:t ˈfə:nitʃə
street name => stri:t neim
street trader => stri:t ˈtreɪdə
streetcar => 'stri:tkɑ:
streetlamp => 'stri:tlæmp
streetlight => 'stri:tlait
streetlights => ˈstri:tlaits
streets => stri:ts
streetscape => stri:ts'keɪp
streetwalker => 'stri:t.wɒ:kә
streetwalking => 'stri:t.wɒ:kiŋ
streetward => 'stri:twәd
streetwise => ˈstri:twaɪz
strelitzia => stre'l,tsiә
strength => streŋθ
strengthen => 'streŋθәn
strengthened => ˈstreŋθnd
strengthener => 'sreŋθənə
strengthening => 'streŋθәniŋ
strengthens => ˈstreŋθnz
strengthless => 'streŋθlis
strenuous => 'strenjuәs
strep => strep
strep throat => ˌstrep ˈθrəʊt
strepsipteran => strep'siptərən
streptocarpus => streptəuˈkɑ:pəs
streptococcal => ,streptәj'kɔkәl
streptococci => .streptә'kɒksai
streptococcus => .streptәu'kɒkәs
streptokinase => ,streptәj'kaineis, -neiz, -'ki-
streptomycete => ,streptәj'maisi:t
streptomycin => .streptәu'maisin
stress => stres
stress mark => stres mɑ:k
stresses => stresiz
stressing => stresɪŋ
stressor => 'stresә
stretch => stretʃ
stretchable => 'strɛtʃəbl
stretcher => 'stretʃә
stretcher party => ˈstretʃə ˈpɑ:ti
stretcher-bearers => 'stretʃə,bεərə
stretchers => ˈstretʃəz
stretches => stretʃiz
stretchier => ˈstretʃiə
stretching => 'stretʃiŋ
stretchmark => ˈstretʃmɑ:k
stretchy => 'stretʃi
Stretford => 'stretfәd
stretto => 'stretәu
streusel => 'stru:zl,'ʃtrәizәl
strew => stru:
strewing => stru:ɪŋ
strewn => stru:n
strews => stru:z
strewth => stru:θ
stria => 'straiә
striate => 'straieit
striated => 'straieitid
striates => 'straɪət; 'straɪeɪt
striating => 'straɪət; 'straɪeɪt
striation => stai'eiʃәn
stricken => 'strikәn
strickle => 'strikl
strickled => strɪk(ə)l
strickles => strɪk(ə)l
strict => strikt
strictly => 'striktli
strictness => 'stiktnis
stricture => 'striktʃә
strictures => ˈstrɪktʃəz
stride => straid
strident => 'straidnt
stridently => 'straidentli
strides => straidz
striding => straidɪŋ
stridor => 'straidә
stridulant => 'stridjjlәnt
stridulate => 'stridjuleit
stridulated => 'strɪdjʊleɪt
stridulates => 'strɪdjʊleɪt
stridulating => 'strɪdjʊleɪt
stridulation => .stridju'leiʃәn
stridulatory => 'stridjjlәtәri
strife => straif
strigil => 'stridʒil
strike => straik
strike force => straik fɔ:s
strike price => straik prais
strike rate => straik reit
strike zone => straik zəun
strike-breaker => straik ˈbreikə
strike-slip fault => ˈstraɪkˈslɪp
strikebound => 'straikbajnd
strikebreaker => 'straik.breikә
strikeout => 'straikaut
striker => 'straikә
strikes => straiks
striking => 'straikiŋ
striking circle => ˈstraikiŋ ˈsə:kl
striking price => ˈstraikiŋ prais
strimmer => ˈstrɪmə(r)
string => striŋ
string along => striŋ əˈlɔŋ
string bean => striŋ bi:n
string orchestra => striŋ ˈɔ:kistrə
string out => striŋ aut
string quartet => striŋ kwɔ:ˈtet
string tie => striŋ tai
string vest => strɪŋ vɛst
stringboard => 'striŋbɒ:d
stringed => striŋd
stringency => 'strindʒәnsi
stringendo => strin'dʒendәu
stringent => 'strindʒәnt
stringently => ˈstrɪndʒəntlɪ
stringer => 'striŋә
stringers => ˈstriŋəz
stringhalt => 'striŋhɔ:lt
stringier => ˈstriŋiə
stringiness => st'rɪdʒɪnəs
stringing => 'striŋiŋ
stringless => 'striŋlis
stringpiece => 'striŋpi:s
stringy => 'striŋi
strip => strip
strip cartoon => strip kɑ:ˈtu:n
strip club => strip klʌb
strip cropping => strip ˈkrɔpiŋ
strip joint => strip dʒɔint
strip light => strip lait
strip poker => strip ˈpəʊkə
strip search => strip sə:tʃ
strip-mine => 'stripmain
strip-search => strip sə:tʃ
stripe => straip
striped => straipt
striped bass => straɪpt beɪs
striped hyena => straɪpt haɪˈi:nə
striper => 'straipә
striping => st'rɪpɪŋ
stripling => 'stripliŋ
striplings => ˈstrɪplɪŋz
stripped => stript
stripper => 'stripә
strippers => ˈstripəz
stripping => 'stripiŋ
striptease => 'stripti:z
stripy => 'straipi
strive => straiv
striven => 'strivn
strives => straivz
striving => 'straiviŋ
strobe => strәub
strobe light => strəub lait
strobilus => strәu'bailәs
stroboscope => 'strәubәskәup
stroboscopic => ,strәjbәj'skɔpik, ,strɔ-
strode => strәud
stroganoff => 'strɔ^әnɔf
stroke => strәuk
stroke play => strəuk plei
stroll => strәul
stroller => 'strәulә
strollers => ˈstrəuləz
strolling => 'strәuliŋ
strolls => strəulz
stroma => 'strәumә
stromatolite => strәu'mætә,lait
strong => strɒŋ
strong breeze => strɒŋ bri:z
strong drink => strɒŋ driŋk
strong gale => strɒŋ ɡeil
strong safety => strɒŋ ˈseifti
strong suit => strɒŋ sju:t
strong-arm => 'strɔŋɑ:m
strong-armed => strɒŋ ɑ:md
strong-arms => strɒŋ ɑ:mz
strong-willed => 'strɔŋ'wild; 'strɔ:ŋ-
strongbox => 'strɒŋbɒks
stronghold => 'strɒŋhәuld
strongholds => ˈstrɔ:ŋˌhəʊldz
strongly => 'strɒŋli
strongman => ˈstrɒŋmæn
strongpoint => 'strɒŋpɒint
strongroom => ˈstrɒŋru:m
strongyle => st'rɒnɡɪl
strongyloidiasis => ,strɔndʒilɔi'daiәsis
strontia => 'strɔnʃiә
strontianite => 'strɔnʃiәnait
strontium => 'strɔnʃiәm
strop => strɒp
strophanthin => strәu'fænθin
strophe => 'strәufi
strophes => ˈstrəufiz
strophic => 'strəʊfɪk
stropped => strɔpt
stroppier => ˈstrɔpi:ə
stropping => strɔpɪŋ
stroppy => ˈstrɒpi
strops => strɔps
Stroud => strajd
strove => strәuv
strow => strәu
struck => strʌk
structural => 'strʌktʃәrәl
structural engineer => ˈstrʌktʃərəl ˌendʒiˈniə
structuralism => 'strʌktʃәrәlizm
structuralist => 'strʌktʃәrәlist
structure => 'strʌktʃә
structureless => 'strʌktʃәlis
strudel => 'stru:dәl
struggle => 'strʌgl
struggles => ˈstrʌɡlz
struggling => 'strʌgliŋ
strum => strʌm
struma => 'stru:mә
strummed => strʌmd
strumming => strʌmɪŋ
strumous => 'stru:mәs
strumpet => 'strʌmpit
strums => strʌmz
strung => strʌŋ
strung-out => st'rʌŋ'aʊt
strut => strʌt
Strutt => strʌt
strutted => strʌtid
strutter => 'strʌtә
strutting => 'strʌtiŋ
strychnine => 'strikni:n
stu => stju:
stuart => stjuәt
stub => stʌb
stubbed => 'stʌbd
stubbier => 'stʌbi
stubbing => stʌbɪŋ
stubble => 'stʌbl
stubbled => 'stʌbld
stubbly => 'stʌbli
stubborn => 'stʌbәn
Stubbs => stʌbz
stubby => 'stʌbi
stucco => 'stʌkәu
stuccoed => ˈstʌkəud
stuck => stʌk
stuck-up => 'stʌk'ʌp
stud => stʌd
studbook => 'stʌdbuk
studded => ˈstʌdɪd
studding => 'stʌdiŋ
student => 'stju:dnt
student body => ˈstju:dənt ˈbɔdi
student teaching => ˈstju:dənt ˈti:tʃɪŋ
studentships => 'stjuːdentʃɪp
studied => 'stʌdid
studio => 'stju:diәu
studio couch => ˈstju:diəu kautʃ
studio flat => ˈstju:diəu flæt
studious => 'stju:djәs
studmuffin => ˈstʌdmʌfɪn
study => 'stʌdi
stuff => stʌf
stuff it => stʌf it
stuffer => 'stʌfә
stuffier => ˈstʌfi:ə
stuffing => 'stʌfiŋ
stuffs => stʌfs
stuffy => 'stʌfi
Stuka => 'stu:kә, 'ʃtu:kɑ:
stultification => .stʌltifi'keiʃәn
stultified => ˈstʌltəˌfaɪd
stultifies => ˈstʌltəˌfaɪz
stultify => 'stʌltifai
stultifying => ˈstʌltɪfaɪɪŋ
stum => stʌm
stumble => 'stʌmbl
stumbled => ˈstʌmbld
stumbler => 'stʌmblə
stumbles => ˈstʌmblz
stumblingly => s'tʌmblɪŋlɪ
stumer => 'stju:mә
stump => stʌmp
stumpage => 'stʌmpidʒ
stumped => stʌmpt
stumper => 'stʌmpә
stumps => stʌmps
stumpy => 'stʌmpi
stun => stʌn
stun grenade => stʌn grəˈneɪd
stun gun => stʌn ɡʌn
stung => stʌŋ
stunk => stʌŋk
stunner => 'stʌnә
stunners => ˈstʌnəz
stunning => 'stʌniŋ
stunningly => 'stʌnɪŋlɪ
stuns => stʌnz
stunsail => 'stʌnsəl
stunt => stʌnt
stunt man => stʌnt mæn
stunt woman => stʌnt ˈwumən
stunted => 'stʌntid
stunting => s'tʌntɪŋ
stuntmen => 'stʌntmæn
stunts => stʌnts
stuntwoman => 'stʌnt,wjmәn
stupa => 'stu:pә
stupe => stju:p
stupefacient => ,stju:pi'feiʃәnt
stupefaction => .stju:pi'fækʃәn
stupefied => 'stju:pɪfaɪd
stupefy => 'stju:pifai
stupefying => ˈstju:pɪfaɪɪŋ
stupendous => stju:'pendәs
stupendously => stju:'pendəslɪ
stupid => 'stju:pid
stupidities => stu:ˈpɪdɪti:z
stupidity => stju:'piditi
stupidly => 'stju:pidli
stupor => 'stju:pә
stuporous => 'stju:pәrәs
sturdied => 'stә:did
sturdier => ˈstə:diə
sturdily => 'stә:dili
sturdiness => 'stә:dinis
sturdy => 'stә:di
sturgeon => 'stә:dʒәn
Sturm und Drang => 'ʃturm unt'draŋ
Sturmabteilung => 'ʃturm,aptailuŋ
stutter => 'stʌtә
stuttered => ˈstʌtəd
stutteringly => 'stʌtәriŋli
stutters => ˈstʌtəz
stuttgart => 'stut^ɑ:t
sty => stai
Stygian => 'stidʒiәn
stylar => 'stailә
style => stail
stylebook => 'stailbuk
styled => staild
styler => 'stailə
stylet => 'stailit
styli => 'stailai
styling => 'stailiŋ
stylise => 'stailaiz
stylish => 'stailiʃ
stylishly => 'staɪlɪʃlɪ
stylishness => 'stailiʃnis
stylist => 'stailist
stylistic => stai'listik
stylistically => staɪ'lɪstɪklɪ
stylistics => stai'listiks
stylists => ˈstaɪlɪsts
stylite => 'stailait
stylize => 'stailaiz
stylizes => ˈstaɪˌlaɪziz
stylizing => ˈstaɪˌlaɪzɪŋ
stylo => 'stailәu
stylobate => 'stailәbeit
stylograph => 'stailәgrɑ:f
stylographic => stailә'græfik
styloid => 'stailɔid
styloid process => ˈstailɔid ˈprəuses
stylolite => 'stailәu,lait
stylops => 'stailɔps
stylus => 'stailәs
stymie => 'staimi
stymied => 'staimi:d
stymieing => ˈstaɪmi:ɪŋ
stymying => 'staimi
styptic => 'stiptik
styptic pencil => ˈstɪptɪk ˈpensəl
styrax => 'stairæks
styrene => 'stairi:n
Styria => 'stiriə
styrofoam => 'stairәfәum
Styx => stiks
suasion => 'sweiʒәn
suasive => 'sweisiv
suave => swɑ:v
suavely => 'sweivli
suaver => swɑ:və
suavity => 'swæviti
sub => sʌb
sub judice => sʌb'dʒu:disi:
sub-basement => 'sʌbb'eɪsmənt
sub-machine gun => sʌb məˈʃi:n ɡʌn
sub-plot => 'sʌbpl'ɒt
sub-post office => sʌb pəust ˈɔfis
sub-prime => sʌb praim
sub-standard => 'sʌbst'ændəd
subacid => sʌb'æsid
subacute => .sʌbә'kju:t
subadult => .sʌbә'dʌlt
subaerial => .sʌb'єәriәl
subagency => 'sʌb'eidʒәnsi
subagent => .sʌb'eidʒәnt
subalpine => .sʌb'ælpain
subaltern => sәb'ɒ:ltәn
subalterns => ˈsʌbltənz
subantarctic => 'sʌbænt'ɑ:ktik
subaqueous => .sʌb'eikwiәs
subarachnoid => ,sʌbә'ræknɔid
subarctic => .sʌb'ɑ:ktik
subassembly => .sʌbә'sembli
subatomic => 'sʌbә'tɔmik
subatomic particle => ˈsʌbəˈtɔmik ˈpɑ:tikl
subaudition => 'sʌbɔ:'diʃәn
subbed => sʌbd
subbing => 'sʌbiŋ
subcarrier => 'sʌb'kæriә
subcategorization => 'sʌb,kæti^ɔrai'zeiʃәn
subcategory => 'sʌb'kæti^әri
subchapter => 'sʌbtʃæptə
subclass => 'sʌbklɑ:s
subclavian => 'sʌb'kleiviәn
subclinical => sʌb'klinikl
subcommittee => 'sʌbkә.miti
subcommittees => ˈsʌbkəˌmɪti:z
subcompact => 'sʌb'kɔmpækt
subconical => ,sʌb'kɔnikəl
subconscious => .sʌb'kɒnʃәs
subconsciously => ˌsʌb'kɒnʃəslɪ
subcontinent => sʌb'kɒntinәnt
subcontinental => sʌbkɒntɪ'nentl
subcontract => sʌb'kɒntrækt
subcontracted => sʌbˈkɔnˌtræktid
subcontracting => sʌb'kəntræktɪŋ
subcontractor => ,sʌbkәn'træktә(r)
subcontractors => sʌb'kəntræktəz
subcontracts => sʌbˈkɔnˌtrækts
subcontrary => sʌb'kɒntrәri
subcortical => 'sʌb'kɔ:tikәl
subcostal => 'sʌb'kɔstl
subcritical => sʌb'kritikl
subculture => 'sʌb,kʌltʃә
subcultures => ˈsʌbˌkʌltʃəz
subcutaneous => .sʌbkju:'teiniәs
subcutaneously => ˌsʌbkjʊ'teɪnɪəslɪ
subdeacon => sʌb'di:kәn
subdiaconate => .sʌbdai'ækәnit
subdirectory => sʌb'direktәri
subdivide => 'sʌbdi'vaid
subdivided => ˌsʌbdɪˈvaɪdid
subdivides => ˌsʌbdɪˈvaɪdz
subdivision => .sʌbdi'viʒәn
subdivisions => 'sʌbdɪvɪʒnz
subdominant => .sʌb'dɒminәnt
subduable => sәb'dju:әbl
subduction => sʌb'dʌkʃәn
subdue => sәb'dju:
subdued => sәb'dju:d
subdues => səbˈdju:z
subduing => səbˈdju:ɪŋ
subdural => sʌb'djjәrәl
subedit => .sʌb'edit
subeditor => .sʌb'editә
suberin => 'sju:bәrin
suberization => ,sju:bәrai'zeiʃən; -ri'z-
suberize => 'sju:bә,raiz, 'su:-
subfamily => sʌb'fæmili
subfield => 'sʌbfi:ld
subfloor => 'sʌb,flɔ:
subform => 'sʌbfɔ:m
subfusc => sʌb'fʌsk
subgenre => 'sʌb,dʒeŋrə
subgenus => .sʌb'dʒi:nәs
subglacial => sʌb'^leiʃәl
subglottic => sʌbɡ'lɒtɪk
subgroup => 'sʌbgru:p
subharmonic => ,sʌbhɑ:'mɔnik
subharmonics => 'sʌbhɑ:'mɔniks
subhead => 'sʌbhed
subheading => 'sʌb.hediŋ
subheadings => sʌb'hedɪŋz
subhuman => .sʌb'hju:mәn
subjacency => sʌb'dʒeisnsi
subjacent => .sʌb'dʒeisnt
subject => 'sʌbdʒekt
subject matter => ˈsʌbdʒikt ˈmætə
subjecting => ˈsʌbdʒiktɪŋ
subjection => sәb'dʒekʃәn
subjective => sәb'dʒektiv
subjectiveness => səbd'ʒektɪvnəs
subjectivism => sәb'dʒektivizm
subjectivist => sәb'dʒektivist
subjectivity => ,sʌbdʒek'tivәti
subjectless => 'sʌbdʒiktlis, -dʒek-
subjoin => .sʌb'jʒɒin
subjugate => 'sʌbdʒugeit
subjugated => ˈsʌbdʒəˌgeɪtid
subjugates => ˈsʌbdʒəˌgeɪts
subjugating => ˈsʌbdʒəˌgeɪtɪŋ
subjugation => .sʌbdʒu'geiʃәn
subjunct => sәb'dʒʌŋkt
subjunctive => sәb'dʒʌŋktiv
subkingdom => sʌb'kiŋdәm
sublanguage => sʌb'læŋ^widʒ
sublate => .sʌb'leit
sublateral => 'sʌb'lætәrәl
sublation => sʌb'leiʃәn
sublease => 'sʌbli:s
subleased => ˈsʌbˈli:st
subleases => ˈsʌbˈli:siz
subleasing => ˈsʌbˈli:sɪŋ
sublet => .sʌb'let
sublethal => sʌb'li:θәl
sublets => ˈsʌbˈlets
subletting => sʌb'letɪŋ
sublieutenant => .sʌblu:'tenәnt
sublimate => 'sʌblimeit
sublimated => sʌb'lɪmeɪtɪd
sublimates => sʌb'lɪmeɪts
sublimating => ˈsʌblɪmətɪŋ
sublimation => .sʌbli'meiʃәn
sublime => sә'blaim
sublimed => səb'laɪmd
sublimely => sə'blaɪmlɪ
subliminal => sʌb'liminl
subliminally => sʌb'liminəli
subliming => sʌb'laɪmɪŋ
sublimities => səˈblimitiz
sublimity => sʌb'limiti
sublingual => sʌb'liŋgwәl
sublittoral => sʌb'litәrәl
sublunar => 'sʌb'lu:nә
sublunary => 'sʌb'lu:nәri
subluxation => ,sʌblʌk'seiʃən
submachine gun => 'sʌbmәʃi:n
submandibular => ,sʌbmæn'dibjjlә(r)
submandibular gland => ˌsʌbmænˈdibjulə ɡlænd
submarginal => sʌb'mɑ:dʒinl
submarine => 'sʌbmәri:n
submariner => 'sʌbmәri:nә
submarining => 'sʌbmərɪnɪŋ
submatrix => sʌb'meitriks
submaxillary gland => sʌbmækˈsiˌləri ɡlænd
submaximal => səb'mæksɪml
submediant => ,sʌb'mi:diәnt
submerge => sәb'mә:dʒ
submerged => sәb'mә:dʒd
submergence => sәb'mә:dʒәns
submerges => səbˈmə:dʒz
submergible => sʌb'mә:dʒәbl
submerging => səbˈmə:dʒɪŋ
submerse => sәb'mә:s
submersed => sәb'mә:st
submersible => sәb'mә:sәbl
submersing => səbˈmə:sɪŋ
submersion => sʌb'mә:ʃәn
submicroscopic => ,sʌbmaikrә'skɔpik
submillimeter => sʌb'mɪlɪmi:tə
subminiature => sʌb'minjәtʃә
submission => sәb'miʃәn
submissions => səb'mɪʃnz
submissive => sәb'misiv
submissively => səb'mɪsɪvlɪ
submit => sәb'mit
submits => səbˈmits
submittal => sәb'mitl
submitting => səbˈmitɪŋ
submontane => sʌb'mɒntein
submucosa => ,sʌbmju:'kәusә
submultiple => .sʌb'mʌltipl
subnormal => .sʌb'nɒ:ml
subnotebook => sʌb'nəutbu:k
suboptimal => 'sʌb'ɔptimәl
suborbital => sʌb'ɔ:bitl
suborder => sʌb'ɒ:dә
subordinary => sʌb'ɔ:dinәri
subordinate => sә'bɒ:dnit
subordinate clause => səˈbɔ:dinit klɔ:z
subordinated => sə'bɔ:dɪneɪtɪd
subordinates => səˈbɔ:dinits
subordinating => sә'bɔ:dineitiŋ
subordination => sә.bɒ:di'neiʃәn
subordinative => sә'bɔ:dinәtiv
suborn => sʌ'bɒ:n
subornation => ,sʌbɔ:'neiʃәn
suborned => səˈbɔ:nd
suborning => sə'bɔ:nɪŋ
suborns => səˈbɔ:nz
suboscine => sʌb'ɔsain; -sin
suboxide => sʌb'ɒksaid
subparallel => 'sʌb'pærәlel
subpart => sʌb'pɑ:t
subphylum => sʌb'failәm
subplot => 'sʌbplɒt
subpoena => sәb'pi:nә
subpoenaed => səˈpi:nəd
subpoenaing => səˈpi:nərɪŋ
subpoenas => səˈpi:nəz
subpopulation => 'sʌb,pɔpjj'leiʃən
subprime => ˌsʌb'praɪm
subprogram => 'sʌb.prәugræm
subregion => 'sʌb.ri:dʒәn
subrogate => 'sʌbrә,^eit
subrogated => ˈsʌbrəˌɡeitid
subrogates => ˈsʌbrəˌɡeits
subrogating => ˈsʌbrəˌɡeitɪŋ
subrogation => .sʌbrә'geiʃәn
subroutine => 'sʌbru:.ti:n
subsample => 'sʌb,sɑ:mpl
subscale => 'sʌb,skeil
subscribe => sәb'skraib
subscribed => səbˈskraibd
subscriber => sʌbs'kraibә
subscribes => səbˈskraibz
subscribing => səbˈskraibɪŋ
subscript => 'sʌbskript
subscription => sәb'skripʃәn
subscription concert => səbˈskrɪpʃən ˈkɔnsət
subsea => sʌb'si:
subsection => 'sʌb.sekʃәn
subsections => ˈsʌbˈsekʃənz
subsector => sʌb'sektə
subsellium => sʌb'seliәm
subsequence => 'sʌbsikwәns
subsequent => 'sʌbsikwәnt
subsequently => 'sʌbsikwәntli
subserve => sәb'sә:v
subserved => səbˈsə:vd
subserves => səbˈsə:vz
subservient => sәb'sә:viәnt
subserving => səbˈsə:vɪŋ
subset => 'sʌbset
subsets => 'sʌbsets
subshrub => 'sʌbʃrʌb
subside => sәb'said
subsided => səbˈsaidid
subsidence => sәb'saidәns
subsides => səbˈsaidz
subsidiaries => səbˈsidiəriz
subsidiarily => səb'sidiərili
subsidiarity => səbˌsɪdiˈærɪti
subsidiary => sәb'sidiәri
subsidies => ˈsʌbsidiz
subsidised => 'sʌbsɪdaɪz
subsidization => .sʌbsidai'zeiʃәn. -di'zei-
subsidize => 'sʌbsidaiz
subsidized => ˈsʌbsidaizd
subsidizes => ˈsʌbsidaiziz
subsidizing => ˈsʌbsidaizɪŋ
subsidy => 'sʌbsidi
subsist => sәb'sist
subsisted => səbˈsɪstid
subsistence => sәb'sistәns
subsistent => sәb'sistәnt
subsists => səbˈsɪsts
subsoil => 'sʌbsɒil
subsoiler => 'sʌb,sɔilә
subsonic => sʌb'sɒnik
subspace => 'sʌb,speis
subspecialty => .sʌb'speʃәlti
subspecies => 'sʌb.spi:ʃi:z
subspecific => ,sʌbspi'sifik
substage => 'sʌb,steidʒ
substance => 'sʌbstәns
substances => ˈsʌbstənsiz
substandard => .sʌb'stændәd
substantial => sәb'stænʃәl
substantialism => sәb'stænʃəlizəm
substantialist => sәb'stænʃəlist
substantiality => sәb.stænʃi'æliti
substantialize => sәb'stænʃәlaiz
substantially => sәb'stænʃәli
substantiate => sәb'stænʃieit
substantiated => səbˈstænʃi:ˌeɪtid
substantiates => səbˈstænʃi:ˌeɪts
substantiating => səbˈstænʃi:ˌeɪtɪŋ
substantiation => sәb.stænʃi'eiʃәn
substantival => .sʌbstәn'taivl
substantive => 'sʌbstәntiv
substation => 'sʌbsteiʃәn
substellar => sʌb'stelə
substituent => sәb'stitjuәnt
substitutable => 'sʌbstitju: tәbl
substitute => 'sʌbstitju:t
substitutes => ˈsʌbstitju:ts
substituting => 'sʌbstitju:tiŋ
substitution => .sʌbsti'tju:ʃәn
substitutional => .sʌbsti'tju:ʃәnәl
substitutionary => ,sʌbsti'tju:ʃənәri
substitutive => 'sʌbstitju:tiv
substorm => 'sʌbstɔ:m
substrain => 'sʌbstrein
substrate => 'sʌbstreit
substratum => 'sʌb'strɑ:tәm, 'sʌb'streitәm
substructure => 'sʌbstrʌktʃә
substructures => 'sʌbstrʌktʃə
subsume => sʌb'sju:m
subsumed => səbˈsu:md
subsumes => səbˈsu:mz
subsuming => səbˈsu:mɪŋ
subsumption => sʌb'sʌmpʃәn
subsurface => 'sʌb'sә:fis
subsystem => 'sʌb.sistәm
subtenancy => .sʌb'tenәnsi
subtenant => .sʌb'tenәnt
subtend => sәb'tend
subtended => səbˈtendid
subtending => səbˈtendɪŋ
subtends => səbˈtendz
subtense => sәb'tens
subterfuge => 'sʌbtәfju:dʒ
subterfuges => ˈsʌbtəˌfju:dʒz
subterminal => 'sʌb'tә:minl
subterranean => .sʌbtә'reinjәn
subtest => sʌb'test
subtext => sʌb'tekst
subtheme => sʌb'θi:m
subtilization => sʌtɪlaɪ'zeɪʃn
subtilize => 'sʌtilaiz
subtitle => 'sʌb.taitl
subtitled => ˈsʌbˌtaitld
subtitling => 'sʌbˌtaɪtlɪŋ
subtle => 'sʌtl
subtleness => 'sʌtlnes
subtler => ˈsʌtlə
subtleties => 'sʌtltɪz
subtlety => 'sʌtlti
subtly => 'sʌtli
subtonic => sʌb'tɒnik
subtopia => sʌb'tәupjә, -'tɔpjә
subtopic => 'sʌb.tɔpik
subtotal => 'sʌbtәutl
subtract => sәb'trækt
subtracter => sәb'træktә
subtraction => sәb'trækʃәn
subtractions => səb'trækʃn
subtractive => sәb'træktiv
subtracts => səbˈtrækts
subtrahend => 'sʌbtrәhend
subtropical => sʌb'trɒpikl
subtropics => sʌb'trɒpiks
subtype => 'sʌbtaip
subulate => 'sju:bjulit
subumbrella => ,sʌbʌm'brelә
subungulate => 'sʌb'ʌŋ^juleit
subunit => sʌb'ju:nit
suburb => 'sʌbә:b
suburban => sә'bә:bәn
suburbanite => sә'bә:bәnait
suburbanization => sә.bә:bәnai'zeiʃәn. ni'z-
suburbanize => sә'bә:bәnaiz
suburbanized => sə'bɜːbənaɪz
suburbanizing => sə'bɜːbənaɪz
suburbia => sә'bә:biә
subvention => sәb'venʃәn
subversion => sәb'vә:ʃәn
subversive => sәb'vә:siv
subversively => sʌb'və:sivli
subversiveness => sʌb'və:sivnis
subversives => səbˈvɜ:sɪvz
subvert => sәb'vә:t
subverted => səbˈvɜ:tid
subverting => səbˈvɜ:tɪŋ
subverts => səbˈvɜ:ts
subvocal => .sʌb'vәukl
subvocalization => 'sʌb,vәjkəlai'zeiʃən; - li'z-
subway => 'sʌbwei
subways => 'sʌbweɪz
succah => su:k'ɑ:; 'sukə
succedaneous => ,sʌksi'deiniәs
succedaneum => .sʌksi'deiniәm
succeed => sәk'si:d
succeeding => sәk'si:diŋ
succeeds => səkˈsi:dz
succentor => sәk'sentә
success => sәk'ses
success story => səkˈses ˈstɔ:ri
successes => sək'sesɪz
successful => sәk'sesful
successfully => sәk'sesfjli
succession => sәk'seʃәn
successional => sәk'seʃәnәl
successions => səkˈseʃənz
successive => sәk'sesiv
successiveness => sək'sesɪvˌnɪs
successor => sәk'sesә
successors => səkˈsesəz
succinate => 'sʌksi,neit
succinct => sәk'siŋkt
succinctly => sək'sɪŋktlɪ
succinylcholine => ,sʌksinil'kәjli:n, -'kɔ-
succor => 'sʌkә
succored => ˈsʌkəd
succoring => ˈsʌkərɪŋ
succors => ˈsʌkəz
succory => 'sʌkәri
succotash => 'sʌkәtæʃ
Succoth => suː'kɔːt
succour => 'sʌkә
succoured => ˈsʌkəd
succouring => ˈsʌkərɪŋ
succours => ˈsʌkəz
succubous => sʌ'kʌbəs
succubus => 'sʌkjubәs
succulence => 'sʌkjulәns
succulent => 'sʌkjulәnt
succulently => sʌk'jʊləntlɪ
succulents => 'sʌkjʊlənts
succumb => sә'kʌm
succumbed => səˈkʌmd
succumbing => səˈkʌmɪŋ
succumbs => səˈkʌmz
succursal => sә'kә:sәl
succuss => sә'kʌs
succussed => sə'kʌs
succusses => sə'kʌs
succussing => sə'kʌs
such => sʌtʃ
such-and-such => 'sʌtʃәn'sʌtʃ
suchlike => 'sʌtʃlaik
Suchou => 'su:'dʒәj, -'tʃaj
suck => sʌk
suck-up => 'sʌkʌp
sucker => 'sʌkә
suckered => ˈsʌkəd
suckerfish => 'sʌkәfiʃ
suckering => ˈsʌkərɪŋ
sucking => 'sʌkiŋ
sucking louse => ˈsʌkiŋ laʊs
suckle => 'sʌkl
suckled => ˈsʌkld
suckler => 'sʌklər
suckles => ˈsʌklz
suckling => 'sʌkliŋ
sucky => 'sʌki
sucralose => 'su:krələʊs
sucrase => 'su:kreis
sucre => 'su:krei
sucrier => ,sju:kri:'ei
sucrose => 'sju:krәus
suction => 'sʌkʃәn
suctioned => ˈsʌkʃənd
suctioning => ˈsʌkʃənɪŋ
suctions => ˈsʌkʃənz
suctorial => sʌk'tɒ:riәl
Sudan => su:'dæn
Sudanese => su:dә'ni:z
sudarium => sju:'deәriәm
sudatorium => .su:dә'tɒ:riәm
Sudbury => 'sʌdbəri
sudd => sʌd
sudden => 'sʌdn
suddenly => 'sʌdәnli
suddenness => 'sʌdnnɪs
Sudetenland => su:'deitənlænd, zu:'deitənlɑ:nt
sudoriferous => .su:dә'rifәrәs
sudorific => .su:dә'rifik
Sudra => 'su:drә
suds => sʌdz
sudser => 'sʌdzər
sudsy => 'sʌdzi
sue => su:
suede => sweid
suedehead => 'sweidhed
suet => 'su:it
suet pudding => ˈsjuit ˈpudiŋ
Suetonius => swi'təuniəs
suety => 'su:iti
Suez => 'sju(:)iz
Suez Canal => 'su:iz'kænәl
suffer => 'sʌfә
sufferable => 'sʌfәrәbl
sufferance => 'sʌfәrәns
suffered => 'sʌfəd
sufferer => 'sʌfәrә
sufferers => ˈsʌfɵrəz
suffering => 'sʌfәriŋ
suffers => ˈsʌfəz
suffice => sә'fais
sufficed => səˈfaist
suffices => səˈfaisiz
sufficiency => sә'fiʃәnsi
sufficient => sә'fiʃәnt
sufficiently => sә'fiʃәntli
sufficing => səˈfaisɪŋ
suffix => 'sʌfiks
suffixation => sʌfik'seiʃәn
suffixed => 'sʌfɪks
suffixes => ˈsʌfɪksiz
suffixing => 'sʌfɪks
suffocate => 'sʌfәkeit
suffocates => ˈsʌfəˌkeɪts
suffocatingly => ˊsʌfәkeitiŋli
suffocation => .sʌfә'keiʃәn
suffolk => 'sʌfәk
suffragan => 'sʌfrәgәn
suffrage => 'sʌfridʒ
suffragette => .sʌfrә'dʒet
suffragettes => sʌfrəˈdʒets
suffragist => 'sʌfrәdʒist
suffuse => sә'fju:z
suffused => səf'ju:zd
suffuses => səˈfju:ziz
suffusing => səˈfju:zɪŋ
suffusion => sә'fju:ʒәn
Sufism => 'su:fizəm
sug => ʃu^
sugan => 'sʌ^әn
sugar => 'ʃugә
sugar apple => ˈʃuɡə ˈæpl
sugar bush => ˈʃuɡə buʃ
sugar cube => ˈʃuɡə kju:b
sugar lump => ˈʃuɡə lʌmp
sugar maple => ˈʃuɡə ˈmeipl
sugar soap => ˈʃuɡə səup
sugar-coat => ˈʃuɡə kəut
sugarcane => 'ʃugәkein
sugared => 'ʃuɡәd
sugariness => 'ʃugәrinis
sugaring => 'ʃu^әriŋ
sugarless => 'ʃj^әlis
sugarloaf => 'ʃugәlәuf
sugarplum => 'ʃugәplæm
sugary => 'ʃugәri
suggest => sәg'dʒest
suggestibility => sә.dʒestә'biliti
suggestible => sә'dʒestәbl
suggestion => sә'dʒestʃәn
suggestive => sә'dʒestiv
suggestively => sə'dʒestivli
Suharto => su'hɑ:təu
sui generis => 'sju(:)ai'dʒenәris
sui juris => 'sju'dʒuәris
suicidal => sjui'saidәl
suicidally => ˌsju:ɪ'saɪdəlɪ
suicide => 'sjuisaid
suicides => ˈsjuisaidz
suint => 's(j)u:int; swint
Suisse => swi:s
suit => sju:t. su:t
suitability => .sju:tә'biliti
suitable => 'sju:tәbl
suitably => 'sju:tәbli
suitcase => 'sju:tkeis
suitcases => ˈsju:tkeisiz
suite => swi:t
suited => 'sju:tid
suiter => s'wi:tər
suiting => 'sju:tiŋ
suitor => 'sju:tә
suitors => ˈsu:təz
suk => su:k
Sukey => 'su:ki
sukiyaki => suki:'jɑ:ki:
sukkah => 'sjkә, -kɑ:
Sukkur => 'sjkә(r)
Sulawesi => ,su:lә'weisi
sulcate => 'sʌlkeit
sulcus => 'sʌlkәs
Suleiman => 'su:ləmɑ:n; ,su:lei'mɑ:n
sulfa => 'sʌlfә
sulfate => 'sʌlfeit
sulfated => ˈsʌlˌfeɪtid
sulfates => ˈsʌlˌfeɪts
sulfating => 'sʌlfeitiŋ
sulfide => 'sʌlfaid
sulfite => 'sʌlfait
sulfur => 'sʌlfә
sulfured => ˈsʌlfəd
sulfuric => sʌl'fjuәrik
sulfuring => ˈsʌlfərɪŋ
sulfurous => 'sʌlfәrәs
sulk => sʌlk
sulked => sʌlkt
sulkily => 'sʌlkili
sulkiness => 'sʌlkinis
sulking => sʌlkɪŋ
sulks => sʌlks
sulky => 'sʌlki
sull => sʌl
sullage => 'sʌlidʒ
sullen => 'sʌlәn
sullenly => 'sʌlənlɪ
sullenness => 'sʌlənnis
sullied => ˈsʌli:d
sullies => ˈsʌli:z
sully => 'sʌli
sullying => ˈsʌli:ɪŋ
sulphadiazine => ,sʌlfә'daiәzi:n
sulphamate => 'sʌlfәmeit
sulphanilamide => ,sʌlfә'nilәmaid
sulphapyridine => ,sʌlfә'piridi:n
sulphate => 'sʌlfeit
sulphide => 'sʌlfaid
sulphite => 'sʌlfait
sulphonamide => ,sʌl'fɔnәmaid
sulphonate => 'sʌlfә,neit
sulphonation => ,sʌlfә'neiʃən
sulphone => 'sʌlfәun
sulphonic acid => sʌlˈfɔnik ˈæsid
sulphonyl => 'sʌlfәnil
sulphur => 'sʌlfә
sulphur dioxide => ˈsʌlfə daɪˈɔksaɪd
sulphureous => sʌl'fjuәriәs
sulphuric => sʌl'fjuәrik
sulphuric acid => sʌlˌfjʊərɪk ˈæsɪd
sulphurous => 'sʌlfәrәs
sulphury => 'sʌlfәri
Sulpician => sʌl'piʃən
sultan => 'sʌltn
sultana => sʌl'tɑ:nә
sultanas => sʌl'tɑ:nəz
sultanate => 'sʌltәnit
sultans => ˈsʌltənz
sultrily => 'sʌltrili
sultriness => 'sʌltrinis
sultry => 'sʌltri
sulu => 'suːluː
sum => sʌm
sumac => 'su:mæk, 'ʃu:-
sumatra => su'mɑ:trә
Sumatran => su'mɑ:trәn
Sumba => 'su:mbә
Sumbawa => su:m'bɑ:wә
Sumer => 'su:mə
Sumerian => su:'miәriәn, -'mer-
sumi => 'su:mi
summa => 'sumә
summa cum laude => 'sjmәkjm'lajdei, 'sʌmәkʌm'lɔ:di:
summand => 'sʌmәnd
summaries => ˈsʌməriz
summarily => 'sʌmәrili
summarise => 'sʌmәraiz
summarization => .sʌmәrai'zeiʃәn
summarize => 'sʌmәraiz
summarized => ˈsʌməraizd