S => es
Saanen => 'sɑ:nәn
Saar => sɑ:
Saarland => 'zɑ:rlɑ:nt; 'sɑ:lænd
sabadilla => 'sæbә,dilә
Sabaean => sә'bi(:)әn
Sabah => 'sɑ:bɑ:
Sabaoth => sæ'beiɔθ, 'sæbeiɔθ
sabayon => ,sɑ:bɑ:'jjŋ
Sabbath => 'sæbәθ
sabbatical => sә'bætikl
sabbatical year => səˈbætɪkəl jə:
sabbaticals => səˈbætɪkəlz
Sabellian => sә'beliәn
saber => 'seibә
sabered => ˈseɪbəd
sabering => ˈseɪbərɪŋ
sabers => ˈseɪbəz
sabicu => ,sæbi'ku:
sabin => 'seibin
sabina => sә'bainә, -'bi:-
sabine => 'sæbain
sabkha => 'sæbkhə
sable => 'seibl
sablefish => 'seiblfiʃ
sables => ˈseɪbəlz
sabot => 'sæbәu
sabotage => 'sæbәtɑ:ʒ
sabotaged => ˈsæbəˌtɑ:ʒd
sabotages => ˈsæbəˌtɑ:ʒz
sabotaging => ˈsæbəˌtɑ:ʒɪŋ
saboteur => .sæbә'tә:
saboteurs => ˌsæbəˈtɜ:z
sabra => 'sɑ:brә
sabre => 'seibә
sabres => ˈseɪbəz
sabretache => 'seibәtæʃ
sabreur => sa'broer
Sabrina => sә'bri:nә
sabzi => 'sæbzi
SAC => sæk
saccade => sæ'kɑ:d
saccadic => sæ'kɑ:dik
saccate => 'sækeit
saccharide => 'sækәraid
saccharin => 'sækәrin
saccharine => 'sækәrain, -ri:n
saccharometer => .sækә'rɒmitә
saccharose => 'sækәrәus
saccular => 'sækjulә
sacculated => 'sækjuleitid
saccule => 'sækju:l
sacculus => 'sækjulәs
sacerdotal => ,sæsә'dәutl
sacerdotalism => ,sæsә'dәjtәlizәm, ,sæk-
sachem => 'seitʃәm
sachet => sæ'ʃei
sachets => sæˈʃeɪz
Sachs => zaks
Sachsen => 'zɑ:ksәn
sack => sæk
sack coat => sæk kəut
sack race => sæk reis
sackable => 'sækәbl
sackbut => 'sækbʌt
sackcloth => 'sækklɒθ
sackful => 'sækful
sacking => 'sækiŋ
Sackville => 'sækvil
sacra => 'seikrә
sacral => 'seikrәl
sacrality => sei'krælәti, sæk'ræ-
sacralize => 'sækrәlaiz, 'seikrәlaiz
sacrament => 'sækrәmәnt
sacramental => sækrә'mentl
sacramentalism => ,sækrә'mentәlizәm
sacramento => ,sækrә'mentәu
sacraments => ˈsækrəmənts
sacrarium => sә'kreәriәm
sacred => 'seikrid
sacred ibis => ˈseikrid ˈaibis
sacredness => 'seɪkrɪdnəs
sacrifice => 'sækrifais
sacrificed => ˈsækrifaist
sacrifices => ˈsækrifaisiz
sacrificial => .sækri'fiʃәl
sacrificially => sækriˊfiʃәli
sacrificing => ˈsækrifaisɪŋ
sacrilege => 'sækrilidʒ
sacrilegious => .sækri'lidʒәs
sacrilegiously => sækrɪ'lɪdʒəslɪ
sacring => 'seikriŋ
sacrist => 'sækrist
sacristan => 'sækristәn
sacristies => ˈsækristiz
sacristy => 'sækristi
sacroiliac => .seikrәu'iliæk
sacrosanct => 'sækrәusæŋkt
sacrosanctity => .sækrә'sæŋktiti
sacrum => 'seikrәm
sacs => sæks
sad => sæd
sad sack => sæd sæk
sadden => sædn
saddened => ˈsædnd
saddening => 'sædәniŋ
saddens => ˈsædnz
saddest => sædist
saddish => 'sædiʃ
saddle => 'sædl
saddle shoe => ˈsædl ʃu:
saddle-sore => 'sædlˌsɔ:
saddleback => 'sædlbæk
saddlebacked => 'sædlbækt
saddlebag => 'sædlbæg
saddlebags => ˈsædlˌbægz
saddlebred => 'sædlbred
saddlecloth => 'sædlklɒθ
saddler => 'sædlә
saddlers => ˈsædləz
saddlery => 'sædlәri
saddles => ˈsædlz
saddling => 'sædliŋ
saddo => ˈsædəʊ
Sadducean => sædju'si:әn
Sadducee => 'sædjusi:
Sade => 'tsɑ:di:
sadhana => 'sɑ:dәnә
sadhu => 'sɑ:du:
Sadi => sɑ:'di:
sadie => 'seidi
sadism => 'sædizm
sadist => 'sædist
sadistic => sæ'distik
sadists => ˈseɪˌdɪzəmz
sadly => 'sædli
sadness => 'sædnis
sadomasochism => ,seidәu'mæsәkizәm
sadomasochist => ,seidәj'mæsәjkist,,sæ-
sadza => 'sædzә
sae => sei
safari => sә'fɑ:ri
safari park => səˈfɑ:ri: pɑ:k
safari suit => səˈfɑ:ri: sju:t
safaris => səˈfɑ:ri:z
safe => seif
safe conduct => seif kənˈdʌkt
safe house => seif haus
safe keeping => seif ˈki:pɪŋ
safe seat => seif si:t
safe sex => seif seks
safe-breaker => 'seifbreikə
safecracker => 'seifkrækә
safeguard => 'seifgɑ:d
safekeeping => 'seif'ki:piŋ
safelight => 'seiflait
safely => 'seifli
safety => 'seifti
safety curtain => ˈseifti ˈkə:tn
safety harness => ˈseifti ˈhɑ:nis
safety net => ˈseifti net
safety pin => ˈseifti pin
safety-deposit box => ˈsefti dɪˈpɑzɪt bɑks
safflower => 'sæflauә
saffron => 'sæfrәn
safranine => 'sæfrәni:n
sag => sæg
saga => 'sɑ:gә
sagacious => sә'geiʃәs
sagaciously => sə'ɡeɪʃəslɪ
sagacity => sә'gæsiti
sagamore => 'sægәmɒ:
sagas => ˈsɑ:gəz
sage => seidʒ
sage green => seɪdʒ ɡri:n
sagebrush => 'seidʒbrʌʃ
sagely => 'seidʒli
sageness => 'seidʒinis
saggar => 'sægә
sagged => sægd
sagging => 'sæ^iŋ
saggy => 'sægi
Sagitta => sә'dʒitә
sagittal => 'sædʒitl
Sagittarius => ,sædʒi'teәriәs
sagittate => 'sædʒiteit
sago => 'seigәu
sago palm => ˈseiɡəu pɑ:m
sags => sæɡz
saguaro => sә'gwɑ:rәu
Sahara => sә'hɑ:rә
Sahel => 'sɑ:hel
Sahelian => sә'heiliәn,-'hi:-
sahib => 'sɑ:hib
sahibs => ˈsɑ:hibz
sahitya => sɑ:'hitjә,'sɑ:h-
Sahiwal => 'sɑ:hiwɑ:l
said => sed
Saida => 'sɑ:idɑ:
saiga => 'sai^ә
saigon => sai'^ɔn
sail => seil
sailboard => ˈseɪlbɔ:d
sailboat => 'seilbәut
sailcloth => 'seilklɒθ
sailed => seild
sailer => 'seilә
sailfish => 'seilfiʃ
sailing => 'seiliŋ
sailing master => ˈseɪlɪŋ ˈmɑ:stə
sailing ship => ˈseɪlɪŋ ʃip
sailmaker => 'seil,meikә(r)
sailor => 'seilә
sailor suit => ˈseilə sju:t
sailorly => 'seilәli
sailors => 'seɪləz
sailplane => 'seilplein
sainfoin => 'seinfɒin
Sainsbury => 'seinzbәri
Saint => seint
saint's day => seɪnts
sainted => 'seintid
sainthood => 'seinthud
sainting => seɪnt
saintlike => 'seintlaik
saintliness => 'seintlinis
saintly => 'seintli
saintpaulia => sәnt'pɔ:liә
saintship => 'seint-ʃip
saith => seθ
saithe => seiθ
Saiva => 'saivә,'ʃai-
sake => seik
saker => 'seikә
sakes => seiks
Sakhalin => sækә'li:n
saki => 'sɑ:ki
sal => sɑ:l
sal volatile => .sælvәu'lætәli
sala => 'sɑ:lә
salaam => sә'lɑ:m
salaamed => səˈlɑ:md
salaaming => səˈlɑ:mɪŋ
salaams => səˈlɑ:mz
salable => 'seilәbl
salacious => sә'leiʃәs
salacity => sә'læsiti
salad => 'sælәd
salad cream => ˈsæləd kri:m
salad days => ˈsæləd deɪz
salad dressing => ˈsæləd ˈdresiŋ
salade => sә'leid,-'lɑ:d,'sælәd
salads => 'sælədz
Salah => sә'lɑ:
salal => sә'læl
Salamanca => ,sælə'mæŋkə; ,sɑ:lɑ:'mɑ:ŋkɑ:
salamander => .sælә'mændә
salamanders => ˈsæləmændəz
salamandrine => .sælә'mændrain
salami => sә'lɑ:mi
salamis => sæˈlɑ:mi(:)z
salariat => sә'leәriæt
salaried => 'sælәrid
salaries => ˈsæləriz
salary => 'sælәri
salaryman => ˈsælərimæn
salat => sә'lɑ:t
salbutamol => sæl'bju:tәmɔl,-mɔ:l
salchow => 'sælkɔv
sale => seil
saleable => 'seilәbl
salem => 'seilәm
salep => 'sælep
saleratus => .sælә'reitәs
saleroom => 'seilru:m, 'seilrjm
salesclerk => 'seilzklә:k
salesgirl => 'seilzgә:l
salesgirls => ˈseɪlzˌgɜ:lz
Salesian => sә'li:ʒәn,-ʃәn
saleslady => 'seilzleidi
salesman => 'seilzmәn
salesmanship => 'seilzmәnʃip
salespeople => 'seilz,pi:pl
salesperson => 'seilzpә:sәn
salespersons => ˈseɪlzˌpɜ:sənz
salesroom => 'seilzru:m
saleswoman => 'seilzwumәn
saleswomen => 'seɪlzwɪmɪn
Salford => 'sɔ:lfәd,'sɔl-
Salian => 'seiliәn
Salic => 'sælik
salicin => 'sælisin
salicional => sә'liʃәnәl
salicylate => 'sælisileit
salience => 'seiliәns
salient => 'seiliәnt
salientian => seili'enʃiәn
saliently => 'seiljənt; -liənt
salients => ˈseɪli:ənts
salina => sә'lainә
Salinas => sə'li:nəs
saline => 'seilain
salinity => sә'liniti
salinization => sәlini'zeiʃәn
salinometer => .sæli'nɒmitә
salisbury => 'sɔ:lzbәri
Salish => 'seiliʃ
Salishan => 'seiliʃәn
saliva => sә'laivә
salivary => 'sælivәri
salivary gland => ˈsæləˌveri: ɡlænd
salivate => 'sæliveit
salivated => ˈsæliveitid
salivates => ˈsæliveits
salivating => ˈsæliveitɪŋ
salivation => .sæli'veiʃәn
salle => sɑ:l, sæl
sallee => 'sæli
sallet => 'sælit
sallied => 'sællaɪd
sallies => 'sællaɪz
sallow => 'sælәu
sallowish => 'sælәuiʃ
sallowness => 'sæləunis
sallowy => 'sælәji
Sallust => 'sæləst
sally => 'sæli
sally port => ˈsæli pɔ:t
salmagundi => .sælmә'gʌndi
salmi => 'sælmi
salmon => 'sæmәn
salmon trout => ˈsæmən traʊt
salmonberry => 'sæmәnberi
salmonella => .sælmә'nelә
salmonellosis => ,sælmәne'lәusis
salmonid => 'sælmənid
salmonoid => 'sælmәnɔid
salmons => ˈsæmənz
Salome => sә'lәumi
salon => 'sælɔ:ŋ
Salonika => sә'lɔnikә,,sælә'ni:kә
salons => ˈsælɔ:ŋz
saloon => sә'lu:n
saloons => səˈlu:nz
Salop => 'sælәp
Salopian => sә'lәupiәn
salp => sælp
salpicon => 'sælpikәn
salpiglossis => .sælpi'glɒsis
salpingectomy => .sælpin'dʒektәmi
salpingitis => sælpin'dʒaitis
salpingostomy => sælpiŋ'^ɔstәmi
salsa => 'sɑ:lsә
salsify => 'sælsaifi
salt => sɒ:lt
salt cellar => sɔ:lt ˈselə
salt dome => sɔ:lt dəum
salt lake => sɔ:lt leik
salt lick => sɔ:lt lik
salt meadow => sɔ:lt ˈmedəu
salt shaker => sɔ:lt ˈʃeikə
saltarello => ,sætә'relәu
saltation => sæl'teiʃәn
saltatorial => .sæltә'tɒ:riәl
saltatory => 'sæltәtәri
saltbox => 'sɔ:ltbɔks
saltbush => 'sɔ:lt,buʃ
salted => 'sɒ:ltid
salter => 'sɔ:ltә
saltern => 'sɒ:ltәn
saltier => 'sɔ:ltaiә. 'sæl-
Saltillo => sɑ:l'ti:jɔ:
saltimbocca => ,sɑ:lti:m'bɔ:kkɑ:
saltine => sɒ:l'ti:n
salting => 'sɔ:ltiŋ
saltire => 'sæltaiә
saltirewise => 'sɔ:ltaiәwaiz,-tiә-,'sæl-
saltish => 'sɔ:ltiʃ
saltless => 'sɔ:ltlis
saltmarsh => 'sɔ:lt,mɑ:ʃ
saltpeter => 'sɒ:lpi:tә
salts => sɔ:lts
saltshaker => 'sɔ:lt,ʃeikә
saltus => 'sæltәs
saltwater => 'sɒ:ltwɒ:tә
saltwort => 'sɔ:ltwә:t
salty => 'sɒ:lti
salubrious => sә'lu:briәs
salubriously => sə'lu:brɪəslɪ
salubriousness => sə'lju:briəs
salubrity => sә'lu:briti
salut => sɑ:'lju:
salutary => 'sæljutәri
salutation => .sælju:'teiʃәn
salutations => ˌsæljəˈteɪʃənz
salutatorian => sә,lu:tә'tɔ:riәn
salutatory => sә'lu:tәtәri
salute => sә'lu:t
saluted => səˈlu:tid
salutes => səˈlu:ts
saluting => səˈlu:tɪŋ
salvable => 'sælvәbl
Salvador => 'sælvәdɔ:
salvadorean => ˌsælvə'dɔ:rɪən
salvage => 'sælvidʒ
salvageable => 'sælvidʒәbl
salvaged => ˈsælvidʒd
salvages => ˈsælvidʒz
Salvarsan => 'sælvәsәn
salvation => sæl'veiʃә
salvationism => sæl'veiʃәnizәm
salvationist => sæl'veiʃәnist
salvatore => 'sælvәtɔ:(r)
salve => sælv
salved => sævd
salver => 'sælvә
salvers => ˈsælvəz
salves => sævz
salvia => 'sælviә
salvific => sæl'vɪfɪk
salving => sævɪŋ
salvo => 'sælvәu
salvor => 'sælvә
salwar => 'sɑ:lwɑ:(r)
Salween => 'sælwi:n,sæl'wi:n
Salyut => 'sɑ:lju:t,sæl'ju:t
Salzburg => 'sæltsbә:^
Salzgitter => 'zɑ:lts,^itә(r)
SAM => sæm
samadhi => sә'mɑ:di
Samantha => sə'mænθə
samara => 'sæmәrә
samaria => sә'meәriә
Samarinda => ,sæmә'rindә
Samaritan => sә'mæritәn
samaritans => səˈmæritənz
samarium => sә'mєәriәm
Samarkand => ,sæmә'kænd
samba => 'sæmbә
sambal => 'sæmbәl,'sɑ:mbɑ:l
sambar => 'sæmbә
sambas => ˈsæmbəz
sambhar => 'sæmbә(r),'sɑ:-
sambo => 'sæmbәu
sambuca => sɑ:m'bjkә
same => seim
same difference => seim ˈdifərəns
sameness => 'seimnis
samey => ˈseɪmi
samfu => 'sæmfu:
samian => 'seimiәn
samisen => 'sæmisәn
samite => 'sæmait
samizdat => səmaɪz'dæt
sammie => 'sæmiә
sammy => 'sæmi
Samnite => 'sæmnait
samoa => sә'mәuә
samoan => sә'mәuәn
SAMOS => 'seimɔs
samovar => ,sæmәu'vɑ:
samovars => ˌsæməuˈvɑ:z
Samoyed => ,sæmɔi'ed
Samoyedic => sæmɔi'edik
samp => sæmp
sampan => 'sæmpæn
sampans => 'sæmpæn
samphire => 'sæmfaiә
sample => 'sæmpl
sample space => ˈsɑ:mpl speis
sampler => 'sæmplә
samplers => ˈsæmpləz
sampling => 'sɑ:mpliŋ
samsara => sәm'sɑ:rә
samuel => 'sæmjuәl
samurai => 'sæmurai
san => sɑ:n
San Diego => ,sændi(:)'ei^әu
San Franciscan => ,sænfræn'siskən
San Francisco => ,sænfrәn'siskәu
San Jose => sɑ:n hәu'zei
San Juan => sæn'hwɑ:n
San Marino => ,sæn mә'ri:nәu
San Salvador => sæn'sælvәdɔ:
sanative => 'sænәtiv
sanatorium => .sænә'tɒ:riәm
Sancerre => sɔŋ'ser
Sancho Panza => 'sæŋkәu 'pænzә
sanctification => .sæŋktifi'keiʃәn
sanctified => 'sæŋktifaid
sanctifier => 'sæŋktifaiә(r)
sanctify => 'sæŋktifai
sanctimonious => .sæŋkti'mәuniәs
sanctimoniously => ,sæŋkti'məunjəsli
sanctimony => 'sæŋktimәni
sanction => 'sæŋkʃәn
sanctioned => ˈsæŋkʃənd
sanctioning => ˈsæŋkʃənɪŋ
sanctities => ˈsæŋktɪti:z
sanctitude => 'sæŋktitjud
sanctity => 'sæŋktiti
sanctuaries => ˈsæŋktʃu:ˌeri:z
sanctuary => 'sæŋktʃuәri
sanctum => 'sæŋktәm
sanctum sanctorum => sæŋk'tɔ:rәm
sanctus => 'sæŋktәs
sand => sænd
sand bar => sænd bɑ:
sand cherry => sænd ˈtʃeri:
sand crack => sænd kræk
sand dollar => sænd ˈdɔlə
sand eel => sænd i:l
sand lance => sænd læns
sand martin => sænd ˈmɑ:tn
sand shark => sænd ʃɑ:k
sand table => sænd ˈteibl
sand wedge => sænd wedʒ
sand yacht => sænd jɔt
sandal => 'sændl
sandalwood => 'sændlwud
sandarac => 'sændәræk
sandbag => 'sændbæg
sandbagged => ˈsændbæɡd
sandbagger => 'sændbæɡə
sandbagging => ˈsændbæɡɪŋ
sandbags => ˈsændbæɡz
sandbank => 'sændbæŋk
sandbanks => ˈsændbæŋks
sandbar => 'sændbɑ:(r)
sandblast => 'sændblæst
sandblaster => 'sændblæstɜ:
sandblasts => ˈsændblɑ:sts
sandbox => 'sændbɒks
sandboy => 'sændbɒi
sandcastle => 'sændkɑ:s(ә)l
sanded => 'sændid
sander => 'sændә
sanderling => 'sændәliŋ
sanders => 'sændәs
sandfish => 'sændfɪʃ
sandglass => 'sændglæs
sandgrouse => 'sænd,^raus
sandhi => 'sændi
sandhill => 'sændhil
sandhill crane => ˈsændhil
sandhog => 'sændhɒg
Sandhurst => 'sændhә:st
sandier => ˈsændi:ə
sandiness => 'sændinis
sanding => 'sændiŋ
Sandinista => ,sa:ndi'ni:sta:
sandiver => 'sændivә
sandlot => 'sændlɔt
sandman => 'sændmæn
sandpaper => 'sændpeipә
sandpapered => ˈsændˌpeɪpəd
sandpapering => 'sændpeɪpərɪŋ
sandpapers => ˈsændˌpeɪpəz
sandpapery => 'sænd,peipәri
sandpiper => 'sændpaipә
sandpit => 'sændpit
sandpits => sænd'pɪts
Sandro => 'sændrәj
sandstone => 'sændstәun
sandstones => ˈsændˌstəʊnz
sandstorm => 'sændstɒ:m
sandstorms => 'sændstɔ:mz
sandwich => 'sændwitʃ
sandwich course => ˈsænwidʒ kɔː(r)s
sandwiched => ˈsænwidʒd
sandwiches => ˈsænwidʒz
sandwiching => 'sænwɪdʒɪŋ
sandwort => 'sændwә:t
sandy => 'sændi
sane => sein
saneness => 'seɪnnes
saner => seinə
sanford => 'sænfәd
sang => sæŋ
sang-froid => 'sa:ŋfrwa
sangar => 'sæn^ә
sangaree => ,sæŋ^ә'ri:
Sanger => 'sæŋ^ә
sangfroid => sɒŋ'frwɑ:
sangha => 'sʌŋgə
Sango => 'sɑ:ŋ^әj
sangria => sæŋ'^ri:ә
sanguinary => 'sæŋgwinәri
sanguine => 'sæŋgwin
Sanhedrin => 'sænidrin
sanicle => 'sænikl
sanidine => 'sæni,di:n
sanitarian => .sæni'tєәriәn
sanitarily => 'sænitәrәli, ,sæni'teә-
sanitariness => 'sænɪtærɪnɪs
sanitarium => ,sæni'teәriәm
sanitary => 'sænitәri
sanitary napkin => ˈsænɪˌteri: ˈnæpkin
sanitary towel => ˈsænɪˌteri: ˈtauəl
sanitaryware => 'sænitәriweә
sanitation => sæni'teiʃәn
sanitise => 'sænitaiz
sanitised => 'sænitaiz
sanitization => ,sænitai'zeiʃәn
sanitize => 'sænitaiz
sanitized => ˈsænitaizd
sanitizes => ˈsænitaiziz
sanitizing => 'sænitaiziŋ
sanity => 'sæniti
sanjak => 'sændʒæk
sank => sæŋk
sans => sә
sans serif => ˌsæn ˈserɪf
sansevieria => ,sænsi'viәriә, -vi'i:riә
Sanskrit => 'sænskrit
Sanskritist => 'sænskritist
Sansom => 'sænsәm
santa => 'sæntә
Santa Claus => sæntә 'klɔ:z
Santa Fe => 'sæntә'fei
Santana => sæn'tænə
Santander => ,sæntən'dεə
santeria => ,sæntei'ri:ɑ:
santero => sæn'teirәj
Santiago => sænti'ɑ:^әu
santo => 'sɑ:ntәu
Santo Domingo => 'sæntәu dә'miŋ^әu
santolina => ,sæntәj'li:nә
santon => 'sæntәn
santonica => sæn'tɔnikә
santonin => 'sæntәnin
Santos => 'sæntәs
sap => sæp
saphenous => sә'fi:nәs,'sæfә-
sapid => 'sæpid
sapidity => sә'piditi
sapience => 'seipjәns
sapiens => 'seipjәnz
sapient => 'seipjәnt
sapiential => .seipi'enʃәl
sapless => 'sæplis
sapling => 'sæpliŋ
saplings => ˈsæplɪŋz
sapodilla => sæpә'dilә
saponaceous => .sæpә'neiʃәs
saponifiable => sә'pɔnifaiәbl
saponification => sә.pɒnifi'keiʃәn
saponify => sә'pɒnifai
saponifying => sæ'pɒnɪfaɪɪŋ
saponin => 'sæpәnin
sapped => sæpt
sapper => 'sæpә
sapphic => 'sæfik
sapphire => 'sæfaiә
sapphires => ˈsæfˌaɪəz
sapphirine => 'sæfәrain
sapphism => 'sæfizm
sappho => 'sæfәu
sappiness => 'sæpɪnɪs
sapping => 'sæpɪŋ
sappy => 'sæpi
saprogenic => ,sæprәu'dʒenik
saprophage => 'sæprә,feidʒ
saprophagous => sæp'rɒfәgәs
saprophyte => 'sæprәfait
saprophytic => ,sæprә'fitik
saprotrophic => ,sæprә'trɔfik
saps => 'sæps
sapsucker => 'sæpsʌkә
sapwood => 'sæpwud
Saqqara => sә'kɑ:rә
Sara => 'sɑ:rә
saraband => 'særәbænd
saracen => 'særәsn
Saragossa => ,særə'ɡɔsə
Sarah => 'sєәrә
Sarajevo => ,særә'jeivәu
Saran Wrap => sə'ræn ræp
sarangi => 'sɑ:rәŋdʒi
Saransk => sɑ:'rɑ:nsk, sә-, -'rænsk
sarape => sә'rɑ:pi
Saratoga => ,særә'tәu^ә
Saratov => sɑ:'rɑ:tɔf
Sarawak => sә'rɑ:wәk
sarcasm => 'sɑ:kæzm
sarcastic => sɑ:'kæstik
sarcastically => sɑ:'kæstɪklɪ
sarcenet => 'sɑ:snet
sarcoid => 'sɑ:kɔid
sarcoidosis => .sɑ:kɒi'dәusis
sarcolemma => ,sɑ:kә'lemә
sarcoma => sɑ:'kәumә
sarcomatosis => sɑ:,kәumә'tәusis
sarcomatous => sɑ:'kәumәtәs
sarcomere => 'sɑ:kәmiә
sarcopenia => sɑ:kəʊ'pi:nɪə
sarcophagi => sɑ:'kɔfә^ai, -dʒai, -^i:
sarcophagus => sɑ:'kɒfәgәs
sarcoplasm => 'sɑ:kә,plæzәm
sarcosine => 'sɑ:kәsi:n
sard => sɑ:d
sardar => sә'dɑ:(r), 'sɑ:dɑ:(r)
Sardegna => sɑ:'deinjә, -njɑ:
sardelle => sɑ:'delə
sardine => sɑ:'di:n
sardines => sɑ:ˈdi:nz
Sardinia => sɑ:'dinjә
Sardinian => sɑ:'diniәn
sardinians => sɑ:'diniәns
Sardis => 'sɑ:dis
sardius => 'sɑ:dɪəs
sardonic => sɑ:'dɒnik
sardonically => sɑ:'dɒnɪklɪ
sardonicism => sɑ:'dɒnɪsɪzəm
sardonyx => 'sɑ:dәniks
saree => 'sɑ:ri:, -ri
sargasso => sɑ:'gæsәu
sarge => sɑ:dʒ
Sargodha => sɑ:'^әjdә, sә-
sari => 'sɑ:ri:
sarin => 'sɑ:rin, 'sæ-, zɑ:'ri:n
saris => ˈsɑ:ri:z
sark => sɑ:k
sarking => 'sɑ:kiŋ
sarky => ˈsɑ:ki
Sarmatia => sɑ:'meiʃiə
Sarmatian => sɑ:'mɑ:ʃәn
sarnie => ˈsɑ:ni
sarod => sә'rәjd
sarong => sә'rɒŋ
sarongs => ˈsɑ:rɔŋz
saros => 'seәrɔs
sarpanch => sә'pʌntʃ
sarracenia => ,særә'si:niә
Sarre => sɑ:r, zɑ:r
sarrusophone => sә'rʌsәfәun
sarsaparilla => ,sɑ:sәpә'rilә
sarsen => 'sɑ:sәn
sarsenet => 'sɑ:snit
sartorial => sɑ:'tɒ:riәl
sartorially => sa:'tɔ:riəli
sartorius => sɑ:'tɒ:riәs
Sartre => 'sɑ:trә
sarum => 'seәrәm, 'sær-
Sasanian => sæ'seiniən
sasanqua => sә'sɑ:ŋkwә
sash => sæʃ
sash cord => sæʃ kɔ:d
sash weight => sæʃ weit
sashay => sæ'ʃei
sashayed => sæˈʃeid
sashaying => sæˈʃeiŋ
sashays => sæˈʃeiz
sashes => sæʃiz
sashimi => sɑ:'ʃi:mi
sashless => 'sæʃlis
sasin => 'sæsin, 'sei-
sasine => 'seisin
Saskatchewan => sәs'kætʃiwәn, sæs-
Sasquatch => 'sæskwætʃ
sass => sæs
sassaby => 'sæsәbi
sassafras => 'sæsәfræs
sassed => sæst
Sassenach => 'sæsәnæk
sasses => sæsiz
sassing => sæsɪŋ
sassy => 'sæsi
sastra => 'sɑ:strә
sastrugi => 'sɑ:stru:dʒi:
sat => sæt
satai => 'sɑ:tei
Satan => 'seitәn
satang => sә'tæŋ
Satanic => sә'tænik
satanically => sәˊtænikәli
Satanism => 'seitәnizәm
satanist => 'seɪtənɪst
satay => 'sɑ:tei, sɑ:'tei
satchel => 'sætʃәl
satchels => ˈsætʃəlz
sate => seit
sated => ˈseɪtɪd
sateen => sæ'ti:n
sateless => 'seitlis
satellite => 'sætlait
satellite dish => ˈsætəlait diʃ
satellite television => ˈsætəlait ˈteliˌviʒən
satellites => ˈsætəlaits
satellitium => ,sætə'litiәm, -'liʃi-,
sates => seɪt
sati => 'sʌti:. sʌ'ti:
satiable => 'seiʃәbl
satiate => 'seiʃieit
satiated => 'seiʃieitid
satiates => ˈseɪʃi:ˌeɪts
satiating => ˈseɪʃi:ˌeɪtɪŋ
satiation => .seiʃi'eiʃәn
satiety => sә'taiiti
satin => 'sætin
satin walnut => ˈsætn ˈwɔ:lnət
satin weave => ˈsætn wi:v
satinize => 'sætinaiz
satinwood => 'sætinwud
satiny => 'sætini
satire => 'sætaiә
satires => 'sætaiəz
satiric => sә'tirik
satirical => sә'tirik(ә)l
satirically => sə'tɪrɪklɪ
satirise => 'sætәraiz
satirist => 'sætәrist
satirists => ˈsætərɪsts
satirize => 'sætәraiz
satirized => ˈsætəˌraɪzd
satirizes => ˈsætəˌraɪziz
satirizing => ˈsætəˌraɪzɪŋ
satisfaction => .sætis'fækʃәn
satisfactorily => .sætis'fæktәrili
satisfactoriness => sætɪs'fæktərɪnɪs
satisfactory => .sætis'fæktәri
satisfiability => ,sætisfaiә'biliti
satisfiable => 'sætisfaiәbl
satisfice => 'sætɪsfɪs
satisfied => 'sætisfaiәd
satisfy => 'sætisfai
satisfying => 'sætisfaiiŋ
satisfyingly => 'sætis,faiiŋli
sativa => sә'tivә
satnav => 'sætnæv
satori => sә'tɔ:ri
satrap => 'sætrәp
satrapy => 'seitrәpi
satsang => 'sɑ:t'sɑ:ŋ
satsuma => sætˈsu:mə
satsumas => sætˈsu:məz
saturable => 'sætʃәrәbl
saturate => 'sætʃәreit
saturated => 'sætʃәreitid
saturated fat => ˈsætʃəreitid fæt
saturates => ˈsætʃəreits
saturating => ˈsætʃəreitɪŋ
saturation => .sætʃә'reiʃәn
saturations => ˌsætʃəˈreɪʃənz
Saturday => 'sætәdi
Saturdays => 'sætәdiz, -deiz
Saturn => 'sætәn
Saturnalia => ,sætә:'neiljә
Saturnian => ,sæ'tә:niәn
saturnic => sә'tә:nik
saturniid => sә'tә:niid
saturnine => 'sætәnain
saturnism => 'sætә(:)nizәm
satyr => 'sætә
satyriasis => ,sæti'raiәsis
satyric => sә'tirik
satyrid => 'sætirid
satyrs => ˈsætəz
sauce => sɒ:s
sauce boat => sɔ:s bəut
saucepan => 'sɒ:spәn
saucepans => ˈsɔ:spænz
saucepot => 'sɔ:spɔt
saucer => 'sɒ:sә
saucerful => 'sɔ:sәfjl
saucers => ˈsɔ:səz
sauces => sɔ:siz
saucier => sәj'sjei
saucily => 'sɒ:sili
sauciness => 'sɒ:sinis
saucisson => ,sɔ:si'sɔ:ŋ
saucy => 'sɒ:si
saudi => 'sajdi
Saudi Arabia => 'saudi ә'reibjә
Saudi Arabian => 'saudi ә'reibjәn
sauerbraten => 'sauәbrɑ:tn
sauerkraut => 'sauәkraut
sauger => 'sɔ:^ә
saul => sɔ:l
Saumur => 'sәumjuә
sauna => 'saunә
saunas => ˈsɔ:nəz
saunders => 'sɔ:ndәs
saunter => 'sɒ:ntә
sauntered => ˈsɔ:ntəd
sauntering => 'sɔ:ntərɪŋ
saunters => ˈsɔ:ntəz
saurian => 'sɒ:riәn
saurischian => sɔ:'riskiәn
sauropod => 'sɔ:rәpɔd
saury => 'sɒ:ri
sausage => 'sɒsidʒ
sausage dog => ˈsɔsidʒ dɔɡ
sausage meat => ˈsɔsidʒ mi:t
sausages => 'sɒsɪdʒɪz
sauted => 'səutei
sautoir => sәu'twɑ:
sauve qui peut => sәuv ki: pә:
Sauvignon => ,səuvi:'njuŋ
savable => 'seivәbl
savage => 'sævidʒ
savaged => ˈsævidʒd
savageness => 'sævɪdʒnɪs
savagery => 'sævidʒәri
savaging => ˈsævidʒɪŋ
savanna => sә'vænә
savannah => sә'vænә
savannahs => səˈvænəz
savant => 'sævәnt
savants => sæˈvɑ:nts
savarin => sɑ:vɑ:'ræŋ
savate => sә'vɑ:t, sæ'væt
save => seiv
save-all => 'seivɔ:l
saveloy => 'sævәlɒi
saver => 'seivә
savers => ˈseɪvəz
saving => 'seiviŋ
saving grace => ˈseiviŋ ɡreis
savings and loan => ˈseiviŋz ænd ləun
savior => 'seivjә
saviour => 'seivjә
saviours => ˈseɪvjəz
savoir faire => ˌsævwɑ: ˈfeə(r)
savoir-faire => 'sævwɑ:'feә
savor => 'seivә
savored => ˈseivəd
savoring => ˈseivərɪŋ
savors => ˈseivəz
savory => 'seivәri
savour => 'seivә
savoured => ˈseivəd
savouries => ˈseɪvəri:z
savourily => ˊseivәrili
savouriness => ˊseivәrinis
savouring => 'seɪvərɪŋ
savourless => 'seivәlis
savours => ˈseivəz
savoury => 'seivәri
savoy => sә'vɔi
Savoyard => sә'vɔiɑ:d
savvied => ˈsævid
savvies => ˈsæviz
savvy => 'sævi
savvying => ˈsæviŋ
saw => sɒ:
saw set => sɔ: set
saw-whet owl => 'sɔ:hwet
sawbill => 'sɔ:bɪl
sawbones => 'sɔ:bәjnz
sawbuck => 'sɔ:bʌk
sawdust => 'sɒ:dʌst
sawed-off => 'sɔ:d'ɔ:f
sawfish => 'sɒ:fiʃ
sawfly => 'sɒ:flai
sawgrass => 'sɔːgrɑːs
sawhorse => 'sɒ:hɒ:s
sawing => 'sɔ:iŋ
sawlog => 'sɔ:lɔ^; -lɔ:^
sawmill => 'sɒ:mil
sawmills => ˈsɔ:ˌmɪlz
sawn => sɔ:n
sawn-off => 'sɔ:n'ɔ:f
sawn-off shotgun => sɔ:n ɔf ˈʃɔtˌgʌn
saws => 'sɔ:z
sawtooth => 'sɒ:tu:θ
sawyer => 'sɒ:jә
sax => sæks
saxe => sæks
saxes => sæksiz
saxhorn => 'sækshɒ:n
saxifrage => 'sæksifridʒ
saxist => sæksɪst
Saxon => sæksn
Saxonize => 'sæksәnaiz
Saxony => 'sæksәni
saxophone => 'sæksәfәun
saxophones => ˈsæksəˌfəʊnz
saxophonist => sæk'sɔfәnist; 'sæksәfәj-
saxophonists => sækˈsɔfənists
saxton => 'sækstn
say => sei
say cheese => sei tʃi:z
say-so => 'seisәu
sayable => 'seiәbl
sayers => 'seiәz, seәz
saying => 'seiiŋ
sayonara => 'sɑ:jɔ:'nɑ:rɑ:
sayyid => 'seɪi:ɪd
scab => skæb
scabbard => 'skæbәd
scabbards => ˈskæbədz
scabbed => skæbd, -id
scabbiness => s'kæbɪnəs
scabbing => 'skæbiŋ
scabby => 'skæbi
scabies => 'skæbis
scabious => 'skeibiәs
scabland => 'skæblænd
scabrous => 'skeibrәs
scabs => skæbz
scad => skæd
scaffold => 'skæfәld
scaffolded => 'skæfəʊld; -f(ə)ld
scaffolding => 'skæfәldiŋ
scaffolds => ˈskæfəldz
scag => skæ^
scagliola => skæl'jәulә
scalability => ,skeilә'biliti
scalable => 'skeilәbl
scalar => 'skeilә
scalar field => ˈskeilə fi:ld
scalariform => skә'lærifɒ:m
scalawag => 'skælәwæ^
scald => skɒ:ld
scalded => skɔ:ldid
scaldfish => 'skɔ:ldfiʃ
scalding => 'skɔ:ldiŋ
scalds => skɔ:ldz
scale => skeil
scale leaf => skeil li:f
scaled => skeild
scaleless => 'skeillis
scalene => 'skeili:n
scalenus => skei'li:nәs
scaler => 'skeilә
scaliness => 'skeilinis
scaling => 'skeiliŋ
scallion => 'skæljәn
scallions => ˈskæljənz
scallop => 'skɒlәp
scallop shell => ˈskɔləp ʃel
scalloped => 'skɔlәpt
scalloper => 'skɔlәpә
scalloping => 'skɔlәpiŋ
scallops => 'skɒləp
scally => ˈskæli
scallywag => 'skæliwæ^
scaloppine => ,skɑ:lә'pi:ni, ,skæl-
scalp => skælp
scalp lock => skælp lɔk
scalped => skælpt
scalpel => 'skælpәl
scalpels => ˈskælpəlz
scalper => 'skælpә
scalping => 'skælpiŋ
scalps => skælps
scaly => 'skeili
scaly anteater => ˈskeɪli: ˈæntˌi:tə
scam => skæm
scammer => s'kæmər
scamming => skæmiŋ
scammony => 'skæmәni
scamp => skæmp
scamper => 'skæmpә
scampered => ˈskæmpəd
scampering => ˈskæmpərɪŋ
scampers => ˈskæmpəz
scampi => 'skæmpi
scamping => 'skæmpiŋ
scampish => 'skæmpiʃ
scamps => s'kæmps
scan => skæn
scandal => 'skændәl
scandalize => 'skændәlaiz
scandalized => ˈskændlˌaɪzd
scandalizes => ˈskændlˌaɪziz
scandalizing => ˈskændlˌaɪzɪŋ
scandalmonger => 'skændlmʌŋgә
scandalmongering => 'skænd(ə)lmʌŋgə
scandalmongers => 'skænd(ə)lmʌŋgə
scandalous => 'skændәlәs
scandalously => 'skændələsli
scandals => ˈskændlz
scandent => 'skændәnt
Scandinavia => ,skændi'neivjә, -viә
Scandinavian => ,skændi'neivjәn
scandium => 'skændiәm
scannable => 'skænәbl
scanner => 'skænә
scanners => s'kænəz
scanning => 'skæniŋ
scansion => 'skænʃәn
scant => skænt
scanted => skæntid
scantier => ˈskænti:ə
scanties => 'skæntiz
scantily => ˈskæntɪlɪ
scantiness => 'skæntinis
scanting => skæntɪŋ
scantling => 'skæntliŋ
scantly => 'skæntli
scanty => 'skænti
scape => skeip
scaped => skeɪp
scapegoat => 'skeipgәut
scapegoating => 'skeɪpgəʊtɪŋ
scapegoats => ˈskeɪpˌgəʊts
scapegrace => 'skeipgreis
scaphoid => 'skæfɒid
scaphopod => 'skæfәpɔd
scapula => 'skæpjulә
scapular => 'skæpjulә
scapulary => 'skæpjjlәri
scar => skɑ:
scarab => 'skærәb
scarabaeid => ,skærә'bi:id
scarabaeoid => ,skærә'bi:ɔid
scaramouch => 'skærәmautʃ
scarce => skɑ:s
scarcely => 'skɑ:sli
scarceness => 'skɛəsnis
scarcer => skɛəsə
scarcity => 'skɑ:siti
scare => skєә
scarecrow => 'skєәkrәu
scarecrows => ˈskeəˌkrəʊz
scared => skeәd
scaremonger => 'skєәmʌŋgә
scarer => 'skeәrә
scares => 'skærәs
scarey => 'skeәri
scarf => skɑ:f
scarfed => s'kɑ:ft
scarfing => 'skɑ:fiŋ
scarification => .skærifi'keiʃәn
scarified => 'skeәri,faid
scarifier => 'skærifaiә
scarify => 'skærifai
scarifying => skærɪ'faɪɪŋ
scaring => skeərɪŋ
scarlatina => .skɑ:lә'ti:nә
Scarlatti => skɑ:'læti
scarless => s'kɑ:les
scarlet => 'skɑ:lit
scarlet pimpernel => ˈskɑ:lɪt ˈpimpənel
scarlet runner => ˈskɑ:lɪt ˈrʌnə
scarlets => ˈskɑ:lɪts
Scarlett => 'ska:lət
scarp => skɑ:p
scarped => skɑ:pt
scarper => 'skɑ:pә
scarves => skɑ:vz
scary => 'skєәri
scat => skæt
scathe => skeið
scathed => skeɪðd
scatheless => 'skeiðlis
scathing => 'skeiðiŋ
scathingly => 'skeɪðɪŋlɪ
scatological => ˌskætəˈlɒdʒɪkl
scatology => skә'tɒlәdʒi
scatophagous => skә'tɔfә^әs
scatted => skætid
scatter => 'skætә
scatter cushion => ˈskætə ˈkuʃən
scatterbrain => 'skætәbrein
scatterbrained => 'skætәbreind
scattered => 'skætәd
scatterer => 'skætәrә
scattergram => 'skætә^ræm
scattergun => 'skætә^ʌn
scattering => 'skætәriŋ
scatters => ˈskætəz
scattershot => 'skætәʃɒt
scatting => skætɪŋ
scatty => 'skæti
scaup => skɒ:p
scauper => 'skɔ:pә
scaur => skɑ:, skɔ:
scavenge => 'skævindʒ
scavenged => ˈskævəndʒd
scavenger => 'skævindʒә
scavenger cell => ˈskævəndʒə sel
scavengers => 'skævɪn(d)ʒə
scavenges => ˈskævəndʒz
scavenging => 'skævindʒiŋ
scazon => 'skeizən,'skæ-
scena => 'ʃeinә. -nɑ:
scenario => si'nɑ:riәu
scenarist => si'nєәrist
scend => send
scending => send
scends => send
scene => si:n
scenery => 'si:nәri
scenester => 'si:nstə
scenic => 'si:nik
scenic railway => ˈsi:nɪk ˈreilwei
scenically => 'si:nikli
scenography => si:'nɒgrәfi
scent => sent
scent mark => sent mɑ:k
scented => 'sentid
scentless => 'sentlis
scents => sents
scepter => 'septә
sceptic => 'skeptik
sceptical => 'skeptikl
sceptically => 'skeptɪklɪ
scepticism => 'skeptisizm
sceptics => ˈskeptɪks
sceptres => ˈseptəz
schadenfreude => 'ʃɑ:dәnfrɔidә
schappe => ʃæp, 'ʃɑ:pә
sched => ʃed. sked
schedular => 'ʃedjulә; 'skedʒulә
schedule => 'skedʒuәl
scheduled => 'skedʒuәld
scheduler => 'ʃedju:lә
scheduling => 'skedʒuәliŋ
scheelite => 'ʃi:lait
schefflera => 'ʃeflәrә
Scheherazade => ʃi,hiərə'zɑ:də; ʃə,hεə-
Scheldt => ʃelt, skelt
schema => 'ski:mә
schematic => ski:'mætik
schematism => 'ski:mәtizm
schematization => ski:mətaɪ'zeɪʃn
schematize => 'ski:mәtaiz
schematized => 'skiːmətaɪz
schematizing => 'skiːmətaɪz
scheme => ski:m
schemed => ski:md
schemer => 'ski:mә
schemes => ski:mz
scheming => 'ski:miŋ
schemozzle => ʃi'mɔzl, ʃә-
scherzando => skeә'tsændәu, skә:-
scherzo => 'skεәtsәu
schiller => 'ʃilә
schilling => 'ʃiliŋ
schillings => 'ʃɪlɪŋ
schipperke => 'skipәki
schism => 'sizm
schismatic => siz'mætik
schisms => ˈsɪzəmz
schist => ʃist
schistose => 'ʃistәus
schistosity => ʃis'tɔsiti
schistosome => 'ʃistәsәum
schistosomiasis => .ʃistәsәu'maiәsis
schizanthus => skid'zænθәs,skit'sæ-
schizo => 'skitsәu
schizocarp => 'skizәukɑ:p
schizogenic => ,skidzәj'dʒenik,,skits-
schizogenous => ski'zɔdʒәnәs
schizogony => ski'zɔ^әni
schizoid => 'skizɒid
schizont => 'skizɔnt
schizophrenia => .skizәu'fri:niә
schizophrenic => .skizәu'frenik
schizophrenics => skɪtsəʊf'renɪks
schizotype => 'skizәu,taip
schlemiel => ʃlә'mi:l
schlep => ʃlep
schlepped => ʃlept
schlepping => ʃlepɪŋ
schleps => ʃleps
Schleswig => 'ʃləzwiɡ
schlieren => 'ʃli:rәn
schlimazel => ʃli:'mɑ:zәl
schlock => ʃlɔk
schlockmeister => 'ʃlɔkmaistә
schlocky => 'ʃiɔki
schloss => ʃlɔ:s
schlub => ʃlʌb
schlump => ʃ'lʌmp
schmaltz => ʃmɒ:lts
schmaltzy => 'ʃmæltsi,'ʃmɑːltsi
schmatte => 'ʃmɑ:tә
schmear => ʃmiә
Schmitt => ʃmit
schmo => ʃmәu
schmooze => ʃmu:z
schmoozed => ʃmu:zd
schmoozer => ʃmu:zə(r)
schmoozes => ʃmu:ziz
schmoozing => ʃmu:zɪŋ
schmuck => ʃmʌk
schnapps => ʃnæps
schnauzer => 'ʃnauzә
schnitzel => 'ʃnitsәl
schnook => ʃnuk
schnorrer => 'ʃnɔrә
schnozzle => 'ʃnɒzl
Schofield => 'skәufi:ld
scholar => 'skɒlә
scholarly => 'skɔlәli
scholars => s'kɒləz
scholarship => 'skɒlәʃip
scholarships => ˈskɔləʃips
scholastic => skә'læstik
scholasticism => skә'læstisizm
scholastics => skə'læstɪk
scholiast => 'skәuliæst
scholiastic => .skәuli'æstik
scholium => 'skәuliәm
school => sku:l
school board => sku:l bɔ:d
school district => sku:l ˈdistrikt
school ship => sku:l ʃip
school-leaver => sku:l 'li:və(r)
school-leavers => 'sku:l,li:və
schoolbook => 'sku:lbuk
schoolbooks => 'skuːlbʊk
schoolboy => 'sku:lbɒi
schoolboys => s'ku:lbɔɪz
schoolchild => 'sku:ltʃaild
schoolday => 'sku:ldei
schooled => sku:ld
schoolfellow => 'sku:l.felәu
schoolgirl => 'sku:lgә:l
schoolgirls => s'ku:lɡɜ:lz
schoolhouse => 'sku:lhaus
schoolhouses => ˈsku:lˌhaʊsiz
schooling => 'sku:liŋ
schoolman => 'sku:lmәn
schoolmarm => 'sku:lmɑ:m
schoolmarmish => 'skuːl,mɑːmɪʃ
schoolmaster => 'sku:lmɑ:stә
schoolmasterly => 'skuːl,mɑːstəlɪ
schoolmasters => s'ku:lmɑ:stəz
schoolmate => 'sku:lmeit
schoolmates => ˈsku:lˌmeɪts
schoolmen => sku:l'men
schoolmistress => 'sku:lmistris
schoolmistresses => ˈsku:lˌmɪstrɪsiz
schoolmistressy => 'sku:l,mistrisi
schoolroom => 'sku:lru:m
schoolrooms => ˈsku:lˌru:mz
schoolteacher => 'sku:lti:tʃә
schoolteachers => ˈsku:lˌti:tʃəz
schoolteaching => 'sku:lti:tʃiŋ
schoolyard => 'sku:ljɑ:d
schooner => 'sku:nә
schooners => ˈsku:nəz
Schopenhauer => 'ʃәupәnhauә
schorl => ʃɔ:l
schottische => 'ʃɒtiʃ
schtick => ʃtik
schtup => dj:ʃtʌp
schuss => ʃus
schwa => ʃwɑ:
Schwann => ʃwɔn
schwartz => ʃwɑ:ts
Schwarz => ʃwɑ:z
Schwarzenegger => ,ʃwazi'nigə
Schwarzwald => 'ʃvɑ:rtsvɑ:lt
schweitzer => 'ʃvaitsә
Schweiz => ʃvaits
Schwerin => ʃvei'ri:n
Schwyz => ʃvi:ts
sci-fi => 'sai'fai
sciaenid => sai'i:nid
sciagram => 'saiәgrәm
sciagraph => 'saiә^rɑ:f
sciagraphy => sai'æ^rәfi
sciamachy => sai'æmәki
sciatic => sai'ætik
sciatic nerve => saiˈætik nə:v
sciatica => sai'ætikә
science => 'saiәns
science fiction => ˈsaiəns ˈfikʃən
science park => ˈsaiəns pɑ:k
scient => 'saiәnt
scienter => sai'entә(r)
sciential => sai'enʃәl
scientific => .saiәn'tifik
scientifically => .saiәn'tifikәli
scientificity => ,saiәnti'fisәti
scientism => 'saiәntizm
scientist => 'saiәntist
scientists => 'saɪəntɪsts
scientology => ,saiәn'tɔlәdʒi
scilicet => 'sailiset
Scillonian => si'lәjniәn
Scilly => 'sili;'sili
scimitar => 'simitә
scimitars => ˈsimitəz
scintigram => 'sintә^ræm
scintigraphy => sɪn'tɪgrəfɪ
scintilla => sin'tilә
scintillant => 'sintilәnt
scintillate => 'sintileit
scintillation => ,sinti'leiʃәn
scintillator => 'sɪntɪleɪtə
scintiscan => 'sintiskæn
sciolism => 'saiәlizm
sciolist => 'saiәlist
sciolistic => .saiә'listik
scion => 'saiәn
scions => ˈsaɪənz
scire facias => 'saiәri 'feiʃiæs
scirocco => sɪ'rɒkəʊ
scirrhous => 'sirәs
scirrhus => 'sirәs, skirәs
scissel => 'sisәl
scissile => 'sisail
scission => 'siʒәn
scissor => 'sizә
scissor kick => ˈsizə kik
scissored => ˈsizəd
scissoring => 'sizәriŋ
scissors => 'sizәz
scissortail => 'sizәteil
sclera => 'skliәrә
sclerenchyma => skliә'reŋkimә
sclerite => 'skliәrait
scleritis => skliә'raitis
scleroderma => ,skliәrәu'dә:mә
sclerophyll => 'skliәrәufil
sclerophyllous => sk'lerəfɪləs
scleroprotein => ,skliәrәu'prәuti:n
sclerose => skli'rәus
sclerosed => skli'rәust, 'skliәrәuzd
sclerosing => skliә'rәjsiŋ
sclerosis => skliә'rәusis
sclerotic => .skliә'rɒtik
sclerotin => 'skliәrәutin
sclerotium => skli'rәuʃiәm
sclerotization => ,skliәrәutai'zeiʃәn
sclerotized => 'skliәrәtaizd,'skleә-
sclerotome => 'skliәrәtәum
sclerous => 'skliәrәs
scoff => skɒf
scoffed => skɔft
scoffer => 'skɒfә
scoffing => skɔfɪŋ
scoffingly => 'skɒfiŋli
scofflaw => 'skɒflɒ:
scoffs => skɔfs
scold => skәuld
scolded => skəuldid
scolder => 'skəuldə
scolding => 'skәuldiŋ
scolds => skəuldz
scolex => 'skәuleks
scoliosis => ,skɔli'әusis
scollop => 'skɔlәp
scolloped => ˈskɔləpt
scolloping => ˈskɔləpɪŋ
scollops => ˈskɔləps
scombroid => 'skɔmbrɔid
sconce => skɒns
scone => skәun
scones => skɔnz
scoop => sku:p
scooped => sku:pt
scooper => 'sku:pə
scoopful => 'sku:pful
scoopfuls => 'skuːpfʊl
scooping => 'sku:piŋ
scoops => sku:ps
scoot => sku:t
scooted => sku:tid
scooter => 'sku:tә
scooterist => -әrist
scooting => sku:tɪŋ
scoots => sku:ts
scope => skәup
scoped => s'kəʊpt
scopolamine => skәu'pɔlәmin, ,skәupә'læmin
scorbutic => skɒ:'bju:tik
scorch => skɒ:tʃ
scorched => skɔ:tʃt
scorcher => 'skɔ:tʃә
scorchers => 'skɔːtʃə
scorches => skɔ:tʃiz
scorching => 'skɒ:tʃiŋ
scordatura => ,skɔ:dɑ:'tu:rɑ:
score => skɒ:
score draw => skɔ: drɔ:
score points => skɔ: pɔints
scoreboard => 'skɒ:bɒ:d
scoreboards => ˈskɔ:bɔ:dz
scorecard => 'skɒ:kɑ:d
scorecards => ˈskɔ:ˌkɑ:dz
scored => skɔ:d
scorekeeper => 'skɒ:.ki:pә
scoreless => 'skɒ:lis
scoreline => 'skɔ:lain
scorer => 'skɒ:rә
scorers => ˈskɔ:rəz
scores => skɔ:z
scoresheet => 'skɔ:ʃi:t
scoria => 'skɒ:riә
scoriaceous => .skɒ:ri'eiʃәs
scoring => 'skɔ:riŋ
scorn => skɒ:n
scorned => skɔ:nd
scorner => 'skɔ:nә
scornful => 'skɒ:nful
scornfully => 'skɔ:nfəlɪ
scornfulness => ˊskɒːnfulnis
scorning => skɔ:nɪŋ
scorns => skɔ:nz
Scorpian => 'skɔ:piәn
Scorpio => 'skɔ:piәu
scorpioid => 'skɔ:piɔid
scorpion => 'skɒ:piәn
scorpionfish => 'skɔ:piәnfiʃ
scorpions => s'kɔ:pɪənz
scorzonera => ,skɔzә'nirә
scot => skɒt
scot-free => 'skɔtfri:
Scotch => skɔtʃ
scotched => skɔtʃt
scotches => skɔtʃiz
Scotchgard => 'skɔtʃ^ɑ:d
scotching => 'skɔtʃiŋ
Scotchman => 'skɔtʃmәn
Scotchwoman => 'skɔtʃ,wjmәn
scoter => 'skәutә
scotia => 'skәuʃә
Scoticism => 'skɔtisizәm
Scoticize => 'skɔtisaiz
Scotland => 'skɒtlәnd
scotoma => skәu'tәumә
scotopic => skɔ'tɔpik, -'tәj-, skәj-
Scots => skɔts
scotsman => 'skɔtsmәn
Scotsmen => 'skɔtsmən
Scotswoman => 'skɔts,wumәn
scott => skɔt
Scotticize => 'skɔtisaiz
Scottie => 'skɔti
Scottish => 'skɒtiʃ
scotty => 'skɔti
scoundrel => 'skaundrәl
scoundrelism => 'skajndrəlizəm
scoundrelly => 'skajndrəli
scoundrels => ˈskaʊndrəlz
scour => 'skauә
scoured => ˈskauəd
scourer => 'skauәrә
scourers => 'skauərə
scourge => skә:dʒ
scourged => skɜ:dʒd
scourges => skɜ:dʒz
scourging => skɜ:dʒɪŋ
scouring => 'skauriŋ
scouring rush => ˈskauriŋ rʌʃ
scouse => skaus
scouser => 'skajsә(r)
scout => skaut
scouted => skautid
scouter => 'skautә
scouting => 'skautiŋ
scoutmaster => 'skaut.mɑ:stә
scouts => skauts
scow => skau
scowl => skaul
scowled => skauld
scowling => skaulɪŋ
scowls => skaulz
scrabble => 'skræbl
scrabbled => ˈskræbəld
scrabbles => ˈskræbəlz
scrabbling => ˈskræbəlɪŋ
scrag => skræg
scragged => skræɡd
scraggier => ˈskrægi:ə
scragging => sk'ræɡɪŋ
scraggly => 'skrægli
scraggy => 'skrægi
scrags => skræɡz
scram => skræm
scramasax => 'skræmә,sæks
scramble => 'skræmbl
scrambler => 'skræmblә
scramblers => ˈskræmbləz
scrambles => ˈskræmblz
scramjet => 'skræmdʒet
scrammed => skræmd
scramming => skræmɪŋ
scrams => skræmz
scran => skræn
scrap => skræp
scrap paper => skræp ˈpeipə
scrapbook => 'skræpbuk
scrapbooks => ˈskræpˌbʊks
scrape => skreip
scraped => skreipt
scraper => 'skreipә
scrapes => skreips
scrapheap => 'skræphi:p
scrapie => 'skræpi
scraping => 'skreipiŋ
scrapper => 'skræpә
scrapping => skræpɪŋ
scrapple => 'skræpl
scrappy => 'skræpi
scrapyard => ˈskræpjɑ:d
scratch => skrætʃ
scratch card => skrætʃ kɑ:d
scratchboard => 'skrætʃbɔ:d
scratched => skrætʃt
scratcher => 'skrætʃә
scratches => skrætʃiz
scratchpad => 'skrætʃpæd
scratchy => 'skrætʃi
scrawl => skrɒ:l
scrawled => skrɔ:ld
scrawling => skrɔ:lɪŋ
scrawls => skrɔ:lz
scrawnier => ˈskrɔ:ni:ə
scrawny => 'skrɒ:ni
scream => skri:m
screamed => sk'ri:md
screamer => 'skri:mә
screaming => 'skri:miŋ
screamingly => 'skri:miŋli
screams => skri:mz
scree => skri:
screech => skri:tʃ
screech owl => skri:tʃ aul
screeched => skri:tʃt
screeches => skri:tʃiz
screeching => sk'ri:tʃɪŋ
screechy => sk'ri:tʃɪ
screed => skri:d
screen => skri:n
screen door => skri:n dɔ:
screen print => skri:n print
screen saver => skri:n ˈseɪvə
screenager => sk'ri:neɪdʒər
screener => 'skri:nә
screening => 'skri:niŋ
screenplay => 'skri:nplei
screenplays => ˈskri:nˌpleɪz
screensaver => skrɪn'seɪvə
screenshot => ˈskri:nʃɒt
screenwash => 'skri:nwɔʃ, -wɔ:ʃ
screenwriter => 'skri:nraitә
screenwriters => ˈskri:nˌraitəz
screenwriting => 'skri:n,raitiŋ
screes => skri:z
screw => skru:
screw around => skru: əˈraund
screw pine => skru: pain
screw-topped => sk'ru:t'ɒpt
screw-up => ˈskru:ˌʌp
screwball => 'skru:bɒ:l
screwdriver => 'skru:draivә
screwdrivers => ˈskru:ˌdraɪvəz
screwed => skru:d
screwer => skru':ər
screwworm => 'skru:wә:m
screwy => 'skru:i
scribal => 'skraibәl
scribble => 'skribl
scribbled => ˈskrɪbəld
scribbler => 'skriblә
scribbles => ˈskrɪbəlz
scribbling => 'skribliŋ
scribe => skraib
scriber => 'skraibә
scribes => skraibz
scribing => 'skraibiŋ
scried => skraɪ
scries => skraɪ
scrim => skrim
scrimmage => 'skrimidʒ
scrimmaged => ˈskrimidʒd
scrimmager => sk'rɪmɪdʒɜ:
scrimmages => ˈskrimidʒz
scrimmaging => ˈskrimidʒɪŋ
scrimp => skrimp
scrimped => skrɪmpt
scrimping => skrɪmpɪŋ
scrimps => skrɪmps
scrimshander => 'skrim,ʃændә(r)
scrimshank => 'skrimʃæŋk
scrimshanked => 'skrɪmʃæŋk
scrimshanker => sk'rɪmʃæŋkər
scrimshanking => 'skrɪmʃæŋk
scrimshanks => 'skrɪmʃæŋk
scrimshaw => 'skrimʃɒ:
scrip => skrip
script => skript
scripted => ˈskrɪptɪd
scriptorium => skrip'tɒ:riәm
scriptural => 'skriptʃәrәl
scripturally => sk'rɪptʃərəlɪ
scripture => 'skriptʃә
scriptwriter => 'skript.raitә
scriptwriters => ˈskrɪptˌraɪtəz
scrivener => 'skrivnә
scrod => skrɒd
scrofula => 'skrɒ:fjulә
scrofulous => 'skrɒ:fjulәs
scroll => skrәul
scroll saw => skrəʊl sɔ:
scrollable => 'skrəuləbl
scrolled => skrәuld
scrolling => 'skrәuliŋ
scrolls => skrəʊlz
scrollwork => 'skrәulwә:k
scrooch => skru:tʃ
scrooge => 'skru:dʒ
scrotal => 'skrәutl
scrotum => 'skrәutәm
scrotums => ˈskrəutəmz
scrounge => skraundʒ
scrounged => skraʊndʒd
scrounger => 'skraundʒə
scrounges => skraʊndʒz
scrounging => skraʊndʒɪŋ
scrub => skrʌb
scrub oak => skrʌb əuk
scrub up => skrʌb ʌp
scrubbed => sk'rʌbd
scrubber => 'skrʌbә
scrubby => 'skrʌbi
scrubland => 'skrʌblænd
scruff => skrʌf
scruffier => ˈskrʌfi:ə
scruffily => 'skrʌfili
scruffiness => 'skrʌfinis
scruffs => skrʌf
scruffy => 'skrʌfi
scrum => skrʌm
scrum half => skrʌm hɑ:f
scrumhalf => skru:m'hæf
scrummage => 'skrʌmidʒ
scrump => sk'rʌmp
scrumptious => 'skrʌmpʃәs
scrumpy => ˈskrʌmpi
scrums => skrʌmz
scrunch => skrʌntʃ
scrunched => skrʌntʃt
scrunches => skrʌntʃiz
scrunching => skrʌntʃɪŋ
scruple => 'skru:pl
scrupled => ˈskru:pəld
scruples => ˈskru:pəlz
scrupling => ˈskru:pəlɪŋ
scrupulosity => .skru:pju'lɒsiti
scrupulous => 'skru:pjulәs
scrupulousness => ˊskʌmpʃәsnis
scrutator => skru:'teitә
scrutineer => .skru:ti'niә
scrutinize => 'skrutinaiz
scrutinized => ˈskru:tnˌaɪzd
scrutinizes => ˈskru:tnˌaɪziz
scrutinizing => ˈskru:tnˌaɪzɪŋ
scrutiny => 'skru:tini
scry => skrai
scrying => skraɪ
scuba => 'skju:bә
scuba diving => ˈsku:bə ˈdaɪvɪŋ
scuba-diving => ˈsku:bə daɪvɪŋ
scud => skʌd
scudded => skʌdid
scudding => 'skʌdiŋ
scudo => s'ku:dəʊ
scuds => skʌdz
scuff => skʌf
scuffed => skʌft
scuffing => 'skʌfiŋ
scuffle => 'skʌfl
scuffled => ˈskʌfəld
scuffles => ˈskʌfəlz
scuffling => ˈskʌflɪŋ
scuffs => skʌfs
scull => skʌl
scullcap => 'skʌlkæp
sculled => skʌld
sculler => 'skʌlә
sculleries => ˈskʌləri:z
scullery => 'skʌlәri
sculling => 'skʌliŋ
scullion => 'skʌljәn
sculls => skʌlz
sculpin => 'skʌlpin
sculpins => 'skʌlpins
sculpt => skʌlpt
sculpted => skʌlptid
sculpting => skʌlptɪŋ
sculptor => 'skʌlptә
sculptors => ˈskʌlptəz
sculptress => 'skʌlptris
sculpts => skʌlpts
sculptural => 'skʌlptʃәrәl
sculpture => 'skʌlptʃә
sculptured => 'skʌlptʃәd
sculptures => ˈskʌlptʃəz
sculpturesque => ,skʌlptʃә'resk
sculpturing => 'skʌlptʃәriŋ
scum => skʌm
scumbag => ˈskʌmbæg
scumble => 'skʌmbl
scumbled => s'kʌmbled
scumbling => ˈskʌmblɪŋ
scummed => skʌmd
scummy => 'skʌmi
scums => skʌmz
scuncheon => 'skʌntʃәn
scunge => skʌndʒ
scungy => 'skʌndʒi
scunner => 'skʌnә
Scunthorpe => 'skʌnθɔ:p
scup => skʌp
scupper => 'skʌpә
scuppered => ˈskʌpəd
scuppering => ˈskʌpərɪŋ
scuppernong => 'skʌpәnɒ:ŋ
scuppers => ˈskʌpəz
scurf => skә:f
scurfy => 'skә:fi
scurried => ˈskɜ:ri:d
scurries => ˈskɜ:ri:z
scurrility => skә'riliti
scurrilous => 'skʌrilәs
scurrilously => 'skʌrələslɪ
scurry => 'skʌri
scurrying => ˈskɜ:ri:ɪŋ
scurvily => 'skә:vili
scurvy => 'skә:vi
scut => skʌt
scuta => 'skju:tә
scutage => 'skju:tidʒ
Scutari => 'sku:tәri, sku:'tɑ:ri
scutch => 'skʌtʃ
scutcheon => 'skʌtʃәn
scutcher => 'skʌtʃә
scute => skju:t
scutellum => skju:'telәm
scutter => 'skʌtә
scuttle => 'skʌtl
scuttlebutt => 'skʌtlbʌt
scuttled => s'kʌtld
scuttles => ˈskʌtlz
scuttling => 'skʌtliŋ
scutum => 'skju:tәm
scuzz => skʌz
scuzzball => s'kʌzbɔ:l
scuzzy => 'skʌzi
scylla => 'silә
scyphistoma => sai'fistәmә
Scyphozoa => ,saifә'zәuә
scyphozoan => ,saifә'zәuәn
scythe => saið
scythed => saɪðd
scythes => saɪðz
Scythia => 'siðiә, -θiә
Scythian => 'siðiәn, -θiәn
scything => saɪðɪŋ
sea => si:
sea bass => si: beɪs
sea boat => si: bəut
sea bream => si: bri:m
sea breeze => si: bri:z
sea change => si: tʃeindʒ
sea chest => si: tʃest
sea cow => si: kau
sea cucumber => si: ˈkju:kʌmbə
sea eagle => si: ˈi:ɡl
sea elephant => si: ˈelifənt
sea fan => si: fæn
sea grape => si: ɡreip
sea hare => si: heə
sea horse => 'si: hɔ:s
sea lane => si: lein
sea lavender => si: ˈlævəndə
sea lawyer => si: ˈlɔ:jə
sea lettuce => si: ˈletis
sea lily => si: ˈlili
sea mat => si: mæt
sea mouse => si: maus
sea otter => si: ˈɔtə
sea pen => si: pen
sea pink => si: piŋk
sea room => si: ru:m
sea serpent => si: ˈsɜ:pənt
sea snail => si: sneil
sea spider => si: ˈspaidə
sea squirt => si: skwɜ:t
sea star => si: stɑ:
sea trout => si: traʊt
sea turtle => si: ˈtə:tl
sea urchin => si: ˈɜ:tʃɪn
sea wall => si: wɔ:l
sea wolf => si: wulf
sea-horse => 'si:h'ɔ:s
sea-run => 'si:r'ʌn
seabag => 'si:bæɡ
seabed => 'si:bed
Seabee => 'si:bi:
seabird => 'si:bә:d
seabirds => ˈsi:bɜ:dz
seaboard => 'si:bɒ:d
Seaborg => 'si:bɔ:^
seaborgium => si:ˈbɔ:giəm
seaborne => 'si:bɒ:n
seacoast => 'si:kәust
seacock => 'si:kɒk
seafarer => 'si:.fєәrә
seafaring => 'si:.fєәriŋ
seafloor => 'si:flɔ:
seafood => 'si:fu:d
seafoods => 'si:fu:dz
seafront => 'si:frʌnt
seafronts => ˈsi:frʌnts
seagoing => 'si:.gәuiŋ
seagull => 'si:^ʌl
seagulls => ˈsi:gʌlz
seahorses => ˈsi:hɔ:siz
seakale => ˈsi:keɪl
seakeeping => 'si:.ki:piŋ
seal => si:l
sealable => si:ləbl
sealant => 'si:lәnt
sealants => 'si:lænts
sealed => si:ld
sealer => 'si:lә
sealift => 'si:lift
sealing => 'si:liŋ
seals => si:lz
sealskin => 'si:lskin
seam => si:m
seaman => 'si:mәn
seamanlike => 'si:mәnlaik
seamanly => 'si:mәnli
seamanship => 'si:mәnʃip
seamark => 'si:mɑ:k
seamed => si:md
seamer => 'si:mә
seamier => ˈsi:mi:ə
seaming => 'si:miŋ
seamless => 'si:mlis
seamlessly => 'si:mlisli
seamount => 'si:maunt
seams => si:mz
seamstress => 'si:mstris
seamstresses => ˈsi:mstrɪsiz
seamy => 'si:mi
sean => ʃɔ:n
seance => 'seiɒns
seances => ˈseɪɔŋsiz
seaplane => 'si:plein
seaplanes => ˈsi:ˌpleɪnz
seaport => 'si:pɒ:t
seaports => 'si:pɔ:ts
seaquake => 'si:kweik
sear => siә
search => sә:tʃ
searched => sə:tʃt
searcher => 'sә:tʃә
searchers => ˈsə:tʃəz
searching => 'sә:tʃiŋ
searchingly => 'sɜ:tʃɪŋlɪ
searchlight => 'sә:tʃlait
searchlights => ˈsɜ:tʃˌlaɪts
seared => sɪəd
searing => 'siәriŋ
seascape => 'si:skeip
seascapes => ˈsi:ˌskeɪps
seashell => 'si:ʃel
seashells => 'si:ʃelz
seashore => 'siʃɒ:
seashores => ˈsi:ˌʃɔ:z
seasick => 'si:sik
seasickness => 'si:,siknis
seaside => 'si:said
season => 'si:zn
seasonable => 'si:znәbl
seasonableness => ˊsiːznәblnis
seasonably => 'si:zənəblɪ
seasonal => 'si:znәl
seasonality => ˌsi:zəˈnæləti
seasoned => 'si:znd
seasoning => 'si:zniŋ
seat => si:t
seatbelts => si:tbelt
seater => 'si:tә
seating => 'si:tiŋ
seatmate => 'si:tmeit
SEATO => 'si:tәj
Seattle => si'ætl
seatwork => 'si:t,wә:k
Seaview => 'si:vju:
seaward => 'si:wәd
seawards => 'si:wәdz
seawater => 'si:.wɒtә
seaway => 'si:wei
seaweed => 'si:wi:d
seaweeds => 'si:wi:dz
seaworthiness => 'si:wә:ðinis
seaworthy => 'si:wә:ði
sebaceous => si'beiʃәs
sebaceous gland => siˈbeiʃəs ɡlænd
sebastian => si:'bæstjәn
Sebastopol => si'bæstәpɔl
seborrhoeic => ˌsebə'ri:ɪk
sebum => 'si:bәm
SEC => sek
SECAM => 'si:,kæm
secant => 'si:kәnt
secateur => 'sekәtә:
secateurs => .sekә'tә:
secco => 'sekәu
secede => si'si:d
seceded => sɪˈsi:did
seceder => si'si:dә(r)
secedes => sɪˈsi:dz
seceding => sɪˈsi:dɪŋ
secession => si'seʃәn
secessionism => si'seʃәnizәm
secessionist => si'seʃәnist
secessionists => siˈseʃənists
Seckel => 'sekәl
seclude => si'klu:d
secluded => si'klu:did
secludes => sɪˈklu:dz
secluding => sɪˈklu:dɪŋ
seclusion => si'klu:ʒәn
seclusive => si'klu:siv
second => 'sekәnd
second lieutenant => ˈsekənd lefˈtenənt
second name => ˈsekənd neim
second person => ˈsekənd ˈpə:sən
second string => ˈsekənd striŋ
second-generation => ˈsekənd ˌdʒenəˈreiʃən
second-hand => 'sekәnd'hænd
second-in-command => 'sekənd'ɪnkəm'ɑ:nd
second-rater => 'sekәnd'reitә(r)
second-sighted => 'sekәnd'saitid
secondarily => 'sekәndәrili
secondary => 'sekәndәri
secondary school => ˈsekəndəri sku:l
seconde => si'kɒnd
secondee => səˌkɒn'di:
seconder => 'sekәndә
seconders => 'sekəndə
secondhand => 'sekәnd'hænd
seconding => ˈsekəndɪŋ
secondly => 'sekәndli
secondment => si'kɔndmәnt
secondments => siˈkɔndmənts
secondo => se'kɒndəʊ
secrecy => 'si:krisi
secret => 'si:krit
secretagogue => si'kri:tә^ɔ^
secretaire => .sekrә'tєә
secretarial => .sekrә'tєәriәl
secretariat => .sekrә'tєәriәt
secretariats => ˌsekrɪˈteəri:ɪts
secretaries => ˈsekrətəriz
secretary => 'sekrәtәri
secretary bird => ˈsekrətəri bə:d
secretaryship => 'sekrәtәriʃip
secrete => si'kri:t
secreted => sɪˈkri:tid
secretes => sɪˈkri:ts
secretin => si'kri:tn
secreting => sɪˈkri:tɪŋ
secretion => si'kri:ʃәn
secretions => sɪˈkri:ʃənz
secretive => si'kri:tiv
secretly => 'si:kritli
secretor => si'kri:tә
secretory => si'kri:tәri
sect => sekt
sectarian => sek'tєәriәn
sectarianism => sek'tεәriәnizәm
sectarianize => sek'teәriәnaiz
sectaries => 'sektərɪ
sectary => 'sektәri
section => 'sekʃәn
sectional => 'sekʃәnl
sectionalism => 'sekʃ(ә)nәliz(ә)m
sectionalist => 'sekʃәnәlist
sectionalize => 'sekʃәnәlaiz
sectionally => 'sekʃənəlɪ
sectioned => ˈsekʃənd
sector => 'sektә
sectoral => 'sektərə
sectorial => sek'tɔ:riәl
secular => 'sekjulә
secularism => 'sekjulәrizm
secularist => 'sekjulәrist
secularity => .sekju'læriti
secularization => ,sekjulәrai'zeiʃәn
secularize => 'sekjulәraiz
secularized => ˈsekjuləraizd
secularizes => ˈsekjuləraiziz
secularizing => ˈsekjuləraizɪŋ
secund => 'si:kʌnd
securable => si'kjuәrәbl
secure => si'kjuә
securely => si'kjuәli
securement => si'kjuəmənt
secures => siˈkjuəz
securities => si'kjuәritis
securitization => sɪ'kjʊrətɪzeɪʃn
securitize => sɪk'jʊərɪtaɪz
security => si'kjuriti
security blanket => siˈkjuəriti ˈblæŋkit
sedan => si'dæn
sedan chair => sɪˈdæn tʃɛə
sedate => si'deit
sedated => sɪˈdeɪtid
sedately => sɪ'deɪtlɪ
sedateness => siˊdeitnis
sedates => sɪˈdeɪts
sedating => sɪˈdeɪtɪŋ
sedation => si'deiʃәn
sedative => 'sedәtiv
sedatives => 'sedətɪvz
sedentarily => 'sedntrəlɪ
sedentariness => 'sedntɑ:rɪnɪs
sedentary => 'sedәntәri
sederunt => si'diәrʌnt
sedge => sedʒ
sedges => 'sedʒɪz
Sedgwick => 'sedʒwik
sedgy => 'sedʒi
sedilia => se'dailiә
sediment => 'sedimәnt
sedimentary => .sedi'mentәri
sedimentation => .sedimen'teiʃәn
sedimented => 'sedɪm(ə)nt
sedimentological => sedɪməntɒ'lɒdʒɪkl
sedition => si'diʃәn
seditious => si'diʃәs
seditiously => siˊdiʃәsli
seduce => si'dju:s
seduced => siˈdju:st
seducer => si'dju:sә
seduces => siˈdju:siz
seducible => si'dju:sibl
seducing => siˈdju:sɪŋ
seduction => si'dʌkʃәn
seductions => sɪ'dʌkʃ(ə)n
seductive => si'dʌktiv
seductively => sɪ'dʌktɪvlɪ
seductress => si'dʌktris
sedulity => si'dju:liti
sedulous => 'sedjulәs
sedulously => 'sedjʊləslɪ
sedum => 'si:dәm
see => si:
see eye to eye => si: ai tu: ai
see-saw => ˈsi:ˌsɔ:
see-through => 'si:'θru:
seeable => 'si:әbl
seed => si:d
seed cake => si:d keik
seed coat => si:d kəut
seed fern => si:d fɜ:n
seed leaf => si:d li:f
seed money => si:d ˈmʌni
seed potato => si:d pəˈteitəu
seedbed => 'si:dbed
seedbeds => ˈsi:dbedz
seedcorn => 'si:dkɔ:n
seedeater => 'si:d,i:tә(r)
seeded => 'si:did
seeder => 'si:dә
seedier => ˈsi:di:ə
seedily => 'si:dili
seediness => 'sidɪnɪs
seeding => 'si:diŋ
seedless => 'si:dlis
seedling => 'si:dliŋ
seedlings => 'si:dɪŋz
seedpod => 'si:dpɔd
seedsman => 'si:dzmәn
seedy => 'si:di
seeing => 'si:iŋ
seek => si:k
seeker => 'si:kә
seekers => ˈsi:kəz
seeks => si:ks
seel => si:l
seeled => siːl
seely => 'si:li
seem => si:m
seeming => 'si:miŋ
seemingly => 'si:miŋli
seemliness => 'si:mlinis
seemly => 'si:mli
seems => si:mz
seen => si:n
seep => si:p
seepage => 'si:pidʒ
seeped => si:pt
seeping => si:pɪŋ
seeps => si:ps
seer => 'siә
seers => siəz
seersucker => 'siәsʌkә
seesaw => 'si:sɒ:
seesawed => ˈsi:ˌsɔ:d
seesawing => ˈsi:ˌsɔ:ɪŋ
seesaws => ˈsi:ˌsɔ:z
seethe => si:ð
seethed => si:ðd
seethes => si:ðz
seething => 'si:ðiŋ
segment => 'segmәnt
segmental => seg'mentl
segmentalize => se^'mentәlaiz
segmentary => 'se^mәntәri
segmentation => .segmәn'teiʃәn
segmented => seɡ'mentid. 'seɡmәntid
segregable => 'se^rә^әbl
segregate => 'segrigeit
segregates => ˈseɡriɡeits
segregating => 'segrɪˌgeɪtɪŋ
segregation => .segri'geiʃәn
segregationist => ,se^ri'^eiʃәnist
segregative => 'segrigeitiv
segue => 'se^wei, 'sei^wei
segued => ˈseɡweid
segueing => ˈseɡweiŋ
segues => ˈseɡweiz
seguidilla => ,se^ә'di(:)ljә
sei => sei. sai
sei whale => sei hweil
seicentist => sei'tʃentist
seicento => se'tʃentәu
seiche => seiʃ
seidel => 'saidәl
seif => seif, saif
seigneur => sei'njә:
seigneurial => sei'njəriəl; si:-
seigniorage => 'si:njәridʒ
seigniory => 'si:njәri
seine => sein
seined => 'seɪnd
seiner => 'seɪnər
seines => 'seɪnz
seining => 'seɪnɪŋ
seise => si:z
seisin => 'si:zin
seismic => 'saizmik
seismicity => saɪz'mɪsɪtɪ
seismo- => 'saizmәj,'sais-
seismogram => 'saizmәgræm
seismograph => 'saizmәgrɑ:f
seismographic => saizmә'^ræfik
seismographs => ˈsaizməɡrɑ:fs
seismological => .saizmә'lɒdʒikl
seismologist => saiz'mɒlәdʒist
seismology => saiz'mɒlәdʒi
seismometer => saiz'mɒmitә
seizable => 'si:zәbl
seize => si:z
seized => 'si:zd
seizer => 'si:zә
seizes => si:ziz
seizin => 'si:zin
seizing => 'si:ziŋ
seizure => 'si:ʒә
sejant => 'si:dʒәnt
Sejm => seim
selachian => si'leikiәn
seladang => si'lɑ:dɑ:ŋ
selaginella => ,selәdʒi'nelә,sә,lædʒi-
selah => 'si:lә,-lɑ:
Selangor => sә'læŋә(r)
seldom => 'seldәm
select => si'lekt
select committee => siˈlekt kəˈmiti
selected => si'lektid
selectee => si.lek'ti:
selection => si'lekʃәn
selectional => si'lekʃәnәl
selective => si'lektiv
selective service => sɪˈlektɪv ˈsɜːvɪs
selectivity => .silek'tiviti
selectman => si'lektmәn
selector => si'lektә
selectors => sɪ'lektəz
selenate => 'selәneit
selenide => 'selinaid
selenite => 'selinait
selenium => si'li:niәm
selenodont => si'li:nәdɔnt
selenographer => ,seli'nɔ^rәfә
selenographic => si,li:nә'^ræfik
selenography => .seli'nɒgrәfi
selenologist => ,seli'nɔlәdʒist,,si:li-
selenology => .seli'nɒlәdʒi
Seleucid => si'lu:sid
self => self
self-abandoned => ,selfә'bændәnd
self-abandonment => 'selfəb'ændənmənt
self-abasement => 'selfә'beismәnt
self-abnegation => 'selfәbni'^eiʃәn
self-absorbed => 'selfәb'sɔ:bd
self-absorption => 'selfәb'sɔ:pʃәn
self-abuse => 'selfә'bju:s
self-accusation => 'self,ækju:'zeiʃәn
self-acting => 'self'æktiŋ
self-actualization => ˈselfˌæktjuəlaiˈzeiʃən
self-addressed => 'selfә'drest
self-adhesive => ˌselfədˈhi:siv
self-adjusting => 'selfә'dʒʌstiŋ
self-advancement => 'selfәd'vɑ:nsmәnt
self-advertisement => 'selfədv'ɜ:tɪsmənt
self-affirmation => 'self,æfә(:)'meiʃәn
self-aggrandizement => 'selfә'^rændizmәnt
self-aggrandizing => ,selfə'ɡrændaiziŋ
self-analysis => 'selfә'nælisis
self-annihilation => 'selfənaɪə'leɪʃən
self-appointed => 'selfә'pɔintid
self-approval => ,selfә'pru:vәl
self-assemble => ,selfə'sembl
self-assembly => 'selfә'sembli
self-asserting => 'selfə'sə:tiŋ
self-assertion => 'selfә'sә:ʃәn
self-assertiveness => sɛlf əˈsɜːtɪvnəs
self-assessment => self əˈsesmənt
self-assurance => 'selfә'ʃuәrәns
self-assured => selfә'ʃjәd; (?@) -'ʃjәrd
self-aware => ˌselfəˈwɛə
self-awareness => ,selfә'weәnis
self-balancing => 'selfb'ælənsɪŋ
self-betrayal => 'selfbi'treiәl
self-builder => self'bild
self-catering => self ˈkeɪtərɪŋ
self-censorship => 'selfs'ensəʃɪp
self-cleaning => 'self'kli:niŋ
self-closing => 'selfkl'əʊzɪŋ
self-compatible => 'selfkәm'pætәbl
self-conceit => 'selfkәn'si:t
self-conceited => 'selfˌkən'si:tɪd
self-concept => ˌself'kɒnsept
self-condemnation => 'selfkɒndemn'eɪʃn
self-condemned => 'selfkәn'demd
self-confessed => 'selfkәn'fest
self-confidence => self'kɔnfid(ә)ns
self-confident => 'self'kɔnfidәnt
self-confidently => 'self'kɔnfidəntli
self-congratulation => 'selfkәn,^rætjj'leiʃәn,-,^rætʃә-
self-congratulatory => selfˌkənˈɡrætjuleitəri
self-conscious => 'self'kɔnʃәs
self-consciously => ˌselfˈkɔnʃəslɪ
self-consistent => 'selfkәn'sistәnt
self-contained => 'selfkәn'teind
self-containment => 'selfkənt'eɪnmənt
self-contempt => 'selfkәn'tempt
self-contemptuous => ,selfkәn'temptjjәs,-tʃjәs
self-contradiction => 'self,kɔntrә'dikʃәn
self-contradictory => 'self,kɔntrә'diktәri
self-control => 'selfkәn'trәul
self-controlled => self kənˈtrəuld
self-correcting => 'selfkә'rektiŋ
self-correction => 'selfkər'ekʃn
self-created => 'selfkri:'eɪtɪd
self-critical => 'self'kritikәl
self-criticism => ,self'kritisizәm
self-deceit => ,selfdi'si:t
self-deceiving => selfdi'si:viŋ
self-deception => 'selfdi'sepʃәn
self-deceptive => ,selfdi'septiv
self-defeating => 'selfdi'fi:tiŋ
self-defence => ,selfdi'fens
self-defensive => ,selfdi'fensiv
self-definition => 'selfdefɪn'ɪʃn
self-delusion => 'selfdi'lu:ʒәn
self-denial => 'selfdi'naiәl
self-denying => 'selfdi'naiiŋ
self-dependence => 'selfdi'pendәns
self-deprecating => ,self'deprikeitiŋ
self-depreciation => 'selfdɪpri:ʃɪ'eɪʃn
self-despair => 'selfdi'spεə
self-destruct => ˌselfdiˈstrʌkt
self-destruction => 'selfdis'trʌkʃәn
self-destructive => self disˈtrʌktiv
self-destructively => ,selfdi'strʌktiv
self-determination => 'selfdi,tә:mi'neiʃәn
self-development => .selfdi'velәpmәnt
self-devotion => 'selfdi'vәuʃәn
self-directed => ,selfdi'rektid
self-direction => 'selfdɪr'ekʃn
self-discipline => 'self'disiplin
self-disciplined => 'selfd'ɪsəplɪnd
self-discovery => ˌselfdɪˈskʌvəri:
self-doubt => 'self'daut
self-dramatization => 'selfdræmətaɪz'eɪʃn
self-educated => self'edjjkeitid
self-effacement => 'selfi'feismәnt
self-effacing => selfi'feisiŋ
self-employed => 'selfim'plɔid
self-employment => self imˈplɔimənt
self-esteem => 'selfis'ti:m
self-evaluation => 'selfɪvæljʊ'eɪʃn
self-evident => 'self'evidәnt
self-examination => 'self,i^zæmi'neiʃәn
self-excited => 'selfik'saitid
self-explanatory => selfik'splænәtәri
self-expression => 'selfiks'preʃәn
self-faced => 'self'feist
self-feeder => 'self'fi:dә
self-feeding => 'self'fi:diŋ
self-fertility => 'selffət'ɪlɪtɪ
self-financing => self'fainænsin, -'nænsiŋ
self-flagellation => ˈselfˌflædʒəˈleiʃən
self-flattering => 'self'flætəriŋ
self-flattery => 'selffl'ætərɪ
self-forgetful => 'selffә'^etful
self-fulfilling => ˌselffulˈfiliŋ
self-generating => 'self'dʒenәreitiŋ
self-glorification => 'self,^lɔrifi'keiʃәn
self-governed => ,self'^ʌvәnd
self-governing => 'self'^ʌvәniŋ
self-government => 'self'^ʌvәnmәnt
self-hatred => 'selfh'eɪtrɪd
self-heal => 'self'hi:l
self-help => 'self'help
self-identification => 'selfaɪdentɪfɪk'eɪʃn
self-identity => 'selfai'dentiti
self-image => 'self'imidʒ
self-immolation => 'self,imәj'leiʃәn
self-importance => 'selfim'pɔ:tәns
self-important => selfim'pɔ:tәnt
self-importantly => ˌselfɪmˈpɔːtəntlɪ
self-imposed => 'selfim'pәuzd
self-improvement => 'selfim'pru:vmәnt
self-incompatibility => 'selfɪnkəmpætəb'ɪlɪtɪ
self-incompatible => 'selfɪnkəmp'ætəbl
self-induced => selfin'dju:sd
self-induction => 'selfin'dʌkʃәn
self-indulgence => 'selfin'dʌldʒәns
self-indulgent => selfin'dʌldʒ(ә)nt
self-inflicted => 'selfin'fliktid
self-interest => 'self'intәrist
self-interested => ,self'intәristid
self-involved => ˌselfɪn'vɒlvd
self-involvement => 'selfɪnv'ɒlvmənt
self-justification => self,dʒʌstifi'keiʃәn
self-justifying => 'self'dʒʌstifaiiŋ
self-knowing => 'self'nəuiŋ
self-knowledge => 'self'nɔlәdʒ
self-limiting => 'selfl'ɪmɪtɪŋ
self-liquidating => 'self'likwideitiŋ
self-loader => 'self'lәudә
self-loading => ,self'lәjdiŋ
self-locking => self'lɔkiŋ
self-love => 'self'lʌv
self-made => 'self'meid
self-management => 'selfm'ænɪdʒmənt
self-mastery => 'self'mɑ:stәri
self-medicate => 'selfm'edɪkeɪt
self-medication => 'self ˌmedɪ'keɪʃən
self-mockery => ,self'mɔkәri
self-mocking => sɛlf'mɒkɪŋ
self-mortification => 'self,mɔ:tifi'keiʃən
self-motivated => self ˈməʊtɪveɪtɪd
self-motivation => self ,məuti'veiʃən
self-neglect => 'selfni'ɡlekt
self-obsessed => 'selfəbs'est
self-opinion => ,selfә'pinjәn
self-opinionated => selfә'pinjәneitid
self-parody => 'selfp'ærədɪ
self-perpetuating => 'selfpә'petjueitiŋ
self-perpetuation => 'selfpə,petʃu'eiʃən
self-pity => 'self'piti
self-pitying => self ˈpɪtɪɪŋ
self-policing => ,selfpə'li:siŋ
self-pollinated => 'selfp'ɒlɪneɪtɪd
self-pollination => selfpɔli'neiʃ(ә)n
self-portrait => 'self'pɔ:treit
self-possessed => 'selfpә'zest
self-possession => 'selfpә'zeʃәn
self-preservation => 'self,prezә'veiʃәn
self-proclaimed => 'selfprә'kleimd
self-promotion => ˌselfprəˈməʊʃən
self-propagating => 'selfpr'ɒpəɡeɪtɪŋ
self-propelled => 'selfprә'peld
self-propelling => 'selfprəp'elɪŋ
self-protection => 'selfprә'tekʃәn
self-rating => 'selfr'eɪtɪŋ
self-realization => 'self,riәlai'zeiʃәn
self-referential => ˌself refəˈrenʃl
self-reflection => 'selfri'flekʃәn
self-reflective => 'selfri'flektiv
self-regard => 'selfri'^ɑ:d
self-regarding => ,selfri'^ɑ:diŋ
self-regulating => 'self're^juleitiŋ
self-regulation => 'self,re^ju'leiʃәn
self-regulatory => 'selfr'eɡjʊlətərɪ
self-reliance => 'selfri'lains
self-reliant => selfri'laiәnt
self-renewal => 'selfrɪnj'u:əl
self-report => 'selfrɪp'ɔ:t
self-reproach => 'selfri'prәutʃ
self-respect => 'selfris'pekt
self-respecting => selfris'pektiŋ
self-restraint => 'selfris'treint
self-revealing => 'selfri'vi:liŋ
self-revelation => 'self,revi'leiʃәn
self-righteous => 'self'raitʃәs
self-righteousness => ,self'raitʃəsnis
self-righting => 'self'raitiŋ
self-rising flour => ˈselfˈraɪzɪŋ
self-rule => self'ru:l
self-sacrifice => 'self'sækrifais
self-satisfaction => 'self,sætis'fækʃәn
self-satisfied => 'self'sætisfaid
self-sealing => 'self'si:liŋ
self-seed => 'selfs'i:d
self-seeker => 'self'si:kә
self-seeking => 'self'si:kiŋ
self-selection => 'selfsi'lekʃәn
self-service => 'self'sә:vis
self-serving => 'self'sә:viŋ
self-similar => ,self'similə
self-similarity => 'selfsɪməl'ærɪtɪ
self-sow => 'self'sәu
self-starter => self'stɑ:tә(r)
self-starting => 'selfst'ɑ:tɪŋ
self-sterility => 'selfstər'ɪlɪtɪ
self-stimulation => 'selfstɪmjʊl'eɪʃən
self-styled => 'self'staild
self-subsistent => 'selfsəb'sistənt
self-sufficiency => ,selfsә'fiʃәnsi
self-sufficient => 'selfsә'fiʃәnt
self-suggestion => 'selfsә'dʒestʃәn
self-support => 'selfsә'pɔ:t
self-supporting => 'selfsә'pɔ:tiŋ
self-surrender => 'selfsә'rendә
self-sustaining => selfsәs'teiniŋ
self-tapping => 'selft'æpɪŋ
self-taught => self'tɔ:t
self-timer => 'self'taimә
self-will => 'self'wil
self-willed => 'selfwild
self-winding => 'self'waindiŋ
selfhood => 'selfhud
selfish => 'selfiʃ
selfishly => 'selfiʃli
selfishness => 'selfiʃnis
selfless => 'selflis
selflessly => 'selfləslɪ
selfsame => 'selfseim
Seljuk => sel'dʒju:k
Selkirk => 'selkə:k
sell => sel
sell-by date => sel bai deit
sell-outs => 'selaut
sell-through => sel θru:
sellable => 'selәbl
seller => 'selә
selling => 'seliŋ
selling point => ˈseliŋ pɔint
selling race => ˈseliŋ reis
sellout => 'selaut
seltzer => 'seltsә
selva => 'selvә
selvage => 'selvidʒ
selvedge => 'selvidʒ
selves => selvz
selwyn => 'selwin
semanteme => si'mænti:m
semantic => si'mæntik
semantic field => siˈmæntik fi:ld
semanticist => si'mæntisist
semantics => si'mæntiks
semaphore => 'semәfɒ:
semaphored => ˈseməˌfɔ:d
semaphores => ˈseməˌfɔ:z
semaphoric => ,semә'fɔrik,-'fɔ:-
semaphoring => ˈseməˌfɔ:ɪŋ
Semarang => sә'mɑ:rɑ:ŋ
semasiology => si,meisi'ɔlәdʒi
semblable => 'semblәbl
semblance => 'semblәns
seme => 'semei
Semele => 'semili
sememe => 'semi:m
semen => 'si:mәn
semester => si'mestә
semesters => siˈmestəz
semi => 'semi
semi-annual => 'semɪ'ænjʊəl
semi-autonomous => 'semɪɔ:t'ɒnəməs
semi-detached => ˈsemi dɪˈtætʃt
semi-final => ˈsemi:ˌfaɪnəl, ˈsemaɪ-
semi-finalist => ˈsemi ˈfaɪnəlɪst
semi-finals => 'semɪf'aɪnlz
semi-liquid => 'semɪl'ɪkwɪd
semi-opaque => 'semɪəʊp'eɪk
semi-permanent => 'semɪp'ɜ:mənənt
semi-precious => ˈsemi ˈpreʃəs
semi-professional => ˈsemi prəˈfeʃənəl
semi-skilled => ˈsemi skild
semi-tropical => ˈsemi ˈtrɔpikəl
semiannually => ˌsemɪ'ænjʊəlɪ
semiaquatic => 'semiә'kwætik
semiautomatic => 'semi.ɒ:tә'mætik
semibold => ,semi'bәjld,,semai-
semibreve => 'semibri:v
semibreves => ˈsemibri:vz
semicircle => 'semi.sә:kl
semicircles => ˈsemɪˌsɜ:kəlz
semicircular => .semi'sә:kjulә
semiclassical => ,semi'klæsikәl,,semai-
semicolon => 'semi.kәulәn
semiconducting => ,semikәn'dʌktiŋ,,semai-
semiconductor => .semikәn'dʌktә
semiconductors => semɪkən'dʌktəz
semidemisemiquaver => 'semi,demi'semi,kweivә(r),'semai-
semidiameter => .semidai'æmitә
semifinal => .semi'fainl
semifinalist => .semi'fainәlist
semifinals => semɪ'faɪnlz
semiformal => .semi'fɒ:ml
semilethal => ,semi'li:θәl,,semai-
semilunar => .semi'lu:nә
semilunar cartilage => ˈsemiˈlju:nə ˈkɑ:tlɪdʒ
semimetal => 'semi'metl
semimetallic => semɪme'təlɪk
seminal => 'seminl
seminar => 'seminɑ:
seminarian => .semi'nєәriәn
seminaries => ˈseməˌneri:z
seminarist => 'seminәrist
seminars => 'semɪnɑ:z
seminary => 'seminәri
seminiferous => .semi'nifәrәs
semiochemical => ,semiәu'kemikәl
semiologist => si:mi':əʊlədʒɪst
semiology => .semi'ɒlәdʒi
semiosis => ,si:mi'әjsis,-mai-,,semi-,,semai-
semiotic => .semi'ɒtik
semiotics => .semi'ɒtiks
semipalmated => semɪ'pælmɪtɪd
semipermeable => .semi'pә:miәbl
semiprecious => .semi'preʃәs
semiquaver => 'semi.kweivә
semiquavers => 'semɪ,kweɪvə
Semiramis => se'mirәmis,si-
semis => 'semis
Semitic => si'mitik, se'm-
semitone => 'semitәun
semitones => ˈsemitəunz
semitropical => .semi'trɒpikl
semivowel => .semi'vauәl
semiweekly => 'semi'wi:kli
semmit => 'semit
semolina => .semә'li:nә
sempervivum => ,sempә'vaivәm
sempiternal => .sempi'tә:nl
Semple => 'sempl
semplice => 'semplitʃi
sempre => 'sempri
sempstress => 'sempstris
Semtex => 'semteks
SEN => sen
senarius => si'neәriәs,-'næ-
senary => 'senәri
senate => 'senit
senator => 'senәtә
senatorial => .senә'tɒ:riәl
senators => ˈsenətəz
senatorship => 'senәtәʃip
send => send
send a message => send ə ˈmesidʒ
Sendai => 'sen'dai
sendal => 'sendl
sended => send
sender => 'sendә
senders => ˈsendəz
sending => 'sendiŋ
sene => si:n
seneca => 'senikә
senecio => si'ni:ʃiәj,-si-
Senegal => ,seni'^ɔ:l
Senegalese => 'seni^әli:z
Senegambia => ,senə'ɡæmbiə
senesce => si'nes
senescence => si'nesns
senescent => si'nesnt
seneschal => 'seniʃәl
senhor => si'njɔ:r
senhora => si'njɔ:rә
senhorita => ,sinjɔ:'ri:tә
senile => 'si:nail
senility => si'niliti
senior => 'si:njә
seniority => .si:ni'ɒriti
seniti => 'senәti(:)
senna => 'senә
Sennacherib => sə'nækərib
sennet => 'senit
sennight => 'senait
sennit => 'senit
Senor => se'njɔː
sensate => 'senseit
sensation => sen'seiʃәn
sensational => sen'seiʃәnl
sensationalism => sen'seiʃәnәliz(ә)m
sensationalist => sen'seiʃənәlist
sensationalize => sen'seiʃәn,laiz
sensationalized => senˈseiʃənˌlaizd
sensations => senˈseiʃənz
sense => sens
sense datum => sens ˈdeɪtəm
sensei => sen'seɪ
senseless => 'senslis
senselessly => 'senslisli
sensibilities => ˌsensəˈbɪlɪti:z
sensibility => .sensi'biliti
sensible => 'sensәbl
sensibly => 'sensәbli
sensillum => 'sensiliәm
sensing => 'sensiŋ
sensitise => 'sensitaiz
sensitised => 'sensitaiz
sensitising => sen'sɪtɪsɪŋ
sensitive => 'sensitiv
sensitivities => ˌsensɪˈtɪvɪti:z
sensitivity => .sensә'tiviti
sensitization => .sensitai'zeiʃәn
sensitize => 'sensitaiz
sensitized => 'sensitaizd
sensitizer => 'sensi,taizә
sensitizes => ˈsensitaiziz
sensitizing => 'sensitaiziŋ
sensitometer => ,sensi'tɔmitә
sensor => 'sensә
sensorial => sen'sɔ:riәl
sensorimotor => ,sensәri'mәutә
sensorineural => ,sensəri'njjәrəl
sensorium => sen'sɒ:riәm
sensory => 'sensәri
sensory deprivation => ˈsensəri: ˌdeprəˈveɪʃən
sensual => 'senʃuәl
sensualism => 'senʃuәlizm
sensualist => 'senʃuәlist
sensuality => ,sensju'æliti
sensualize => 'senʃuәlaiz
sensually => ˌsenʃʊəlɪ
sensum => 'sensәm
sensuous => 'senʃuәs
sensuously => 'senʃʊəslɪ
sensuousness => 'senʃʊəsnəs
sent => sent
sente => 'senti:
sentence => 'sentәns
sentence adverb => ˈsentəns ˈædvə:b
sentenced => ˈsentənst
sentencer => 'sentənsə
sentences => ˈsentənsiz
sentential => sen'tenʃәl
sententious => sen'tenʃәs
sententiously => sen'tenʃəslɪ
sententiousness => senˊtenʃәsnis
sentience => 'senʃәns
sentient => 'senʃәnt
sentiment => 'sentimәnt
sentimental => .senti'mentl
sentimentalise => ,senti'mentəlaz
sentimentalism => ,senti'mentəlizəm
sentimentalist => senti'mentәlist
sentimentality => .sentimen'tæliti
sentimentalization => ,sentimentəlai'zeiʃən; -li'z-
sentimentalize => .senti'mentәlaiz
sentimentalized => ˌsentiˈmentəlaizd
sentimentalizes => ˌsentiˈmentəlaiziz
sentimentalizing => ˌsentiˈmentəlaizɪŋ
sentimentally => ˌsentɪ'mentəlɪ
sentiments => 'sentɪmənts
sentinel => 'sentinl
sentinelled => 'sentɪn(ə)l
sentinels => ˈsentənəlz
sentries => ˈsentriz
sentry => 'sentri
Senussi => si'nu:si
Seoul => sәul
sepal => 'si:pl
separability => .sepәrә'biliti
separable => 'sepәrәbl
separableness => se'pərəblnɪs
separably => se'pərəblɪ
separate => 'sepәreit
separated => 'sepәreitid
separately => 'sepәrәtli
separateness => 'sepәritnis
separates => ˈseprəts
separating => 'sepәreitiŋ
separation => .sepә'reiʃәn
separation anxiety => ˌsepəˈreɪʃən ænˈzaiəti
separations => sepə'reɪʃnz
separatism => 'sepәrәtizm
separatist => 'sepәreitist
separatists => ˈsepəreitists
separative => 'sepәreitiv
separator => 'sepәreitә
Sephadex => 'sefәdeks
Sephardi => se'fɑ:di
Sephardic => si'fɑ:dik
sepia => 'si:pjә
sepias => ˈsi:pjəz
sepoy => 'si:pɒi
seppuku => se'pu:ku:
seps => seps
sepsis => 'sepsis
sept => sept
sept- => sept
septa => 'septә
septal => 'septl
septarian => sep'tæriәn
septarium => sep'teәriәm
septate => 'septeit
septation => sep'teiʃәn
September => sep'tembә
septenarius => ,septi'neәriәs
septenary => sep'ti:nәri
septennial => sep'tenjәl
septennium => sep'teniәm
septet => sep'tet
septi- => 'septi
septic => 'septik
septicaemic => ,septi'si:mik
septicemia => ,septi'si:miә
septicity => sep'tisiti
septillion => sep'tiljәn
septimal => 'septimәl
septime => 'septi:m
Septimus => 'septimәs
septivalent => ,septi'veilәnt
septuagenarian => septjjәdʒi'neәriәn
septuagenarians => septjuədʒiˈneəriənz
Septuagesima => ,septjuә'dʒesimә
Septuagint => 'septjuәdʒint
septum => 'septәm
septuple => sep'tjupl
septuplet => sep'tʌplit
sepulcher => 'seplkә
sepulchral => si'pʌkrәl
sepulchre => 'sepәlkә
sepulchres => ˈsepəlkəz
sepulture => 'sepәltʃә
sequacious => si'kweiʃәs
sequacity => si'kwæsiti
sequel => 'si:kwәl
sequela => si'kwi:lә
sequels => ˈsi:kwəlz
sequence => 'si:kwәns
sequencer => 'si:kwәnsә
sequences => ˈsi:kwənsiz
sequencing => 'si:kwәnsiŋ
sequent => 'si:kwәnt
sequential => si'kwenʃәl
sequentially => si'kwenʃәli
sequester => si'kwestә
sequestered => si'kwestәd
sequestering => sɪˈkwestərɪŋ
sequesters => sɪˈkwestəz
sequestrable => si'kwestrәbl
sequestral => si'kwestrәl
sequestrate => si'kwestreit
sequestrated => ˈsi:kwɪˌstreɪtid
sequestrates => ˈsi:kwɪˌstreɪts
sequestrating => ˈsi:kwɪˌstreɪtɪŋ
sequestration => ,si:kwe'streiʃən,,si:kwә-,,se-,si,kwe-
sequestrator => 'si:kwestreitә
sequestrectomy => ,si:kwes'trektәmi
sequestrum => si'kwestrәm
sequin => 'si:kwin
sequined => 'si:kwind
sequinned => 'si:kwɪnd
sequins => ˈsi:kwɪnz
sequoia => si'kwɔiә
sera => 'siәrә
serac => sә'ræk
seraglio => se'rɑ:liәu
serai => sә'rai
serang => sә'ræŋ
serape => se'rɑ:pi
seraph => 'serәf
seraphic => sә'ræfik
seraphim => 'serәfim
Serapis => 'serәpis,sә'rei-
seraskier => ,serәs'kiә
Serb => sә:b
serbia => 'sә:bjә
serbian => 'sә:bjәn
Sercial => ,sersi'æl
sere => siә
Seremban => sә'rembәn
Serena => sә'ri:nә
serenade => 'serineid
serenaded => ˌserəˈneɪdid
serenades => ˌserəˈneɪdz
serenading => ˌserəˈneɪdɪŋ
serenata => seri'nɑ:tә
serendipitous => ,serәn'dipitәs
serendipity => ,serәn'dipiti
serene => si'ri:n
serenely => sə'ri:nlɪ
Serengeti => ,serən'ɡeti
serenity => si'reniti
serf => sә:f
serfage => 'sә:fidʒ
serfdom => 'sә:fdәm
serfs => sɜ:fs
serge => sә:dʒ
sergeancy => 'sɑ:dʒәnsi
sergeant => 'sɑ:dʒәnt
sergeant major => ˈsɑ:dʒənt ˈmeidʒə
sergeants => 'sɑ:dʒənts
Sergipe => sə'dʒi:pə
serial => 'siәriәl
serial killer => ˈsiəriəl ˈkɪlə
serial monogamy => ˈsiəriəl məˈnɔgəmi:
serialisation => ,siәriәlai'zeiʃən;-li'z-
serialise => 'siәriәlaiz
serialism => 'siәriәlizm
seriality => 'sɪərɪəlɪtɪ
serialization => .siәriәlai'zeiʃәn
serialize => 'siәriәlaiz
serialized => ˈsɪəri:əˌlaɪzd
serializes => ˈsɪəri:əˌlaɪziz
serializing => ˈsɪəri:əˌlaɪzɪŋ
seriate => 'siәrieit
seriatim => ,siәri'eitim
seriation => ,siәri'eiʃən,,ser-
sericite => 'serisait
sericultural => ,seri'kʌltʃәrәl
sericulture => 'seri,kʌltʃә(r)
sericulturist => ,seri'kʌltʃәrist
seriema => ,seri'i:mә, -'eimә
series => 'siәri:z
serif => 'serif
seriffed => 'serɪf
serigraph => 'serigrɑ:f
serigrapher => si'ri^rәfә
serigraphy => sә'rigrәfi
serin => 'serin
serine => 'seri:n, 'siәr-
serio-comic => sɪəri':əʊk'ɒmɪk
serious => 'siәriәs
seriously => 'siәriәsli
seriousness => 'siәriәsnis
serjeant => 'sɑ:dʒәnt
serjeant-at-law => sɑ:d'ʒənt'ætl'ɔ:
serjeanty => 'sɑ:dʒənti
sermon => 'sә:mәn
sermonic => sә:'mɒnik
sermonize => 'sә:mәnaiz
sermonized => ˈsɜ:məˌnaɪzd
sermonizes => ˈsɜ:məˌnaɪziz
sermonizing => ˈsɜ:məˌnaɪzɪŋ
sermons => ˈsə:mənz
serodiagnosis => ,siәrәu,daiә^'nәusis
serologic => ,siәrә'lɔdʒik
serological => .siәrә'lɒdʒikl
serology => siә'rɒlәdʒi
seronegative => ,siәrәu'ne^әtiv
seropositive => ,siәrәu'pɔzitiv
seroprevalence => serɒp'revələns
serosa => si'rәusә,-zә
serositis => ,siәrәu'saitis
serosity => siә'rɒsiti
serotine => 'seәrәtin, -tain
serotonin => .siәrәu'tәunin
serotype => 'siәrәtaip
serous => 'siәrәs
serous membrane => ˈsiərəs ˈmemˌbreɪn
serow => 'serәu
serp => 'sɜ:p
Serpens => 'sә:penz
serpent => 'sә:pәnt
serpentine => 'sә:pәntain
serpentinite => ,sәpәn'ti:nait
serpentinize => ,sә:pәn'ti:naiz
serpents => ˈsɜ:pənts
serpiginous => sә:'pidʒinәs
serpulid => 'sә:pju:lid
serra => 'serә
serranid => 'serәnid,sә'rænid
serrate => 'serit
serrated => se'reitid
serration => se'reiʃәn
serried => 'serid
serum => 'siәrәm
serum hepatitis => ˈsɪərəm ˌhepəˈtaɪtɪs
serval => 'sә:vl
servant => 'sә:vәnt
servants => 'sɜ:vənts
serve => sә:v
server => 'sә:vә
servery => 'sә:vәri
serves => sə:vz
service => 'sә:vis
service ceiling => ˈsɜːvɪs ˈsi:liŋ
service industry => ˈsɜːvɪs ˈindəstri
service module => ˈsɜːvɪs ˈmɔdju:l
service tree => ˈsɜːvɪs tri:
serviceability => ,sә:visә'biliti
serviceable => 'sә:visәbl
serviceably => ˊsәːvisәbli
serviceberry => 'sɜ:vɪsberɪ
servicer => 'sә:visә
servicewoman => ˈsɜ:vɪsmən
servicing => 'sә:visiŋ
serviette => ,sә:vi'et
serviettes => ˌsɜ:vi:ˈets
servile => 'sә:vail
servility => sә:'viliti
serving => 'sә:viŋ
servitor => 'sә:vitә
servitude => 'sә:vitju:d
servo => 'sә:vәu
servomechanism => .sә:vәu'mekәnizm
servomotor => 'sә:vәu.mәutә
sesame => 'sesәmi
sesame seed => ˈsesəmi si:d
sesamoid => 'sesәmɒid
Sesotho => si'su:tj
sesqui- => 'seski:
sesquialtera => seskwi'ɔ:ltәrә
sesquicentenary => ,seskwisen'ti:nәri,-'ten-
sesquicentennial => ,seskwisen'teniәl
sesquioxide => ,seskwi'ɔksaid
sesquipedalian => .seskwipi'deiliәn
sesquiterpene => ,seskwi'tә:pi:n
sess => ses
sessile => 'sesail
session => 'seʃәn
sessional => 'seʃәnl
sestet => 'sestet
sestina => ses'ti:nә
set => set
set phrase => set freiz
set piece => set pi:s
set shot => set ʃɔt
set-top box => set tɔp bɔks
seta => 'si:tә
setaceous => si'teiʃәs
setback => 'setbæk
setbacks => 'setbæks
seth => seθ
seton => 'si:tn
setose => 'si:tәus
sett => set
settee => se'ti:
settees => seˈti:z
setter => 'setә
setters => 'setəz
setting => 'setiŋ
settle => 'setl
settleable => 'setlәbl
settled => 'setld
settlement => 'setlmәnt
settlement house => ˈsetlmənt haus
settlements => 'setlmənts
settler => 'setlә
settlers => 'setləz
settles => ˈsetlz
settling => 'setliŋ
settlor => 'setlә
setup => 'setʌp
setups => 'setʌps
Sevastopol => si'væstәpl
seven => 'sevn
sevens => 'sevnz
seventeen => sevn'ti:n
seventeenth => sevn'ti:nθ
seventh => 'sevnθ
seventhly => 'sevәnθli
seventies => 'sevntɪz
seventieth => 'sevntiiθ
seventy => 'sevnti
sever => 'sevә
several => 'sevәrәl
severally => 'sevәrәli
severalty => 'sevәrәlti
severance => 'sevәrәns
severe => si'viә
severely => si'viәli
severer => siˈviəə
severing => ˈsevərɪŋ
severities => səˈverɪti:z
severity => si'veriti
severn => 'sevәn
severs => ˈsevəz
severy => 'sevәri
seviche => 'seviki
Sevin => 'sevin
sew => sәu
sewage => 'sju:idʒ
sewen => 'su:in
sewer => 'su:ә
sewer rat => ˈsu:ə ræt
sewerage => 'su:әridʒ
sewers => s'ju:əz
sewin => 'sju:in
sewing => 'sәuiŋ
sewn => sәun
sews => səuz
sex => seks
sex act => seks ækt
sex change => seks tʃeindʒ
sex chromosome => seks ˈkrəʊməˌsəʊm
sex crime => seks kraim
sex drive => seks draiv
sex life => seks laif
sex maniac => seks ˈmeɪni:ˌæk
sex object => seks ˈɔbdʒikt
sex offender => seks əˈfendə
sex organ => seks ˈɔ:ɡən
sex symbol => seks ˈsimbəl
sex typing => seks ˈtaɪpɪŋ
sex worker => seks ˈwə:kə
sex- => seks
sex-linked => 'seksliŋkt
sex-starved => 'seksst'ɑ:vd
sexagenarian => .seksәdʒi'nєәriәn
Sexagesima => ,seksә'dʒesimә
sexagesimal => .seksә'dʒesiml
sexcapade => 'sekskәpeid
sexcentenary => ,sekssen'ti:nәri
sexed => sekst
sexennial => seks'eniәl
sexennium => seks'eniәm
sexfoil => 'seksfɒil
sexily => 'seksili
sexiness => 'seksinis
sexism => 'seksizm
sexist => 'seksist
sexists => ˈseksists
sexivalent => 'seksi,veilәnt
sexless => 'sekslis
sexologist => sek'sɒlәdʒist
sexology => sek'sɒlәdʒi
sexpartite => seks'pɑ:tait
sexpert => 'sekspɜ:t
sexploitation => , seksplɔi'teiʃәn
sexpot => 'sekspɒt
sext => sekst
sextant => 'sekstәnt
sextants => ˈsekstənts
sextet => seks'tet
sextets => seksˈtets
sextile => 'sekstail
sextillion => seks'tiljәn
sextodecimo => .sekstәu'desimәu
sexton => 'sekstәn
sextons => ˈsekstənz
sextuple => 'sekstjupl
sextuplet => seks'tju:plit
sexual => 'sekʃuәl
sexual harassment => ˈseksjuəl ˈhærəsmənt
sexual intercourse => ˈseksjuəl ˈintəkɔ:s
sexual orientation => ˈsɛkʃuəl ˌɔriɛnˈteʃən
sexual relations => ˈseksjuəl riˈleiʃənz
sexuality => .sekʃu'æliti
sexualization => ,sɛʃʊəlaɪ'zeʃən
sexualize => 'sekʃuәlaiz
sexualized => 'seksjʊəlaɪz; 'sekʃʊəlaɪz
sexy => 'seksi
Seychelles => sei'ʃelz
seymour => 'si:mɔ:, 'seimɔ:
sez => 'se
Sfax => sfæks
sforzando => sfɔ:'tsændәu
sfz => 'es'efz'i:
sgd => 'esdʒ'i:d'i:
sgraffito => skræ'fi:tәu
sh => ʃ
Shaanxi => 'ʃæn'ʃi:
Shaba => 'ʃɑ:bә
shabbier => ˈʃæbiə
shabbily => 'ʃæbili
shabbiness => 'ʃæbinis
shabby => 'ʃæbi
shabrack => 'ʃæbræk
shack => ʃæk
shackle => 'ʃækl
shackled => ˈʃækəld
Shackleton => 'ʃækltәn
shackling => ˈʃækəlɪŋ
shad => ʃæd
shadbush => 'ʃædbuʃ
shadchan => 'ʃɑ:dhәn
shaddock => 'ʃædәk
shaddup => ʃʌ'dʌp
shade => ʃeid
shadeless => 'ʃeidlis
shadier => ˈʃeɪdi:ə
shadily => 'ʃeidili
shadiness => 'ʃeidinis
shading => 'ʃeidiŋ
shadoof => ʃɑ:'du:f, ʃә'du:f
shadow => 'ʃædәu
shadowgraph => 'ʃædәugrɑ:f
shadowiness => 'ʃædәuinis
shadowland => 'ʃædәulænd
shadowless => 'ʃædәulis
shadowy => 'ʃædәui
shady => 'ʃeidi
shaft => ʃæft
shaft-driven => 'ʃɑ:ftdr'ɪvn
shafted => 'ʃɑ:ftɪd
Shaftesbury => 'ʃɑ:ftsbәri
shafting => 'ʃæftiŋ
shafts => ʃɑ:fts
shag => ʃæg
shagged => 'ʃæ^id
shaggier => ˈʃægi:ə
shagginess => 'ʃæginis
shaggy => 'ʃægi
shagreen => ʃæ'gri:n
shags => ʃæɡz
shah => ʃɑ:
shahada => ʃɑ:'hɑ:də
shahdom => 'ʃədəm
shaitan => ʃai'tɑ:n
shake => ʃeik
shake-up => 'ʃeik'ʌp
shakedown => 'ʃeikdaun
shaken => 'ʃeikәn
shakeout => 'ʃeik,aut
shaker => 'ʃeikә
Shakeress => 'ʃeikәris
shakers => 'ʃeɪkəz
Shakespeare => 'ʃeik.spiә
Shakespearean => ʃeik'spiәriәn
shakeup => 'ʃeikʌp
Shakhty => 'ʃɑ:hti
shakier => ˈʃeɪki:ə
shakily => 'ʃeikili
shakiness => 'ʃeikinis
shaking => 'ʃeikiŋ
shako => 'ʃækәu
shakuhachi => ,ʃɑ:kә'hɑ:tʃi
shaky => 'ʃeiki
shale => ʃeil
shall => ʃæl
shallop => 'ʃælәp
shallot => ʃә'lɒt
shallots => ʃəˈlɔts
shallow => 'ʃælәu
shallowly => ˈʃæləʊlɪ
shallowness => 'ʃæləunis
shallows => ˈʃæləʊz
shalom => ʃә'lәum
shalt => ʃælt;ʃәlt;ʃilt
shalwar => 'ʃɑ:lwɑ:
shaly => 'ʃeili
sham => ʃæm
shama => 'ʃɑ:mə
shamal => ʃә'mɑ:l
shaman => 'ʃæmәn
shamanism => 'ʃæmәnizәm,'ʃɑ:-
shamanize => 'ʃæmәnaiz,'ʃɑ:-
shamateur => 'ʃæmәtә:
shamateurism => 'ʃæmətʃərɪzəm
shamba => 'ʃæmbә
shamble => 'ʃæmbl
shambled => ˈʃæmbəld
shambles => 'ʃæmblz
shambolic => ʃæm'bɒlik
shame => ʃeim
shamed => ʃeimd
shamefaced => 'ʃeimfeist
shamefacedly => ˌʃeɪm'feɪsɪdlɪ
shameful => 'ʃeimful
shamefulness => ˊʃeimfulnis
shameless => 'ʃeimlis
shamelessly => 'ʃeimlisli
shames => ʃeimz
shaming => ˈʃeɪmɪŋ
shammed => ʃæmd
shammer => 'ʃæmә
shamming => ʃæmɪŋ
shammy => 'ʃæmi
shampoo => ʃæm'pu:
shampooed => ʃæmˈpu:d
shampooing => ʃæm'pu:ɪŋ
shampoos => ʃæmˈpu:z
shamrock => 'ʃæmrɒk
shamrocks => ˈʃæmrɔks
shams => ʃæmz
shamus => 'ʃeimәs
Shan => ʃɑ:n, ʃæn
shandies => ˈʃændiz
Shandong => 'ʃæn'djŋ
shandy => 'ʃændi
shane => ʃein
Shanghai => 'ʃæŋhai
shanghaiing => ,ʃæŋ'haɪ
shank => ʃæŋk
shanked => 'ʃæŋkt
shanking => 'ʃæŋkɪŋ
shannies => 'ʃænɪ
shanny => 'ʃæni
Shansi => 'ʃæn'si:, 'ʃæn'ʃi:
Shanti => 'ʃɑ:nti
shanties => ˈʃænti:z
Shantou => 'ʃɑ:n'tәj
Shantung => ʃæn'tʌŋ
shanty => 'ʃænti
shanty town => ˈʃænti: taun
shantyman => 'ʃæntimæn
shantytown => 'ʃæntitaun
shapable => 'ʃeipәbl
shape => ʃeip
shaped => ʃeipt
shaped charge => ʃeɪpt tʃɑ:dʒ
shapeless => 'ʃeiplis
shapelessly => 'ʃeɪpləslɪ
shapeliness => 'ʃeiplinis
shapely => 'ʃeipli
shaper => 'ʃeipә
shapewear => ʃeɪp'wɜ:r
shaping => 'ʃeipiŋ
shapiro => ʃә'pirәu
shapka => 'ʃæpkɑ:
shard => ʃɑ:d
shards => ʃɑ:dz
share => ʃєә
share index => ʃɛə ˈindeks
share-cropper => 'ʃɛrkrɑpɚ
shareable => 'ʃeәrәbl
sharecrop => 'ʃєәkrɒp
sharecropper => 'ʃєә.krɒpә
shared => ʃεәd
shareholder => 'ʃєә.hәuldә
shareholders => 'ʃeəhəʊldəz
shareholding => 'ʃεә.hәuldiŋ
shareholdings => ˈʃeəˌhəuldiŋz
shareowner => 'ʃeəəʊnər
sharer => 'ʃєәrә
sharia => ʃә'ri:ә
Sharif => ʃɑ:'ri:f
sharing => 'ʃeәriŋ
Sharjah => 'ʃɑ:dʒə
shark => ʃɑ:k
sharks => ʃɑ:ks
sharkskin => 'ʃɑ:kskin
sharp => ʃɑ:p
sharp-eared => 'ʃɑ:p'iәd
sharp-eyed => 'ʃɑ:p'aid
sharp-set => 'ʃɑ:p'set
sharp-tongued => 'ʃɑ:p'tʌŋd
Sharpe => 'ʃa:p
sharpen => 'ʃɑ:pn
sharpener => 'ʃɑ:pnә
sharpeners => ˈʃɑ:pənəz
sharpening => 'ʃɑ:pәniŋ
sharpens => ˈʃɑ:pənz
sharper => 'ʃɑ:pә
sharpie => 'ʃɑ:pi
sharpish => ˈʃɑ:pɪʃ
sharply => 'ʃɑ:pli
sharpness => 'ʃɑ:pnis
sharps => ʃɑ:ps
sharpshooter => 'ʃɑ:pʃu:tә
sharpshooters => ˈʃɑ:pʃu:təz
sharpshooting => 'ʃɑ:pʃu:tɪŋ
shashlik => 'ʃɑ:ʃlik
shat => ʃæt
shatter => 'ʃætә
shatter cone => ˈʃætə kəun
shattering => 'ʃætәriŋ
shatterproof => 'ʃætәpru:f
shatters => ˈʃætəz
shave => ʃeiv
shaveling => 'ʃeivliŋ
shaven => 'ʃeivn
shaver => 'ʃeivә
shavers => ˈʃeɪvəz
shaves => ʃeivz
shavetail => 'ʃeivteil
Shavian => 'ʃeivjәn, -viәn
shaving => 'ʃeiviŋ
shaving cream => ˈʃeiviŋ kri:m
shaving foam => ˈʃeiviŋ fəum
Shavuoth => ʃə'vu:əus; ʃɑ:-
shaw => ʃɒ:
shawl => ʃɒ:l
shawl collar => ʃɔ:l ˈkɔlə
shawls => ʃɔ:lz
shawm => ʃɔ:m
shawn => ʃɔ:n
shay => ʃei
shazam => ʃә'zæm
she => ʃi:
she'd => ʃi:d
she-devil => 'ʃi:,devәl
she-oak => 'ʃi:'əʊk
shea => ʃi:. ʃiә
shea butter => ˈʃi: bʌtə(r)
sheading => 'ʃi:diŋ
sheaf => ʃi:f
shealing => 'ʃi:liŋ
shear => ʃiә
shearer => 'ʃiәrә
shearing => 'ʃiәriŋ
shearling => 'ʃiәliŋ
shears => ʃiәz
shearwater => 'ʃiә.wɒ:tә
sheatfish => 'ʃi:tfiʃ
sheath => ʃi:θ
sheath knife => ʃi:θ naif
sheathbill => 'ʃi:θbil
sheathe => ʃi:ð
sheathed => ʃi:θt
sheathes => ʃi:ðz
sheathing => 'ʃi:ðiŋ
sheave => ʃi:v
sheaved => ʃi:vd
sheaves => ʃi:vz
Sheba => 'ʃi:bә
shebang => ʃi'bæŋ
Shebat => ʃә'vɑ:t
shebeen => ʃi'bi:n
shebeening => ʃi'bi:niŋ
shed => ʃed
shedder => 'ʃedә
shedding => 'ʃediŋ
sheds => ʃedz
sheen => ʃi:n
Sheena => 'ʃi:nә
sheens => ʃi:nz
sheeny => 'ʃi:ni
sheep => ʃi:p
sheep dip => ʃi:p dip
sheep tick => ʃi:p tik
sheep walk => 'ʃiːpwɔːk
sheepdogs => ˈʃi:pˌdɔ:gz
sheepfold => 'ʃi:pfәuld
sheepfolds => 'ʃiːpfəʊld
sheepherder => 'ʃi:phә:dә
sheepish => 'ʃi:piʃ
sheepishly => 'ʃi:pɪʃlɪ
sheeplike => 'ʃi:plaik
sheepshank => 'ʃi:pʃæŋk
sheepshead => 'ʃi:pshed
sheepskin => 'ʃi:pskin
sheepskins => 'ʃi:pskɪnz
sheer => ʃiә
sheered => ʃiəd
sheering => ʃiərɪŋ
sheerly => 'ʃiәli
sheers => ʃiәs
sheesh => ʃi:ʃ
sheet => ʃi:t
sheet bend => ʃi:t bend
sheeting => 'ʃi:tiŋ
sheetrock => 'ʃi:trɔk
sheffield => 'ʃefi:ld
sheikdom => 'ʃeɪkdəm
sheikh => ʃeik, ʃi:k
sheila => 'ʃi:lә
shekel => 'ʃekl
shekels => 'ʃeklz
sheldon => 'ʃeldәn
sheldrake => 'ʃeldreik
shelduck => 'ʃeldʌk
shelf => ʃelf
shell => ʃel
shell suit => ʃel sju:t
shell-less => 'ʃellis
shell-like => 'ʃellaik
shell-shocked => ʃel ʃɔkt
shellac => ʃә'læk
shellacking => ʃә'lækiŋ
shellacs => ʃəˈlæks
shellback => 'ʃelbæk
shelled => ʃeld
shelley => 'ʃeli
shellfire => 'ʃelfaiә
shellfish => 'ʃelfiʃ
shelling => 'ʃeliŋ
shelly => 'ʃeli
shelter => 'ʃeltә
shelterless => 'ʃeltәlis
shelters => ˈʃeltəz
sheltie => 'ʃeltaɪ
Shelton => 'ʃeltәn
shelve => ʃelv
shelves => ʃelvz
shelving => 'ʃelviŋ
Shema => ʃә'mɑ:,ʃmɑ:
shemozzle => ʃi'mɒzl
Shenandoah => ,ʃenən'dəuə
shenanigan => ʃә'næni^әn
shenanigans => ʃɪˈnænɪgənz
sheng => ʃeŋ
Shensi => 'ʃen'si:
Shenyang => 'ʃʌn'jɑ:ŋ
Sheol => 'ʃi:әul
Shepard => 'ʃepəd
Shephard => 'ʃepәd
shepherd => 'ʃepәd
shepherd dog => ˈʃepəd dɔɡ
shepherd's pie => ˈʃepədz
shepherded => 'ʃepəd
shepherdess => 'ʃepәdis
shepherdesses => ˈʃepədisiz
shepherding => 'ʃepəd
sherardize => 'ʃerәdaiz
Sheraton => 'ʃerәt(ә)n
sherbet => 'ʃә:bәt
sherbets => ˈʃə:bəts
sherd => ʃәd
shereef => ʃә'ri:f
Sheridan => 'ʃeridn
sherif => ʃә'ri:f
sheriff => 'ʃerif
sherlock => 'ʃә:lɔk
sherman => 'ʃә:mәn
sherpa => 'ʃә:pә
sherries => ˈʃeri:z
Sherrington => 'ʃeriŋtn
sherry => 'ʃeri
sherwani => ʃeә'wɑ:ni
Sherwin => 'ʃә:win
sherwood => 'ʃә:wud
Shetland => 'ʃetlәnd
shetlander => 'ʃetlənd
shew => ʃәu
shewbread => 'ʃәjbred
shewed => ʃəʊ
shewing => ʃəʊ
shewn => ʃәun
shews => ʃəʊ
shh => ʃ
shiatsu => ʃiˈætsu:
shibboleth => 'ʃibәleθ
shibboleths => ˈʃɪbəlɪθs
shicer => 'ʃaisә
shicker => 'ʃikә
Shiel => ʃiːl
shield => 'ʃi:ld
shield volcano => ʃi:ld vɔlˈkeinəu
shielded => 'ʃi:ldid
shielding => 'ʃi:ldiŋ
shieldtail => 'ʃi:lteɪl
shieling => 'ʃi:liŋ
shies => ʃaiz
shift => ʃift
shiftable => 'ʃɪfteɪbl
shifted => ʃiftid
shifter => 'ʃiftә
shifting => 'ʃiftiŋ
shifting cultivation => ˈʃiftiŋ ˌkʌltəˈveɪʃən
shiftless => 'ʃiftlis
shifts => ʃifts
shiftwork => 'ʃɪftwɜ:k
shifty => 'ʃifti
shigellosis => ,ʃi^ә'lәusis
Shiism => 'ʃi:izәm
shiite => 'ʃi:ait
Shijiazhuang => ,ʃi:tʃjɑ:'tʃwæŋ
shikar => ʃi'kɑ:
shikari => ʃaɪkɑ:'rɪ
shikker => 'ʃikә(r)
shiksa => 'ʃɪksə
shill => ʃil
shillelagh => ʃi'leilә
shilling => 'ʃiliŋ
shillings => 'ʃɪlɪŋz
Shillong => ʃi'lɔŋ
Shilluk => ʃi'lu:k
shilly-shally => 'ʃili.ʃæli
shillyshally => 'ʃɪli .ʃæli
shim => ʃim
shimmer => 'ʃimә
shimmered => ˈʃɪməd
shimmering => 'ʃɪmərɪŋ
shimmers => ˈʃɪməz
shimmery => 'ʃimәri
shimmied => ˈʃimid
shimmies => ˈʃimiz
shimmy => 'ʃimi
shimmying => ˈʃimiŋ
shin => ʃin
shin pad => ʃin pæd
shinbone => 'ʃinbәun
shindig => 'ʃindig
shindigs => ˈʃindiɡz
shindy => 'ʃindi
shine => ʃain
shiner => 'ʃainә
shingle => 'ʃiŋgl
shingled => ˈʃɪngld
shingles => 'ʃiŋ^lz
shingling => 'ʃɪŋɡlɪŋ
shingly => 'ʃiŋgli
shinier => ˈʃaɪni:ə
shininess => 'ʃaininis
shining => 'ʃainiŋ
shinned => ʃind
shinnied => ˈʃinid
shinnies => ˈʃiniz
shinning => ʃinɪŋ
shinny => 'ʃini
shinnying => ˈʃiniŋ
shinplaster => 'ʃinplæstә
shins => ʃinz
Shintoism => 'ʃintәjizәm
Shintoist => 'ʃintәjist
shiny => 'ʃaini
ship => ʃip
ship canal => ʃip kəˈnæl
ship money => ʃip ˈmʌni
ship of the line => ʃip ɔv ðə lain
ship-rigged => 'ʃipri^d
ship-to-shore => 'ʃiptu'ʃɔ:
shipboard => 'ʃipbɒ:d
shipbroker => ʃɪpb'rəʊkər
shipbuilder => 'ʃipbildә
shipbuilding => 'ʃipbildiŋ
shiplap => 'ʃiplæp
shipload => 'ʃiplәud
shipman => 'ʃipmәn
shipmaster => 'ʃip.mɑ:stә
shipmate => 'ʃipmeit
shipmen => 'ʃɪpmən
shipment => 'ʃipmәnt
shipowner => 'ʃipәunә
shippable => 'ʃipәbl
shippen => 'ʃipәn
shipper => 'ʃipә
shippers => ˈʃɪpəz
shipping => 'ʃipiŋ
shippon => 'ʃipәn
shipshape => 'ʃipʃeip
shipway => 'ʃipwei
shipworm => 'ʃipwә:m
shipwreck => 'ʃiprek
shipwrecking => 'ʃɪprek
shipwrecks => ˈʃɪpˌreks
shipwright => 'ʃiprait
shipyard => 'ʃipjɑ:d
shipyards => 'ʃɪpjɑ:dz
shiralee => 'ʃirәli:
Shiraz => ʃiә'rɑ:z
shire => 'ʃaiә
shire horse => ˈʃaiə hɔ:s
shires => ˈʃaiəz
shirk => ʃә:k
shirked => ʃɜ:kt
shirker => 'ʃә:kә
shirking => ʃɜ:kɪŋ
shirks => ʃɜ:ks
shirley => 'ʃә:li
shirr => ʃә:
shirring => 'ʃә:riŋ
shirt => ʃә:t
shirt tail => ʃə:t teil
shirtfront => 'ʃә:tfrʌnt
shirtfronts => 'ʃə:tfrʌnt
shirting => 'ʃә:tiŋ
shirtsleeve => ˈʃɜ:tsli:v
shirttail => 'ʃә:tteil
shirtwaist => 'ʃә:tweist
shirtwaister => 'ʃɜ:tweɪstər
shirty => 'ʃә:ti
shish kebab => 'ʃiʃ kә,bɑ:b
shit => ʃit
shit stirrer => ʃit ˈstə:rə
shite => 'ʃait
shithead => 'ʃɪthed
shitheads => 'ʃithed
shitless => 'ʃitlis
shitlist => 'ʃɪtlɪst
shits => ʃits
shitter => 'ʃitə
shitting => ʃitɪŋ
shitty => 'ʃiti
shiur => 'ʃi:jә(r)
shiv => ʃiv
shiva => 'ʃi:vә
shivaree => ,ʃivә'ri:
shive => ʃaiv
shiver => 'ʃivә
shivered => ˈʃivəd
shivering => 'ʃivәriŋ
shiveringly => 'ʃivәriŋli
shivers => ˈʃivəz
shivery => 'ʃivәri
shivoo => ʃi'vu:
Shizuoka => ʃi'zuәkɑ:
shlub => ʃlʌb
shmatte => 'ʃmɑ:tә
sho => ʃәu
Shoah => ʃɔ:ɑ:, 'ʃəuə
shoal => ʃәul
shoaling => 'ʃəʊlɪŋ
shoals => ʃəʊlz
shoaly => 'ʃәuli
shoat => ʃәut
shock => ʃɒk
shock therapy => ʃɔk ˈθerəpi
shocked => ʃɔkt
shocker => 'ʃɔkә
shockers => ˈʃɔkəz
shocking => 'ʃɒkiŋ
shocking pink => ˈʃɔkɪŋ piŋk
shockproof => 'ʃɔkpru:f
shod => ʃɔd
shoddier => ˈʃɔdi:ə
shoddily => 'ʃɔdili
shoddiness => 'ʃɔdinis
shoddy => 'ʃɒdi
shoe => ʃu:
shoe leather => ʃu: ˈleðə
shoe tree => ʃu: tri:
shoebill => 'ʃu:bil
shoeblack => 'ʃu:blæk
shoebox => ˈʃu:bɒks
shoehorn => 'ʃu:hɒ:n
shoehorned => ˈʃu:hɔ:nd
shoehorning => ˈʃu:hɔ:nɪŋ
shoehorns => ˈʃu:hɔ:nz
shoelace => 'ʃu:leis
shoelaces => ˈʃu:ˌleɪsiz
shoeless => 'ʃu:lis
shoemaker => 'ʃu:.meikә
shoemakers => ˈʃu:ˌmeɪkəz
shoemaking => 'ʃu:.meikiŋ
shoeshine => 'ʃu:ʃain
shoestring => 'ʃu:striŋ
shoestrings => ˈʃu:ˌstrɪŋz
shoetree => 'ʃu:tri:
shofar => 'ʃәufɑ:
shogun => 'ʃәu,^u:n
shogunate => 'ʃәugʌneit
shoji => 'ʃәudʒi:
Sholapur => 'ʃәjlә,pjә(r)
Shona => 'ʃәunɑ:
shone => ʃɔn
shonky => ˈʃɒŋki
shoo => ʃu:
shooed => ʃu:d
shooing => ʃu:ɪŋ
shook => ʃuk
shoos => ʃu:z
shoot => ʃu:t
shoot through => ʃu:t θru:
shootable => 'ʃu:tәbl
shooter => 'ʃu:tә
shooting => 'ʃu:tiŋ
shooting box => ˈʃu:tɪŋ bɔks
shooting match => 'ʃu:tiŋ
shootout => 'ʃʊtɚʊt
shop => ʃɒp
shop assistant => ʃɔp əˈsistənt
shop girl => ʃɔp ɡə:l
shopaholic => ˌʃɒpəˈhɒlɪk
shopfront => 'ʃɔpfrʌnt
shopgirl => 'ʃɒpgә:l
shopkeeper => 'ʃɒp.ki:pә
shopkeepers => ˈʃɔpˌki:pəz
shopkeeping => 'ʃɔp,ki:piŋ
shoplifted => ˈʃɔpˌlɪftid
shoplifter => 'ʃɒp.liftә
shoplifting => 'ʃɒp.liftiŋ
shoplifts => ˈʃɔpˌlɪfts
shopman => 'ʃɔpmәn
shopmen => 'ʃɒpmən
shoppe => ʃɔp
shopper => 'ʃɒpә
shopping => 'ʃɒpiŋ
shopping cart => ˈʃɔpɪŋ kɑ:t
shopping centre => ˈʃɔpɪŋ ˈsentə
shopping list => ˈʃɔpɪŋ list
shopping mall => ˈʃɔpɪŋ mɔ:l
shopsoiled => 'ʃɔpsɔild
shopwalker => 'ʃɒpwɒ:kә
shopworn => 'ʃɒpwә:n
shore => ʃɒ:
shore leave => ʃɔ: li:v
shorebird => 'ʃɔ:bɜ:d
shorefront => 'ʃɔ:frʌnt
shoreless => 'ʃɒ:lis
shoreline => 'ʃɒ:lain
shorelines => ˈʃɔ:ˌlaɪnz
shores => ʃɔ:z
shoreside => 'ʃɔ:said
shoreward => 'ʃɒ:wәd
shoring => 'ʃɒ:riŋ
shorn => ʃɔ:n
short => ʃɒ:t
short and sweet => ʃɔ:t ænd swi:t
short cut => ʃɔ:t kʌt
short division => ʃɔ:t diˈviʒən
short hundredweight => ʃɔ:t ˈhʌndrədweit
short measure => ʃɔ:t ˈmeʒə
short order => ʃɔ:t ˈɔ:də
short story => ʃɔ:t ˈstɔ:ri
short temper => ʃɔ:t ˈtempə
short time => ʃɔ:t taim
short-acting => 'ʃɔ:t'æktɪŋ
short-circuits => 'ʃɔ:ts'ɜ:kɪts
short-haul => 'ʃɔ:t'hɔ:l
short-listing => 'ʃɔ:tlist
short-lists => 'ʃɔ:tlist
short-order cook => ˈʃɔ:tˈɔ:də kuk
short-range => 'ʃɔ:t'reindʒ
short-sightedness => 'ʃɔ:ts'aɪtɪdnəs
short-staffed => ˈʃɔ:tˈstæft
short-tempered => ʃɔ:t'tempәd
shortage => 'ʃɒ:tidʒ
shortages => 'ʃɔ:tɪdʒɪz
shortbread => 'ʃɒ:tbred
shortcoming => 'ʃɒ:t'kʌmiŋ
shortcomings => 'ʃɔ:tkʌmɪŋz
shortcrust => ʃɔ:tk'rʌst
shortcut => 'ʃɒ:tkʌt
shorted => ʃɔ:tid
shorten => 'ʃɒ:tn
shortened => ˈʃɔ:tnd
shortening => 'ʃɔ:tniŋ
shortens => ˈʃɔ:tnz
shortfall => 'ʃɒ:tfɒ:l
shortfalls => ˈʃɔ:tˌfɔ:lz
shortgrass => 'ʃɔ:t^rɑ:s; -^ræs
shorthair => 'ʃɔ:theә(r)
shorthand => 'ʃɒ:thænd
shorthand typist => ˈʃɔ:thænd ˈtaipist
shorthanded => 'ʃɒ:t'hændid
shorthorn => 'ʃɒ:thɒ:n
shortie => 'ʃɔ:ti
shorties => ˈʃɔ:tiz
shortish => 'ʃɒ:tiʃ
shortlist => 'ʃɔ:tlist
shortlived => 'ʃɔ:t'livd
shortly => 'ʃɒ:tli
shortness => 'ʃɒ:tnis
shorts => ʃɔ:ts
shortsighted => 'ʃɒ:t'saitid
shortstop => 'ʃɒ:tstɒp
shortwave => 'ʃɒ:tweiv
shorty => 'ʃɒ:ti
Shoshonean => ʃәj'ʃәjniәn, ,ʃәjʃә'ni:әn
shot => ʃɒt
shot-put => ʃɔt put
shot-putter => 'ʃɔt,pjtә(r)
shote => ʃәut
shotgun => 'ʃɒtgʌn
shotgun marriage => ˈʃɔtˌgʌn ˈmæridʒ
shotgun wedding => ˈʃɔtˌgʌn ˈwediŋ
shotguns => ˈʃɔtˌgʌnz
shotmaking => 'ʃɔt,meikiŋ
shotted => 'ʃɒtted
should => ʃud
shoulder => 'ʃәuldә
shoulder bag => ˈʃəuldə bæɡ
shoulder belt => ˈʃəuldə belt
shoulder joint => ˈʃəuldə dʒɔint
shoulder pad => ˈʃəuldə pæd
shoulder-length => ˈʃəuldə leŋθ
shouldered => 'ʃәuldәd
shout => ʃaut
shouted => 'ʃaʊtɪd
shouting => 'ʃajtiŋ
shouts => ʃauts
shove => ʃʌv
shove up => ʃʌv ʌp
shoved => ʃʌvd
shovel => 'ʃʌvl
shovel pass => ˈʃʌvl pɑ:s
shovelboard => 'ʃʌvlbɔ:d
shoveler => 'ʃʌvəlә(r)
shovelful => 'ʃʌvəlfjl
shovelhead => 'ʃʌvlhed
shovelled => ˈʃʌvld
shoveller => 'ʃʌvlә
shovelling => ʃʌ'vəlɪŋ
shovels => ˈʃʌvlz
shovelware => 'ʃʌvəlwεə
shoves => ʃʌvz
show => ʃәu
show house => ʃəu haus
show jumping => ʃəu ˈdʒʌmpiŋ
show out => ʃəu aut
show trial => ʃəu ˈtraiəl
show willing => ʃəu ˈwiliŋ
show-stopper => ˈʃəʊˌstɔpə
showbiz => .ʃәubiz
showboat => 'ʃәubәut
showboater => 'ʃəu,bəutə
showboating => 'ʃəʊbəʊt
showcard => 'ʃəʊkɑ:d
showcase => 'ʃәukeis
showcases => ˈʃəʊˌkeɪsiz
showdown => 'ʃәudaun
showdowns => ˈʃəʊˌdaʊnz
shower => 'ʃauә
showered => ˈʃauəd
showerhead => 'ʃaʊəhed
showering => ˈʃauərɪŋ
showery => 'ʃauәri
showgirls => ˈʃəuɡə:lz
showground => 'ʃәj^rajnd
showier => ˈʃəʊi:ə
showily => 'ʃәuili
showiness => 'ʃəʊɪnɪs
showing => 'ʃәuiŋ
showjumping => ˈʃəʊdʒʌmpɪŋ
showman => 'ʃәumәn
showmanship => 'ʃәjmәnʃip
shown => ʃәun
showpiece => 'ʃәupi:s
showpieces => ˈʃəʊˌpi:siz
showplace => 'ʃәupleis
showroom => 'ʃәuru:m
showrooms => ˈʃəurumz
showstopper => 'ʃәu.stɒpә
showtime => 'ʃәutaim
showy => 'ʃәui
shoyu => 'ʃәjju:
shrank => 'ʃræŋk
shrapnel => 'ʃræpnәl
shred => ʃred
shredder => 'ʃredә
shredders => ʃ'redəz
shreds => ʃredz
shrew => ʃru:
shrewd => ʃru:d
shrewder => ʃru:də
shrewdness => ʃru:dnəs
shrewish => 'ʃru:iʃ
shrews => ʃru:z
Shrewsbury => 'ʃrәjzbəri, 'ʃru:z-
shriek => ʃri:k
shrieked => ʃri:kt
shrieking => ʃri:kɪŋ
shrieks => ʃri:ks
shrieval => 'ʃri:vəl
shrievalty => 'ʃri:vәlti
shrift => ʃrift
shrike => ʃraik
shrill => ʃril
shrilled => ʃrɪld
shrilling => ʃrɪlɪŋ
shrillness => ʃrɪlnəs
shrills => ʃrɪlz
shrilly => 'ʃrili
shrimp => ʃrimp
shrimper => 'ʃrɪmpə(r)
shrimping => ˈʃrɪmpɪŋ
shrimps => ʃ'rɪmps
shrine => ʃrain
Shriner => 'ʃrainə
shrines => ʃrainz
shrink => ʃriŋk
shrink from => ʃriŋk frɔm
shrink-wrap => ʃ'rɪŋkr'æp
shrinkable => 'ʃriŋkәbl
shrinkage => 'ʃriŋkidʒ
shrinker => 'ʃriŋkә
shrinkingly => ʃ'rɪŋkɪŋlɪ
shrinks => ʃriŋks
shrive => ʃraiv
shrivel => 'ʃrivl
shriveled => 'ʃrɪvəld
shrivelled => ˈʃrɪvəld
shrivelling => ʃrɪ'vəlɪŋ
shrivels => ˈʃrɪvəlz
shriven => 'ʃrivәn
Shropshire => 'ʃrɔpʃiә
shroud => ʃraud
shrouded => ʃraudid
shrouding => 'ʃraudiŋ
shrouds => ʃ'raʊdz
shrove => ʃrәuv
Shrovetide => 'ʃrәuvtaid
shrub => ʃrʌb
shrubberies => ˈʃrʌbəriz
shrubbery => 'ʃrʌbәri
shrubby => 'ʃrʌbi
shrubs => ʃrʌbz
shrug => ʃrʌg
shrugged => ʃ'rʌɡd
shrugging => ʃrʌg
shrugs => ʃrʌɡz
shrunk => 'ʃrʌnk
shrunken => 'ʃrʌnkәn
shtetl => 'ʃtetl
shtick => ʃtik
shuck => ʃʌk
shucked => ʃʌkt
shucker => 'ʃʌkər
shucking => 'ʃʌkɪŋ
shucks => ʃʌks
shudder => 'ʃʌdә
shuddered => ˈʃʌdəd
shuddering => 'ʃʌdərɪŋ
shudders => ˈʃʌdəz
shuffle => 'ʃʌfl
shuffleboard => 'ʃʌflbɒ:d
shuffled => ˈʃʌfəld
shuffles => ˈʃʌfəlz
shufti => ˈʃʊfti
shul => ʃu:l, ʃjl
shun => ʃʌn
shunned => ʃʌnd
shunning => ʃʌnɪŋ
shuns => ʃʌnz
shunt => ʃʌnt
shunted => 'ʃʌntɪd
shunter => 'ʃʌntә
shunting => 'ʃʌntiŋ
shunts => ʃʌnts
shura => 'ʃu:rɑ:
shush => ʃʌʃ
shushed => ʃʌʃt
shushes => ʃʌʃiz
shushing => ʃʌʃɪŋ
shut => ʃʌʃ
shut-in => 'ʃʌtin
shut-off => 'ʃʌt'ɔ:f
shutdown => 'ʃʌtdaun
shutdowns => ˈʃʌtdaunz
shute => ʃu:t
shutoff => 'ʃʌtɒ:f
shutout => 'ʃʌtaut
shuts => ʃʌts
Shutt => ʃʌt
shutter => 'ʃʌtә
shutter release => ˈʃʌtə riˈli:s
shutter speed => ˈʃʌtə spi:d
shutterbug => 'ʃʌtәbʌ^
shuttered => ˈʃʌtəd
shuttering => 'ʃʌtәriŋ
shuttle => 'ʃʌtl
shuttle diplomacy => ˈʃʌtl dɪˈpləʊməsi:
shuttlecock => 'ʃʌtlkɒk
shuttlecocked => ˈʃʌtlkɔkt
shuttlecocking => ˈʃʌtlkɔkɪŋ
shuttlecocks => ˈʃʌtlkɔks
shuttled => 'ʃʌt(ə)l
shuttles => ˈʃʌtlz
shy => ʃai
shyer => ʃaɪə
shying => ʃaiŋ
shylock => 'ʃailɔk
shyness => 'ʃainis
shyster => 'ʃaistә
SI => si:
sial => 'saiæl
sialagogue => 'saiәlә^ɔ^, sai'ælә-
sialidase => sai'ælideiz
Sialkot => si'ælkɔt
Siam => 'saiæm, sai'æm
siamang => 'si:ә,mæŋ
Siamese => saiә'mi:z, 'saiә-
sian => 'ʃi:'ɑ:n, ʃjɑ:n
sib => sib
siberia => sai'biәriә
siberian => sai'biәriәn
sibilance => 'sibilәns
sibilant => 'sibilәnt
sibling => 'sibliŋ
siblings => 'sɪblɪŋz
sibyl => 'sibil
sibylline => 'sibili:n
sic => sik
siccative => 'sikәtiv
sice => sais
Sichuan => 'si:tʃ'wɑ:n
Sicilia => si'siljә, si'tʃi:ljɑ:
sicilian => si'siljәn, -liәn
siciliano => si.sili'ɑ:nәu
sicilians => siˈsiljənz
sick => sik
sick benefit => sik ˈbenifit
sick of => sik ɔv
sick-out => 'sɪk'aʊt
sickbay => ˈsɪkbeɪ
sickbed => 'sikbed
sicked => sikt
sicken => 'sikәn
sickened => ˈsɪkənd
sickener => 'sikәnә
sickening => 'sikniŋ
sickeningly => 'sikniŋli
sickens => ˈsɪkənz
sicker => 'sikә
sickie => ˈsɪki
sicking => sikɪŋ
sickish => 'sikiʃ
sickle => sikl
sickle-cell anaemia => ˈsɪkəl sɛl əˈnimiə
sickle-cell trait => ˈsɪkəl sel treit
sicklebill => 'siklbil
sickles => ˈsɪkəlz
sicklied => 'sɪklɪ
sicklier => ˈsɪkli:ə
sickliness => 'siklinis
sickly => 'sikli
sickness => 'siknis
sickness benefit => ˈsɪknɪs ˈbenifit
sicknesses => ˈsɪknɪsiz
sicko => 'sikәj
sickroom => 'sikru:m
sicks => 'sɪks
SID => sid
sida => 'saɪdə
siddhi => 'sidi:
Siddons => 'sidnz
side => said
side chapel => said ˈtʃæpəl
side door => said dɔ:
side salad => said ˈsæləd
side table => said ˈteibl
side-foot => said fut
side-on => said ɔn
side-saddle => said ˈsædl
side-splitting => said ˈsplitiŋ
sidearm => 'saidɑ:m
sideband => 'said,bænd
sidebar => 'saidbɑ:(r)
sideboard => 'saidbɒ:d
sideburn => ˈsaɪdbɜ:n
sideburns => 'saidbә:nz
sidecar => 'saidkɑ:
sidecars => ˈsaidkɑ:z
sided => 'saidid
sidehill => 'saidhil
sidekick => 'saidkik
sidekicks => ˈsaɪdˌkɪks
sidelight => 'saidlait
sidelights => 'saɪdlaɪts
sideline => 'saidlain
sidelined => ˈsaɪdˌlaɪnd
sidelines => ˈsaɪdˌlaɪnz
sidelining => 'saidlainiŋ
sidelock => 'said,lɔk
sidelong => 'saidlɒŋ
sideman => 'saidmæn
sidereal => sai'diәriәl
sidereal day => saɪˈdɪəri:əl dei
sidereal month => saɪˈdɪəri:əl mʌnθ
sidereal time => saɪˈdɪəri:əl taim
sidereal year => saɪˈdɪəri:əl jə:
siderite => 'saidәrait
siderophore => 'sidәrә,fɔ:
siderostat => 'sidәrә,stæt
sides => saidz
sidesaddle => 'saidsædl
sideshow => 'saidʃәu
sideshows => ˈsaidʃəuz
sideslip => 'saidslip
sidesman => 'saidzmәn
sidesmen => 'saidzmən
sidestep => 'saidstep
sidestepped => ˈsaɪdˌstept
sidestepping => ˈsaɪdˌstepɪŋ
sidesteps => ˈsaɪdˌsteps
sidestroke => 'saidstrәuk
sideswipe => 'saidswaip
sideswiped => ˈsaidswaipt
sideswipes => ˈsaidswaips
sideswiping => ˈsaidswaipɪŋ
sidetrack => 'saidtræk
sidetracked => ˈsaidtrækt
sidetracking => 'saɪdtrækɪŋ
sidetracks => ˈsaidtræks
sidewalk => 'saidwɒ:k
sidewalk artist => ˈsaɪdˌwɔ:k ˈɑ:tist
sidewalks => ˈsaɪdˌwɔ:ks
sideward => 'saidwәd
sideways => 'saidweiz
sidewise => 'saidwaiz
Sidi => 'si:di
siding => 'saidiŋ
sidle => 'saidl
sidled => ˈsaɪdld
sidles => ˈsaɪdlz
sidling => ˈsaɪdlɪŋ
Sidon => 'saidn
Sidra => 'sidrә
SIDS => sidz
Sieg Heil => 'zi:k'hail
siege => si:dʒ
siege mentality => si:dʒ menˈtæliti
sieges => si:dʒz
Siegfried => 'si:^fri:d
siemens => 'si:mәnz
siena => si'enә, 'sjenɑ:
sienese => ,saiә'ni:z, ,si:-
sienna => si'enә
sierra => si'єәrә
Sierra Leone => 'siәrә li'әun
Sierra Madre => si'eәrә'mɑ:drei, 'sjerɑ:'mɑ:dre
Sierra Nevada => si'eәrәni'vædә, -'vɑ:-
sierras => ˈsiərəz
siesta => si'estә
siestas => si:ˈestəz
sieve => siv
sieve tube => siv tju:b
sieved => sivd
sieves => sivz
sieving => 'siviŋ
sifaka => si'fɑ:kә, -'fæ-
sift => sift
sifted => siftid
sifter => 'siftә
sifting => 'siftiŋ
sifts => sifts
Sigatoka => si^ә'tәukә
sigh => sai
sighed => said
sighing => saiŋ
sight => sait
sight line => sait lain
sight-reader => 'sait,ri:d
sighted => 'saitid
sighter => 'saitə
sighting => saitiŋ
sightless => 'saitlis
sightline => 'saitlain
sightly => 'saitli
sightsee => 'saitsi:
sightseeing => 'saitsi:iŋ
sightseer => 'saitsi:ә(r)
sightseers => ˈsaɪtˌsi:əz
sightworthy => 'sait.wә:ði
sigil => 'sidʒil
Sigismund => 'zi:ɡismunt
sigma => 'si^mә
sigmas => ˈsiɡməz
sigmate => 'si^meit
sigmoid => 'sigmɒid
sigmoid colon => ˈsiɡmɔid ˈkəulən
sigmoidal => sɪɡ'mɔɪdl
sigmoidoscope => sig'mɒidәskәup
sigmoidoscopic => siɡ,mɔidə'skɔpik
Sigmund => 'sɪgmənd
sign => sain
sign of the cross => sain ɔv ðə krɔs
sign-off => 'sainɔf,-ɔ:f
sign-up => 'sin,ʌp
signage => ˈsaɪnɪdʒ
signal => 'signl
signal tower => ˈsiɡnəl ˈtauə
signaling => 'siɡnәliŋ
signalize => 'signәlaiz
signalized => ˈsiɡnəlaizd
signalizes => ˈsiɡnəlaiziz
signalizing => ˈsiɡnəlaizɪŋ
signalled => 'sɪgnəld
signalling => 'si^nәliŋ
signally => 'signәli
signalman => 'signәlmәn
signals => ˈsiɡnəlz
signatories => ˈsiɡnətəriz
signatory => 'si^nәtәri
signature => 'signәtʃә
signature tune => ˈsiɡnitʃə tju:n
signboard => 'sainbɒ:d
signboards => 'saɪnbɔ:dz
signed => saind
signee => sai'ni:, 'saini:
signer => 'sainә
signers => ˈsaɪnəz
signet => 'signit
signifiant => 'si^nifaiәnt, ,si:nji:'fjɔŋ
significance => sig'nifikәns
significant => sig'nifikәnt
significant other => siɡˈnifikənt ˈʌðə(r
signification => .signifi'keiʃәn
significative => si^'nifikәtiv, -keit-
signifier => ˈsɪgnɪfaɪə(r)
signifies => ˈsiɡnifaiz
signify => 'signifai
signor => 'si:njɔ:
signora => si:'njɔ:rә
signorina => ,si:njә'ri:nә
signory => 'si:njәri
signpost => 'sainpәust
signposted => saɪn'pəʊstɪd
signposting => 'saɪnpəʊstɪŋ
signposts => ˈsaɪnˌpəʊsts
signwriter => 'sainraitә
sigri => 'si^ri:
Sigurd => 'si,^jәd,'zi:^jrt
sika => 'si:kә
sike => saik
sikh => si:k
sikhs => si:ks
Sikkimese => 'siki'mi:z,-'mi:s
silage => 'sailidʒ
silane => 'silein
silas => 'sailәs
sild => sild
silence => 'sailәns
silenced => ˈsailənst
silencer => 'sailәnsә
silencers => 'saɪlənsəz
silences => ˈsailənsiz
silencing => 'sailәnsiŋ
silent => 'sailәnt
silently => 'sailәntli
Silenus => sai'li:nәs
Silesia => sai'li:ʃiә,-ʒiә,si-
silex => 'saileks
silhouette => .silu:'et
silhouetted => ˌsɪlu:ˈetɪd
silhouettes => ˌsɪlu:ˈets
silica => 'silikә
silicate => 'silikit
siliceous => si'liʃәs
silicic => si'lisik
silicide => 'sili,said
silicification => si,lisifi'keiʃən
silicify => si'lisifai
silicon => 'silikәn
silicone => 'silikәun
silicosis => ,sili'kәusis
siliqua => 'silikwә
siliquose => 'silikwәus
silk => silk
silk cotton => silk ˈkɔtən
silk gland => silk ɡlænd
silk hat => silk hæt
silk moth => silk mɔθ
silk-stocking => 'silk'stɔkiŋ
silken => 'silkәn
silkie => ˈsɪlki
silkier => ˈsɪlki:ə
silkily => 'silkili
silkiness => 'sɪlkɪnəs
silks => 'sɪlks
silkworm => 'silkwә:m
silkworms => ˈsɪlkˌwɜ:mz
silky => 'silki
silky oak => ˈsɪlki: əuk
sill => sil
sillabub => 'silәbʌb
Sillar => si'lɑ:
sillily => 'silili
sillimanite => 'silimәnait
silliness => 'silinis
sills => sɪlz
silly => 'sili
silly billy => ˈsili ˈbɪli:
silo => 'sailәu
Siloam => sai'lәjәm,si-
silos => 'saɪləʊs
siloxane => si'lɔksein
silt => silt
siltation => sɪl'teɪfən
silted => sɪltid
silting => 'siltiŋ
silts => sɪlts
siltstone => 'siltstәjn
silty => 'silti
silurian => sai'ljuәriәn, si-
siluroid => 'silju,rɔid
silva => 'silvә
silvan => 'silvәn
Silvanus => sil'veinәs
silver => 'silvә
silver age => ˈsilvə eidʒ
silver anniversary => ˈsilvə ˌæniˈvə:səri
silver band => ˈsilvə bænd
silver birch => ˈsilvə bɜ:tʃ
silver bullet => ˈsilvə ˈbulit
silver dollar => ˈsilvə ˈdɔlə
silver fir => ˈsilvə fɜ:
silver fox => ˈsilvə fɔks
silver jubilee => ˈsilvə ˈdʒu:bəˌli:
silver paper => ˈsilvə ˈpeipə
silver plate => ˈsilvə pleit
silver salmon => ˈsilvə ˈsæmən
silver service => ˈsilvə ˈsɜːvɪs
silver tongue => ˈsilvə tʌŋ
silver tree => ˈsilvə tri:
silver-tongued => 'silvә'tʌŋd
silverback => 'silvәbæk
silverberry => 'silvәbəri
silverbill => 'sɪlvərbɪl
silvered => 'silvәd
silverfish => 'silvәfiʃ
silveriness => sɪlvə'ri:nɪs
silvering => 'silvәriŋ
silvern => 'silvәn
silverpoint => 'silvәpɔint
silverside => 'silvәsaid
silversides => 'silvәsaidz
silversmith => 'silvәsmiθ
silversmithing => 'silvə,smiθiŋ
silversmiths => ˈsɪlvəˌsmɪθs
silverware => 'silvәwєә
silverweed => 'silvәwi:d
silvery => 'silvәri
silvia => 'silviә
silvicultural => 'sɪlvɪkʌltʃərəl
silviculture => 'silvikʌltʃә
sim => sim
sima => 'saimә
simazine => 'simәzi:n
Simbirsk => sim'biәsk
Simferopol => ,simfә'rәupl
simian => 'simiәn
similar => 'similә
similarities => ˌsɪməˈlærɪti:z
similarity => .simi'læriti
similarly => 'similәli
simile => 'simili
similes => 'sɪmɪlɪz
similitude => si'militjud
simla => 'simlә
Simmental => 'simәntәl
simmer => 'simә
simmered => ˈsiməd
simmering => 'sɪmərɪŋ
simmers => ˈsiməz
simnel cake => ˈsɪmnəl keɪk
simoleon => si'mәuliәn
simon => 'saimәn
simon-pure => 'saimәn'pjuә
simoniac => si'mәuniæk
simoniacal => .saimә'naiәkl
Simonides => sai'mɔnidi:z
simonize => 'saimәnaiz
simony => 'saimәni
simp => simp
simpatico => sim'pɑ:tikәu
simper => 'simpә
simpered => ˈsɪmpəd
simperingly => 'simpәriŋli
simpers => ˈsɪmpəz
simple => 'simpl
simple eye => ˈsimpl ai
simple machine => ˈsimpl məˈʃi:n
simple-minded => ˈsɪmpəlˈmaɪndɪd
simpleness => 'sɪmplnɪs
simpleton => 'simpltәn
simpletons => ˈsimpltənz
simplex => 'simpleks
simpliciter => sim'plisitә
simplicities => simˈplisitiz
simplicity => sim'plisiti
simplification => .simplifi'keiʃәn
simplifications => ˌsɪmplɪfɪˈkeɪʃənz
simplify => 'simplifai
simplifying => ˈsimplifaiŋ
simplism => 'simplizm
simplistic => sim'plistik
simplistically => -kli
simply => 'simpli
simpson => 'simpsn
simul => 'simәl
simulacrum => .simju'leikrәm
simulant => 'simjulәnt
simulate => 'simjuleit
simulates => ˈsimjuleits
simulating => 'simjuleitiŋ
simulation => .simju'leiʃәn
simulative => 'simjuleitiv
simulator => 'simjuleitә
simulators => 'sɪmjʊleɪtəz
simulcast => 'simәlkɑ:st
simultaneity => .simәltә'ni:әti
simultaneous => .simәl'teinjәs
simultaneously => simәl'teiniәsly; (?@) saim-
simvastatin => sɪm'vɑ:steɪtɪn
sin => sin
sin bin => sin bin
sinai => 'sainai
Sinaitic => ,sainei'itik,-ni'i-
Sinanthropus => ,sinæn'θrәupәs
sinbad => 'sinbæd
since => sins
sincere => sin'siә
sincerely => sin'siәli
sincereness => sɪn'sɪrnɪs
sincerity => sin'serәti
sincipital => sin'sipitəl
sinciput => 'sinsipʌt
Sinclair => 'siŋkleә
sind => sind
sine => sain
sine die => saini 'daii, sinei 'di:ei
sine qua non => sinei kwɑ: 'nәjn
sinecure => 'saini.kjuә
sinecures => ˈsaɪnɪˌkjʊəz
sinecurist => 'saini.kjurist
sinew => 'sinju:
sinewed => 'sɪnjuː
sinews => ˈsɪnju:z
sinewy => 'sinju:i
sinfonia => .sinfә'niә
sinfonia concertante => sinfəˈni:ə ˌkɔntʃəˈtænti
Sinfonietta => ,sɪnfəʊnɪ'etə
sinful => 'sinful
sinfully => 'sɪnfəlɪ
sinfulness => 'sinfəlnis
sing => siŋ
sing along => 'sɪŋəlɔŋ
Sing Sing => 'siŋsiŋ
sing-song => siŋ sɔŋ
sing-songs => 'siŋsɔŋ
Singapore => .siŋgә'pɒ:
singaporean => ,siŋ^ә'pɔ:riәn
singe => sindʒ
singed => sɪndʒd
singeing => sɪnd'ʒɪŋ
singer => 'siŋә
singer-songwriter => 'sɪnɡərs'ɒŋraɪtə
singers => ˈsɪŋəz
singes => sɪndʒz
Singh => siŋ
Singhalese => ,siŋhә'li:z,-'li:s,,siŋ^ә-
singing => 'siŋiŋ
single => 'siŋgl
single cream => ˈsiŋɡl kri:m
single file => ˈsiŋɡl fail
single market => ˈsiŋɡl ˈmɑ:kit
single parent => ˈsiŋɡl ˈpɛərənt
single-acting => 'siŋ^l'æktiŋ
single-action => 'sɪŋɡl'ækʃn
single-blind => 'siŋɡl,blaind
single-foot => 'siŋ^lfjt
single-hander => 'siŋɡl'hændə
single-lens reflex => ˈsɪŋgəlˌlenz
single-source => 'sɪŋɡls'ɔ:s
singled => ˈsiŋɡld
singleness => 'siŋglnis
singlet => 'siŋglit
singleton => 'siŋgltәn
singletree => 'siŋgltri:
singlets => sɪŋɡ'lɪts
singling => ˈsiŋɡlɪŋ
singly => 'siŋgli
singsong => 'siŋsɒŋ
singular => 'siŋgjulә
singularities => ˌsɪŋgjəˈlærɪti:z
singularity => .siŋgju'læriti
singularization => sɪŋɡjʊləraɪ'zeɪʃn
singularize => 'siŋgjulәraiz
singularly => 'siŋgjulәli
Sinhalese => siŋhә'li:z
Sining => 'ʃi:'niŋ
sinister => 'sinistә
sinisterly => 'sɪnɪstəlɪ
sinistral => 'sinistrәl
sinistrality => sinis'træliti
Sinitic => si'nitik
sink => siŋk
sinkable => 'siŋkәbl
sinkage => 'siŋkidʒ
sinker => 'siŋkә
sinkhole => 'siŋkhәul
Sinkiang => 'sin'kjæŋ,'ʃin'kjɑ:ŋ
sinking => 'siŋkiŋ
sinless => 'sinlis
sinlessly => ˊsinlisli
sinlessness => ˊsinlisnis
Sinn Fein => 'ʃin'fein
sinned => sind
sinner => 'sinә
sinners => ˈsɪnəz
sinnet => 'sinit
sinning => sinɪŋ
Sino- => 'sainәj
sinsemilla => ,sinsә'miljә
sinter => 'sintә
sintered => 'sintәd
sintering => 'sintәriŋ
sinters => 'sɪntə
Sintra => 'si:ntrә,'sin-
sinuate => 'sinjueit
Sinuiju => 'ʃini:,dʒu:
sinuosity => .sinju'ɒsiti
sinuous => 'sinjuәs
sinuously => 'sinjuəsli
sinuousness => 'sɪnjʊəsnəs
sinus => 'sainәs
sinus venosus => vi:ˈnəʊsəs
sinusitis => .sainә'saitis
sinusoid => 'sainәsɒid
sinusoidal => .sainә'sɒidl
sion => 'saiәn
Siouan => 'su:әn
sioux => su:
sip => sip
sipe => 'sɪp
siphon => 'saifәn
siphonage => 'saifənidʒ
siphonal => 'saifənәl
siphoned => ˈsaɪfənd
siphonic => sai'fɔnik
siphoning => 'saɪfənɪŋ
siphonophore => sai'fɔnә,fɔ:, 'saifәnә-
siphons => ˈsaɪfənz
siphuncle => 'saifʌŋkl
sipped => sipt
sipper => 'sɪpə
sippet => 'sipit
sipping => sipɪŋ
sippy => 'sɪpɪ
sips => sips
sipunculan => sai'pʌŋkjjlәn
sipunculid => sai'pʌŋkjulid
sir => sә:
Siracusa => ,sirɑ:'ku:zɑ:
sirdar => sә:'dɑ:
sire => saiә
sired => saɪəd
siree => sә:'ri:
siren => 'saiәrin
sirenian => sai'ri:niәn
sirens => ˈsaiərinz
sires => saɪəz
siring => saɪərɪŋ
Sirius => 'siriәs
sirloin => 'sә:lɒin
sirloins => ˈsɜ:ˌlɔɪnz
sirocco => si'rɒkәu
sirrah => 'sirә
sirree => sә:'ri:
sirtaki => siә'tɑ:ki:
sirup => 'sirәp
sirupy => 'sirәpi
sis => sis
sisal => 'sisәl
siskin => 'siskin
Sisley => 'sisli
sissified => 'sisi,faid
sissy => 'sisi
sister => 'sistә
sisterhood => 'sistәhud
sisterly => 'sistәli
sistine => 'sistain, 'sisti:n
sistrum => 'sistrәm
Sisyphean => ,sisi'fi(:)әn
sisyphus => 'sisifәs
sit => sit
sitar => si'tɑ:
sitarist => 'sɪtərɪst
sitars => siˈtɑ:z
sitcom => 'sitkɔm
sitcoms => ˈsɪtˌkɔmz
site => sait
siting => 'saitiŋ
Sitka => 'sitkə
sitrep => 'sitrep
Sittang => 'sitɑ:ŋ
sitter => 'sitә
sitters => ˈsɪtəz
sitting => 'sitiŋ
sitting tenant => ˈsitiŋ ˈtenənt
sittings => 'sɪtɪŋz
situate => 'sitjueit
situated => 'sitjueitid
situates => ˈsɪtʃu:ˌeɪts
situating => ˈsɪtʃu:ˌeɪtɪŋ
situation => .sitju'eiʃәn
situational => sitju'eiʃәnәl. -tʃu-
situationist => ,sitju'eiʃәnist
situs => 'saitәs
Sitwell => 'sitwәl
sitzkrieg => 'sitskri:g
Sivan => si:'vɑ:n, 'sivәn
six => siks
six-footer => 'siks'fjtә(r)
six-pack => 'sikspæk
sixain => 'siksein
sixer => 'siksә
sixfold => 'siksfәuld
sixpence => 'sikspәns
sixpences => ˈsikspənsiz
sixpenny => 'sikspәni
sixte => sikst
sixteen => 'siks'ti:n
sixteenmo => 'siks'ti:nmәj
sixteenth => 'siks'ti:nθ
sixteenth note => sɪkˈsti:nθ nəut
sixth => siksθ
sixth form => sɪksθ fɔ:m
sixth-form college => sɪksθ fɔrm ˈkɑlɪdʒ
sixthly => 'siksθli
sixths => sɪksθs
sixties => ˈsɪksti:z
sixtieth => 'sikstiiθ
sixty => 'siksti
sixty-fourmo => ,siksti'fɔ:mәj
sixty-fourth note => ˌsɪksti:ˈfɔ:θ, -ˈfəʊrθ
sixty-nine => 'siksti'nain
sixtyfold => 'sikstifәuld
sixtyish => 'sikstiiʃ
sizable => 'saizәbl
sizar => 'saizә
size => saiz
size zero => saiz ˈziərəu
sizeable => 'saizәbl
sized => 'saizd
sizer => 'saizә
sizing => 'saiziŋ
sizzle => 'sizl
sizzled => ˈsɪzəld
sizzler => 'sizlә
sizzles => ˈsɪzəlz
sizzling => ˈsɪzlɪŋ
sjambok => 'ʃæmbɒk
ska => skɑ:
skag => skæ^
Skagerrak => 'skæ^әræk
skald => 'skɔ:ld
skarn => skɑ:n
skat => skɑ:t, skæt
skate => skeit
skateboard => 'skeitbɔ:d
skateboarder => 'skeɪtbɔ:də(r)
skateboarding => 'skeit.bɔ:diŋ
skateboards => ˈskeɪtˌbɔ:dz
skated => skeitid
skatepark => 'skeitpɑ:k
skater => 'skeitә
skaters => s'keɪtəz
skating => 'skeitiŋ
skean => ski:n
sked => sked
skedaddle => ski'dædl
skeet => ski:t
skeet shooting => ˈski:t ʃu:tɪŋ
skeeter => 'ski:tә
skeg => ske^
skein => skein
skeins => skeɪnz
skeletal => 'skelәtәl
skeletal muscle => ˈskelitl ˈmʌsl
skeleton => 'skelәtn
skeletonize => 'skelitәnaiz
skeletons => ˈskelitnz
skelp => skelp
Skelton => 'skeltn
skene => ski:n
skep => skep
skeptic => 'skeptik
skeptical => 'skeptikәl
skeptically => 'skeptɪkəlɪ
skepticism => 'skeptisizm
skerrick => 'skerik
skerries => ˈskeriz
skerry => 'skeri
sketch => sketʃ
sketchbooks => ˈsketʃˌbʊks
sketches => sketʃiz
sketchier => ˈsketʃi:ə
sketchily => 'sketʃili
sketchiness => 'sketʃinis
sketching => 'sketʃiŋ
sketchpad => 'sketʃpæd
sketchpads => ˈsketʃˌpædz
sketchy => 'sketʃi
skew => skju:
skew arch => skju: ɑ:tʃ
skew-whiff => skju: hwɪf
skewback => 'skju:bæk
skewbald => 'skju:bɒ:ld
skewed => skju:d
skewer => skju:ә
skewered => ˈskju:əd
skewering => ˈskju:ərɪŋ
skewers => ˈskju:əz
skewing => 'skju:iŋ
skews => skju:z
ski => ski:
ski binding => ski: ˈbaɪndɪŋ
ski boot => ski: bu:t
ski jump => ski: dʒʌmp
ski jumper => ski: ˈdʒʌmpə
ski jumping => ski: ˈdʒʌmpiŋ
ski lift => ski: lift
ski stick => ski: stik
ski tow => ski: təu
skiable => 'ski:əbl
skiagraphy => skai'ægrәfi
skibob => 'ski:bɔb
skid => skid
skid road => skɪd roʊd
skidded => skɪdid
skidding => 'skidiŋ
skidoo => ski'du:
skidpan => ˈskɪdpæn
skids => skɪdz
skied => s'kaɪd
skier => 'ski:ә
skiers => 'skiːə
skies => skaiz
skiff => skif
skiffle => 'skif(ә)l
skiffs => skɪfs
skiing => 'ski:iŋ
skijoring => ski:'dʒɒ:riŋ
skilful => 'skilful
skilfulness => ˊskilfulnis
skill => 'skil
skilled => 'skild
skilless => 'skɪllɪs
skillet => 'skilit
skillets => ˈskɪlɪts
skillful => 'skilful
skilly => 'skili
skim => skim
skimboard => 'skimbɔ:d
skimmed => skimd
skimmer => 'skimә
skimming => 'skimiŋ
skimobile => 'ski:mә?bi:l
skimp => skimp
skimped => skɪmpt
skimpier => ˈskɪmpi:ə
skimpily => s'kɪmpɪlɪ
skimps => skɪmps
skimpy => 'skimpi
skims => skimz
skin => skin
skin diving => skin ˈdaɪvɪŋ
skin up => skin ʌp
skin-diver => skin ˈdaɪvə
skin-divers => 'skin,daivə
skin-pop => s'kɪnp'ɒp
skin-popper => 'skinpɔp
skincare => 'skɪnkeə(r)
skinflint => 'skinfliŋt
skinfold => 'skinfәjld
skinful => 'skinful
skinhead => 'skinhed
skinheads => s'kɪnhedz
skink => skiŋk
skinned => 'skind
skinner => 'skinә
skinniness => 'skininis
skinning => 'skiniŋ
skinny => 'skini
skins => skinz
skint => skint
skintight => 'skin'tait
skip => skip
skipjack => 'skipdʒæk
skipper => 'skipә
skippered => ˈskɪpəd
skippering => ˈskipəriŋ
skippers => ˈskɪpəz
skippet => 'skipit
skipping => 'skipiŋ
skipping rope => ˈskipiŋ rəup
skips => skips
skirl => skә:l
skirmish => 'skә:miʃ
skirmished => ˈskɜ:mɪʃt
skirmisher => 'skә:miʃә
skirmishes => ˈskɜ:mɪʃiz
skirmishing => ˈskɜ:mɪʃɪŋ
skirr => skә:
skirret => 'skirit
skirt => skә:t
skirted => 'skә:tid
skirting => 'skә:tiŋ
skirting board => ˈskə:tiŋ bɔ:d
skis => ski:z
skit => skit
skite => skait
skits => skɪts
skitter => 'skitә
skittered => ˈskitəd
skittering => ˈskitərɪŋ
skitters => ˈskitəz
skittery => s'kɪtərɪ
skittish => 'skitiʃ
skittle => 'skitl
skive => skaiv
skived => skaɪvd
skiver => 'skaivә
skives => skaɪvz
skiving => 'skaiviŋ
skivvies => s'kɪvɪz
skivvy => 'skivi
skiwear => 'ski:weә(r)
skokiaan => 'skɔ:ki,ɑ:n, 'skәj-
skolly => 'skɔli
skookum => 'sku:kәm
skort => s'kəʊərt
skosh => skәjʃ
skua => 'skju:ә
skulduggery => skʌl'dʌgәri
skulk => 'skʌlk
skulked => skʌlkt
skulker => 'skʌlkә
skulking => skʌlkɪŋ
skulks => skʌlks
skull => skʌl
skull and crossbones => skʌl ænd ˈkrɔsbəunz
skullcap => 'skʌlkæp
skullduggery => skʌl'dʌ^әri
skulling => skʌŋkɪŋ
skulls => skʌlz
skunk => skʌŋk
skunk cabbage => skʌŋk ˈkæbidʒ
skunks => skʌŋks
skunkweed => ˈskʌŋkwi:d
skutterudite => 'skʌtә,rʌdait
sky => skai
sky surfing => skai ˈsə:fiŋ
skycap => 'skaikæp
skydive => 'skaidaiv
skydived => ˈskaidaivd
skydiver => 'skaɪdaɪvə(r)
skydives => ˈskaidaivz
skye => skai
skyer => 'skaiә
skyey => 'skaii
skyhook => 'skaihuk
skyjacked => ˈskaɪˌdʒækt
skyjacking => 'skaidʒækiŋ
skyjacks => ˈskaɪˌdʒæks
skylark => 'skailɑ:k
skylarks => ˈskailɑ:ks
skyless => 'skailis
skylight => 'skailait
skylights => ˈskaɪˌlaɪts
skyline => 'skailain
skylines => ˈskaɪˌlaɪnz
skylit => 'skailit
skyrocket => 'skai.rɒkit
skyrocketed => ˈskaɪˌrɔkɪtid
skyrocketing => s'kaɪrɒkɪtɪŋ
skyrockets => ˈskaɪˌrɔkɪts
skysail => 'skaiseil
skyscape => 'skaiskeip
skyscraper => 'skaiskreipә
skyscrapers => 'skaɪˌskreɪpəz
skywalk => 'skaiwɔ:k
skyward => 'skaiwәd
skywards => ˈskaɪwədz
skywatch => 'skaiwɔtʃ, -wɔ:tʃ
skyway => 'skaiwei
skywriting => 'skairaitiŋ
slab => slæb
slabber => 'slæbә
slabby => 'slæbi
slack => slæk
slack water => slæk ˈwɔ:tə
slacked => slækt
slacken => 'slækәn
slackened => ˈslækənd
slackening => ˈslækənɪŋ
slackens => ˈslækənz
slacker => 'slækә
slacking => slækɪŋ
slackness => 'slæknɪs
Slade => sleid
slag => slæg
slag heap => slæg hi:p
slagged => slægd
slagging => 'slæ^iŋ
slaggy => 'slægi
slags => slægz
slain => slein
slake => sleik
slaked => sleɪkt
slakes => sleɪks
slaking => 'sleikiŋ
slalom => 'slælәm
slaloms => ˈsleiləmz
slam => slæm
slam dunk => slæm dʌŋk
slam-dunk => ˈslæmˈdʌŋk
slammed => slæmd
slammer => 'slæmә
slamming => 'slæmiŋ
slander => 'slændә
slandered => ˈslændərt
slandering => ˈslændərɪŋ
slanderous => 'slændәrәs
slanderously => s'lɑ:ndərəslɪ
slanders => ˈslændərs
slang => slæŋ
slanged => slæŋ
slanging => slæŋ
slangs => slæŋz
slanguage => 'slæŋgwidʒ
slangy => 'slæŋi
slant => slænt
slant height => slɑ:nt hait
slanted => ˈslɑ:ntɪd
slanting => 'slɑ:ntiŋ
slants => slɑ:nts
slantwise => 'slæntwaiz
slap => slæp
slap bang => slæp bæŋ
slapdash => 'slæpdæʃ
slaphappy => 'slæphæpi
slapjack => 'slæpdʒæk
slapped => slæpt
slapper => 'slæpə
slapping => 'slæpiŋ
slaps => slæps
slapstick => 'slæpstik