sulphonate => 'sʌlfә,neit
sulphonation => ,sʌlfә'neiʃən
sulphone => 'sʌlfәun
sulphonic acid => sʌlˈfɔnik ˈæsid
sulphonyl => 'sʌlfәnil
sulphur => 'sʌlfә
sulphur dioxide => ˈsʌlfə daɪˈɔksaɪd
sulphureous => sʌl'fjuәriәs
sulphuric => sʌl'fjuәrik
sulphuric acid => sʌlˌfjʊərɪk ˈæsɪd
sulphurous => 'sʌlfәrәs
sulphury => 'sʌlfәri
Sulpician => sʌl'piʃən
sultan => 'sʌltn
sultana => sʌl'tɑ:nә
sultanas => sʌl'tɑ:nəz
sultanate => 'sʌltәnit
sultans => ˈsʌltənz
sultrily => 'sʌltrili
sultriness => 'sʌltrinis
sultry => 'sʌltri
sulu => 'suːluː
sum => sʌm
sumac => 'su:mæk, 'ʃu:-
sumatra => su'mɑ:trә
Sumatran => su'mɑ:trәn
Sumba => 'su:mbә
Sumbawa => su:m'bɑ:wә
Sumer => 'su:mə
Sumerian => su:'miәriәn, -'mer-
sumi => 'su:mi
summa => 'sumә
summa cum laude => 'sjmәkjm'lajdei, 'sʌmәkʌm'lɔ:di:
summand => 'sʌmәnd
summaries => ˈsʌməriz
summarily => 'sʌmәrili
summarise => 'sʌmәraiz
summarization => .sʌmәrai'zeiʃәn
summarize => 'sʌmәraiz
summarized => ˈsʌməraizd
summarizes => ˈsʌməraiziz
summary => 'sʌmәri
summat => ˈsʌmət
summation => sʌ'meiʃәn
summations => səˈmeɪʃənz
summative => 'sʌmətɪv
summer => 'sʌmә
summer camp => ˈsʌmə kæmp
summer cypress => ˈsʌmə ˈsaɪprɪs
summer house => ˈsʌmə haus
summer pudding => ˈsʌmə ˈpudiŋ
summer solstice => ˈsʌmə ˈsɔlstis
summer squash => ˈsʌmə skwɔʃ
summer stock => ˈsʌmə stɔk
summer time => ˈsʌmə taim
summered => 'sʌmə
summerhouse => 'sʌmәhaus
summerhouses => ˈsʌməˌhaʊsiz
summering => 'sʌmәriŋ
summersault => 'sʌmәsɔ:lt
summertime => 'sʌmәtaim
summery => 'sʌmәri
summing => 'sʌmiŋ
summing-up => 'sʌmiŋ'ʌp
summit => 'sʌmit
summiteer => ,sʌmi'tiә
summitry => 'sʌmitri
summits => ˈsʌmits
summon => 'sʌmәn
summoned => ˈsʌmənd
summoner => 'sʌmәnә
summoning => ˈsʌmənɪŋ
summons => 'sʌmәnz
summum bonum => 'sʌmәm'bәunәm
sumner => 'sʌmnә
sumo => 'sju:mәu
sump => sʌmp
sumph => sʌmf
sumps => sʌmps
sumpter => 'sʌmptә
sumptuary => 'sʌmptʃuәri
sumptuosity => ,sʌmptjj'ɔsәti, -tʃj-
sumptuous => 'sʌmptʃuәs
sumptuously => 'sʌmptʃʊəslɪ
sumptuousness => ˊsʌmptjuәsnis
sun => sʌn
sun bear => sʌn bɛə
sun dance => sʌn dɑ:ns
sun deck => sʌn dek
sun dog => sʌn dɔɡ
sun god => sʌn ɡɔd
sun hat => sʌn hæt
sun helmet => sʌn ˈhelmit
sun lounge => sʌn laundʒ
sun porch => sʌn pɔ:tʃ
sun visor => sʌn ˈvaizə
sun-up => 'sʌn'ʌp
sunbake => 'sʌnbeik
sunbath => 'sʌnbɑ:θ
sunbathe => 'sʌnbeið
sunbathed => ˈsʌnˌbeɪðd
sunbathers => 'sʌnbeiðə
sunbathes => ˈsʌnˌbeɪðz
sunbeam => 'sʌnbi:m
sunbeams => ˈsʌnbi:mz
sunbed => ˈsʌnbed
sunbelt => 'sʌnbelt
sunbird => 'sʌnbә:d
sunblind => 'sʌnblaind
sunblock => ˈsʌnblɒk
sunbonnet => 'sʌnbɒnit
sunbonnets => 'sʌn,bɒnɪt
sunburn => 'sʌnbә:n
sunburning => 'sʌnbɜːn
sunburns => ˈsʌnˌbɜ:nz
sunburnt => 'sʌnb\\\\:nt
sunburst => 'sʌnbә:st
Sunbury => 'sʌnbəri; -bεəri
Sunda Islands => 'sʌndә 'ailәndz
sundae => 'sʌndi:
sundaes => ˈsʌndi:z
Sundanese => sʌndә'ni:z
Sunday => 'sʌndi
Sundays => 'sʌndiz, -deiz
sundeck => 'sʌndek
sunder => 'sʌndә
sundered => ˈsʌndəd
sundering => ˈsʌndərɪŋ
Sunderland => 'sʌndәlәnd
sunders => ˈsʌndəz
sundew => 'sʌndju:
sundial => 'sʌndaiәl
sundials => 'sʌndaɪəlz
sundown => 'sʌndaun
sundowner => 'sʌn,dajnә(r)
sundress => 'sʌn,dres
sundries => 'sʌndriz
sundrops => 'sʌndrɔps
sundry => 'sʌndri
sunfast => 'sʌnfɑ:st
sunfish => 'sʌnfiʃ
sunflower => 'sʌnflauә
sunflowers => ˈsʌnˌflauəz
sung => sʌŋ
sunglass => 'sʌnglæs
sunhat => sʌn'hæt
suni => 'su:ni
sunk => sʌŋk
sunken => 'sʌŋkәn
sunlamp => 'sʌnlæmp
sunless => 'sʌnlis
sunlight => 'sʌnlait
sunlike => 'sʌnlaik
sunlit => 'sʌnlit
Sunna => 'sunә
Sunni => 'suni:
sunnier => ˈsʌniə
sunnily => 'sʌnili
sunniness => 'sʌninis
Sunnite => 'sun,ait
sunny => 'sʌni
sunny side => ˈsʌni said
sunny-side up => ˈsʌni:ˌsaɪd
sunray => 'sʌnrei
sunrise => 'sʌnraiz
sunrise industry => ˈsʌnraiz ˈindəstri
sunroof => 'sʌnru:f. -ruf
sunroofs => ˈsʌnru:fs
sunroom => 'sʌnru(:)m
sunscreen => 'sʌnskri:n
sunset => 'sʌnset
sunset industry => ˈsʌnset ˈindəstri
sunsets => ˈsʌnsets
sunshade => 'sʌnʃeid
sunshine => 'sʌnʃain
sunshine law => ˈsʌnʃain lɔ:
sunshiny => 'sʌnʃaini
sunspot => 'sʌnspɒt
sunspots => ˈsʌnspɔts
sunstar => 'sʌnstɑ:(r)
sunstone => 'sʌnstәun
sunstroke => 'sʌnstrәuk
sunsuit => 'sʌnsu:t
suntan => 'sʌntæn
suntanned => 'sʌntænd
suntans => ˈsʌnˌtænz
suntrap => ˈsʌntræp
sunup => 'sʌnʌp
sunward => 'sʌnwәd
sunwards => 'sʌnwәdz
sunyata => sən'jɑ:tə
sup => sʌp
super => 'sju:pә
super- => 'sju:pә(r)
super-duper => ˌsu:pə ˈdu:pə(r)
superabound => .sju:pәrә'baund
superabundance => .sju:pәrә'bʌndәns
superabundant => .sju:pәrә'bʌndәnt
superacid => ,sju:pә'æsid
superacidity => sju:pәrә'siditi
superadd => 'sju:pәr'æd
superaddition => 'sju:pәrә'diʃәn
superadiabatic => 'sju:pә,ædiә'bætik
superalloy => ,sju:pә'ælɔi
superaltar => ,sju:pə'rɔ:ltə
superannuable => ,sju:pәr'ænjjәbl
superannuate => sju:pә'rænjueit
superannuated => sju:pә'rænjueitid
superannuation => ,sju:pә,rænju'eiʃәn
superb => sju'pә:b
superbike => 'sju:pәbaik
superbug => ˈsu:pəbʌg
supercalender => ,sju:pә'kælәndә
supercar => 'sjuːpəkɑː
supercargo => 'sju:pә.kɑ:gәu
supercede => ,sju:pә'si:d
superceded => ,sju:pə'si:d
supercedes => ,sju:pə'si:d
superceding => ,sju:pə'si:d
supercell => su:pər'sel
supercenter => 'sju:pә,sentә
supercharge => 'sju:pәtʃɑ:dʒ
supercharged => ˈsu:pətʃɑ:dʒd
supercharger => 'sju:pә.tʃɑ:dʒә
superciliary => .sju:pә'siliәri
supercilious => .sju:pә'siliәs
superciliously => ,su:pə'siliəsli
superciliousness => sjuːpәˊsiliәsnis
superclass => 'sju:pә,klɑ:s, -klæs
supercluster => 'sju:pә,klʌstә
supercoil => 'sju:pә,kɔil
supercollider => su:pərkə'laɪdər
supercomputer => ,sju:pәkәm'pju:tә
supercomputers => ˌsju:pəkəmˈpju:təz
superconduct => ,sju:pәkәn'dʌkt
superconducting => ,sju:pәkәn'dʌktiŋ
superconductive => .sju:pәkәn'dʌktiv
superconductivity => su:pәkɔndʌk'tiviti
superconductor => ,sju:pәkәn'dʌktә
superconscious => ,sju:pә'kɔnʃәs
supercontinent => ,sju:pә'kɔntinәnt
supercool => ,sju:pә'ku:l
supercooled => su:pər'ku:ld
supercritical => ,sju:pә'kritikәl
superdelegate => su:pər'delɪɡət
superduper => .sju:pә'dju:pә
superego => .sju:pәr'i:gәu
superelevation => ,sju:pә,eli'veiʃәn
supereminence => ,sju:pәr'eminәns
supereminent => .sju:pәr'eminәnt
supererogation => 'sju:pәr,erә'^eiʃәn
supererogatory => ,sju:pәre'rɔ^әtәri
superette => sju:pә'ret
superfamily => .sju:pә'fæmili
superfatted => .sju:pә'fætid
superfecundation => ,sju:pә,fi:kәn'deiʃәn, -,fekәn-
superfetation => ,sju:pәfi:'teiʃәn
superficial => .sju:pә'fiʃәl
superficiality => ,sju:pәfiʃi'æliti
superficialness => sjuːpәˊfiʃәnis
superficies => ,sju:pә'fiʃii:z
superfine => .sju:pә'fain
superfluid => 'sju:pә.flu:id
superfluidity => ,sju:pәflu-'iditi
superfluities => ˌsju:pəˈflu:ɪtiz
superfluity => ,sju:pә'fluiti
superfluous => sju'pә:fluәs
superfluously => sju:'pə:fluəsli
superfluousness => 'su:pɜ:flʊəsnes
superfly => 'sju:pəflai
supergalaxy => 'sju:pә,^ælәksi
supergene => 'sju:pә,dʒi:n
supergiant => 'sju:pә,dʒaiәnt
superglue => ˈsu:pəglu:
supergrass => ˈsu:pəgrɑ:s
supergravity => 'sju:pə,ɡrævəti
supergroup => 'sju:pә,^ru:p
superheat => .sju:pә'hi:t
superheated => ˌsu:pəˈhi:tɪd
superheater => 'sju:pәhi:tә
superheavy => ,sju:pә'hevi
superheavyweight => ˌsu:pəˈheviweɪt
superhelical => ,sju:pә'helikәl
superhelix => ,sju:pә'heliks
superhero => 'sju:pә,hiәrәj
superhet => 'sju:pә'het
superheterodyne => 'sju:pә'hetәrәdain
superhighway => .sju:pә'haiwei
superhuman => .sju:pә'hju:mәn
superimpose => 'sju:pәrim'pәuz
superimposed => ,sju:pәrim'pәuzd
superimposes => ˌsju:pərɪmˈpəʊziz
superimposing => ˌsju:pərɪm'pəʊzɪŋ
superimposition => 'sju:pәr,impә'ziʃәn
superincumbent => ,sju:pәrin'kʌmbәnt
superinduce => ,sju:pәrin'dju:s
superinfection => ,sju:pәrin'fekʃәn
superintend => .sju:pәrin'tend
superintended => ˌsju:pərɪnˈtendid
superintendence => ,sju:pәrin'tendәns
superintendency => ,sju:pәrin'tendәnsi
superintendent => ,sju:pәrin'tendәnt
superintendents => su:pərɪn'tendənts
superintending => ˌsju:pərɪnˈtendɪŋ
superintends => ˌsju:pərɪnˈtendz
superior => sju:'piәriә
superior conjunction => sjuˈpiəriə kənˈdʒʌŋkʃən
superior planet => sjuˈpiəriə ˈplænit
superiority => sju:.piәri'ɒriti
superiorly => sju:'piәriәli, sә-
superiors => sjuˈpiəriəz
superjacent => ,sju:pә'dʒeisnt
superlative => sju:'pә:lәtiv
superlatively => sə'pɝlətɪvli
superlatives => sʊˈpɜ:lətɪvz
superlattice => sju:pә'lætis
superluminal => ,sju:pә'lju:minәl
superlunary => ,sju:pә'lju:nәri
supermajority => ,sju:pəmə'dʒɔriti, -,dʒɔ:-
superman => 'sju:pәmæn
supermarket => 'sju:pәmɑ:kit
supermarkets => 'su:pəmɑ:kɪts
supermassive => 'sju:pә,mæsiv
supermen => 'sju:pəmen
supermodel => ˈsu:pəmɒdl
supermodels => ˈsju:pəˌmɔdəlz
supermom => 'suːpə(r).mɒm
supermundane => sju:pә'mʌndein
supernal => sju:'pә:nl
supernatant => .sju:pә'neitәnt
supernatural => .sju:pә'nætʃәrәl
supernaturalism => ,sju:pә'nætʃәrәlizәm
supernaturalist => -list
supernaturally => ˌsju:pə'nætʃrəlɪ
supernormal => .sju:pә'nɒ:ml
supernova => .sju:pә'nәuvә
supernovas => ˌsju:pəˈnəʊvəz
supernumeraries => sjupəˈnju:mərəriz
supernumerary => sjupә'nju:mәrәri
superorder => 'sju:pә,ɔ:dә
superordinate => ,sju:pә'ɔ:dinit, -,neit
superordinated => ˌsju:pəˈɔ:dinitid
superordinating => ˌsju:pəˈɔ:dinitɪŋ
superorganism => ,sju:pә'ɔ:^әnizm
superoxide => ,sju:pә'ɔksaid
superphosphate => .sju:pә'fɒsfeit
superplastic => ,sju:pә'plæstik
superplasticity => ,sju:pәplæs'tisiti
superpose => .sju:pә'pәuz
superposed => .sju:pә'pәuzd
superposes => sju:pəˈpəuziz
superposing => sju:pəˈpəuzɪŋ
superposition => .sju:pәpә'ziʃәn
superpower => .sju:pә'pauә
superpowers => ˈsju:pəˌpaʊəz
supersaturate => .sju:pә'sætʃәreit
supersaturated => su:pər'sætʃəreɪtɪd
supersaturation => 'sju:pә,sætʃә'reiʃәn
superscribe => sju:pә'skraib
superscript => 'sju:pәskript
superscription => .sju:pә'skripʃәn
supersede => .sju:pә'si:d
superseded => ˌsju:pəˈsi:did
supersedes => ˌsju:pəˈsi:dz
superseding => ˌsju:pəˈsi:dɪŋ
supersensitive => .sju:pә'sensitiv
supersession => .sju:pә'seʃәn
superset => 'sju:pәset
supersize => ˈsu:pəsaɪz
supersonic => .sju:pә'sɒnik
supersonics => .sju:pә'sɒniks
superspace => 'suːpəspeɪs; 'sjuː-
superstar => 'sju:pәstɑ:
superstardom => 'sjuːpə,stɑːdəm
superstars => ˈsju:pəˌstɑ:z
superstate => 'sju:pәsteit
superstation => ,sju:pәs'teiʃәn
superstition => .sju:pә'stiʃәn
superstitions => ˌsju:pəˈstiʃənz
superstitious => .sju:pә'stiʃәs
superstitiously => ,su:pə'stiʃəsli
superstitiousness => sjuːpәˊstiʃәsnis
superstore => 'sju:pә,stɔ:
superstratum => .sju:pә'streitәm
superstring => 'su:pəstrɪŋ
superstructure => 'sju:pәstrʌktʃә
superstructures => ˈsju:pəˌstrʌktʃəz
supersymmetry => ,sju:pә'simitri
supertanker => 'sju:pәtæŋkә
supertax => 'sju:pәtæks
supertitle => 'sju:pə,taitl
supertonic => 'sju:pә'tɔnik
supertwist => 'su:pətwɪst
supervene => ,sju:pә'vi:n
supervened => ˌsju:pəˈvi:nd
supervenes => ˌsju:pəˈvi:nz
supervenient => ,sju:pә'vi:njәnt
supervening => ˌsju:pəˈvi:nɪŋ
supervention => ,sju:pә'venʃәn
supervise => 'sju:pәvaiz
supervision => .sju:pә'viʒәn
supervisor => .sju:pә'vaizә
supervisors => 'su:pəvaɪzəz
supervisory => .sju:pә'vaizәri
supervoltage => ,sju:pә'vɔltidʒ
superweed => 'sju:pəwi:d
superwoman => 'sju:pә,wumәn
supinate => 'sju:pineit
supinated => 's(j)uːpɪneɪt
supinates => 's(j)uːpɪneɪt
supinating => 's(j)uːpɪneɪt
supination => sju:pi'neiʃәn
supinator => 'sju:pi,neitә
supine => sju:'pain
supinely => sʊ'paɪnli
supped => sʌpt
supper => 'sʌpә
supper club => ˈsʌpə klʌb
supperless => 'sʌpәlis
suppers => ˈsʌpəz
suppertime => 'sʌpәtaim
supping => sʌpɪŋ
supplant => sә'plɑ:nt
supplanted => səˈplæntid
supplanting => səˈplæntɪŋ
supplants => səˈplænts
supple => 'sʌpl
supplejack => 'sʌpldʒæk
supplely => 'sʌplli
supplement => 'sʌplimәnt
supplemental => .sʌpli'mentl
supplementary => .sʌpli'mentәri
supplementary angle => ˌsʌpliˈmentəri ˈæŋɡl
supplementary benefit => ˌsʌpliˈmentəri ˈbenifit
supplementation => ,sʌplimen'teiʃәn
suppleness => 'sʌplnis
suppletion => sә'pli:ʃәn
suppletive => sә'pli:tiv, 'sʌpli-
suppliant => 'sʌpliәnt
suppliantly => ˊsʌpliәntli
supplicant => 'sʌplikәnt
supplicants => ˈsʌplɪkənts
supplicate => 'sʌplikeit
supplicated => ˈsʌplɪˌkeɪtid
supplicating => ˈsʌplɪˌkeɪtɪŋ
supplication => .sʌpli'keiʃәn
supplications => ˌsʌpliˈkeiʃənz
supplicatory => 'sʌplikәtәri
supplier => sә'plaiә
supply => sә'plai
supply chain => səˈplai tʃein
supply-side => səˈplaɪˌsaɪd
support => sә'pɒ:t
support group => səˈpɔ:t ɡru:p
supportability => sә.pɒ:tә'biliti
supportable => sә'pɒ:tәbl
supporter => sә'pɒ:tә
supporting => sә'pɔ:tiŋ
supportive => sә'pɔ:tiv
supposable => sә'pәuzәbl
suppose => sә'pәuz
supposed => sә'pәuzd
supposedly => sә'pәuzidli
supposes => səˈpəuziz
supposing => sә'pәjziŋ
supposition => .sʌpә'ziʃәn
suppositional => .sʌpә'ziʃәnl
suppositions => ˌsʌpəˈzɪʃənz
suppositious => ,sʌpә'ziʃәs
supposititious => sә.pɒzi'tiʃәs
suppositories => səˈpɔzitəriz
suppository => sә'pɒzitәri
suppress => sә'pres
suppressant => sә'presәnt
suppresses => səˈpresiz
suppressible => sә'presәbl
suppression => sә'preʃәn
suppressive => sә'presiv
suppressor => sә'presә
suppressor cell => səˈpresə sel
suppurate => 'sʌpjureit
suppurated => ˈsʌpjəˌreɪtid
suppurates => ˈsʌpjəˌreɪts
suppurating => ˈsʌpjəˌreɪtɪŋ
suppuration => .sʌpju'reiʃәn
suppurative => 'sʌpjureitiv
supra => 'sju:prә
supramolecular => ,sju:prәmә'lekjulә
supramundane => 'sju:prә'mʌndein
supranational => .sju:prә'næʃәnәl
supranationalism => su:prə'næʃnəlɪzəm
supraoptic => ,sju:prә'ɔptik
supraorbital => .sju:prә'ɒ:bitl
suprarenal => .sju:prә'ri:nәl
suprasegmental => ˌsu:prəsegˈmentl
supremacism => sʊp'reməsɪzəm
supremacist => sә'premәsist, sju-
supremacy => sju'premәsi
supreme => sju'pri:m
supremo => sju'pri:mәu
supremum => sju:'pri:mәm
sups => sʌps
suq => su:k
sur => s\\\\:(r)
sura => 'suәrә
Surabaya => ,suərə'bɑ:jə; ,su:rɑ:'bɑ:jɑ:
surah => 'sjuәrә
sural => 'sjuәrәl
suramin => 's\\\\:rәmin
surcease => sә:'si:s
surcharge => 'sә:tʃɑ:dʒ
surcharged => 'sɜːtʃɑːdʒ
surcharges => ˈsɜ:ˌtʃɑ:dʒz
surcharging => 'sɜːtʃɑːdʒ
surcingle => 'sә:siŋgl
surcoat => 'sә:kәut
surd => sә:d
sure => ʃuә
sure-fire => ʃuə ˈfaiə
sure-footed => ʃuə ˈfutid
surefire => 'ʃuәfaiә
surefooted => 'ʃuә'futid
surely => 'ʃuәli
sureness => 'ʃuәnis
sureties => ˈʃuətiz
surety => 'ʃuәti
suretyship => 'ʃjәrәtiʃip, 'ʃjәti-
surf => sә:f
surface => 'sә:fis
surface-to-air => 's\\\\:fistә'eә(r)
surface-to-surface => 's\\\\:fistә's\\\\:fis
surfaced => 'sә:fist
surfacer => 'sә:fisә
surfacing => 'sә:fisiŋ
surfactant => sә:'fæktәnt
surfbird => 'sә:fbә:d
surfboard => 'sә:fbɒ:d
surfboards => ˈsə:fbɔ:dz
surfcaster => 's\\\\:f,kɑ:stә(r);-,kæ-
surfcasting => 's\\\\:f,kɑ:stiŋ; -,kæ-
surfed => sə:ft
surfeit => 'sә:fit
surfeited => ˈsɜ:fɪtid
surfeiting => ˈsɜ:fɪtɪŋ
surfeits => ˈsɜ:fɪts
surfer => 'sә:fә
Surfers => 'sɜːfə
surficial => sә:'fiʃәl
surfie => 's\\\\:fi
surfing => 'sә:fiŋ
surfperch => 's\\\\:fp\\\\:tʃ
surfs => sə:fs
surfy => 'sә:fi
surge => sә:dʒ
surgeon => 'sә:dʒәn
surgeonfish => 's\\\\:dʒәnfiʃ
surgeons => 'sɜ:dʒənz
surgeries => ˈsə:dʒəriz
surgery => 'sә:dʒәri
surgical => 'sә:dʒikl
surgical strike => ˈsɜ:dʒɪkəl straik
surging => 'sә:dʒiŋ
suricate => 'suri,keit
surimi => sju:'rɪmaɪ
Surinam => ,suәri'næm
Suriname => ,sjәri'nɑ:mә
Surinamer => 'sjәri,næmә(r)
Surinamese => ,suərinə'mi:z; -'mi:s
surjection => s\\\\:'dʒekʃәn
surjective => s\\\\:'dʒektiv
surlier => ˈsɜ:li:ə
surlily => 'sә:lili
surliness => 'sә:linis
surly => 'sә:li
surmise => 'sә:maiz
surmised => səˈmaɪzd
surmises => səˈmaɪziz
surmising => səˈmaɪzɪŋ
surmount => sә:'maunt
surmountable => sә:'mauntәbl
surmounted => sɚ'maʊnt
surmounting => səˈmaʊntɪŋ
surmounts => səˈmaʊnts
surmullet => sә'mʌlit
surname => 'sә:neim
surnames => ˈsə:neimz
surpass => sә'pɑ:s
surpassed => səˈpɑ:st
surpasses => səˈpɑ:siz
surpassing => sә'pɑ:siŋ
surpassingly => sə'pɑ:sɪŋlɪ
surplice => 'sә:plis
surpliced => 's\\\\:plist
surplices => ˈsə:plisiz
surplus => 'sә:plәs
surprise => sә'praiz
surprised => sә'praizd
surprisedly => sә'praizidli
surprises => səˈpraiziz
surprising => sә'praiziŋ
surra => 'sʌrә, 'su:rә
surreal => sә'riәl
surrealism => sә'riәlizm
surrealist => sә'riәlist
surrealistic => sә.riә'listik
surrealistically => sərɪəlɪs'tɪklɪ
surrealists => səˈrɪəlɪsts
surrebuttal => ,sә:ri'bʌtl
surrebutter => .sʌri'bʌtә
surrejoinder => .sʌri'dʒɒindә
surrender => sә'rendә
surrendered => səˈrendəd
surrendering => səˈrendərɪŋ
surrenders => səˈrendəz
surreptitious => .sʌrәp'tiʃәs
surrey => 'sʌri
surrogacy => ˈsʌrəgəsi
surrogate => 'sʌrәgit
surrogate mother => ˈsɜ:rəgɪt ˈmʌðə
surrogates => ˈsɜ:rəgɪts
surround => sә'raund
surround sound => səˈraund saund
surrounding => sә'raundiŋ
surroundings => sә'rajndiŋz
surtax => 'sә:tæks
surtaxed => ˈsə:tækst
surtaxes => ˈsə:tæksiz
surtaxing => ˈsə:tæksɪŋ
surtitle => 'sɜ:taɪtl
surtout => 'sә:tu:, sә:'tu:
Surtsey => 'sə:tsi:; 'sjuətsei
surveillance => sә:'veilәns
surveillances => sə'veɪl(ə)ns; -'veɪəns
survey => sә'vei
surveyed => ˈsɜrˌveɪd
surveying => sә'veiiŋ
surveyor => sә'veiә. sә:-
surveyors => sə'veɪəz
survivability => ˌsəvɚɪvə'bɪlɪtɪ
survivable => sә'vaivәbl
survival => sә'vaivәl
survival kit => səˈvaivəl kit
survivalism => sə'vaɪvəlɪzəm
survivalist => sә'vaivәlist
survivals => səˈvaivəlz
survive => sә'vaiv
survived => səˈvaivd
survives => səˈvaivz
surviving => sә'vaiviŋ
survivor => sә'vaivә
survivors => sə'vaɪvəz
survivorship => sә'vaivәʃip
sus => sʌs
susan => 'su:zn
Susanna => su:'zænə
Susannah => su:'zænә
susceptibilities => səseptə'bɪlɪtɪz
susceptibility => sә.septә'biliti
susceptible => sә'septәbl
susceptibly => sә'septәbli
susceptive => sә'septiv
sushi => 'su:ʃi
susie => 'su:zi
suslik => 'sʌslik
suspect => sә'spekt
suspected => sә'spektid
suspecting => səˈspektɪŋ
suspects => səˈspekts
suspend => sә'spend
suspender => sә'spendә
suspender belt => səˈspendə belt
suspends => səˈspendz
suspense => sә'spens
suspenseful => sәs'pensful
suspension => sә'spenʃәn
suspensions => səs'penʃnz
suspensive => sә'spensiv
suspensively => sәsˊpensivli
suspensory => sә'spensәri
suspicion => sә'spiʃәn
suspicions => səsˈpiʃənz
suspicious => sә'spiʃәs
suspiration => .sʌspi'reiʃәn
suspire => sә'spaiә
suspired => səsˈpaiəd
suspires => səsˈpaiəz
suspiring => səsˈpaiərɪŋ
suss => sʌs
sussed => sust
sussex => 'sʌsiks
sussing => sʌsɪŋ
sustain => sә'stein
sustainability => sə,stenə'bɪlɪti
sustainable => sә'steinәbl
sustained => sәs'teind
sustained yield => səˈsteɪnd ji:ld
sustainer => sә'steinә
sustaining => sә'steiniŋ
sustainment => sə'steɪnmənt
sustains => səˈsteinz
sustenance => 'sʌstinәns
sustentation => .sʌsten'teiʃәn
susu => su:'su:
sutherland => 'sʌðәlәnd(ʃiә(r))
Sutlej => 'sʌtlidʒ, -ledʒ
sutler => 'sʌtlә
sutra => 'su:trә
suttee => 'sʌti:
sutton => 'sʌtәn
Suttons => 'sʌtən
sutural => 'su:tʃәrәl
suture => 'su:tʃә
sutured => 'suːtʃə
Suva => 'su:vә
Suwannee => sə'wɔni; -'wɔ:-
suxamethonium => ,sʌksәmi'θәjniәm
Suzanne => su'zæn
suzerain => 'sju:zәrein
suzerainty => 'sju:zәreinti
suzie => 'su:zi
Svalbard => 'svɑ:lbɑ:r
svelte => svelt. sfelt
svengali => svenˈgɑ:li
Sverdlovsk => 'sveәdlɔvsk, svir'dlɔfsk
Sverige => 'sveri:je, 'sværjә
svetlana => svet'lɑ:nә, sfet-
Svizzera => 'zvi:ttserɑ:
swab => swɒb
swabbed => swɔbd
swabbing => 'swɔbiŋ
Swabia => 'sweibiә, -bjә
Swabian => 'sweibiәn, -bjәn
swabs => swɔbz
swacked => swækt
swaddle => swɒdl
swaddled => ˈswɔdld
swaddles => ˈswɔdlz
swaddling => ˈswɔdlɪŋ
swaddling clothes => ˈswɔdlɪŋ
swag => swæg
swage => sweidʒ
swaged => s'wæɡd
swages => sweidʒz
swagged => swæ^d
swagger => 'swægә
swaggered => ˈswægəd
swaggering => 'swæɡәriŋ
swaggeringly => 'swægәriŋli
swaggers => ˈswægəz
swagging => swæg
swaging => 'sweidʒiŋ
swagman => 'swæ^mәn
swags => swæɡz
swahili => swɑ:'hi:li
swain => swein
swains => sweinz
swale => sweil
swallow => 'swɒlәu
swallow dive => ˈswɔləu daiv
swallow hole => ˈswɔləu həul
swallow-tailed => 'swɔlәjteild
swallows => ˈswɔləuz
swallowtail => 'swɒlәuteil
swam => swæm
swami => 'swɑ:mi
swamp => swɒmp
swamp cypress => swɔmp ˈsaɪprɪs
swamper => 'swɔ:mpә
swamphen => 'swɔmp,hen
swamping => s'wɒmpɪŋ
swampland => 'swɔmplænd, 'swɔ:m-
swamps => swɔmps
swampy => 'swɒmpi
swan => swɒn
swan dive => swɔn daiv
Swanee => 'swɔni:, 'swɔ:ni:
swank => swæŋk
swanked => swæŋkt
swanking => swæŋkɪŋ
swanks => swæŋks
swanky => 'swæŋki
swanlike => 'swɔnlaik, 'swɔ:n-
swannery => 'swɒnәri
swanning => 'swɔniŋ, 'swɔ:n-
swans => swɔnz
swansdown => 'swɒnzdaun
swansea => 'swɔnzi
swansong => ˈswɒnsɒŋ
swap => swɒp
swap meet => swɔp mi:t
Swapo => 'swɑ:pәj
swapped => s'wɒpt
swapping => 'swæpiŋ
swaps => swɔps
sward => swɒ:d
sware => swεә
swarf => swɔ:f
swarm => swɒ:m
swarmed => swɔ:md
swarmer => 'swɔ:mә
swarms => swɔ:mz
swart => swɔ:t
swarthily => 'swɒ:ðili
swarthiness => 'swɒ:ðinis
swarthy => 'swɒ:ði
swash => swɒʃ
swashbuckle => 'swɔʃ,bʌkl, 'swɔ:-
swashbuckler => 'swɒʃbʌklә
swashbuckling => 'swɒʃbʌkliŋ
swashed => swɔʃt
swashes => swɔʃiz
swashing => 'swɔʃiŋ
swastika => 'swɔstikә
swastikas => s'wɒstɪkəz
swat => swɒt
swatch => swɒtʃ
swath => swɔ:θ
swathe => sweiθ
swathed => swɔðd
swather => 'swɔ:θә
swathes => swɔðz
Swatow => 'swɔ'taj
swats => swæts
swatted => swɔtid
swatter => 'swɒtә
swatting => swɔtɪŋ
sway => swei
sway bar => swei bɑ:
swayback => 'sweibæk
swaybacked => 'sweibækt
swayed => sweid
swaying => sweiŋ
sways => sweiz
Swazi => 'swɑ:zi
Swaziland => 'swɑ:zilænd
swear => swєә
swear word => swɛə wə:d
swears => swɛəz
sweat => swet
sweat equity => swet ˈekwiti
sweat suit => swet sju:t
sweatband => 'swetbænd
sweated => 'swetid
sweater => 'swetә
sweaters => ˈswetəz
sweatily => 'swetili
sweatiness => 'swetinis
sweating => 'swetiŋ
sweatpants => ˈswetpænts
sweats => swets
sweatshirts => ˈswetˌʃɜ:ts
sweatshop => 'swet,ʃɔp
sweatshops => ˈswetˌʃɔps
sweatsuit => ˈswetsu:t
sweaty => 'sweti
Swede => swi:d
Sweden => 'swi:dn
Swedenborg => 'swi:dn,bɔ:g,
Swedenborgian => 'swi:dn'bɔ:dʒiәn
swedes => swi:dz
swedge => swedʒ
Swedish => 'swi:diʃ
Sweeney => 'swi:ni
sweep => swi:p
sweepback => 'swi:pbæk
sweeper => 'swi:pә
sweepers => ˈswi:pəz
sweeping => 'swi:piŋ
sweeps => swi:ps
sweepstake => 'swi:psteik
sweepstakes => 'swi:psteiks
sweet => swi:t
sweet alyssum => swi:t əˈlisəm
sweet balm => swi:t bɑ:m
sweet basil => swi:t ˈbæzəl
sweet chestnut => swi:t ˈtʃesˌnʌt
sweet corn => swi:t kɔ:n
sweet gum => swi:t ɡʌm
sweet pea => swi:t pi:
sweet pepper => swi:t ˈpepə
sweet spot => swi:t spɔt
sweet talk => swi:t tɔ:k
sweet tooth => swi:t tu:θ
sweet violet => swi:t ˈvaiəlit
sweet-and-sour => 'swi:tәn'sajә(r)
sweet-talking => swi:t ˈtɔ:kɪŋ
sweet-tempered => 'swi:t'tempәd
sweetbread => 'swi:tbred
sweetbreads => 'swi:tbredz
sweetcorn => ˈswi:tkɔ:n
sweeten => 'swi:tn
sweetener => 'swi:tnә
sweeteners => s'wi:tnəz
sweetening => 'swi:tniŋ
sweetens => ˈswi:tnz
sweetheart => 'swi:thɑ:t
sweethearts => ˈswi:tˌhɑ:ts
sweetie => 'swi:ti
sweeting => 'swi:tiŋ
sweetish => 'swi:tiʃ
sweetly => 'swi:tli
sweetmeat => 'swi:tmi:t
sweetmeats => swi:t'mi:ts
sweetness => 'swi:tnis
sweetness and light => ˈswi:tnəs ænd lait
sweetpea => swi:t'pi:
sweets => swi:ts
sweetshop => 'swi:tʃɒp
sweetsop => 'swi:tsɒp
sweety => 'swi:ti
swell => swel
swell box => swel bɔks
swelling => 'sweliŋ
swells => swelz
swelter => 'sweltә
sweltered => ˈsweltəd
sweltering => 'sweltәriŋ
swelters => ˈsweltəz
swept => swept
swept-wing => s'weptw'ɪŋ
swerve => swә:v
swerved => swə:vd
swerves => swə:vz
swerving => 'swɜ:vɪŋ
swidden => 'swidәn
swift => swift
swifter => 'swiftә
swiftest => swɪf'test
swiftlet => 'swiftlit
swiftly => 'swiftli
swiftness => 'swiftnis
swifts => swifts
swifty => 'swifti
swig => swig
swigged => swɪgd
swigger => s'wɪɡər
swigging => swɪgɪŋ
swigs => swɪgz
swill => swil
swilled => swɪld
swilling => swɪlɪŋ
swills => swɪlz
swim => swim
swim bladder => swim ˈblædə
swimfeeder => 'swim,fi:dә(r)
swimmable => 'swimәbl
swimmer => 'swimә
swimmeret => 'swimәret
swimmers => s'wɪməz
swimming => 'swimiŋ
swimming bath => ˈswɪmɪŋ bɑ:θ
swimming crab => ˈswɪmɪŋ kræb
swimming hole => ˈswɪmɪŋ həul
swimming pool => ˈswɪmɪŋ pu:l
swimmingly => 'swimiŋli
swims => swimz
swimsuit => 'swimsju:t
swimsuits => ˈswɪmˌsu:ts
swimwear => ˈswɪmweə(r)
swindle => swindl
swindled => ˈswɪndld
swindler => 'swindlә
swindles => ˈswɪndlz
swine => swain
swine flu => swaɪn flu:
swineherd => 'swainhә:d
swines => swaɪn
swing => swiŋ
swing bridge => swiŋ bridʒ
swing door => swiŋ dɔ:
swing set => swiŋ set
swing state => swiŋ steit
swing vote => swiŋ vəut
swing voter => swiŋ ˈvəʊtə
swing-boat => s'wɪŋb'əʊt
swing-wing => ˈswɪŋˌwɪŋ
swingboat => 'swiŋbәut
swingby => 'swiŋbai
swinge => swindʒ
swingeing => 'swindʒiŋ
swinger => 'swiŋә
swingers => ˈswiŋəz
swinging => 'swiŋiŋ
swingle => 'swiŋgl
swingletree => 'swiŋ^ltri:
swingman => s'wɪŋmæn
swingometer => swiŋ'ɔmitә(r)
swingy => s'wɪnɡɪ
swinish => 'swainiʃ
swinishly => ˊswainiʃli
swipe => swaip
swipe card => swaɪp kɑ:d
swiped => swaɪpt
swipes => swaips
swiping => swaɪpɪŋ
swirl => swә:l
swirled => swɜ:ld
swirls => swɜ:lz
swish => swiʃ
swished => swɪʃt
swishes => swɪʃiz
swishing => swɪʃɪŋ
Swiss => swis
switch => switʃ
switchable => s'wɪtʃeɪbl
switchback => 'switʃbæk
switchbacks => ˈswitʃbæks
switchblade => 'switʃbleid
switchboard => 'switʃbɒ:d
switchboards => s'wɪtʃbɔ:dz
switched => switʃt
switched-on => s'wɪtʃt'ən
switcher => 'switʃә
switcheroo => ,switʃә'ru:
switchgear => 'switʃ^iә
switchgrass => 'switʃ^rɑ:s; -^ræs
switching => 'switʃiŋ
switchover => 'switʃәuvә
switchyard => 'switʃjɑ:d
swither => 'swiðә
Switzerland => 'switsәlәnd
swive => swaiv
swivel => 'swivl
swiveling => 'swivliŋ
swivelled => swɪvdl
swivelling => ˈswɪvəlɪŋ
swivels => ˈswɪvəlz
swivet => 'swivit
swiz => swiz
swizz => swiz
swizzle => 'swizl
swizzle stick => ˈswɪzl stɪk
swollen => 'swәulәn
swoon => swu:n
swooned => swu:nd
swooning => swu:nɪŋ
swoons => swu:nz
swoony => 'swu:ni
swoop => swu:p
swooped => swu:pt
swooping => swu:pɪŋ
swoops => swu:ps
swoosh => swuʃ
swooshed => swu:ʃt
swooshes => swu:ʃiz
swooshing => swu:ʃɪŋ
swop => swɔp
swopped => swɒp
swopping => swɒp
sword => sɒ:d
sword dance => sɔ:d dɑ:ns
sword fern => sɔ:d fɜ:n
sword lily => sɔ:d ˈlili
swordbill => 'sɒ:dbil
swordfish => 'sɒ:dfiʃ
swordplay => 'sɒ:dplei
swordsman => 'sɒ:dzmәn
swordsmanship => 'sɔ:dzmәnʃip
swordsmen => 'sɔ:dzmən
swordtail => 'sɔːdteɪl
swore => swɔ:, swɔә
sworn => swɒ:n
swot => swɒt
swots => swɔts
swotted => swɔtid
swotting => swɔtɪŋ
swum => swʌm
swung => swʌŋ
swung dash => swʌŋ dæʃ
sybarite => 'sibәrait
sybaritic => ,sibә'ritik
sybaritism => 'sibәraitizәm
sybil => 'sibil
sycamine => 'sikәmain
sycamore => 'sikәmɒ:
sycamores => ˈsɪkəˌmɔ:z
syce => sais
syconium => sai'kәuniәm
sycophancy => 'sikәfәnsi
sycophant => 'sikәfәnt
sycophantic => .sikә'fæntik
sycophants => ˈsɪkəfənts
sycosis => sai'kәusis
sydney => 'sidni
syenite => 'saiәnait
syenitic => saiә'nitik
syllabary => 'silәbәri
syllabi => 'silәbai
syllabic => si'læbik
syllabically => si'læbikli
syllabicity => silæ'bisiti
syllabification => 'silæbifi'keiʃәn
syllabified => siˈlæbifaid
syllabifies => siˈlæbifaiz
syllabify => si'læbifai
syllabifying => siˈlæbifaiŋ
syllabize => 'silәbaiz
syllable => 'silәbl
syllabled => 'sɪləbld
syllables => ˈsiləblz
syllabub => 'silәbʌb
syllabus => 'silәbәs
syllepsis => si'lepsis
sylleptic => si'leptik
syllogism => 'silәdʒizm
syllogistic => .silә'dʒistik
syllogistically => .silә'dʒistikli
syllogize => 'silәdʒaiz
sylph => silf
sylphlike => 'silflaik
sylvan => 'silvәn
Sylvaner => sil'vɑ:nә
sylvatic => sil'vætik
Sylvester => sil'vestә(r)
sylvinite => 'silvinait
sylvite => 'silvait
symbiont => 'simbaiɔnt
symbiosis => .simbai'әusis
symbiote => sim'baiәut
symbiotic => .simbai'ɒtik
symbol => 'simbl
symbolic => sim'bɒlik
symbolical => sim'bɔlikl
symbolically => sɪm'bɒlɪklɪ
symbolics => sim'bɔliks
symbolise => 'simbәlaiz
symbolism => 'simbәlizm
symbolist => 'simbәlist
symbolization => .simbәlai'zeiʃәn
symbolize => 'simblaiz
symbolized => ˈsɪmbəˌlaɪzd
symbolizes => ˈsɪmbəˌlaɪziz
symbolizing => ˈsɪmbəˌlaɪzɪŋ
symbology => sim'bɒlәdʒi
symmetric => si'metrik
symmetrical => si'metrikl
symmetrically => si'metikli
symmetries => ˈsimitriz
symmetrize => 'simәtraiz
symmetrized => ˈsimitraizd
symmetrizes => ˈsimitraiziz
symmetrizing => ˈsimitraizɪŋ
symmetry => 'simitri
SYMONDS => 'saimәndz, 'simәndz
sympathectomy => ,simpә'θektәmi
sympathetic => .simpә'θetik
sympathetic magic => ˌsimpəˈθetik ˈmædʒik
sympathetically => .simpә'θetikli
sympathise => 'simpәθaiz
sympathiser => 'sɪmpəθaɪzə
sympathize => 'simpәθaiz
sympathized => ˈsimpəθaizd
sympathizer => 'simpәθaizә
sympathizers => ˈsɪmpəθaɪzəz
sympathizes => ˈsimpəθaiziz
sympathizing => ˈsimpəθaizɪŋ
sympatholytic => ,simpәθәu'litik
sympathomimetic => ,simpәθәumi'metik
sympathy => 'simpәθi
sympatric => sim'pætrik
sympatry => 'simpәtri
sympetalous => sim'petәlәs
symphonic => sim'fɒnik
symphonic poem => sɪmˈfɔnɪk ˈpəuim
symphonies => ˈsimfəniz
symphonist => 'simfәnist
symphony => 'simfәni
symphony orchestra => ˈsimfəni ˈɔ:kistrə
symphysial => ,sim'fiziәl
symphysis => 'simfәsis
symplasm => 'simplæzm
sympodial => sim'pәjdiәl
sympodium => sim'pәudiәm
symposiast => sim'pәuzi,æst
symposium => sim'pәuziәm
symptom => 'simptәm
symptomatic => .simptә'mætik
symptomatically => sɪmptə'mætɪklɪ
symptomatology => .simptәmә'tɒlәdʒi
symptomize => 'simptәmaiz
symptomology => ,simptә'mɔlәdʒi
synaesthesia => ,sinis'θi:ziә,-ʒiә,-ni:s-
synaesthetic => ,sinis'θetik,-ni:s-
synagogical => .sinә'gɒdʒikl
synagogue => 'sinәgɒg
synagogues => ˈsɪnəˌgɔgz
synapomorphy => si'næpә,mɔ:fi
synapse => si'næps
synapses => saɪ'næpsɪs
synapsid => saɪ'næpsɪd
synapsis => si'næpsis
synarchy => 'sinɑ:ki
synarthrosis => .sinɑ:'θrәusis
synastry => si'næstri; 'sinəstri
sync => siŋk
syncarpous => sin'kɑ:pәs
synch => siŋk
synchondrosis => ,siŋkәn'drәusis
synchro => 'siŋkrәu
synchro- => 'sɪŋkrəʊ
synchrocyclotron => ,siŋkrәj'saiklәtrɔn,-'sik-,,sin-
synchromesh => 'siŋkrәmeʃ
synchronic => siŋ'krɔnik
synchronically => siŋˈkrɔnikəli
synchronicity => ,siŋkrә'nisәti,,sin-
synchronisation => ˌsɪŋkrənaɪ'zeɪʃən
synchronise => 'siŋkrәnaiz, 'sin-
synchronism => 'siŋkrәnizәm
synchronistic => ,sɪnkrə'nɪstɪk
synchronization => ,siŋkrәnai'zeiʃәn
synchronize => 'siŋkrәnaiz
synchronized swimming => ˈsɪŋkrəˌnaɪzd, ˈsɪn-
synchronizer => 'siŋkrәnaizә
synchronizes => ˈsɪŋkrəˌnaɪziz
synchronizing => 'siŋkrәnaiziŋ
synchronous => 'siŋkrәnәs
synchrony => 'siŋkrәni
synchrotron => 'siŋkrәtrәn
syncing => sɪŋk
synclinal => 'siŋklainl
syncline => 'siŋklain
syncopal => 'siŋkәpl
syncopate => 'siŋkәpeit
syncopated => ˈsɪŋkəpeɪtɪd
syncopates => ˈsɪŋkəˌpeɪts
syncopating => ˈsɪŋkəˌpeɪtɪŋ
syncopation => .siŋkә'peiʃәn
syncope => 'siŋkәpi
syncretic => siŋ'kretik
syncretism => 'siŋkrәtizm
syncretist => 'siŋkritist,'sin-
syncretize => 'siŋkrәtaiz
syncretized => ˈsiŋkrəˌtaizd
syncretizes => ˈsiŋkrəˌtaiziz
syncretizing => ˈsiŋkrəˌtaizɪŋ
syncs => sɪŋk
syncytium => sin'siʃiәm
syndactyly => sin'dæktili
syndesmosis => ,sindes'mәusis
syndetic => sin'detik
syndic => 'sindik
syndical => 'sindikl
syndicalism => 'sindiklizm
syndicalist => 'sindiklist
syndicate => 'sindikit
syndicates => ˈsindikits
syndicating => ˈsindikitɪŋ
syndication => .sindi'keiʃәn
syndicator => 'sindikeitә(r)
syndiotactic => ,sindiәu'tæktik
syndrome => 'sindrәum
syndromes => 'sɪndrəʊmz
syndromic => sin'drәumik, -'drɔ-
syne => sain
synecdoche => si'nekdәki
synecology => ,sini'kɔlәdʒi
synectic => si'nektik
synectics => si'nektiks
syneresis => si'niәrәsis
synergetic => ,sinә'dʒetik
synergic => si'nә:dʒik
synergies => sɪ'nɚdʒɪd; 'sɪnədʒɪd
synergism => 'sinәdʒizm
synergist => 'sinәdʒist
synergistically => -kli
synergy => 'sinәdʒi
synesthesia => ,sinis'θi:ʒә, -ʒiә
synesthetic => ,sinis'θetik,-ni:s-
synfuel => sin'fjuәl
syngamy => 'siŋ^әmi
syngas => 'sin^æs
Synge => siŋ
syngeneic => ,sindʒi'ni:ik
synod => 'sinәd
synodal => 'sinәdl
synodic => si'nɔdik
synodic month => siˈnɔdik mʌnθ
synodical => si'nɔdikәl
synods => ˈsinədz
synonym => 'sinәnim
synonymic => ,sinә'nimik
synonymity => .sinә'nimiti
synonymous => si'nɒnimәs
synonyms => 'sɪnənɪmz
synonymy => si'nɔnimi
synopsis => si'nɒpsis
synopsize => si'nɔpsaiz
synoptic => si'nɒptik
synoptical => si'nɔptikәl
synoptically => siˊnɒptikәli
synoptist => si'nɔptist
synostosis => ,sinɔs'tәjsis
synovial => si'nәjviәl, sai-
synovitis => .sinә'vaitis
syntactic => sin'tæktik
syntactical => sin'tæktikl
syntactically => sin'tæktikli
syntagm => 'sintæm
syntagmatic => ˌsɪntæg'mætɪk
syntagmatics => sintә^'mætiks
syntax => 'sintæks
synth => sinθ
synthase => 'sinθeis
synthesis => 'sinθisis
synthesise => 'sinθisaiz
synthesised => 'sɪnθɪsaɪz
synthesiser => 'sɪnθɪsaɪz
synthesist => 'sinθisist
synthesize => 'sinθisaiz
synthesizer => 'sinθisaizә
synthesizes => ˈsɪnθɪˌsaɪziz
synthesizing => 'sɪnθə,saɪz
synthetic => sin'θetik
synthetical => sin'θetikl
synthetically => sin'θetikli
synthetics => sin'θetiks
synthon => 'sinθɔn
syntone => 'sintәun
syntonic => sin'tɒnik
syntype => 'sin,taip
syphilis => 'sifilis
syphilitic => .sifi'litik
syphon => 'saifәn
syphoned => ˈsaɪfənd
syphoning => ˈsaɪfənɪŋ
syphons => 'saɪfənz
syracuse => 'saiәrәkju:z
Syria => 'siriә
Syriac => 'siriæk
Syrian => 'siriәn
syringa => si'riŋgә
syringe => 'sirindʒ
syringes => si'rindʒi:z
syringing => 'sɪrɪndʒɪŋ
syringomyelia => si,riŋ^әumai'i:liә
syrinx => 'siriŋks
Syro- => 'sairәj,'si-
syrphid => 's\\\\:fid
syrup => 'sirәp
syrups => 'sɪrəps
syrupy => 'sirәpi
system => 'sistәm
system operator => ˈsistəm ˈɔpəreitə
systematic => .sisti'mætik
systematically => .sisti'mætikli
systematics => ,sisti'mætiks
systematise => 'sistimәtaiz
systematised => 'sistimətaiz
systematist => 'sistimәtist
systematize => 'sistimәtaiz
systematized => ˈsistimətaizd
systematizer => 'sistimәtaizә
systematizes => ˈsistimətaiziz
systematizing => ˈsistimətaizɪŋ
systemic => si'stemik
systemization => ,sɪstəmɪ'zeʃən
systemize => 'sistәmaiz
systemized => ˈsistəmaizd
systemizing => ˈsistəmaizɪŋ
systemless => 'sistәmlis
systole => 'sistәli
systolic => si'stɒlik
syzygy => 'sizidʒi
Szczecin => ʃtʃe'tsin
Szechuan => 'setʃ'wa:n
Szeged => 'se^ed