M => em
m-commerce => em ˈkɔmə:s
MA => mɑ:
ma non troppo => mɑ:nɔn'trɔpәu
ma'am => mæm, mɑ:m, mәm
maar => mɑ:
Maas => mɑ:s
Maastricht => mɑ:s'trikt
Maat => mә'ɑ:t
MAB => mæb
mabel => 'meibl
mabela => mɑ:'belә
mac => mæk
macabre => mә'kɑ:brә
macadam => mә'kædәm
macadamia => ,mækә'deimiә
macadamize => mә'kædәmaiz
macadamizing => mə'kædəmaɪzɪŋ
Macanese => mækə'ni:z-'ni:s
Macao => mә'kau
macaque => mә'kɑ:k
macaroni => .mækә'rәuni
macaroni cheese => ˌmækəˈrəʊni: tʃi:z
macaronic => .mækә'rɒnik
macaronis => ˌmækəˈrəʊni:z
macaroon => .mækә'ru:n
macaroons => ,mækə'ruːn
MacArthur => mæ'kɑ:θә, mәk'ɑ:θә
Macassar => mә'kæsә(r)
Macaulay => mә'kɔ:li
macaw => mә'kɒ:
Macbeth => mәk'beθ
Maccabean => ,mækә'bi:әn
Maccabees => 'mækәbi:z
macdonald => mәk'dɔnәld
mace => meis
macedon => 'mæsidɔn
Macedonia => ,mæsi'dәunjә
Macedonian => .mæsә'dәuniәn
macer => 'meisә
macerate => 'mæsәreit
macerated => 'mæsə,ret
macerates => 'mæsəreɪt
maceration => ,mæsә'reiʃәn
Macfarlane => mәk'fɑ:lin
Mach => mɑ:k
machair => 'mætʃeә
machan => mә'tʃɑ:n
mache => mɑ:ʃ
macher => 'mɑ:hər
machete => mә'tʃeiti
machetes => mɑ:'tʃeiti
Machiavel => ,mækiә'vel
Machiavelli => .mɑ:kjɑ:'veli:
machiavellian => .mækiә'veliәn
machicolate => mæ'tʃikәuleit
machicolated => mætʃɪkəʊ'leɪtɪd
machicolation => mæ,tʃikәj'leiʃәn,mә-
machin => mә'tʃi:n
machinability => mәʃi:nә'biliti
machinable => mә'ʃi:nәbl
machinate => 'mækineit
machinated => ˈmækineitid
machinates => ˈmækineits
machinating => ˈmækineitɪŋ
machination => mæki'neiʃәn
machinator => 'mækineitә
machine => mә'ʃi:n
machine tool => məˈʃi:n tu:l
machine-gun => mә'ʃi:n^ʌn
machine-gunner => mə'ʃi:nɡʌn
machine-made => mә'ʃi:nmeid
machinery => mә'ʃi:nәri
machining => mә'ʃi:niŋ
machinist => mә'ʃi:nist
machismo => mɑ:'tʃi:zmәu
Machmeter => 'mɑ:k.mi:tә
macho => 'mɑ:tʃәu
Machtpolitik => 'mɑ:ht,pɔliti:k
mack => mæk
mackerel => 'mækәrәl
mackerel shark => ˈmækərəl ʃɑ:k
mackinaw => 'mækinɒ:
mackintosh => 'mækintɒʃ
mackintoshes => 'mækɪntɒʃ
mackle => 'mækl
macle => 'mækl
MacLeod => mә'klaud
Macquarie => mə'kwɔri
macrame => mә'krɑ:mi
macro => 'mækrәu
macro lens => ˈmækrəu lenz
macro- => 'mækrәj
macrobiotic => ,mækrәubai'ɔtik
macrobiotics => .mækrәubai'ɒtiks
macrocarpa => ,mækrә'kɑ:pә
macrocephalic => .mækrәuse'fælik
macrocephaly => ,mækrәu'sefәli
macrocosm => 'mækrәukɒzәm
macrocosmically => ,mækrəu'kɔzmikəli
macrocycle => 'mækrә'saikl
macroeconomic => -mik
macroeconomics => ,mækrәu,i:kә'nɔmiks
macroeconomist => ,mækrəʊɪ'kɒnəmɪst
macroevolution => ,mækrәu,evә'lu:ʃәn
macroevolutionary => ,mækrəʊ,iːvə'luːʃənərɪ
macrogamete => ,mækrәu'^æmi:t, -^ә'mi:t
macromolecule => .mækrәu'mɒlikju:l
macromolecules => mækrɒmə'lekju:lz
macron => 'mækrәn
macronutrient => ,mækrәu'nju:triәnt
macrophage => 'mækrәfeidʒ
macrophages => məkrə'fɑ:dʒɪz
macrophotography => ,mækrәfә'tɔ^rәfi
macrophyte => 'mækrәfait
macros => 'mækrɔs
macroscopic => ,mækrәu'skɔpik
macrostructure => .mækrәu'strʌktʃә
macruran => mә'kruәrәn
macrurous => mә'kruәrәs
macula => 'mækjulә
macular => 'mækjulә
maculate => 'mækjuleit
maculating => 'mækjʊleɪt
maculation => .mækju'leiʃәn
macumba => mә'kumbә
macushla => mə'kuːʃlə
mad => mæd
mad cow disease => mæd kau diˈzi:z
Madagascar => mædә'^æskә
madam => 'mædәm
madame => 'mædәm
madams => 'mædəmz
madarosis => .mædәu'rәusis
madcap => 'mædkæp
madden => 'mædn
maddening => 'mædniŋ
maddeningly => 'mædnɪŋlɪ
maddens => 'mæd(ə)n
madder => 'mædә
maddest => 'mædɪst
madding => 'mædiŋ
made => meid
made-up => 'meid'ʌp
Madeira => mә'diәrә
Madeleine => 'mædәlin, -lein
Mademoiselle => ,mædәmә'zel
maderization => mә,diәrai'zeiʃәn;-ri'z-
Madge => mædʒ
madhouse => 'mædhaus
madhouses => 'mædhaʊs
madison => 'mædisn
madly => 'mædli
madman => 'mædmәn
madmen => 'mædmən
madness => 'mædnis
Madonna => mә'dɒnә
madras => mә'dræs
madre => 'mɑ:ðre
madreporarian => ,mædrәpɔ:'reәriәn
madrepore => 'mædripɒ:
madreporite => 'mædri,pɔ:rait
Madrid => mә'drid
madrigal => 'mædrigәl
madrigalist => 'mædrɪɡəlɪst
madrigals => 'mædrɪg(ə)l
madrilene => 'mædrilen,,mædri'len
Madura => mә'duәrә
Madurai => 'mædjjrai,,mɑ:dә'rai
Madurese => ,mædju'ri:z
madwoman => 'mædwumәn
madwomen => 'mædwʊmən
mae => mei
Mae West => mei 'west
Maecenas => mi:'si:næs
maelstrom => 'meilstrәm
maenad => 'mi:næd
maenadic => mi'nædik
maestoso => ,mɑ:es'tәuzәu, -sәu
maestro => mɑ:'estrәu
Maeterlinck => 'meitәliŋk
Mafeking => 'mæfikiŋ
mafia => 'mæfiә
mafic => 'mæfik
Mafioso => .mɑ:fi'әusәu
MAG => mæ^
mag tape => mæɡ teip
maga => 'mæɡə
magazine => .mægә'zi:n
Magda => 'mæ^dә
Magdalen => 'mæ^dәlin, -li:n
Magdalena => ,mæɡdə'leinə; -'li:-
magdalene => 'mægdәli:n
Magdalenian => .mægdә'li:niәn
Magdeburg => 'mæ^dәbә:^
mage => meidʒ
Magellan => mә'^elәn, -'dʒelәn
Magen David => mɑ:'^ein dɑ:'vi:d, 'mɔ:^әn'dɔ:vid
magenta => mә'dʒentә
Maggie => 'mæ^i
maggot => 'mægәt
maggoty => 'mægәti
Maghrib => 'mʌ^rәb
magi => 'meidʒai,'mæ-
Magian => 'meidʒiәn
magic => 'mædʒik
magic bullet => ˈmædʒik ˈbulit
magic mushroom => ˈmædʒik ˈmʌʃrum
magic realism => ˈmædʒik ˈri:əˌlɪzəm
magic wand => ˈmædʒik wɔnd
magical => 'mædʒikәl
magician => mә'dʒiʃәn
magicians => məˈdʒɪʃənz
magilp => mә'^ilp
maginot => 'mæʒinәu
magister => mә'dʒistә
magisterial => .mædʒi'stiәriәl
magisterially => mædʒɪ'stɪərɪəlɪ
magisterium => .mædʒis'tiәriәm
magistracies => ˈmædʒɪstrəsi:z
magistracy => 'mædʒistrәsi
magistral => 'mædʒistrәl
magistrand => 'mædʒistrɑ:nd
magistrate => 'mædʒistreit
magistrates => ˈmædʒistrits
magistrature => 'mædʒistrәtjuә
Maglemosian => mæ^li'mәuziәn
maglev => 'mæ^lev
magma => 'mægmә
magmatic => 'mægmətɪk
magna cum laude => 'mɑ:^nɑ:kum'laude, 'mæ^nәkʌm'lәudi:
magnanimity => .mægnә'nimiti
magnanimous => mæg'nænimәs
magnanimously => mæg'næniməsli
magnate => 'mægneit
magnesia => mæg'ni:ʃә
magnesian => mæg'ni:ʃәn
magnesite => 'mægnisait
magnesium => mæg'ni:ziәm
magnet => 'mægnit
magnet school => ˈmæɡnit sku:l
magnetic => mæg'netik
magnetic equator => mæɡˈnetik iˈkweitə
magnetic mine => mæɡˈnetik main
magnetic resonance imaging => mæɡˈnetik ˈrezənəns iˈmædʒiŋ
magnetics => mæg'netiks
magnetise => 'mæ^nitaiz
magnetised => 'mægnɪtaɪzd
magnetism => 'mægnitizm
magnetite => 'mægnitait
magnetizable => 'mæ^nitaizәbl
magnetization => .mægnitai'zeiʃәn
magnetize => 'mægnitaiz
magnetized => 'mægnə,taɪz
magnetizer => 'mæ^nitaizә
magneto => mæg'ni:tәu
magneto- => mæ^'ni:tәj
magneto-optical => mæɡˌni:təuˈɔptikəl
magnetograph => mæg'ni:tәugrɑ:f
magnetohydrodynamic => mæ^'ni:tәj,haidrәjdai'næmik
magnetohydrodynamics => mæ^,ni:tә,haidrәudai'næmiks
magnetometer => .mægni'tɒmitә
magnetometry => ,mæ^ni'tɔmitri
magneton => 'mægnitɒn
magnetopause => mæ^'ni:tәupɔ:z
magnetoresistance => mæ^,ni: tәjri'zistәns
magnetoresistive => mæɡ,ni:təuri'zistiv
magnetosphere => mæg'ni:tәsfiә
magnetotail => mæ^'ni:tәjteil
magnetron => 'mægnitrɒn
magnets => 'mæɡnɪts
Magnificat => mæ^'nifikæt
magnification => .mægnifi'keiʃәn
magnificence => mæg'nifisns
magnificent => mæg'nifisnt
magnificently => mæɡ'nɪfɪsntlɪ
magnifico => mæg'nifikәu
magnifier => 'mægnifaiә
magnify => 'mægnifai
magnifying => 'mæ^nifaiiŋ
magniloquence => mæg'nilәukwәns
magniloquent => mæg'nilәukwәnt
Magnitogorsk => mæ^'ni:tәu'^ɔ:sk
magnitude => 'mægnitju:d
magnolia => mæg'nәuliә
magnox => 'mæ^nɔks
magnum => 'mæ^nәm
magnum opus => mæ^nәm 'әjpәs
magnums => 'mægnəm
magnus => 'mæ^nәs
magpie => 'mægpai
magpies => 'mægpɚɪz
magsman => 'mægzmәn
maguey => 'mægwei
magus => 'meigәs
Magyar => 'mægjɑ:
mah-jong => mɑ:'dʒɔŋ
maha => 'mɑ:hɑ:
Mahabad => ,mɑ:hә'bɑ:d
Mahabharata => mә'hɑ:'bɑ:rәtә
Mahal => 'mæhæl
maharaja => ,mɑ:hә'rɑ:dʒә
maharajah => mɑ:hə'rɑ:dʒə
maharajas => ,mɑː(h)ə'rɑːdʒə; ,məhɑː-
maharani => maːhәˊraːniː
Maharashtra => ,mɑ:hə'rɑ:ʃtrə
Maharashtrian => ,mɑ:hә'rɑ:ʃtriәn
maharishi => ˌmɑ:hɑ:ˈri:ʃi
mahatma => mә'hɑ:tmә
Mahayana => .mɑ:hә'jɑ:nә
Mahdi => 'mɑ:di
Mahdism => 'mɑ:dizәm
Mahican => mә'hi:kәn
mahimahi => mɑ:ɪ'mɑ:aɪ
mahjong => ma:'dʒɔŋ
Mahler => 'malər
Mahlerian => mɑ:'liәriәn
mahlstick => 'mɔ:lstik
mahoe => mә'hәj
mahogany => mә'hɑ:gәni
Mahon => mɑ:'hɔ:
mahonia => mə'həʊnjə
mahout => mә'haut
Mahratta => mә'rætә
Mahratti => mә'rɑ:ti,-'ræ-
maid => meid
maidan => mai'dɑ:n
maiden => 'meidn
maiden aunt => ˈmeidn ɑ:nt
maiden name => ˈmeidn neim
maiden over => ˈmeidn ˈəuvə
maidenhair => 'meidnhєә
maidenhair tree => ˈmeid(ə)nheə tri:
maidenhead => 'meid(ә)nhed
maidenhood => 'meidnhud
maidenish => 'meidniʃ
maidenly => 'meidnli
maidens => ˈmeidnz
maidservant => 'meidsә:vәnt
Maidstone => 'meidstәn
maieutic => mei'ju:tik
maigre => 'meigә
mail => meil
mail bomb => meil bɔm
mail train => meil trein
mailable => 'meilәbl
mailbag => 'meilbæg
mailbags => 'meɪlbæg
mailboat => 'meilbәjt
mailbox => 'meilbɒks
mailed => meild
mailer => 'meilә
mailers => 'meɪlə(r)
mailing => 'meiliŋ
maillot => mɑ:'jәu
mailman => 'meilmæn
mailmen => 'meɪlmən
mailroom => 'meɪlru:m
mailshot => ˈmeɪlʃɒt
maim => meim
maimed => meimd
Maimonides => mai'mɔnidi:z
maims => meɪm
main => mein
main drag => mein dræɡ
main sequence => mein ˈsi:kwəns
main street => mein stri:t
Maine => mein
mainframe => 'meinfreim
mainland => 'meinlәnd
mainlander => ˈmeɪnlændə
mainliner => 'meinlainә
mainlines => 'meɪn,laɪn
mainly => 'meinli
mainmast => 'meinmɑ:st
mainsail => 'meinseil
mainsheet => 'meinʃi:t
mainspring => 'meinspriŋ
mainstay => 'meinstei
mainstream => 'meinstri:m
mainstreaming => 'mein.stri:miŋ
maintain => mein'tein
maintainer => men'teinә
maintains => meinˈteinz
maintenance => 'meintәnәns
maintop => 'meintɒp
Mainz => maints
maiolica => mə'jɔlikə
Mair => meә
Maisie => 'meizi
maisonette => ,meizә'net
maisonettes => ,meɪzə'net
maize => meiz
maizena => 'meizәnә
majestic => mә'dʒestik
majestically => mə'dʒestɪklɪ
majesties => ˈmædʒistiz
majesty => 'mædʒәsti
majlis => mædʒ'lis
majolica => mә'dʒɒlikә
major => 'meidʒә
major axis => ˈmeidʒə ˈæksis
major general => ˈmeidʒə ˈdʒenərəl
major league => ˈmeidʒə li:ɡ
major planet => ˈmeidʒə ˈplænit
major suit => ˈmeidʒə sju:t
major tranquillizer => ˈmeidʒə ˈtræŋkwɪˌlaɪzə(r)
major-league => 'meidʒə'li:ɡ
majorca => mә'dʒɔ:kә, -'jɔ:-
Majorcan => mә'dʒɔ:kәn, -'jɔ:-
majordomo => .meidʒә'dәumәu
majored => 'meɪdʒə
majorette => ,meidʒә'ret
majorettes => ,meɪdʒə'ret
majoritarian => mә.dʒɒri'tєәriәn
majoritarianism => mədʒɒrɪteə'rɪənɪzəm
majorities => məˈdʒɔritiz
majority => mә'dʒɒriti
majority leader => məˈdʒɔriti ˈli:də
majuscule => mә'dʒʌskju:l
makable => 'meikәbl
Makassar => mə'kæsə
make => meik
make do => meik du:
make love => meik lʌv
make-believe => 'meikbi,li:v
make-do => 'meɪkd'u:
make-up => 'meikʌp
makeable => 'meikәbl
maker => 'meikә
makeshift => 'meikʃift
makeup => 'meikʌp
Makhachkala => mә,kɑ:tʃkә'lɑ:
making => 'meikiŋ
Makkah => 'mækә
mako => 'mɑ:kәu
Makua => mɑ:'ku:ɑ:
makuta => mɑ:'ku:tɑ:
mal => mɑ:l
mal de mer => ,mɑ:ldә'mer
mal- => mæl
mala => 'meilә
mala fide => 'meilә'faidi, 'mæ-
mala fides => 'meilә 'faidiz
Malabo => 'mɑ:lɑ:bәu
malabsorption => ,mælæb'sɔ:pʃәn
Malacca => mә'lækә
Malachi => 'mælәkai
malachite => 'mælәkait
malacologist => ,mælə'kɔlədʒist
malacology => .mælә'kɒlәdʒi
malacostracan => ,mælә'kɔstrәkәn
maladaptation => ,mælәdæp'teiʃәn
maladapted => ,mælә'dæptid
maladaptive => ,mælә'dæptiv
maladjusted => .mælә'dʒʌstid
maladjustment => .mælә'dʒʌstmәnt
maladjustments => ,mælə'dʒʌstmənt
maladminister => .mælәd'ministә
maladministration => mælәdminis'treiʃ(ә)n
maladroit => .mælә'drɒit
malady => 'mælәdi
Malaga => 'mælәgә
Malagasy => ,mælә'^æsi
malaise => mæ'leiz
malamute => 'mælәmju:t
Malan => 'mælәn
malanga => mә'læŋ^ә
malapert => 'mælәpә:t
malapropism => 'mælә'prɔpizәm
malapropos => .mæl'æprәpәu
malar => 'meilә
malaria => mә'lєәriә
malarial => mә'leәriәl
malariology => mә,leәri'ɔlәdʒi
malarkey => mә'lɑ:ki
malate => 'mæleit, 'meileit
malathion => .mælә'θaiɒn
Malawi => mә'lɑ:wi
Malawian => mɑ:'lɑ:wiən
Malay => mә'lei
Malaya => mә'leiә
Malayalam => .mælә'jɑ:lәm
Malayan => mә'leiәn
Malaysia => mә'leiziә
Malaysian => mә'leiziәn
malaysians => məˈleiziənz
malcontent => 'mælkәntent
malcontented => ˈmælkənˈten(t)əd
malcontents => 'mælkəntent
Malden => 'mɔ:ldən
maldevelopment => ,mældi'velәpmәnt
maldistribution => ,mældistri'bju:ʃәn
Maldives => 'mɔ:ldaivz, 'mæl-
Maldivian => mɔ:l'diviәn, mæl-
male => meil
male menopause => meil ˈmenəˌpɔ:z
maleate => mæ'li:t
malediction => .mæli'dikʃәn
maledictory => .mæli'diktәri
malefaction => .mæli'fækʃәn
malefactor => 'mælifæktә
malefactors => 'mælɪ,fæktə
malefic => mә'lefik
maleficence => mә'lefisns
maleficent => mә'lefisnt
maleness => meɪlnəs
malevolence => mә'levәlәns
malevolent => mә'levәlәnt
malevolently => mə'levələntli
malfeasance => mæl'fi:zns
malfeasant => mæl'fi:znt
malformation => .mælfɒ:'meiʃәn
malformed => mæl'fɒ:md
malfunction => .mæl'fʌŋʃәn
malfunctioned => mælˈfʌŋkʃənd
malfunctioning => mæl'fʌŋkʃənɪŋ
Mali => 'mɑ:li
Malian => 'mɑ:liən
malibu => 'mælibu:
malice => 'mælis
malicious => mә'liʃәs
malign => mә'lain
malignancy => mә'lignәnsi
malignant => mә'lignәnt
malignantly => məlɪɡ'nəntlɪ
maligner => mә'lainә
malignity => mә'ligniti
Malik => 'mɑ:lik
malinger => mә'liŋgә
malingered => mə'lɪŋgə
malingerers => mə'liŋgərə
malingers => mə'lɪŋgə
Malinke => mәliŋ'kei
malinvestment => ,mælin'vestmәnt
malison => 'mælizn
malkin => 'mɔ:lkin
mall => mɔ:l
mallard => 'mælәd
malleability => .mæliә'biliti
malleable => 'mæliәbl
mallee => 'mæli
malleolus => mә'li:әlәs
mallet => 'mælit
malleus => 'mæliәs
Malling => 'mɔ:liŋ
Mallorca => mɑ:'jɔ:kә, mɑ:l'jɔ:rkɑ:
mallow => 'mælәu
mallows => 'mæləʊ
malm => mɑ:m
malmsey => 'mɑ:mzi
malnourished => mæl'næriʃt
malnutrition => .mælnju:'triʃәn
malocclusion => ,mælә'klu:ʒәn
malodorous => mæ'lәudәrәs
malodour => mæl'әjdә(r)
malolactic => ,mælәu'læktik
malonate => mælәu'neit
malone => mә'lәun
maloti => mә'lәjti
malpractice => mæl'præktis
malpractices => mælp'ræktɪsɪz
malpresentation => ,mælprezen'teiʃәn
malt => mɒ:lt
malt whisky => mɔ:lt ˈhwiski
Malta => 'mɒ:ltә
maltase => 'mɔ:lteis
malted => ˈmɔ:ltɪd
Maltese => .mɒ:l'ti:z
malthouse => 'mɒ:lthaus
Malthus => 'mælθəs
Malthusian => mæl'θju:zjәn
Malthusianism => mæl'θjjsiәniz(ә)m
malting => 'mɔ:ltiŋ
maltose => 'mɒ:ltәus
maltreat => mæl'tri:t
maltreated => mæl'triːt
maltreater => mæl'tri:tə
maltreating => mæl'triːt
maltreats => mæl'triːt
maltster => 'mɒ:ltstә
malty => 'mɒ:lti
Maluku => mɑ:'lu:ku:
malvaceous => mæl'veiʃәs
malversation => .mælvә:'seiʃәn
Malvinas => mæl'vi:nə
malvoisie => 'mælvɔizi
mam => mæm
mama => 'mɑ:mә
mamaguy => 'mɑ:mә^ai
mamas => 'mæmə; mə'mɑː
mamba => 'mɑ:mbә
mambas => ˈmɑ:mbəz
mambo => 'mɑ:mbәu
mamboed => ˈmɑ:mbəud
mamboing => ˈmɑ:mbəuɪŋ
mambos => ˈmɑ:mbəuz
mamelon => 'mæmilәn
mamey => mæ'mi:, -'mei
mamilla => mæˊmilә
mamillate => 'mæmileit(id)
mamillated => 'mæmileit(id)
mamma => 'mɑ:mә
mammal => mæmәl
mammalian => mæ'meiljәn
mammaliferous => ,mæmә'lifәrәs
mammalogy => mæ'mælәdʒi
mammary => 'mæmәri
mammary gland => ˈmæməri ɡlænd
mammas => 'mæmə; mə'mɑː
mammee => mæ'mi:
mammies => 'mæmɪ
mammiform => 'mæmifɔ:m
mammilla => mæ'milә
mammogram => 'mæmә,^ræm
mammography => mә'mɔ^rәfi
mammon => 'mæmәn
mammoth => 'mæmәθ
mammoths => 'mæməθ
mammy => 'mæmi
man => mæn
man of letters => mæn ɔv ˈletəz
man of the cloth => mæn ɔv ðə klɔθ
man of the world => mæn ɔv ðə wɜː(r)ld
man up => mæn ʌp
man-at-arms => 'mænәt'ɑ:mz
man-child => 'mæntʃaild
man-day => 'mæn'dei
man-eater => 'mæn,i:tә(r)
man-eaters => 'mæn,i:tə
man-hour => 'mæn'auә
man-to-man => 'mæntә'mæn
mana => 'mɑ:nɑ:
manacle => 'mænәkl
manacled => 'mænək(ə)l
manacles => 'mænəklz
manacling => 'mænək(ə)l
manage => 'mænidʒ
manageability => .mænidʒә'biliti
manageable => 'mænidʒәbl
management => 'mænidʒmәnt
manager => 'mænidʒә
manageress => 'mænidʒәris
manageresses => ,mænɪdʒə'res; 'mænɪdʒərɪs
managerial => .mænә'dʒiәriәl
managerialism => ,mæni'dʒiәriәlizәm
managerialist => ,mæni'dʒiәriәlist
managership => 'mænidʒәʃip
managing => 'mænidʒiŋ
managing director => ˈmænidʒiŋ diˈrektə
managua => mә'nɑ:^wә
manaia => mә'naiә
manakin => 'mænәkin
Manasseh => mә'næsә
manat => 'mænæt
manatee => .mænә'ti:
Manaus => mɑ:'najs
Manche => mɑ:nʃ
Manchester => 'mæntʃestә
manchet => 'mæntʃit
manchineel => .mæntʃi'ni:l
Manchu => mæn'tʃu:
Manchuria => mæn'tʃuriә
Manchurian => mæn'tʃuriәn
manciple => 'mænsipl
Mancunian => mæŋ'kju:niәn
mandala => 'mʌndәlә
Mandalay => ,mændә'lei
mandamus => mæn'deimәs
Mandan => 'mændæn
mandarin => 'mændәrin
mandarin collar => ˈmændərin ˈkɔlə
mandarin orange => ˈmændərin ˈɔrindʒ
mandarinate => 'mændərɪneɪt
mandatary => 'mændәtәri
mandate => 'mændeit
mandatory => 'mændәtәri
Mande => 'mɑ:ndei
Mandean => mæn'diәn
Mandel => 'mændәl
Mandela => mæn'delә
mandible => 'mændibl
mandibles => 'mændɪb(ə)l
mandibular => mæn'dibjulә
mandibulate => mæn'dibju:lit
mandir => 'mʌndiә(r)
mandola => mæn'dәjlә
mandolin => 'mændәlin
mandoline => mændə'li:n
mandolins => 'mændəlɪn; mændə'lɪn
mandorla => mæn'dɔ:lә
mandragora => mæn'dræ^әrә
mandrake => 'mændreik
mandrakes => 'mændreɪk
Mandrax => 'mændræks
mandrel => 'mændril
mandrels => 'mændr(ə)l
mandrill => 'mændril
mandrills => 'mændrɪl
manducate => 'mændjukeit
manducates => 'mændjʊkeɪt
manducatory => mæn'dju:kәtәri
mandy => 'mændi
mane => mein
maneater => ˈmæni:tə(r)
maned => meind
manes => 'meini:z
Manet => 'mɑ:net
maneuver => mә'nu:vә
maneuverability => mә.nu:vәrә'biliti
maneuverable => mә'nu:vәrәbl
maneuvered => məˈnu:vəd
maneuvering => mə'nu:vərɪŋ
maneuvers => məˈnu:vəz
Manfred => 'mænfred
manful => 'mænful
manga => 'mæŋɡә
mangabey => 'mæŋ^әbei
manganate => 'mæŋ^әneit
manganese => 'mæŋ^әni:z
manganic => mæŋ'^ænik
manganite => 'mæŋ^әnait
manganous => 'mæŋ^әnәs
mange => 'meindʒ
mangel => 'mæŋ^l
manger => 'meindʒә
mangetout => 'mændʒitaut
mangey => 'meindʒi
manginess => 'meindʒinis
mangle => 'mæŋgl
mango => 'mæŋgәu
mangold => 'mæŋ^әld
mangonel => 'mæŋ^әnel
mangosteen => 'mæŋgәsti:n
mangrove => 'mæŋgrәuv
mangy => 'meindʒi
manhandle => 'mænhændl
manhandles => 'mænhænd(ə)l
manhandling => 'mænhænd(ə)l
Manhattan => mæn'hætәn
manhole => 'mænhәul
manhood => 'mænhud
manhunt => 'mænhʌnt
mania => 'meiniә
maniac => 'meiniæk
maniacal => mә'naiәkәl
manic => 'meinik
manic depression => ˈmænɪk diˈpreʃən
manic-depressive => ,mænikdi'presiv
manic-depressives => ,mænikdi'presiv
manically => 'mænikli
Manichaean => ,mæni'ki:ən
Manichee => 'mæniki:
manicotti => ,mænә'kɔti
manicou => 'mɑ:nikj
manicure => 'mænikjuә
manicured => ˈmænɪkjʊəd
manicuring => ˈmænɪˌkjʊərɪŋ
manicurist => 'mænikjurist
manicurists => 'mænɪkjʊərɪst
manifest => 'mænifest
manifestation => .mænifes'teiʃәn
manifested => ˈmænifestid
manifesting => 'mænɪfestɪŋ
manifestly => 'mænifestli
manifesto => .mæni'festәu
manifests => ˈmænifests
manifold => 'mænifәuld
manifolded => ˈmænəˌfəʊldid
manifolding => 'mænifәuldiŋ
manifoldness => 'mænɪfəʊldnes
manifolds => ˈmænəˌfəʊldz
manikin => 'mænikin
Manila => mә'nilә
Manilla => mә'nilә
manille => mә'nil
manioc => 'mæniɒk
maniple => 'mænipl
manipulability => mənɪpjʊlə'bɪlɪtɪ
manipulable => mә'nipjulәbl
manipular => mә'nipjulә
manipulate => mә'nipjuleit
manipulated => məˈnipjuleitid
manipulates => məˈnipjuleits
manipulation => mә.nipju'leiʃәn
manipulations => məˌnɪpjʊˈleɪʃɵnz
manipulative => mә'nipjulәtiv
manipulator => mә'nipjuleitә
manipulators => mə'nɪpjʊleɪtəz
manipulatory => mә'nipjjlәtəri
Manipur => ,mʌni'pjә(r), 'mʌnip-
Manipuri => ,mʌni'puәri
manitoba => ,mæni'tәubә
manitou => 'mænitu:
mankind => mæn'kaind
manky => 'mæŋki
manless => 'mænlis
manlike => 'mælaik
manliness => 'mænlinis
manly => 'mænli
mann => mæn
manna => 'mænә
Mannar => mә'nɑ:(r)
manned => mænd
mannequin => 'mænikin
manner => 'mænә
mannered => 'mænәd
mannerism => 'mænәrizm
mannerisms => 'mænərɪz(ə)m
mannerist => 'mænәrist
mannerless => 'mænәlis
mannerly => 'mænәli
manners => 'mænәs
Mannheim => 'mænhaim
mannie => 'mæni
mannikin => 'mænikin
manning => 'mæniŋ
mannish => 'mæniʃ
mannitol => mænɔl
mannose => 'mænәus
Manny => 'mæni:
manoeuvrability => mә,nu:vrә'biliti
manoeuvrable => mә'nu:vrәbl
manoeuvre => mә'nu:vә
manoeuvred => mə'nuːvə
manoeuvres => mə'nuːvə
manoeuvring => mә'nu:vәriŋ
manoir => mɑ:'nwɑ:r
manomete => 'mænəmɪt
manometer => mә'nɒmitә
manometric => .mænә'metrik
manometry => mә'nɔmitri
manor => 'mænә
manor house => ˈmænə haus
manorial => mә'nɒ:riәl
manpower => 'mænpauә
manrope => 'mænrәup
mansard => 'mænsɑ:d
manse => mæns
manservant => 'mænsә:vәnt
manses => mæns
mansfield => 'mænsfi:ld
mansion => 'mænʃәn
mansions => ˈmænʃənz
manslaughter => 'mænslɒ:tә
manson => 'mænsn
mansuetude => 'mænswitju:d
manta => 'mæntә
manteau => 'mæntәu
mantel => 'mæntәl
mantelet => 'mæntәlit
mantelletta => ,mæntә'letә
mantelpiece => 'mænt(ә)lpi:s
mantelpieces => 'mænt(ə)lpiːs
mantels => 'mænt(ə)l
manteltree => 'mæntәltri:
mantic => 'mæntik
manticore => 'mæntikɔ:(r)
mantid => 'mæntid
mantilla => mæn'tilә
mantis => 'mæntis
mantis shrimp => ˈmæntɪs ʃrimp
mantissa => mæn'tisә
mantle => 'mæntl
mantlet => 'mæntlit
mantra => 'mʌntrә, 'mæn-
mantrap => 'mæntræp
Mantua => 'mæntʃuә
Mantuan => 'mæntjjәn; -tʃjәn
manual => 'mænjuәl
manual alphabet => ˈmænjuəl ˈælfəbit
manually => 'mænjuәli
manubrium => mә'nu:bri:әm, -nju:-
manucode => 'mænjukәud
manuel => 'mænjuel
Manueline => 'mænjjәlain
manufactory => .mænju'fæktәri
manufacturable => ,mænju'fæktʃәrәbl
manufacture => .mænju'fæktʃә
manufactured => ,mænju'fæktʃәd
manufacturer => .mænju'fæktʃәrә
manufacturing => .mænju'fæktʃәriŋ
manuka => mә'nu:kә
manul => 'meinul
manumission => .mænju'miʃәn
manumit => .mænju'mit
manumits => ˌmænjəˈmɪts
manumitted => ˌmænjəˈmɪtid
manumitter => mænjʊ'mɪttɜ:
manumitting => ˌmænjəˈmɪtɪŋ
manure => mә'njuә
manured => mə'njʊə
manures => mə'njʊə
manuring => mә'njuәriŋ
manus => 'meinәs
manuscript => 'mænjuskript
manuscript paper => ˈmænjuskript ˈpeipə
manuscripts => 'mænjʊskrɪpts
Manx => mæŋks
Manxman => 'mæŋksmәn
Manxwoman => 'mæŋks,wjmәn
many => 'meni
many-sided => 'meni'saidid
manyatta => mæn'jætә
manyfold => 'menifәuld
manyplies => 'meni,plaiz
manzanilla => ˌmænzəˈnilə
manzanita => mænzә'ni:tә
MAO => maj
mao-tai => 'maʊt'aɪ
Maoism => 'mauizәm
Maoist => 'majist
Maori => 'mauri
Maoritanga => ,majri'tæŋ^ә, -'tɑ:ŋә
map => mæp
map projection => mæp prəˈdʒekʃən
map-maker => 'mæp,meɪkər
map-making => mæp ˈmeɪkɪŋ
maple => 'meipl
maple leaf => ˈmeipl li:f
maple syrup => ˈmeipl ˈsirəp
mapmaker => 'mæp,meikә(r)
mappable => 'mæpәbl
mapper => 'mæpә
mapping => 'mæpiŋ
Maputo => mæ'putә
maquette => mæ'ket
maquila => məˈki:lə
maquiladora => mækwɪlə'dɔ:rə
maquillage => 'mæki:'jɑ:ʒ
Maquis => 'mæki:
mar => mɑ:
mara => 'mɑ:rә
marabou => 'mærәbu:
marabout => 'mærәbu:t
maraca => mә'rɑ:kә
Maracaibo => ,mærә'kaibәu
maranta => mә'ræntә
maraschino => ,mærәs'ki:nәu
maraschino cherry => ˌmærəˈski:nəu ˈtʃeri:
marasmic => mә'ræzmik
marasmus => mә'ræzmәs
Maratha => mә'rɑ:tә
Marathi => mә'rɑ:ti:
marathon => 'mærәθәn
marathons => 'mærəθ(ə)n
maraud => mә'rɒ:d
marauded => məˈrɔ:did
marauder => mә'rɔ:dә
marauding => mә'rɔ:diŋ
marauds => məˈrɔ:dz
maravedi => 'mærәveidi
Marbella => ma:bel'ə
marble => 'mɑ:bl
marble cake => ˈmɑ:bl keik
marbled => 'mɑ:bld
marbleize => 'mɑ:blaiz
marbleized => 'mɑːb(ə)laɪz
marbles => ˈmɑ:blz
marbling => 'mɑ:bliŋ
marbly => 'mɑ:bli
marc => mɑ:k
Marcan => 'mɑ:kәn
marcasite => 'mɑ:kәsait
marcato => mɑ:'kɑ:tәu
marcel => mɑ:'sel
marcelled => mɑ:ˈseld
marcelling => mɑ:ˈselɪŋ
Marcellus => mɑːˈseləs
marcels => mɑ:ˈselz
marcescence => mɑ:'sesәns
marcescent => mɑ:'sesnt
march => mɑ:tʃ
march past => mɑ:tʃ pɑ:st
marched => 'mɑ:tʃt
marchers => 'mɑːtʃə
marches => 'mɑ:tʃɪz
marchesa => mɑ:'keizɑ:
marchese => mɑ:'keize
marching orders => ˈmɑ:tʃɪŋ
marchioness => 'mɑ:ʃәnis
marchpane => 'mɑ:tʃpein
marcia => 'mɑ:sjә
Marco Polo => 'mɑ:kәu, 'pәulәu
marconi => mɑ:'kәuni
marcottage => 'mɑ:,kɔtidʒ
Marcus => 'mɑ:kәs
Marduk => 'mɑ:duk
mare => mєә
mare clausum => 'mɑ:rei'klajsjm, 'meәri-
mare liberum => 'mɑ:rei'libәrәm, 'meәri-
maremma => mә'remә
Marengo => mә'reŋ^әu
Marg => mɑ:^
margaret => 'mɑ:^әrit
margarine => .mɑ:dʒә'ri:n
margarita => ,mɑ:^ә'ri:tә
margaritas => ˌmɑ:ɡəˈri:təz
Margate => 'mɑːgɪt
margay => 'mɑ:^ei
marge => mɑ:dʒ
margery => 'mɑ:dʒәri
margin => 'mɑ:dʒin
margin call => ˈmɑ:dʒin kɔ:l
marginal => 'mɑ:dʒinәl
marginalia => .mɑ:dʒi'neiljә
marginalisation => ˌma:dʒɪnəlaɪ'zeɪʃən
marginalise => 'mɑ:dʒɪnəlaɪz
marginality => ,mɑ:dʒin'æliti
marginalization => ,mɑ:dʒinəlai'zeiʃən,-li'z-
marginalize => 'mɑ:dʒinəlaiz
marginalizing => 'mɑːdʒɪn(ə)laɪz
marginals => 'mɑːdʒɪn(ə)l
marginate => 'mɑ:dʒinit
margosa => mɑ:'^әusә
Margot => 'mɑ:^әu
margravate => mɑ:ɡ'ræveɪt
margrave => 'mɑ:greiv
margravine => 'mɑ:grәvi:n
marguerite => .mɑ:gә'ri:t
mari => maui
Maria => mә:'raiә, mә'riә
mariachi => 'mɑ:ri'ɑ:tʃi
mariage de convenance => mɑ:'rjɑ:ʒdәkjŋvә'nɔŋs
Marian => 'mæriәn
Mariana => .mæri'ɑ:nә
marianne => ,meәri'æn, mɑ:'rjɑ:n
Maribor => 'mɑ:ribɔ:(r)
mariculture => 'mærikʌltʃә
marie => 'mɑ:ri(:), mә'ri:
Marietta => meәri'etә
marigold => 'mærigәuld
marijuana => .mæriju'ɑ:nә
marimba => mә'rimbә
Marin => 'mærin
marina => mә'rinә
marinade => .mæri'neid
marinara => ,mærә'nærә
marinate => 'mærineit
marinating => 'mærɪneɪtɪŋ
marination => ,mærɪ'neɪʃən
marine => mә'ri:n
mariner => 'mærinә
mariners => 'mærɪnəz
mario => 'mæriәj, 'mɑ:-
Mariolatry => .mєәri'ɒlәtri
Mariology => ,meәri'ɔlәdʒi
marion => 'meәriәn, 'mæriәn
marionette => .mæriә'net
marionettes => ,mærɪə'net
maris => 'mæris
Marist => 'meәrist
marital => 'mæritәl
maritally => 'mæritәli
maritime => 'mæritaim
Maritsa => mɑ:'ri:tsɑ:
Mariupol => ,mɑ:ri:'u:pɔljə
marjoram => 'mɑ:dʒәrәm
Marjory => 'mɑ:dʒəri
mark => mɑ:k
mark you => mɑ:k ju:
mark-to-market => 'mɑ:kt'əm'ɑ:kɪt
mark-up => 'mɑ:k'ʌp
markdown => 'mɑ:kdaun
marked => mɑ:kt
markedly => 'mɑ:kidli
markedness => 'mɑ:kidnis
marker => 'mɑ:kә
marker pen => ˈmɑ:kə pen
market => 'mɑ:kit
market basket => ˈmɑ:kit ˈbɑ:skit
market gardening => ˈmɑ:kit ˈgɑ:dnɪŋ
market leader => ˈmɑ:kit ˈli:də
market research => ˈmɑ:kit riˈsə:tʃ
market share => ˈmɑ:kit ʃɛə
market-maker => 'mɑ:kɪtm'eɪkər
marketability => .mɑ:kitә'biliti
marketable => 'mɑ:kitәbl
marketeer => .mɑ:ki'tiә
marketer => 'mɑ:kitә
marketing => 'mɑ:kitiŋ
marketization => 'mɑ:rkɪtɪzeɪʃn
marketplace => 'mɑ:kit'pleis
marketplaces => 'mɑ:kɪtpleɪsɪz
markham => 'mɑ:kәm
markhor => 'mɑ:kɔ:
marking => 'mɑ:kiŋ
markka => 'mɑ:kә
marksman => 'mɑ:ksmәn
marksmanship => 'mɑ:ksmәnʃip
marksmen => 'mɑ:ksmən
markswoman => 'mɑ:ks,wumәn
markup => 'mɑ:kʌp
marl => mɑ:l
marlborough => 'mɔ:lbәrә
marled => mɑ:ld
marlene => 'mɑ:li:n, mɑ:'li:n
marlin => 'mɑ:lin
marline => 'mɑ:lin
Marlowe => 'ma:ləu
marly => 'mɑ:li
marm => 'mɑ:m
Marmaduke => 'mɑ:mәdju:k
marmalade => 'mɑ:mleid
Marmara => 'mɑ:mәrә
marmite => 'mɑ:mait
marmoreal => mɑ:'mɔ:riәl
marmoset => 'mɑ:mәzet
marmosets => 'mɑːməzet
marmot => 'mɑ:mәt
Marne => mɑ:n
marocain => 'mærәkein
Maronite => 'mærәnait
maronites => 'mærənait
maroon => mә'ru:n
marooned => mə'ruːnd
marque => mɑ:k
marquee => mɑ:'ki:
marquees => mɑ:'ki:z
marquesa => mɑ:'keizә
Marquesan => mɑ:'keizn, -'keisn
marquess => 'mɑ:kwis
marquessate => 'mɑ:kwizit
marquetry => 'mɑ:kitri
marquis => 'mɑ:kwis
marquisate => 'mɑ:kwizit
marquise => mɑ:'ki:z
marquises => ˈmɑ:kwɪsiz
marquisette => .mɑ:ki'zet
marram => 'mærәm
Marrano => mә'rɑ:nәu
marred => 'mɑ:d
marri => 'mæri, 'mɑ:-
marriage => 'mæridʒ
marriage bureau => ˈmæridʒ ˈbjuərəu
marriage guidance => ˈmæridʒ ˈɡaidəns
marriageability => .mæridʒә'biliti
marriageable => 'mæridʒәbl
marriages => ˈmæridʒz
married => 'mærid
marring => 'mɑ:rɪŋ
marron => mɑ:'rjŋ
marrow => 'mærәu
marrowbone => 'mærәubәun
marrowless => 'mærәulis
marrowy => 'mærәui
marry => 'mæri
marry money => ˈmæri ˈmʌni
Mars => mɑ:z
Marsala => mɑ:'sɑ:lә
Marseillaise => mɑ:sә'leiz
Marseille => ma:'seil
Marseilles => mɑ:'seilz
marsh => mɑ:ʃ
marsh marigold => mɑ:ʃ ˈmæriɡəuld
marsha => 'mɑ:ʃә
marshal => 'mɑ:ʃәl
Marshall => 'mɑ:ʃәl
Marshallese => ,mɑ:ʃə'li:z
marshalling => 'mɑ:ʃәliŋ
marshals => ˈmɑ:ʃəlz
Marshalsea => 'mɑ:ʃәl,si:
marshes => mɑ:ʃiz
marshlands => 'mɑːʃlənd
marshmallow => 'mɑ:ʃ.mælәu
marshy => 'mɑ:ʃi
marsupial => mɑ:'sju:piәl
marsupial mole => mɑ:ˈsu:pi:əl məʊl
marsupials => mɑ:'su:pɪəlz
marsupium => mɑ:'sju:piәm
mart => mɑ:t
Martaban => 'mɑ:tә'bɑ:n
Martello => mɑ:'telәj
marten => 'mɑ:tin
martensite => 'mɑ:tinzait
martensitic => ,mɑ:tin'zitik
Martha => 'mɑ:θә
martial => 'mɑ:ʃәl
martial art => ˈmɑ:ʃəl ɑ:t
martial artist => ˈmɑ:ʃəl ˈɑ:tist
martial law => ˈmɑ:ʃəl lɔ:
Martian => 'mɑ:ʃiәn
Martin => 'mɑ:tin
martinet => .mɑ:ti'net
martinets => ,mɑːtɪ'net
martingale => 'mɑ:tiŋ^eil
martini => mɑ:'ti:ni
Martiniquan => ,mɑ:ti'ni:kәn
martinique => ,mɑ:ti'ni:k
martinis => mɑ:ˈti:ni:z
Martinmas => 'mɑ:tinmәs
martlet => 'mɑ:tlit
marty => 'mɑ:ti
martyr => 'mɑ:tә
martyrdom => 'mɑ:tәdәm
martyred => ˈmɑ:təd
martyring => 'mɑːtə
martyrization => ,mɑ:tərai'zeiʃən
martyrize => 'mɑ:tәraiz
martyrologist => ,mɑ:tә'rɔlәdʒist
martyrology => .mɑ:tә'rɒlәdʒi
martyrs => ˈmɑ:təz
martyry => 'mɑ:tәri
maru => 'mɑ:ru
marvel => 'mɑ:vl
Marvell => 'mɑ:vәl
marvelled => ˈmɑ:vəld
marvelling => ˈmɑ:vəlɪŋ
marvellous => 'mɑ:vilәs
marvellously => 'mɑ:vələslɪ
marvelous => 'mɑ:vәlәs
marvelously => 'mɑ:vləslɪ
marvels => ˈmɑ:vəlz
marvin => 'mɑ:vin
marvy => 'mɑ:vi
Marwari => 'mɑ:wɑ:ri:
marx => mɑ:ks
Marxian => 'mɑ:ksjәn
Marxisant => mɑ:rksi:'zɔŋ
Marxism => 'mɑ:ksizm
Marxist => 'mɑ:ksist
mary => 'meәri
Maryland => 'merilәnd
Marylander => 'meәri,lændә(r);'merilәndә(r)
marzipan => ,mɑ:zi'pæn
MAS => mɑ:
masa => 'mɑ:sә
Masaccio => mɑ:'sɑ:ttʃɔ:
Masada => mɑ:'sɑ:dɑ:
Masai => mɑ:'sai
Masbate => mɑ:s'bɑ:tei
masc => 'mæsk
mascara => mæ'skɑ:rә
mascarpone => ˌmæskə'pəʊneɪ
mascle => 'mæskl
mascon => 'mæskɒn
mascot => 'mæskәt
mascots => ˈmæsˌkɔts
masculine => 'mæskjulin
masculinist => mæskjulinist
masculinity => .mæskju'liniti
masculinize => 'mæskjuli,naiz
Masefield => 'meisfi:ld
maser => 'meizә
mash => mæʃ
mash-up => mæʃ ʌp
Masham => 'mæsәm
masher => 'mæʃә
Mashhad => mɑ:ʃ'hɑ:d
mashie => 'mæʃi
mashing => 'mæʃiŋ
Mashona => mә'ʃɔnә
masjid => 'mʌsdʒid
mask => mæsk
masked => mæskt
masker => 'mɑ:skә(r);'mæ-
masking => 'mɑ:skiŋ
masking tape => ˈmɑ:skiŋ teip
maskinonge => 'mæskinɔndʒ
Maslin => 'mæzlin
Maslow => 'mæzləu
masochism => 'mæzәkizm
masochist => 'mæzәkist
masochistic => ˌmæsə'kɪstɪk
masochists => 'mæsəʊkɪst
mason => meisn
mason bee => ˈmeɪsən bi:
mason wasp => ˈmeɪsən wɔsp
Mason-Dixon Line => 'meisən'diksən
masonic => mә'sɒnik
masonry => 'meisnri
masons => ˈmeɪsənz
Masorah => mә'sɔ:rә
Masorete => 'mæsәri:t
masque => mæsk
masquer => 'mɑ:skә(r)
masquerade => .mɑ:skә'reid
masqueraded => ˌmæskəˈreɪdid
masquerades => ˌmæskəˈreɪdz
mass => mæs
mass noun => mæs naun
massa => 'mɑ:ssɑ:
Massachusetts => .mæsә'tʃu:sits
massacre => 'mæsәkә
massacred => 'mæsəkə
massacres => ˈmæsəkəz
massacring => 'mæsəkə
massage => 'mæsɑ:ʒ
massage parlour => ˈmæsɑ:ʒ ˈpɑ:lə
massaged => ˈmæsɑ:ʒd
massasauga => ,mæsә'sɔ:^ә
Massawa => mә'sɑ:wә,mɑ:s'sɑ:wɑ:
massed => mæst
masseter => mæ'si:tә
masseur => mæ'sә:
masseurs => mæˈsɜ:z
masseuse => mæ'sә:z
masseuses => mæˈsə:ziz
massicot => 'mæsikɔt
massif => 'mæsi:f
massifs => ˈmæsi:fs
massive => 'mæsiv
massiveness => 'mæsivnis
massless => 'mæslis
Masson => 'mæsn
Massorete => 'mæsәri:t
massy => 'mæsi
mast => mɑ:st
mast cell => mɑ:st sel
mastaba => 'mæstәbә
mastectomy => mæ'stektәmi
masted => 'mɑ:stid
master => 'mɑ:stә. 'mæstә
master bedroom => ˈmɑ:stə ˈbedˌru:m
master sergeant => ˈmɑ:stə ˈsɑ:dʒənt
mastercard => 'mɑ:stə,kɑ:d
masterclass => ˈmɑ:stəklɑ:s
masterdom => 'mɑ:stәdәm
masterful => 'mɑ:stәful
masterfully => ˈmɑ:stəfʊlɪ
masterless => 'mɑ:stәlis;'mæs-
masterly => 'mɑ:stәli
masterman => 'mɑ:stәmәn;'mæs-
mastermind => 'mɑ:stәmaind
masterminded => ˈmæstəˌmaɪndid
masterminding => ˈmæstəˌmaɪndɪŋ
masterminds => ˈmæstəˌmaɪndz
masterpiece => 'mɑ:stәpi:s
masterpieces => 'mɑ:stəpi:sɪz
masterplan => 'mɑ:stәplæn;'mæs-
mastership => 'mɑ:stʃip
mastersinger => 'mɑ:stә,siŋә(r);'mæs-
masterstroke => 'mɑ:stәstrәuk
masterstrokes => ˈmɑ:stəstrəuks
mastery => 'mɑ:stәri
masthead => 'mɑ:sthed
mastheads => ˈmɑ:sthedz
mastic => 'mæstik
masticate => 'mæstikeit
masticated => ˈmæstɪˌkeɪtid
masticates => ˈmæstɪˌkeɪts
masticating => ˈmæstɪˌkeɪtɪŋ
mastication => .mæsti'keiʃәn
masticator => 'mæstikeitә
masticatory => 'mæstikәtәri
mastiff => 'mæstif
mastiff bat => ˈmæstif bæt
mastiffs => 'mæstɪfs
mastigophoran => ,mæstә'^ɔfәrәn
mastitis => mæs'taitis
mastodon => 'mæstәdɒn
mastoid => 'mæstɒid
mastoid process => ˈmæstɔid ˈprəuses
mastoidectomy => ,mæstɔi'dektәmi
mastoiditis => .mæstɒi'daitis
masts => mɑ:sts
masturbate => 'mæstәbeit
masturbated => ˈmæstəbeitid
masturbates => ˈmæstəbeits
masturbating => ˈmæstəbeitɪŋ
masturbation => ,mæstә'beiʃәn
masturbatory => 'mæstәbeitəri,-bә-
Masuria => mә'zuriә
mat => mæt
Matabele => ,mætә'bi:li
matador => 'mætәdɒ:
matadors => ˈmætəˌdɔ:z
matamata => 'mɑ:tɑ:'mɑ:tɑ:
match => mætʃ
match play => mætʃ plei
match point => mætʃ pɔint
matchable => 'mætʃәbl
matchboard => 'mætʃbɒ:d
matchbook => 'mætʃbuk
matchbox => 'mætʃbɒks
matchboxes => ˈmætʃˌbɔksiz
matching => 'mætʃiŋ
matchless => 'mætʃlis
matchlessly => mætʃlisli
matchlock => 'mætʃlɒk
matchmaker => 'mætʃ.meikә
matchmakers => ˈmætʃˌmeɪkəz
matchmaking => 'mætʃ.meikiŋ
matchstick => 'mætʃstik
matchsticks => ˈmætʃstiks
matchup => 'mætʃ,ʌp
matchwood => 'mætʃwud
mate => meit
mateless => 'meitlis
matelot => 'mætlәu
matelote => 'mætәlәut
mater => 'meitә
materfamilias => .meitәfә'miliәs
materia medica => mә'tiәriә'medikә
material => mә'tiәriәl
material witness => məˈtiəriəl ˈwitnis
materialise => mә'tiәriәlaiz
materialism => mә'tiәriәlizm
materialist => mә'tiәriәlist
materialistic => mә.tiәriә'listik
materialists => mə'tɪərɪəlɪst
materiality => mә.tiәri'æliti
materialization => mә,tiәriәlai'zeiʃən; -li'z-
materialize => mә'tiәriәlaiz
materialized => məˈtɪəri:əˌlaɪzd
materializes => məˈtɪəri:əˌlaɪziz
materializing => məˈtɪəri:əˌlaɪzɪŋ
materially => mә'tiәriәli
materiel => mәtiәri'el
maternal => mә'tә:nl
maternalism => mə'tɜ:nəlɪzəm
maternally => mə'tə:nəli
maternity => mә'tә:niti
mateship => ˈmeɪtʃɪp
matey => 'meiti
math => mæθ
mathematic => ,mæθə'mætik
mathematical => .mæθә'mætikl
mathematically => ˌmæθə'mætɪklɪ
mathematician => .mæθәmә'tiʃәn
mathematicians => mæθə'mətɪʃnz
mathematics => .mæθә'mætiks
mathematization => mæθi,mæti'zeiʃәn
mathematize => 'mæθəmətaɪz
maths => mæθs
Matilda => mә'ti:ldә
matin => 'mætin
matinal => 'mætɪnəl
matinee => 'mætinei
matinee idol => ˌmætnˈeɪ ˈaidl
matinees => ˌmætnˈeɪz
mating => 'meitiŋ
matins => mætnz
Matisse => mə'ti:s
Matlock => 'mætlɔk
Matra => mɑ:trә
matri- => 'mætri,'mei-
matriarch => 'meitriɑ:k
matriarchal => 'meitriɑ:kl
matriarchate => 'meitriɑ:kit
matriarchs => ˈmeitriɑ:ks
matriarchy => 'meitriɑ:ki
matric => mә'trik
matrices => 'meitrisi:z
matricidal => 'meitrisaidәl
matricide => 'meitrisaid
matriculant => mә'trikjulәnt
matriculate => mә'trikjuleit
matriculated => məˈtrɪkjəˌleɪtid
matriculates => məˈtrɪkjəˌleɪts
matriculating => məˈtrɪkjəˌleɪtɪŋ
matriculation => mә.trikju'leiʃәn
matrifocal => 'mætrifәjkəl, 'mei-
matrilateral => ,mætri'lætәrәl,,mei-
matrilineage => ,mætri'liniidʒ,,mei-
matrilineal => .mætri'linjәl
matrilocal => ,mætri'lәukәl
matrimonial => .mætri'mәunjәl
matrimony => 'mætrimәuni
matrix => 'meitriks
matron => 'meitrәn
matronhood => 'meitrənhjd
matronly => 'meitrәnli
matrons => ˈmeɪtrənz
matronymic => ,mætrә'nimik
matryoshka => meɪtri':ɒʃkə
matt => mæt
matte => mæt
matted => 'mætid
matter => 'mætә
matter of fact => ˈmætə ɔv fækt
matter of law => ˈmætə ɔv lɔ:
matter-of-fact => ,mætәrәv'fækt
matter-of-factly => ˌmætərəfˈfæktlɪ
mattered => ˈmætəd
matterhorn => 'mætә:,hɔ:n
Matthew => 'mæθju:
matthews => 'mæθju:z
Matthias => mә'θaiәs
Mattie => 'mæti
matting => 'mætiŋ
mattins => 'mætnz
mattock => 'mætәk
mattress => 'mætris
mattresses => 'mætrɪsɪz
matts => 'mæts
maturate => 'mætʃureit
maturated => ˈmætjureitid
maturates => ˈmætjureits
maturating => ˈmætjureitɪŋ
maturation => .mætʃu'reiʃәn
maturative => mә'tjuәrәtiv
mature => mә'tjuә
mature student => məˈtjuə ˈstju:dənt
maturer => mә'tjuәrә
matures => məˈtjuəz
maturing => mә'tjuәriŋ
maturity => mә'tjuәriti
matutinal => .mætju:'tainl
maty => meiti
matzah => 'mætsə
matzo => 'mɑ:tsәu
matzoh => 'matsə
Mau Mau => 'mau,mau
mau-mau => 'maʊm'aʊ
maud => mɒ:d
maudlin => 'mɒ:dlin
Maugham => mɔ:m
Maui => 'maui
maul => mɒ:l
mauled => mɔ:ld
mauler => 'mɔ:lә
maulers => 'mɔ:lәz
mauling => mɔ:lɪŋ
mauls => mɔ:lz
maulstick => 'mɒ:lstik
maulvi => 'majlvi
Mauna Kea => 'maunә'keiә
Mauna Loa => 'maunә'lәuә
maund => mɒ:nd
maunder => 'mɒ:ndә
maundered => ˈmɔ:ndəd
maundering => ˈmɔ:ndərɪŋ
maunders => ˈmɔ:ndəz
Maundy => 'mɔ:ndi
Maupassant => 'mәupә'sɑ:nt
Maura => 'mɔ:rә
Mauretania => ,mɔ:ri'teiniә
Mauretanian => ,mɔri'teiniәn
Mauriac => mɔ:'rjɑ:k, mɔri'ɑ:k
maurice => 'mɔ:ris
Mauritania => .mɒri'teiniә
Mauritius => mɒ:'riʃiәs
Maurya => 'mauriә
mausoleum => .mɒ:sә'liәn
mausoleums => mɔ:sə'li:əmz
mauve => mәuv
mauves => məʊvz
maven => 'meivin
maverick => 'mævәrik
mavericks => 'mævərɪks
mavis => 'meivis
maw => mɒ:
mawkish => 'mɒ:kiʃ
mawkishly => 'mɔ:kɪʃlɪ
mawkishness => 'mɔ:kiʃnis
maws => mɔ:z
Mawson => 'mɔ:sn
MAX => mæks
maxi => 'mæksi
maxi- => 'mæksi
maxilla => mæk'silә
maxillary => 'mæksilәri
maxilliped => mæk'sili,ped
maxillofacial => mæk,silәu'tә:binәl
Maxim => 'mæksim
maxima => 'mæksimә
maximal => 'mæksiml
maximalism => 'mæksiməlizəm
maximalist => 'mæksimәlist
maximally => 'mæksiməli
Maximilian => ,mæksi'miliәn
maximin => 'mæksimin
maximise => 'mæksimaiz
maximising => 'mæksɪmaɪz
maximization => ,mæksәmai'zeiʃәn
maximize => 'mæksimaiz
maximized => ˈmæksəˌmaɪzd
maximizer => 'mæksimi'z-
maximizes => ˈmæksəˌmaɪziz
maxims => ˈmæksɪmz
maximum => 'mæksimәn
Maximus => 'mæksimәs
maxine => mæk'si:n,'mæksi:n
maxixe => mæk'sɪks
maxwell => 'mækswәl
may => mei
Maya => 'mɑ:jә
Mayan => 'mɑ:jәn
maybe => 'meibi:
mayday => 'meidei
maydays => ˈmeideiz
mayer => 'meiә
mayest => 'meiist, meist
Mayfair => 'meifєә
mayflies => ˈmeiflaiz
mayflower => 'mei.flauә
mayfly => 'meiflai
mayhap => 'meihæp
mayhem => 'meihem
mayn't => meint
maynard => 'meinәd
mayo => 'meiәu
mayonnaise => meiә'neiz
mayor => 'mєә
mayoral => 'mєәrәl
mayoralty => 'mєәrәlti
mayoress => 'mєәris
mayors => mɛəz
mayorship => 'meәʃip,'meiә-
Mayotte => mɑ:'jɔt
maypole => 'meipәul
maypop => 'meipɒp
mayst => meist
mayweed => 'mei,wi:d
mazda => 'mæzdә
Mazdaism => 'mæzdәizәm
mazdoor => mәz'djә(r)
maze => meiz
mazed => 'meizd
mazer => 'meizә
mazes => meɪziz
mazuma => mә'zu:mә
mazurka => mә'zә:kә, -'zuәkә
mazy => 'meizi
mazzard => 'mæzәd
Mbabane => mbɑ:'ba:n
mbira => әm'biәrә
Mbundu => m'bu:ndu:
mccarthy => mә'kɑ:θi
McCarthyism => mә'kɑ:θiizm
McCarthyist => mә'kɑ:θiist
McCarthyite => mә'kɑ:θiait
McClellan => mә'klelәn
mcclure => mә'kluә
McCormack => mә'kɔ:mәk
McCormick => mә'kɔ:mik
mccoy => mә'kɔi
mcdonald => mәk'dɔnәld
McDowell => mәk'dauәl
McIntosh => 'mækintɒʃ
McIntyre => 'mækintaiә
McJob => 'mækdʒɔb
mckenna => mә'kenә
McKinley => mә'kinli
McMillan => mәk'milәn
me => mi:
mea culpa => 'mi:ә 'kʌlpә, 'meiɑ:'kulpɑ:
mead => mi:d
meadow => 'medәu
meadow fescue => ˈmedəu ˈfeskju:
meadow grass => ˈmedəu ɡrɑ:s
meadow mouse => ˈmedəu maus
meadow mushroom => ˈmedəu ˈmʌʃrum
meadow pipit => ˈmedəu ˈpipit
meadow rue => ˈmedəu ru:
meadow saffron => ˈmedəu ˈsæfrən
meadowland => 'medәjlænd, -lәnd
meadowlark => 'medәjlɑ:k
Meadows => medəuz
meadowsweet => 'medәuswi:t
meadowy => 'medәui
meager => 'mi:gә
meagerly => 'mi:gəlɪ
meagre => 'mi:^ә(r)
meagrely => 'mi:ɡəlɪ
meal => mi:l
meal ticket => mi:l ˈtikit
mealie => 'mi:li
mealier => 'miːlɪ
mealies => 'mi:lɪz
mealiest => 'miːlɪ
mealiness => 'mi:linis
mealtime => 'mi:ltaim
mealtimes => ˈmi:lˌtaɪmz
mealworm => 'mi:lwә:m
mealy => 'mi:li
mealybug => 'mi:li:bʌ^
mean => mi:n
mean solar day => mi:n ˈsəulə dei
mean solar time => mi:n ˈsəulə taim
mean sun => mi:n sʌn
mean time => mi:n taim
mean-spirited => 'mi:nsp'ɪrɪtɪd
meander => mi'ændә
meandered => mi:ˈændəd
meandering => mi'ændәriŋ
meanderings => mi'ændәriŋz
meanders => mi:ˈændəz
meanie => 'mi:ni
meanies => 'mi:ni
meaning => 'mi:niŋ
meaningful => 'mi:niŋful
meaningfully => 'mi:niŋfuli
meaningfulness => 'mi:nɪŋflnəs
meaningless => 'mi:niŋlis
meaninglessly => 'mi:niŋlisli
meaninglessness => 'mi:niŋlisnis
meaningly => 'mi:niŋli
meanly => 'mi:nli
meanness => 'mi:nnis
means => mi:nz
meant => ment
meantime => 'mi:ntaim
meanwhile => 'mi:nhwail
measles => 'mi:zlz
measly => 'mi:zli
measurable => 'meʒәrәbl
measurably => 'meʒәrәbli
measure => 'meʒә
measured => 'meʒәd
measureless => 'meʒәdlis
measurement => 'meʒәdmәnt
measurer => 'meʒәrә
measuring => 'meʒәriŋ
measuring cup => ˈmeʒəriŋ kʌp
measuring tape => ˈmeʒəriŋ teip
measuring worm => ˈmeʒəriŋ wə:m
meat => mi:t
meat grinder => mi:t ˈgraɪndə
meat hook => mi:t huk
meat loaf => mi:t ləuf
meat market => mi:t ˈmɑ:kit
meat safe => mi:t seif
meatball => 'mi:tbɒ:l
meatballs => ˈmi:tˌbɔ:lz
Meath => mi:θ
meathead => 'mi:thed
meatier => ˈmi:ti:ə
meatloaf => mi:t'ləʊf
meatspace => mi:ts'peɪs
meatus => mi'eitәs
meaty => 'mi:ti
Mecca => 'mekә
Meccan => 'mekәn
meccano => mә'kɑ:nәu
meccas => ˈmekəz
mechanic => mi'kænik
mechanical => mi'kænikәl
mechanically => mi'kænikәli
mechanicalness => mɪ'kænɪklnəs
mechanicals => mi'kænikәls
mechanician => .mekә'niʃәn
mechanics => mi'kæniks
mechanisation => ,mekәnai'zeiʃən; -ni'z-
mechanised => 'mekənaiz
mechanism => 'mekәnizm
mechanisms => 'mekənɪzəmz
mechanist => 'mekәnist
mechanistic => .mekә'nistik
mechanization => .mekәnai'zeiʃәn
mechanize => 'mekәnaiz
mechanizer => 'mekənaɪzər
mechanizes => ˈmekəˌnaɪziz
mechanizing => ˈmekəˌnaɪzɪŋ
mechanoreceptive => ,mekәnәjri'septiv
mechanoreceptor => ,mekәnә(u)ri'septә
mechatronic => metʃæt'rɒnɪk
Mechelen => 'mεxələn
Mechlin => 'meklin
Mecklenburg => 'meklәn,bә:g
meconium => mi'kәuniәm
Mecoptera => mi'kɔptәrә
mecopteran => mi'kɔptәrәn
MEd => med
medaka => mә'dɑ:kә
medal => 'medl
medal play => ˈmedəl pleɪ
medalist => 'mædәlist
medallic => mi'dælik
medallion => mi'dæljәn
medallions => mɪˈdæljənz
medallist => 'medәlist
medallists => ˈmedɵlɪsts
Medan => me'dɑ:n
Medawar => 'medәwә
meddle => 'medl
meddled => ˈmedld
meddler => 'medlә
meddlers => 'medlə
meddles => ˈmedlz
meddlesome => 'medlsәm
Mede => mi:d
medea => mi:'diә
Medellin => ,medә'li:n
medevac => 'medәvæk
medfly => 'medflaɪ
media => 'mi:diә
mediacy => 'mi:diәsi
mediaeval => .medi'i:vl
mediagenic => ,mediә'dʒenik; ,mi:-
medial => 'mi:diәl
median => 'mi:diәn
median strip => ˈmi:di:ən strip
mediant => 'mi:djәnt
mediastinum => ,mi:diæs'tainәm
mediate => 'mi:dieit
mediated => 'mi:dieitid
mediates => ˈmi:dieits
mediating => ˈmi:dieitɪŋ
mediation => .mi:di'eiʃәn
mediator => 'mi:dieitә
mediatory => 'mi:diәtәri
medic => 'medik
medicable => 'medikәbl
medicaid => 'medikeid
medical => 'medikl
medical examination => ˈmedikəl iɡˌzæmiˈneiʃən
medical school => ˈmedikəl sku:l
medicalize => 'medikәlaiz
medicals => ˈmedikəlz
medicament => me'dikәmәnt
medicaments => 'mɪdɪkəmənts
medicare => 'medi,keә
medicate => 'medikeit
medicates => ˈmedikeits
medicating => ˈmedikeitɪŋ
medication => .medi'keiʃәn
medicative => 'medikeitiv
medici => meditʃi:
medicinal => me'disinәl
medicine => 'medisin
medicine ball => ˈmedisin bɔ:l
medicine cabinet => ˈmedisin ˈkæbinit
medicine chest => ˈmedisin tʃest
medicines => 'medsnz
medick => 'medɪk
medico => 'medikәu
medieval => .medi'i:vl
medievalism => ,medi'i:vəlzəm; ,mi:-
medievalist => ,medi'i:vəlist; ,mi:-
medievalize => ,medi'i:vəlaiz; ,mi:-
medigap => medɪ'ɡæp
medina => me'di:nә
mediocre => .mi:di'әukә
mediocrities => ˌmi:di:ˈɔkrɪti:z
mediocrity => .mi:di'ɒkriti
meditate => 'mediteit
meditated => ˈmedɪˌteɪtid
meditates => ˈmedɪˌteɪts
meditation => .medi'teiʃәn
meditations => ˌmedɪˈteɪʃənz
meditative => 'mediteitiv
meditatively => 'medɪtətɪvlɪ
Mediterranean => .meditә'reiniәn
medium => 'mi:diәm
medium wave => ˈmi:djəm weiv
medium-pacer => 'mi:diəm'peisə
medium-range => 'mi:dɪəmr'eɪndʒ
mediumistic => .mi:diә'mistik
mediumship => 'mi:diәmʃip
medivac => 'medɪˌvæk
medlar => 'medlә
medley => 'medli
medleys => ˈmedli:z
Medoc => 'meidɔk
medulla => me'dʌlә
medullary => 'medʌlәri
Medusa => mi'dju:zә
medusoid => mi'dju:sɔid
meed => mi:d
meek => mi:k
meekly => 'mi:kli
meekness => 'mi:knis
meerkat => 'miәkæt
meerschaum => 'miәʃәm
Meerut => 'miərət
meet => mi:t
meet-and-greet => mi:t ænd ɡri:t
meeting => 'mi:tiŋ
meeting house => ˈmi:tiŋ haus
meetinghouse => 'mi:tiŋhajs
meetly => 'mi:tli
meets => mi:ts
mefloquine => 'mefləkwaɪn
Meg => me^
mega => 'me^ә
mega- => 'me^ә
megabit => 'me^әbit
megabuck => 'megәbʌk
megabyte => 'meɡәbait
Megachiroptera => ,megәki'rɔptәrә
megacity => 'me^ә,siti
megadeal => meɡə'dɪəl
megadeath => 'megәdeθ
megadose => 'me^әdәjs
Megaera => mә'dʒi:rә
megafauna => me'ɡæfɔ:nə
megaflop => ˈmegəflɒp
megagamete => ,me^ә'^æmit
megahertz => 'megәhә:ts
megalith => 'megәliθ
megalithic => .megә'liθik
megaliths => 'megəlɪθ
megalo- => 'me^әlәj
megaloblast => 'me^әlәublɑ:st
megaloblastic => ,me^әlәu'blæstik
megalomania => .megәlә'meiniә
megalomaniac => .megәlәu'meiniæk
megalopolis => .megә'lɒpәlis
megalosaurus => .megәlәu'sɒ:rәs
megaparsec => ,me^ә'pɑ:sek
megaphone => 'megәfәun
megaphones => ˈmegəˌfəʊnz
megaphonic => meɡə'fɒnɪk
megapixel => 'meɡəpɪksl
megapode => 'me^ә,pәud
megaron => 'me^әrɔn
megaspore => 'me^әspɔ:
megastar => ˈmegəstɑ:(r)
megastardom => ,meɡə'stɑ:dɔm
megastore => ˈmegəstɔ:(r)
megatherium => 'me^ә'θiәriәm
megaton => 'megәtʌn
megatons => ˈmeɡəˌtʌnz
megavolt => 'megәvәult
megawatt => 'megәwɒt
Meghalaya => ,mei^ә'leiә
Megiddo => mә'^idәu
megilp => mә'gilp
megohm => 'megәum
megrim => 'mi:^rim
meh => me
Meikle => 'mi:kl
meiofauna => 'maiәj,fɔ:nә
meiosis => mai'әusis
meiotic => mai'ɔtik
Meissen => ˊmaisәn
Meistersinger => 'maistә,siŋә
meitnerium => maɪtˈnɪəriəm
Mekong => 'mei'kɒŋ
mel => mel
melaena => mi'li(:)nә
Melaka => mə'lakə
melaleuca => ,melә'lu:kә
melamine => .melә'mi:n
melancholia => ,melәn'kәuljә
melancholic => .melәn'kɒlik
melancholics => ˌmelənˈkɔliks
melancholy => 'melәnkɒli
Melanesia => .melә'ni:ziә
Melanesian => .melә'ni:ʒәn
melange => mei'lɒŋʒ
melanic => mә'lænik
melanie => 'melәni
melanin => 'melәnin
melanism => 'melәnizm
melanite => 'melә,nait
melanocyte => 'melәnәu,sait
melanoid => 'melәnɔid
melanoma => ,melә'nәumә
melanosis => ,melә'nәusis
melanotic => ,melә'nɔtik
melatonin => ,melә'tәunin
Melba => 'melbә
Melbourne => 'melbәn
Melchior => 'melkiɔ:
Melchizedek => mel'kizi,dek
meld => meld
melded => meld
melds => meld
Meleager => ,meli'eidʒә:
melee => me'lei
melees => ˈmeɪˌleɪz
melena => mә'li:nә
melic => 'melik
Melilla => mei'li:ljɑ:
melilot => 'meli,lɔt
melioidosis => ,meliɔi'dәusis
meliorate => 'mi:ljәreit
meliorated => ˈmi:ljəreitid
meliorating => ˈmi:ljəreitɪŋ
melioration => .mi:ljә'reiʃәn
meliorative => 'mi:ljәreitiv
meliorism => 'mi:ljәrizm
melioristic => ,mi:liə'ristik
melisma => mә'lizmә
melismatic => ,meliz'mætik
melissa => mә'lisә
Melkite => 'melkait
melliferous => mә'lifәrәs
mellifluence => mә'lifluәns
mellifluent => mi'lifljәnt
mellifluous => me'lifljәs
Melling => mel
mellon => 'melәn
mellophone => 'melәfәun
mellow => 'melәu
mellow out => ˈmeləu aut
mellowed => ˈmeləud
mellower => ˈmeləuə
mellowing => 'melәuriŋ
mellowly => me'ləʊlɪ
mellowness => 'meləʊnɪs
mellows => ˈmeləuz
melo => 'melәu
melodeon => mә'lәudiәn
melodic => mә'lɒdik
melodica => mi'lɔdikә
melodies => ˈmelədiz
melodious => mә'lәudiәs
melodiously => mi'ləudiəsli
melodist => 'melәdist
melodize => 'melәdaiz
melodized => ˈmelədaizd
melodizing => ˈmelədaizɪŋ
melodrama => 'melәu.drɑ:mә
melodramas => ˈmeləˌdrɑ:məz
melodramatic => .melәdrә'mætik
melodramatics => meloudrәˊmætiks
melodramatist => .melә'dræmәtist
melodramatize => ,melәu'dræmәtaiz
melody => 'melәdi
melon => 'melәn
Melos => 'mi:lɔs
Melpomene => mel'pɒmәni
Melrose => 'melrәuz
melt => melt
meltable => 'meltәbl
meltdown => 'meltdaun
melter => 'meltә
melting => 'meltiŋ
melton => 'meltn
melts => melts
meltwater => 'melt,wɔ:tә
melville => 'melvil
Melvin => 'melvin
MEM => mem
member => 'membә
membered => 'membəd
membership => 'membәʃip
memberships => 'membəʃɪps
membranaceous => ,membrә'neiʃәs
membrane => 'membrein
membraneous => mem'breiniәs
membranes => ˈmemˌbreɪnz
membranous => 'membrәnәs, mem'breinәs
meme => mi:m
Memel => 'meməl
memento => mi'mentәu
memento mori => mikentәj 'kɔ:ri
mementoes => mɪ'mentəʊz
memo => 'memәu
memoir => 'memwɑ:
memoirist => 'memwɑ:rist, -wɔ:-
memorabilia => .memәrә'biliә
memorability => .memәrә'biliti
memorable => 'memәrәbl
memorably => 'memәrәbli
memorandum => .memә'rændәm
memorial => mi'mɒ:riәl
memorialist => mi'mɒ:riәlist
memorialization => mi'mɔ:riəlai'zeiʃən; -li'z-
memorialize => mi'mɒ:riәlaiz
memorialized => miˈmɔ:riəlaizd
memorializes => miˈmɔ:riəlaiziz
memorializing => miˈmɔ:riəlaizɪŋ
memorise => 'meməraiz
memorizable => 'memə,raɪzəbl
memorization => .memә'rizeiʃәn
memorize => 'memәraiz
memorized => ˈmeməraizd
memorizes => ˈmeməraiziz
memory => 'memәri
memory card => ˈmeməri kɑ:d
memory trace => ˈmeməri treis
memos => ˈmeməuz
Memphis => 'memfis
memsahib => 'mem.sɑ:hib
men => men
menace => 'menis
menaced => ˈmenəst
menaces => ˈmenəsiz
menacing => 'menәsiŋ
menadione => ,menә'daiәun
menage => mei'nɑ:ʒ
menagerie => mi'nædʒәri
menaquinone => ,menәkwi'nәjn
menarche => me'nɑ:ki
Mencius => menʃiәs
mend => mend
mendable => 'mendәbl
mendacious => men'deiʃәs
mendacity => men'dæsiti
mendel => 'mendl
Mendeleev => ,mende'leief
mendelevium => .mendә'li:viәm
Mendelian => men'di:liәn
Mendelism => 'mendәlizm
Mendelssohn => 'mendlsn
mender => 'mendә
mendicancy => 'mendikәnsi
mendicant => 'mendikәnt
mendicity => men'disiti
mending => 'mendiŋ
Mendip => 'mendip
MENDIPS => 'mendip
mends => mendz
Menelaus => .meni'leiәs
Menes => 'mi:ni:z
menfolk => 'menfәuk
menhaden => men'heidn
menhir => 'menhiә
menial => 'mi:niәl
menially => 'mi:nɪəlɪ
menials => ˈmi:ni:əlz
meningeal => mi'nindʒiәl
meninges => mi'nindʒi:z
meningioma => ,minindʒi'әumә
meningitic => ,menin'dʒitik
meningitis => .menin'dʒaitis
meningocele => mә'niŋ^әsi:l
meningococcal => mɪ'nɪŋgəʊsi:l
meningococcus => mә,niŋ^әu'kɔkәs
meningoencephalitis => mi'niŋ^әjәn,sefә'laitis
meninx => 'mi:niŋks
meniscectomy => ,miui'sektәmi
meniscus => mi'niskәs
Mennonite => 'menәnait
meno => 'menɔ:
meno mosso => 'meinәu'mɔsәu
meno- => 'menәj
menology => mi'nɒlәdi
menopausal => ,menәj'pɔ:zәl
menopause => 'menәupɒ:z
menorah => mә'nɒ:rә
menorrhagia => ,menә'reidʒiә
mens => menz
mensa => 'mensә
mensch => mentʃ
menses => 'mensi:z
Menshevik => 'menʃәvik
menstrual => 'menstruәl
menstruate => 'menstrueit
menstruated => ˈmenstru:ˌeɪtid
menstruates => ˈmenstru:ˌeɪts
menstruating => ˈmenstru:ˌeɪtɪŋ
menstruation => .menstru'eiʃәn
menstruous => 'menstruәs
menstruum => 'menstruәm
mensurable => 'mensjuәrәbl
mensural => 'mensjuәrәl
mensuration => .mensjuә'reiʃәn
menswear => 'menz,weә
ment => 'mənt
mental => 'mentl
mental arithmetic => ˈmentl əˈriθmətik
mental block => ˈmentl blɔk
mental hospital => ˈmentl ˈhɔspitəl
mentalism => 'mentlizm
mentalistic => mentә'listik
mentalities => menˈtælitiz
mentality => men'tæliti
mentally => 'mentli
mentally handicapped => ˈmentəlɪ ˈhændi:ˌkæpt
mentation => men'teiʃәn
mentee => menˈti:
menthol => 'menθoul
mentholated => 'menθәleitid
mention => 'menʃәn
mentionable => 'menʃənəbl
mentioned => 'menʃnd
mentioning => ˈmenʃənɪŋ
mentions => ˈmenʃənz
mento => 'mentəʊ
mentor => 'mentɔ:
mentored => ˈmenˌtɔ:d
mentoring => ˈmenˌtɔ:ɪŋ
mentors => ˈmenˌtɔ:z
mentorship => 'mentɔːʃɪp
mentum => 'mentәm
menu => 'menju:
Menuhin => 'menjuin, 'menuhin
Meo => 'mi:əu
meow => mi'au
meowed => mju:d
meowing => mju:ɪŋ
meows => mju:z
mepacrine => 'mepәkrin
meperidine => mә'peridi:n
Mephistophelean => ,mefistә'fi:liәn
Mephistopheles => ,mefis'tɔfili:z
mephitic => me'fitik
merbromin => mә'brәumin
mercado => mer'kɑ:dәj
mercantile => 'mә:kәntail
mercantilism => 'mә:kәntailizәm
mercantilist => 'mә:kәntilist
mercaptan => mә'kæptæn
mercedes => 'mә:sidi:z
mercenaries => ˈmɜ:səˌneri:z
mercenary => 'mә:sinәri
mercer => 'mә:sә
mercerize => 'mә:sәraiz
mercerized => ˈmə:səraizd
mercerizes => ˈmə:səraiziz
mercerizing => mɜ:'səraɪzɪŋ
mercery => 'mә:sәri
merchandise => 'mә:tʃәndaiz
merchandised => 'mɜːtʃ(ə)ndaɪs; -z
merchandiser => 'mә:tʃәndaizә
merchandisers => ˈmə:tʃəndaizəz
merchandising => 'mә:tʃәndaiziŋ
merchant => 'mә:tʃәnt
merchant bank => ˈmə:tʃənt bæŋk
merchant navy => ˈmə:tʃənt ˈneivi
merchantable => 'mә:tʃәntәbl
merchantman => 'mә:tʃәntmәn
merchants => 'mɜ:tʃənts
merci => mεr'si:
mercia => 'mә:ʃә
mercian => 'mә:ʃәn
mercies => ˈmə:siz
merciful => 'mә:siful
merciless => 'mә:silis
mercilessly => 'mɜ:sɪləslɪ
mercurial => mә:'kjuәriәl
mercuriality => mә:kjuәri'æliti
Mercurian => mә:'kjuәriәn
mercuric => mә:'kjuәrik
mercurous => 'mә:kjurәs
mercury => 'mә:kjuri
mercy => 'mә:si
merde => mεrd
mere => miә
Meredith => 'meridiθ
merely => 'miәli
merengue => mә'reŋ^ei
meretricious => .meri'triʃәs
merganser => mә:'gænsә
merge => mә:dʒ
merger => 'mә:dʒә
mergers => 'mɜ:dʒəz
merges => mə:dʒz
meridian => mә'ridiәn
meridians => mə'rɪdɪənz
meridional => mә'ridiәnәl
meringue => mә'ræŋ
meringues => məˈræŋz
merino => mә'ri:nәu
merinos => məˈri:nəuz
meristem => 'meristem
meristematic => ,meristә'mætik
merit => 'merit
merited => 'meritid
meriting => ˈmeritɪŋ
meritocracies => ˌmeriˈtɔkrəsiz
meritocracy => .meri'tɒkrәsi
meritocratic => ˌmerɪtə'krætɪk
meritorious => .meri'tɒ:riәs
meritoriousness => meriˊtɒːriәsnis
merkin => 'mɜ:kɪn
merlon => 'mә:lәn
merlot => 'mɜ:lɒt
mermaid => 'mә:meid
mermaids => ˈmɜ:ˌmeɪdz
merman => 'mә:mæn
mermen => 'mə:men
meronymy => mərə'nɪmɪ
Merovingian => ,merəu'vindʒiən
merrily => 'merili
merriment => 'merimәnt
merriness => 'merinis
Merritt => 'merit
merry => 'meri
merry-making => 'meri:m'eɪkɪŋ
merrymaker => 'meri,meikә(r)
merrymaking => 'meri.meikiŋ
merrythought => 'meriθɔ:t
Merseyside => 'mә:zisaid
merseysider => 'mə:zisaid
Merton => 'mә:tn
mesa => 'meisә
mescal => me'skæl
mescalin => 'meskəlɪn
mescaline => 'meskәlin
mesclun => mezk'lʌn
meself => mi'self, mi:-
mesencephalic => ,mesensi'fælik
mesencephalon => ,mesen'sefәlɔn
mesenchymal => mes'eŋkiməl, mez-
mesenchyme => 'mezәnkaim, 'mes-
mesenteric => ,mesәn'terik
mesenteron => me'zentәrɔn, mes-
mesentery => 'mesәntәri
mesh => meʃ
Meshed => 'meʃed; mә'ʃed
meshes => meʃiz
meshing => 'meʃɪŋ
meshuga => mi'ʃj^ә
meshugaas => miʃj'^ɑ:s, ,miʃә-
mesial => 'mi:ziәl
mesic => 'mi:zik
mesmeric => mes'merik
mesmerise => 'mezmәraiz, 'mes-
mesmerising => 'mezməraiz, 'mes-
mesmerism => 'mezmәrizm
mesmerist => 'mezmәrist
mesmerization => .mezmәrai'zeiʃәn
mesmerize => 'mezmәraiz
mesmerized => ˈmezməˌraɪzd
mesmerizer => 'mezməraɪzə
mesmerizes => ˈmezməˌraɪziz
mesmerizing => ˈmezməˌraɪzɪŋ
mesne => mi:n
meso- => 'mesәj, 'mezәj
mesoblast => 'mesәublɑ:st
mesocarp => 'mesәukɑ:p
mesocephalic => ,mesәusi'fælik, ,mez-
mesoderm => 'mesәudә:m
mesogastrium => ,mesәu'^æstriәm, ,mez-
Mesolithic => ,mesәu'liθik, ,mez-
mesomerism => mi'sɔmәrizәm
mesomorph => 'mesәumɒ:f
mesomorphic => .mesәu'mɒ:fik
meson => 'mezɒn
mesonic => mi:'zɔnik
mesons => 'miːzɒn; 'mezɒn
mesopause => 'mesә,pɔ:z, 'mez-
mesopelagic => ,mesәupә'lædʒik
mesophilic => ,mesә'filik, ,mez-
mesophyll => 'mesәfil
mesophyte => 'mesәfait, 'mez-
Mesopotamia => .mesәpә'teimiә
mesoscale => 'mesәskeil
mesoscopic => meɪ'səskɒpɪk
mesosphere => 'mezәusfiә
mesothelial => ,mesәj'θi:liәl, ,mez-
mesothelioma => ,mesәu,θi:li'әumә, ,mez-
mesothelium => ,mesәu'θi:liәm, ,mez-
mesothoracic => ,mesәuθɔ:'ræsik, mez-
mesothorax => ,mesәu'θɔ:ræks, ,mez-
Mesozoic => .mesәu'zәuik
mesquite => 'meski:t
mess => mes
mess jacket => mes ˈdʒækit
mess-up => 'mesʌp
message => 'mesidʒ
message board => ˈmesidʒ bɔ:d
messed => mest
messenger => 'mesindʒә
messengers => ˈmesindʒəz
Messerschmitt => 'mesәʃmit
messes => mesiz
messiah => mә'saiә
Messianic => .mesi'ænik
messianism => mi'saiәnizm
Messidor => meisi:'dɔ:r
messily => 'mesili
Messina => me'sinә
messiness => 'mesɪnɪs
messmate => 'mesmeit
Messrs => 'mesәz
messuage => 'meswidʒ
messy => 'mesi
mestiza => me'sti:zә, mi-
mestizo => me'sti:zәu
met => met
met- => met
meta- => 'metә
metabolic => .metә'bɒlik
metabolise => mi'tæbәlaiz, me-
metabolism => mi'tæbәlizm
metabolisms => 'mɪtæbəlɪzəmz
metabolite => mi'tæbәlait
metabolize => mi'tæbәlaiz
metabolized => mɪˈtæbəˌlaɪzd
metabolizes => mɪˈtæbəˌlaɪziz
metabolizing => mɪˈtæbəˌlaɪzɪŋ
metacarpal => .metә'kɑ:pәl
metacarpus => .metә'kɑ:pәs
metacentre => ˊmetәsentә
metacentric => 'metəsentrɪk
metachromatic => ,metәkrәu'mætik
metachrosis => ,metә'krәusis
metacognition => me'tækɔ:gnɪʃən
metacognitive => 'metəkɒɡnɪtɪv
metafiction => ,metә'fikʃәn
metage => 'mi:tidʒ
metagenesis => .metә'dʒenisis
metal => 'metәl
metal fatigue => ˈmetl fəˈti:ɡ
metalanguage => 'metә.læŋgwidʒ
metaldehyde => mi'tældәhaid
metaleptic => ,metik
metalhead => 'metl,hed
metaling => 'metlɪŋ
metalinguistic => ,metәliŋ'^wistik
metalinguistics => .metәliŋ'gwistiks
metalled => 'metəld
metallic => mi'tælik
metallicity => mɪtæ'lɪsɪtɪ
metalliferous => .metә'lifәrәs
metalline => 'metlin
metallization => ,metәlai'zeiʃәn
metallize => 'metәlaiz
metallized => mɪ'tælaɪzd
metallographic => mi,tæləu'ɡræfik, mə-,-kəl
metallographical => mi,tælә'^ræfikәl
metallography => .metә'lɒgrәfi
metalloid => 'metәlɒid
metallophone => me'tælәfәjn, mә-
metallurgic => ,metә'lә:dʒik
metallurgical => ,metә'lә:dʒikәl
metallurgist => me'tælәdʒist
metallurgists => mɪ'tælədʒɪsts
metallurgy => 'metәlә:dʒi
metalmark => 'metəlmɑ:k
metalsmith => 'metlsmiθ
metalware => 'metәlwєә
metalwork => 'metәlwә:k
metalworker => 'metlwɜ:kə(r)
metamathematics => ,metә,mæθi'mætiks
metamer => 'metәmә
metamere => 'metәmiә
metameric => ,metә'merik
metamerism => mi'tæmәrizm
metamessage => me'teɪmesɪdʒ
metamorphic => .metә'mɒ:fik
metamorphism => .metә'mɒ:fizm
metamorphose => .metә'mɒ:fәuz
metamorphosed => ˌmetəˈmɔ:ˌfəʊzd
metamorphoses => ˌmetə'mɔ:fəsi:z
metamorphosing => ˌmetəˈmɔ:ˌfəʊzɪŋ
metamorphosis => .metә'mɒ:fәsis
metaphase => 'metәfeiz
metaphor => 'metәfә
metaphorical => metә'fɒ:rikl
metaphorically => ˌmetə'fɒrɪklɪ
metaphosphate => ,metә'fɔsfeit
metaphrase => 'metәfreiz
metaphrastic => ,metə'fræstik
metaphysic => ,metә'fizik
metaphysical => .metә'fizikl
metaphysician => .metәfi'ziʃәn
metaphysics => .metә'fiziks
metaplasia => ,metә'pleiziә
metapsychological => metə,saikə'lɔdʒikəl
metapsychology => .metәsai'kɒlәdʒi
metasomatic => ,metәsәj'mætik
metasomatism => ,metә'sәumәtizm
metastability => ,metәstә'bilәti
metastable => .metә'steibl
metastases => mә'tæstәsi:z
metastasis => mә'tæstәsis
metastasize => mi'tæstәsaiz
metastasized => məˈtæstəˌsaizd
metastasizes => məˈtæstəˌsaiziz
metastasizing => məˈtæstəˌsaizɪŋ
metatarsal => .metә'tɑ:sl
metatarsus => .metә'tɑ:sәs
metate => mә'tɑ:ti, mei'tɑ:tei
metatherian => metә'θeriәn
metathesis => mә'tæθәsis
metathetical => ,metə'θetɪkəl
metathoracic => ,metәθɔ:'ræsik
metathorax => .metә'θɒ:ræks
metazoan => .metә'zәuәn
metazoans => ,metə'zəʊən
METCALFE => 'metkɑ:f
mete => mi:t
meted => mi:tid
metempsychosis => .metәmsai'kәusis
meteor => 'mi:tiә
meteor shower => ˈmi:ti:ə ˈʃauə
meteoric => .mi:ti'ɒrik
meteorite => 'mi:tiәrait
meteorites => 'mi:tɪəraɪts
meteoritic => ,mi:tiә'ritik
meteorograph => ,mi:ti'ɔ:rә^rɑ:f
meteoroid => 'mi:tiәrɒid
meteoroidal => ,miːtɪə'rɒɪdəl
meteorologically => ,eərobaɪə'lɑdʒɪkli
meteorologist => .mi:tiә'rɒlәdʒist
meteorologists => ˌmi:ti:əˈrɔlədʒi:z
meteorology => .mi:tiә'rɒlәdʒi
meteors => ˈmi:ti:əz
meter => 'mi:tә
meter maid => ˈmi:tə meid
metered => 'mi:təd
metering => 'mi:tәriŋ
metes => mi:ts
meth => meθ
methacrylate => mɪ'θækrɪleɪt
methaemoglobin => meθi:mәu'^lәubin
methaemoglobinaemia => meθi:mәu^lәubi'ni:miә
methamphetamine => ,meθæ'fetәmin
methanal => 'meθәnæl
methane => 'meθein
methanogen => 'mәθәnә,dʒen
methanogenesis => ,meθәnәu'dʒenisis
methanol => 'meθәnәul
methaqualone => ,meθә'kwɔlәun
metheglin => mә'θeglin
methemoglobinemia => ,meθimәu,^lәubi'ni:miә
methicillin => meθi'silin
methinks => mi'θiŋks
methiocarb => 'meθiәukɑ:b
methionine => me'θaiәni:n
method => 'meθәd
method acting => ˈmeθəd ˈæktɪŋ
methodical => mi'θɒdikl
methodically => mi'θɒdikәli
methodism => 'meθәdizm
methodist => 'meθәdist
Methodistic => .meθә'distik
methodize => 'meθәdaiz
methodological => .meθәdә'lɒdʒikl
methodologies => ˌmeθəˈdɔlədʒi:z
methodologist => ,meθә'dɔlәdʒist
methodology => .meθә'dɒlәdʒi
methotrexate => ,meθә'trekseit
methought => mi'θɔ:t
Methuselah => mә'θju:zәlә
methyl => 'meθil
methyl alcohol => 'meθil
methylate => 'meθileit
methylated spirits => ˈmeθəˌleɪtɪd
methylbenzene => ,meθil'benzi:n, -ben'zi:n
methylene => 'meθili:n
methylmercury => .meθil'mә:kjuri
metic => 'metik
metical => 'mɪtɪkəl
meticulous => mә'tikjulәs
meticulousness => mə'tɪkjələsnəs
metier => ˈmetieɪ
meting => mi:tɪŋ
metol => 'mi:tәul
metonym => 'metәnim
metonymic => ,metә'nimik
metonymical => 'mɪtɒnɪmɪkəl
metonymy => mi'tɒnimi
metope => 'metәup
metre => 'mi:tә
metres => ˈmi:təz
metric => 'metrik
metrical => 'metrikl
metrically => 'metrɪklɪ
metricate => 'metrikeit
metrication => metri'keiʃ(ә)n
metrics => 'metriks
metritis => mi'traitis
metro => 'metrәu
metrological => .metrә'lɒdʒikl
metrology => mi'trɒlәdʒi
metronidazole => ,metrә'naidәzәjl
metronome => 'metrәnәum
metronomes => ˈmetrənəumz
metronomic => .metrә'nɒmik
metronymic => .metrә'nimik
metroplex => 'metrəpleks
metropolis => mi'trɒpәlis
metropolises => mɪˈtrɔpəlɪsiz
metropolitan => .metrә'pɒlitn
metropolitans => metrə'pɒlɪtənz
metropolitical => ,metrəpə'litikəl
metrorrhagia => ,mi:trɔ:'reidʒiә, ,me-
metros => ˈmetrəuz
metrosexual => ˌmetrəˈsekʃuəl
mettle => 'metl
mettlesome => 'met(ә)lsәm
Metz => mets, mes
Meuse => mju:z; mə:z
mew => mju:
mewed => mju:d
mewing => mju:ɪŋ
mewl => mju:l
mewling => mju:lɪŋ
Mex => meks
Mexicali => ,meksi'kæli, ,mehi:'kɑ:li:
Mexican => 'meksikәn
mexicano => ,meksə'kɑ:nəu
Mexico => 'meksikәu
mezuzah => 'metsu:zə
mezza voce => ˈmedzɑ:ˈvəutʃei
mezzanine => 'mezәni:n
mezzanines => ˈmezəni:nz
mezzo => 'metsәu. 'meddzɔ:
mezzo forte => ˈmezəu fɔ:t
mezzo piano => ˈmezəu piˈænəu
mezzo-relievo => 'metsəʊrɪl'i:vəʊ
mezzo-soprano => ˌmetsəʊ səˈprɑ:nəʊ
Mezzogiorno => ,metsәj'dʒɔ:nәj, ,meddzɔ:-
mezzotint => 'metsәutint
MF => em'ef
mho => mәj
MI => mi:
Miami => mai'æmi
miaow => mi'au
miaowed => mɪˈaʊd
miaowing => mɪˈaʊɪŋ
miaows => mɪˈaʊz
mias => ˌemaɪˈeɪz
miasma => mi'æzmә
miasmal => m'ɪæzməl
miasmas => m'ɪæzməz
miaul => mi'ajl, -'ɔ:l
MIB => mib
mica => 'maikә
micaceous => mai'keiʃәs
Micah => 'maikә
Micawber => mi'kɔ:bə
Micawberish => mi'kɔ:bәriʃ
Micawberism => mi'kɒ:bәrizm
mice => mais
micellar => mi'selə
micelle => mi'sel, mai-
michael => 'maikl
Michaelmas => 'mikәlmәs
Michelangelo => .mi:kel'ɑ:ndʒelɒ:
Michelle => mɪ'ʃɛl
Michigan => 'miʃigәn
Michigander => ,miʃi'^ændә(r)
Mick => mik
mickey => 'miki
mickle => 'mikl
micky => 'miki
Micra => 'maikrә
micrite => 'mikrait
micritic => mi'kritik
micro- => 'maikrәj
micro-organism => ˌmaɪkrəʊˈɔ:gənɪzəm
micro-organisms => mɪk'rəʊ'ɔ:ɡənɪzəmz
microalbuminuria => maɪkrəʊlbjʊmɪn'jʊərɪə
microanalyser => ,maikrәj'ænәlaizә(r)
microanalysis => .maikrәuә'nælәsis
microarray => ˌmɑɪkrəʊə'reɪ
microbalance => .maikrәu'bælәns
microbe => 'maikrәub
microbes => 'maɪkrəʊbz
microbial => mai'krәubiәl
microbiology => maikrәjbai'ɔlәdʒi
microblog => ˈmaɪkroʊˌblɒɡ
microblogging => 'maɪkrəʊblɒgɪŋ
microbrew => maɪkrəʊb'ru:
microbrewery => maɪk'rəʊbrwrɪ
microburst => maɪkrəʊ'bɜ:st
microbus => 'maikrәbʌs
microcapsule => 'maikrәj,kæpsju:l
microcephalous => .maikrәu'sefәlәs
microcephaly => .maikrәu'sefәli
microchemistry => maikrәu'kemistri
microchip => 'maikrәjtʃip
microchips => 'maɪkrəʊtʃɪps
microcircuit => 'maikrәu.sә:kit
microcirculatory => ,maɪkrəʊ'sɜːkjʊlətərɪ
microclimate => 'maikrәu.klaimit
microclimatic => maɪkrəʊk'laɪmætɪk
microcline => 'maikrәjklain
micrococcal => ,maikrәj'kɔkəl
micrococcus => .maikrәu'kɒkәs
microcode => 'maikrәkәjd
microcomputer => .maikrәu'kɒmpjutә
microcomputers => maɪkrəʊkəmp'ju:təz
microcontinent => ,maikrәj'kɔntinәnt
microcopy => 'maikrәukɒpi
microcosm => 'maikrәukɒzm
microcosmic => .maikrәu'kɒzmik
microcosmically => ,maikrəu'kɔzmikəli
microcosms => maɪkrəʊ'kɒzəmz
microcredit => 'maɪkrəʊkrɪdɪt
microcrystalline => ,maikrәj'kristəlain, - lin
microcyte => 'maikrәjsait
microcytic => ,maikrəu'sitik
microdensitometer => 'maikrәj,densi'tɔmitә(r)
microdot => 'maikrәudɒt
microeconomic => 'maɪkrəʊˌɪkə'nɒmɪk
microelectronics => 'maikrәji,lek'trɔniks, -,i:lek-
microenvironment => ,maikrәjin'vaiәrənmәnt, -en'vaiә-
microevolution => 'maikrәj,i:vә'lu:ʃən; -,evә-
microfabrication => maɪkrəʊfæbrɪ'keɪʃən
microfarad => .maikrәu'færәd
microfiber => maɪk'rəʊfɪbər
microfibre => ˈmaɪkrəʊfaɪbə(r)
microfibril => ,maikrәj'faibril, -'fi-
microfiche => 'maikrәufi:ʃ
microfilament => ,maikrәj'filәmәnt
microfilaria => ,maikrәjfi'leәriә
microfilm => 'maikrәufilm
microfilmed => 'maɪkrə(ʊ)fɪlm
microfilming => 'maɪkrəʊfɪlmɪŋ
microfilms => 'maɪkrəʊfɪlmz
microform => 'maikrәufɒ:m
microfossil => ,maikrәj'fɔsəl
microfungus => ,maikrәj'fʌŋ^әs
microgamete => ,maikrәj'^æmi:t, -^ә'mi:t
microglial => maɪk'rəʊɡlɪəl
microgram => 'maikrәugræm
micrograph => 'maikrәugrɑ:f
micrographic => maɪkrəɡ'ræfɪk
micrographics => ,maikrәj'^ræfiks
micrography => mai'krɒgrәfi
microgravity => maɪkrəɡ'rævɪtɪ
microgroove => 'maikrәugru:v
microhabitat => ,maikrәj'hæbitæt
microinject => ,maikrәjin'dʒekt
microinjection => ,maikrәjin'dʒekʃən
microinstruction => ,maikrәjin'strʌkʃən
microlepidoptera => ˈmaikrəuˌlepiˈdɔptərə
microlight => ˈmaɪkrəʊlaɪt
microlith => 'maikrәjliθ
microlithic => 'maikrәu'liθik
microlitre => 'maikrәu.li:tә
micromanage => 'maɪkrəʊmænɪdʒ
micromanagement => maikrəu'mænidʒmənt
micromanager => maɪkrəʊ'mænædʒər
micromesh => 'maikrәumeʃ
micrometeorite => ,maikrәj'mi:tiәrait
micrometeoroid => ,maikrәj'mi:tiәrɔid
micrometeorological => 'maikrəu,mi:tiərə'lɔdʒikəl
micrometeorology => 'maikrәj,mi:tiә'rɔlәdʒi
micrometer => mai'krɒmitә
micrometre => 'maikrәj,mi:tә(r)
micrometry => mai'krɔmitri
microminiaturization => 'maikrәj,miniәtʃәrai'zeiʃən;-ri'z-
micron => 'maikrɒn
Micronesia => .maikrәu'ni:ʒә
Micronesian => ,maikrəu'ni:ziən; -ʒən
micronization => ,maikrәjnai'zeiʃən; -ni'z-
micronize => 'maikrәnaiz
microns => ˈmaikrɔnz
micronutrient => ,maikrәj'nju:triәnt
microorganism => .maikrәu'ɒ:gәnizm
micropayment => maikrəu'peimənt
microphage => 'maikrәfeidʒ
microphone => 'maikrәfәun
microphones => 'maɪkrəfəʊnz
microphotograph => maikrәj'fәjtә^rɑ:f
microphotographic => maɪkrəfətəɡ'ræfɪk
microphyll => 'maikrәfil
microphysical => ,maikrəu'fizikəl
microphysics => ,maikrәj 'fiziks
micropore => 'maikrәpɔ:(r)
microporosity => ,maikrәjpɔ:'rɔsәti
microporous => .maikrәu'pɒ:rәs
microprint => 'maikrәuprint
microprism => 'maikrәjprizəm
microprobe => 'maikrәprәjb
microprocessor => .maikrәu'prәusesә
microprocessors => maɪkrəprəʊ'sesəz
microprogram => ,maikrә'prәj^ræm
microprogrammed => ,maikrәj'prәj^ræmd
microprogramming => ,maikrәj'prәj^ræmiŋ
micropropagation => maɪkrəprɒpə'ɡeɪʃn
microreader => 'maikrәu.ri:dә
microsatellite => maɪkrəʊzə'telaɪt
microscope => 'maikrәuskәup
microscopes => 'maɪkrəskəʊps
microscopic => maikrә'skɔpik
microscopical => ,maikrә'skɔpikəl
microscopist => mai'krɒskәpist
Microscopium => ,maikrә'skәjpiәm
microscopy => mai'krɒskәpi
microsecond => 'maikrәusekәnd
microseconds => ˈmaikrəusekəndz
microseism => 'maikrәjsaizəm
microseismic => ,maikrəu'saizmik
microsomal => ,maɪkrəʊ'səʊməl
microsome => 'maikrәusәum
microspecies => 'maikrәj,spi:ʃi:z
microsphere => 'maikrәsfiә( r)
microspore => 'maikrәuspɒ:
microstructural => maɪk'rɒstrʌktʃərəl
microstructure => 'maikrәustrʌktʃә
microsurgery => 'maikrәu'sә:dʒәri
microswitch => 'maikrәu,switʃ
microsystem => 'maikrәusistәm
microtome => 'maikrәutәum
microtonal => ,maikrəu'təunəl
microtonally => ,maikrəu'təunəli
microtone => 'maikrәutәun
microtubule => ,maikrәu'tju:bju:l
microvascular => ,maikrәj'væskjjlә(r)
microvillar => ,maikrəu'vilə
microvillus => ,maikrәu'vilәs
microwave => 'maikrәuweiv
microwaveable => ˌmaikrəuweivˈeibl
microwaved => 'maɪkrə(ʊ)weɪv
microworld => 'maikrәuwә:ld
micrurgy => mai'krә:dʒi
micturate => 'miktjureit
micturated => ˈmiktjureitid
micturates => 'mɪktjʊreɪt
micturating => ˈmiktjureitɪŋ
micturition => .miktjuә'riʃәn
mid => mid
mid- => mid-
mid-air => mɪd eə(r)
mid-ocean ridge => ˈmidˈəuʃən ridʒ
mid-off => 'mɪd'ɔ:f
mid-on => 'mɪd'ən
midair => .mid'єә
MIDAS => 'maidәs
midbrain => 'midbrein
midday => 'middei
midden => 'midn
middies => ˈmidiz
middle => 'midl
middle distance => ˈmidl ˈdistəns
middle game => ˈmidl ɡeim
middle ground => ˈmidl ɡraund
middle name => ˈmidl neim
middle school => ˈmidl sku:l
middle term => ˈmidl tə:m
middle watch => ˈmidl wɔtʃ
middle-aged => 'midl'eidʒd
middle-aged spread => ˈmidlˈeidʒd spred
middle-class => 'midl'klɑ:s; -'klæs
middle-distance => ˈmidl ˈdistəns
middlebrow => 'mid(ә)lbraj
middleman => 'midlmæn
middlemen => 'midlmen
middles => ˈmidlz
Middlesbrough => 'midlzbrә
middlescent => ,midə'lesənt
middlesex => 'midlseks
middleton => 'midltәn
middleware => 'midlweә(r)
middleweight => 'mid(ә)lweit
middling => 'midliŋ
middy => 'midi
Mideast => 'mid'i:st
midfield => 'midfi:ld
midfielder => 'mid.fi:ldә
Midgard => 'mid^ɑ:d
midge => midʒ
midges => midʒz
midget => 'midʒit
midgets => ˈmɪdʒɪts
midgut => 'mid,^ʌt
midheaven => mɪ'hi:vn
midi => 'midi
midi system => ˈmidi ˈsistəm
midinette => ,mi:di:'net
midiron => 'mid.aiәn
midland => 'midlәnd
midlander => 'mɪdlənd
midlife => 'midlaif
midline => 'midlain
Midlothian => mid'lәjθiәn
midmost => 'midmәust
midnight => 'midnait
midnight blue => ˈmidnait blu:
midnight sun => ˈmidnait sʌn
midocean => mɪ'dəʊtʃɪən
midpoint => 'midpɒint
midpoints => 'mɪdpɒɪnt
midrib => 'midrib
midriff => 'midrif
midriffs => ˈmidrifs
midsection => 'midsekʃәn
midship => 'midʃip
midshipman => 'midʃipmәn
midshipmen => 'mɪdʃɪpmən
midships => 'midʃips
midsize => 'midsaiz
midsole => 'm id,sәul
midst => midst
midstream => 'midstri:m
midsummer => 'midsʌmә
midterm => 'midtә:m
midtown => 'midtajn
midway => 'mid'wei
midweek => 'mid.wi:k
midwestern => 'mid'westәn
midwife => 'midwaif
midwifery => 'midwaifәri
midwinter => 'mid'wintә
mien => mi:n
Miesian => 'mi:ziәn
mifepristone => maɪfprɪs'təʊn
miff => mif
miffed => mɪft
miffing => mifɪŋ
miffs => mifs
miffy => 'mifi
Mig => mig
might => mait
might-have-been => ˈmaɪtəvˌbɪn
mightily => 'maitili
mightiness => 'maitinis
mighty => 'maiti
migmatite => 'mi^mәtait
mignon => 'minjɔn
mignonette => .minjә'net
migraine => 'mi:^rein, 'mai-
migraines => ˈmaɪˌgreɪnz
migrant => 'maigrәnt
migrants => 'maɪɡrənts
migrate => 'maigreit
migrated => maiˈɡreitid
migrates => maiˈɡreits
migration => mai'greiʃәn
migrations => maɪˈgreɪʃənz
migrator => mai'greitә
migratory => 'maigrәtәri
Miguel => mi'gel
mihrab => 'mi:rɔb
mikado => mi'kɑ:dәu
mike => maik
mikes => maɪks
mil => mil
milady => mi'leidi
milage => 'mailidʒ
Milan => mi'læn
Milanese => .milә'ni:z
milano => mi:'lɑ:nɔ:
milch => miltʃ
milch cow => ˈmɪltʃ kaʊ
mild => maild
mild-mannered => maild ˈmænəd
mildew => 'mildju:
mildewing => ˈmɪlˌdu:ɪŋ
mildews => ˈmɪlˌdu:z
mildewy => 'mildju:i
mildly => 'maildli
mildness => 'maildnis
mildred => 'mildrid
mile => mail
mileage => 'mailidʒ
mileages => ˈmailidʒz
mileometer => maili'ɔmitә
milepost => 'mailpәust
mileposts => 'maɪlpəʊst
miler => 'mailә
miles gloriosus => 'maili:z,^lɔ:ri'әusәs, 'mi:leis-
Milesian => mai'li:ʒәn
milestone => 'mailstәun
milestones => ˈmaɪlˌstəʊnz
Miletus => mai'li:təs
milfoil => 'milfɒil
Milford => 'milfәd
milia => 'miliә
miliaria => .mili'єәriә
miliary => 'miliәri
milieu => 'mi:ljә:
milieus => mi:ˈljɜ:z
milieux => mi'ljɝ
militancy => 'militәnsi
militant => 'militәnt
militantly => 'militəntli
militants => ˈmilitənts
militaria => ,mili'teәriә
militarily => 'militərili; ,mili'teәrili
militarism => 'militәrizәm
militarist => 'militәrist
militaristic => .militә'ristik
militarization => .militәrai'zeiʃәn
militarize => 'militәraiz
militarized => ˈmilitəraizd
militarizes => ˈmilitəraiziz
militarizing => ˈmilitəraizɪŋ
military => 'militәri
military band => ˈmilitəri bænd
military policeman => ˈmilitəri pəˈli:smən
military service => ˈmilitəri ˈsɜːvɪs
military-industrial complex => ˈmɪlɪˌteri:ɪnˈdʌstri:əl
militate => 'militeit
militated => ˈmiliteitid
militates => ˈmiliteits
militating => ˈmiliteitɪŋ
militia => mi'liʃә
militiaman => mi'liʃәmәn
militiamen => mɪ'lɪʃəmən
militias => məˈlɪʃəz
milk => milk
milk chocolate => milk ˈtʃɔkəlit
milk cow => milk kau
milk fever => milk ˈfi:və
milk float => milk fləut
milk pudding => milk ˈpudiŋ
milk punch => milk pʌntʃ
milk round => milk raund
milk run => milk rʌn
milk vetch => milk vetʃ
milk-white => 'milkhwait
milked => milkt
milker => 'milkә
milkfish => 'milkfiʃ
milkier => ˈmɪlki:ə
milkiness => 'milkinis
milking => 'milkiŋ
milking machine => ˈmilkiŋ məˈʃi:n
milkmaid => 'milkmeid
milkmaids => ˈmilkmeidz
milkman => 'milkmәn
milks => milks
milkshakes => ˈmɪlkʃeɪks
milksop => 'milksɒp
milktoast => 'milktәjst
milkweed => 'milkwi:d
milky => 'milki
mill => mil
mill wheel => mil hwi:l
millable => 'milәbl
millage => 'milidʒ
Millais => 'milei
MILLARD => 'milәd, 'milɑ:d
millboard => 'milbɒ:d
mille => mil
milled => mild
millefleurs => ,mi:l'flә:
millenarian => .mili'nєәriәn
millenarianism => ,mili'neәriәnizəm
millenary => 'milinәri
millennia => mi'leniә
millennial => mi'leniәl
millennialism => mi'leniəlizəm
millennialist => mi'leniәlist
millennium => mi'leniәm
millenniums => mɪ'lenɪəmz
millepede => 'milipi:d
millepore => 'milipɒ:
miller => 'milә
millerite => 'milәrait
millers => ˈmɪləz
millesimal => mi'lesimәl
millet => 'milit
millhand => 'mɪlhænd
milli- => 'mili
milliammeter => ,mili'æmi:tә
milliamp => ,mili'æmpεə, -piə, ,mili'æmp
milliampere => .mili'æmpiә
milliard => 'miljɑ:d
millibar => 'milibɑ:
Millicent => 'milisnt
millie => 'mili
millieme => mi:'ljem
milligram => 'miligræm
milligrams => ˈmɪlɪˌgræmz
Millikan => 'milikәn
milliliter => 'milili:tә
millilitre => 'milili:tә
millilitres => ˈmɪləˌli:təz
millimeter => 'milimi:tә
millimetre => 'milimi:tә
millimetres => ˈmili-ˌmi:təz
milliner => 'milinә
milliners => ˈmilinəz
millinery => 'milinәri
milling => 'miliŋ
million => 'miljәn
millionaire => .miljә'nєә
millionaires => ˌmiljəˈnɛəz
millionairess => ,miljә'neәris
millionfold => 'miljәnfәuld
millionth => 'miljәnθ
millionths => ˈmiljənθs
millipede => 'milәpid
millipedes => mɪ'lɪpi:dz
millisecond => 'mili,sekәnd
milliseconds => ˈmiliˌsekəndz
millivolt => 'mili,vәult
millpond => 'milpɒnd
millstone => 'milstәun
millstones => ˈmilstəunz
millstream => 'milstri:m
millwheel => 'mɪl.wiːl
millwork => 'milwә:k
millworker => 'mɪlwɜ:kər
millwright => 'milrait
Milne => miln
Milner => 'milnә
milo => 'mailәj, 'mi:lɔ:
milometer => mai'lɔmitә(r)
milord => mi'lɒ:d
milords => mɪ'lɔːd
milquetoast => 'milktoust
milreis => 'milreis
milt => milt
milton => 'miltәn
Miltonic => mil'tɒnik
milwaukee => mil'wɔ:ki,(:)
mim => mim
Mimas => 'mɑimæs
mimbar => 'mimbɑ:(r)
mime => maim
mimed => 'maɪmd
mimeo => 'mimiә
mimeograph => 'mimiәgrɑ:f
mimeographed => ˈmɪmi:əˌgræft
mimeographing => ˈmɪmi:əˌgræfɪŋ
mimeographs => ˈmɪmi:əˌgræfs
mimes => maɪmz
mimesis => mai'mi:sis
mimetic => mi'metik, mai-
mimetite => 'maimi,tait
mimi => 'mimi,'mi:mi
mimic => 'mimik
mimicker => 'mimikә
mimicry => 'mimikri
mimics => ˈmɪmɪks
miming => maɪmɪŋ
mimosa => mi'mәusә
mimosas => miˈməuzəz
mimsy => 'mɪmzɪ
mina => 'mainә
minacious => mi'neiʃәs
minaret => .minә'ret
minarets => ˌmɪnəˈrets
minatory => 'minәtәri
minbar => 'minbɑ:
mince => mins
mince pie => mɪns pai
minced => mɪnst
mincemeat => 'mins,mi:t
mincer => 'minsә
mincers => ˈmɪnsəz
minces => mɪnsiz
mincing => 'minsiŋ
mind => maind
mind reader => maind ˈri:də
mind-altering => 'maɪnd'ɔ:ltərɪŋ
mind-bending => ˈmaɪndˌbendɪŋ
mind-boggling => ˈmaɪndˌbɔglɪŋ
mind-expanding => 'maɪndɪksp'ændɪŋ
Mindanao => ,mindɑ:'nau
minded => 'maindid
mindedness => 'maɪndɪdnɪs
Mindel => 'mindәl
minder => 'maindә
minders => ˈmaindəz
mindful => 'maidful
mindless => 'maindlis
mindlessness => 'maɪdlɪsnɪs
Mindoro => min'dɔ:rәu
mindshare => 'maɪndʃeə(r)
mine => main
mine dump => main dʌmp
mine-detector => main dɪˈtektə
mineable => 'mainәbl
minefields => ˈmaɪnˌfi:ldz
minehunter => ˈmaɪnhʌntə(r)
minelayer => 'mainleiә
miner => 'mainә
mineral => 'minәrәl
mineral water => ˈminərəl ˈwɔ:tə
mineralisation => mɪnərəlaɪ'zeɪʃən
mineralization => .minәrәlai'zeiʃәn
mineralize => 'minәrәlaiz
mineralizes => ˈminərəlaiziz
mineralizing => 'minәrә,laiziŋ
mineralocorticoid => ,minrәlә'kɔ:ti,kɔid
mineralogical => .minәrә'lɒdʒikl
mineralogies => mɪnə'rælədʒɪ
mineralogist => .minә'rælәdʒist
mineralogy => .minә'rælәdʒi
miners => ˈmaɪnəz
Minerva => mi'nә:vә
minestrone => ,mi:nei'strәunei
minesweeper => 'main,swi:pә
minesweepers => ˈmaɪnˌswi:pəz
minesweeping => 'main,swi:piŋ
mineworker => 'mainwә:kә
Mineworkers => 'maɪnwɜːkə
ming => miŋ
minge => mɪndʒ
mingily => 'mindʒili
mingle => 'miŋgl
mingled => ˈmiŋɡld
mingles => ˈmiŋɡlz
mingling => 'miŋɡliŋ
mingy => 'mindʒi
mini => 'mini
mini- => 'mini
mini-break => 'mɪni:br'eɪk
mini-pill => ˈmɪni: pil
miniature => 'miniәtʃә
miniature golf => ˈminiətʃə ɡɔlf
miniatures => ˈminiətʃəz
miniaturisation => mɪnɪtʃəraɪ'zeɪʃən
miniaturist => 'miniәtʃәrist
miniaturize => 'miniәtʃәraiz
miniaturizes => 'mɪnɪtʃəraɪz
miniaturizing => 'mɪnɪtʃəraɪz
minibar => 'minibɑ:
minibeast => 'mɪnibi:st
minibus => 'minibʌs
minicab => 'minikæb
minicabs => ˈminikæbz
minicam => 'minikæm
minicamp => mɪnɪ'kæmp
minicar => 'minikɑ:
minicom => 'minikʌm
minicomputer => 'minikәm,pju:tә
minicomputers => 'mɪnɪkəm,pjuːtə
minidisc => ˈmɪnɪdɪsk
minidress => 'minidres
minifundium => ,mini'fʌndiәm
minikin => 'minikin
minim => 'minim
minima => 'minimә
minimal => 'miniml
minimalism => 'minimәlizm
minimalist => 'minimәlist
minimax => 'minimæks
minimisation => ˌmɪnɪmaɪ'zeɪʃən
minimization => .minimai'zeiʃәn
minimize => 'minimaiz
minimized => ˈminimaizd
minimizer => 'minimaizә
minimizes => ˈminimaiziz
minimizing => 'minimaiziŋ
minims => ˈminimz
minimum => 'minimәm
minimus => 'minimәs
mining => 'mainiŋ
minion => 'minjәn
minions => ˈmɪnjənz
miniscule => 'miniskju:l
miniseries => ˈmɪnisɪəri:z
miniskirt => 'miniskә:t
miniskirts => ˈminiˌskə:ts
minister => 'ministә
ministerial => .mini'stiәriәl
ministerially => mɪnɪs'tɪərɪəlɪ
ministering => ˈmɪnɪstərɪŋ
ministers => ˈministəz
ministership => 'mɪnɪstəʃɪp
ministrant => 'ministrәnt
ministration => .mini'streiʃәn
ministries => ˈministriz
ministry => 'ministri
minivan => 'minivæn
minivans => 'mɪnɪvæn
miniver => 'minivә
minivet => 'mini'vet
mink => miŋk
minks => mɪŋks
Minneapolis => ,mini'æpәlis
Minnesota => .mini'sәutә
Minnesotan => .mini'sәutәn
Minnie => 'mini
minnow => 'minәu
Minoan => mi'nәuәn
minor => 'mainә
minor axis => ˈmainə ˈæksis
minor planet => ˈmainə ˈplænit
minor suit => ˈmainə sju:t
minor tranquillizer => ˈmainə ˈtræŋkwɪˌlaɪzə(r)
minor-leaguer => 'mainə'li:ɡə
Minorca => mi'nɒ:kә
Minorcan => mi'nɔ:kən
Minorite => 'mainәrait
minorities => maiˈnɔritiz
minority => mai'nɒriti
minority government => maiˈnɔriti ˈɡʌvənmənt
Minos => 'mainɔs
Minotaur => 'mainәtɒ:
mins => minz
minsk => minsk
minster => 'minstә
minstrel => 'minstrәl
minstrels => ˈmɪnstrəlz
minstrelsy => 'minstrәlsi
mint => mint
mint julep => mint ˈdʒu:lep
mint sauce => mint sɔ:s
mintage => 'mintidʒ
minted => ˈmɪntɪd
Minto => 'mintәj
mints => mints
minty => 'minti
minuend => 'minjuend
minuet => .minju'et
minus => 'mainәs
minuscular => mi'nʌskjulә
minuscule => 'minәskju:l
minuses => ˈmainəsiz
minute => 'minit. mai'nju:t
minute gun => ˈminit ɡʌn
minute hand => ˈminit hænd
minute of arc => ˈminit ɔv ɑ:k
minute steak => ˈminit steik
minutely => mai'nju:tli
minuteman => 'minitmæn
minutemen => 'minitmen
minuteness => mai'nju:tnis
minutia => mai'nju:ʃiә
minutiae => mi'nju:ʃii:
minx => miŋks
minyan => 'minjәn,min'jɑ:n
Miocene => 'maiәusi:n
miosis => mai'әusis
miotic => mai'ɒtik
MIPS => mips
Miquelon => 'mi:kәlɔn,mi:'kljŋ
mir => miә
mira => 'mirә
mirabelle => 'miәrә,bel, 'miәrә'bel
mirabile dictu => mai'ræbili:'diktju:
miracidium => ,mairә'sidiәm
miracle => 'mirәkl
miracle play => ˈmirəkl pleɪ
miracles => 'mɪrəklz
miraculous => mi'rækjulәs
mirador => ,mirә'dɔ:
mirage => 'mirɑ:ʒ
mirages => mɪˈrɑ:ʒz
miranda => mi'rændә
mirch => mɜ:tʃ
mire => maiә
mirepoix => miә'pwɑ:
mires => maɪəz
mirex => 'maiәreks
miriam => 'miriәm
miring => maɪərɪŋ
mirk => mә:k
mirky => 'mә:ki
mirliton => mi:rli:'tuŋ
Miro => mi:'rəu
mirror => 'mirә
mirror carp => ˈmirə kɑ:p
mirrored => ˈmɪrəd
mirth => mә:θ
mirthful => 'mә:θful
mirthfully => 'mɜ:θfʊlɪ
mirthless => 'mә:θlis
mirthlessly => 'mɜ:θləslɪ
mirthlessness => ˊmәːθlisnis
miry => 'mairi
Mirza => 'mә:zә
MIS => miz
mis- => mis
mis-sell => 'mɪss'el
misadventure => .misәd'ventʃә
misadventures => ˈmisədˈventʃəz
misalign => 'misәlain
misaligned => ,misә'laind
misalignment => 'misәlainmәnt
misalliance => .misә'laiәns
misallocation => ,misәælә'keiʃәn
misandry => 'misændri
misanthrope => 'mizәnθrәup
misanthropes => ˈmɪsənˌθrəʊps
misanthropic => .mizәn'θrɒpik
misanthropical => .mɪs(ə)n'θrɒpɪk
misanthropist => mi'zænθrәpist,-'sæn-
misanthropy => mi'zænθrәpi
misapplication => 'mis.æpli'keiʃәn
misapplications => ˈmisˌæpliˈkeiʃənz
misapplied => mɪsəp'laɪd
misapplies => ˈmisəˈplaiz
misapply => .misә'plai
misapplying => ˈmisəˈplaiŋ
misapprehend => 'mis.æpri'hend
misapprehended => mɪsˌæprɪˈhendid
misapprehending => mɪsˌæprɪˈhendɪŋ
misapprehends => mɪsˌæprɪˈhendz
misapprehension => 'mis.æpri'henʃәn
misapprehensions => mɪsæprɪ'henʃnz
misapprehensive => 'mis.æpri'hensiv
misappropriate => .misә'prәuprieit
misappropriated => ˌmɪsəˈprəʊpri:ˌeɪtid
misappropriates => ˌmɪsəˈprəʊpri:ˌeɪts
misappropriating => ˌmɪsəˈprəʊpri:ˌeɪtɪŋ
misattribution => ,misætri'bju:ʃәn
misbegotten => 'misbigɒtn
misbehave => .misbi'heiv
misbehaves => ˌmɪsbɪˈheɪvz
misbehaving => ˌmɪsbɪˈheɪvɪŋ
misbehavior => 'misbi'heivjә
misbehaviour => .misbi'heivjә
misbelief => .misbi'li:f
misbeliever => ,misbi'li:vә(r)
miscalculate => mis'kælkjuleit
miscalculated => mɪsˈkælkjəˌleɪtid
miscalculates => mɪsˈkælkjəˌleɪts
miscalculating => mɪsˈkælkjəˌleɪtɪŋ
miscall => mis'kɒ:l
miscarriage => mis'kæridʒ
miscarriages => ˈmɪsˌkærɪdʒz
miscarried => ˈmɪsˌkæri:d
miscarries => ˈmɪsˌkæri:z
miscarry => mis'kæri
miscarrying => ˈmɪsˌkæri:ɪŋ
miscast => mis'kɑ:st
miscegenation => .misidʒi'neiʃәn
miscellanea => ,misi'leiniә
miscellaneous => .misә'leinjәs
miscellanies => 'mɪsəˌleɪni:z
miscellany => mi'selәni
mischance => .mis'tʃæns
mischances => mɪsˈtʃænsiz
mischief => 'mistʃif
mischief-maker => 'mistʃiʃ,meikә(r)
mischievous => 'mistʃivәs
mischievously => 'mɪstʃɪvəslɪ
mischievousness => 'mɪstʃɪvəsnɪs
miscibility => .misi'biliti
miscible => 'misibl
misclassification => ,misklæsifi'keiʃәn
miscommunication => ,miskә,mju:ni'keiʃәn
misconceive => .miskәn'si:v
misconceived => ˌmɪskənˈsi:vd
misconceives => ˌmɪskənˈsi:vz
misconceiving => ˌmɪskənˈsi:vɪŋ
misconception => .miskәn'sepʃәn
misconceptions => mɪskən'sepʃnz
misconduct => .mis'kɒndʌkt
misconducted => mɪsˈkɔndʌktid
misconducting => mɪsˈkɔndʌktɪŋ
misconducts => mɪsˈkɔndʌkts
misconstruction => .miskәns'trʌkʃәn
misconstrue => .miskәn'stru:
misconstrued => ˌmɪskənˈstru:d
misconstrues => ˌmɪskənˈstru:z
misconstruing => ˌmɪskənˈstru:ɪŋ
miscount => mis'kaunt
miscreant => 'miskriәnt
miscue => 'mis'kju:
misdate => mis'deit
misdated => mɪs'deɪt
misdates => mɪs'deɪt
misdating => mɪs'deɪt
misdeal => mis'di:l
misdealing => mis'di:liŋ
misdeclaration => mis,deklә'reiʃәn
misdeed => 'mis'di:d
misdeeds => mɪsdi:zd
misdelivery => misdi'livәri
misdemeanor => ,misdi'mi:nә
misdemeanors => mɪsdɪ'mi:nəz
misdemeanour => .misdi'mi:nә
misdemeanours => ˌmɪsdɪˈmi:nəz
misdescribe => ,misdi'skraib
misdescription => 'misdis'kripʃәn
misdiagnose => mis'daiә^nәuz
misdiagnosis => 'mis,daiә^'nәjsis
misdial => 'misdaiәl
misdirect => 'misdi'rekt
misdirected => ˌmɪsdɪˈrektid
misdirecting => ˌmɪsdɪˈrektɪŋ
misdirection => ,misdi'rekʃәn,-dai-
misdirects => ˌmɪsdɪˈrekts
misdoing => mis'du:iŋ
misdoubt => mis'daut
miseducate => ,mis'edju: keit
miseducation => 'mis.edju:'keiʃәn
misemploy => ,misem'plɔi
miser => 'maizә
miserable => 'mizәrәbl
miserableness => 'mɪzərəblnɪs
Miserables => 'mɪz(ə)rəb(ə)l
miserably => 'mizәrәbli
misericord => mi'zerikɔ:d
miseries => ˈmizəriz
miserliness => 'maizәlinis
miserly => 'maizәli
misers => ˈmaɪzəz
misery => 'mizәri
misfeasance => .mis'fi:zәns
misfeed => 'misfi:d
misfile => .mis'fail
misfire => .mis'faiә
misfired => mɪsˈfaɪəd
misfires => mɪsˈfaɪəz
misfit => 'misfit
misfits => ˈmɪsˌfɪts
misfortune => mis'fɒ:tʃәn
misfortunes => misˈfɔ:tʃənz
misgive => .mis'giv
misgiving => mis'^iviŋ
misgivings => .mis'giviŋz
misgovern => mis'gʌvәn
misgoverned => mɪs'gʌv(ə)n
misgoverning => mɪs'gʌv(ə)n
misgovernment => ˌmɪs'ɡʌvənmənt
misgoverns => mɪs'gʌv(ə)n
misguidance => ,mis'^aidәns
misguide => mis'gaid
misguided => mis'gaidid
misguides => mɪsˈgaɪdz
misguiding => mɪsˈgaɪdɪŋ
mishandle => mis'hændl
mishandled => mɪs'hændld
mishandles => mɪsˈhændlz
mishandling => 'mis'hændliŋ
mishap => 'mishæp
mishaps => ˈmɪsˌhæps
mishear => mis'hiә
misheard => ˌmɪs'hɜ:d
mishearing => mɪsˈhɪərɪŋ
mishit => 'mis'hit
mishmash => 'miʃmæʃ
misidentification => misai,dentifi'keiʃәn
misidentified => ,misai'dentifai
misidentify => ,misai'dentifai
misimpression => ,misim'preʃәn
misinform => .misin'fɒ:m
misinformation => 'misinfә'meiʃәn
misinformed => ˌmɪsɪnˈfɔ:md
misinforming => ˌmɪsɪnˈfɔ:mɪŋ
misinforms => ˌmɪsɪnˈfɔ:mz
misinterpret => .misin'tә:prit
misinterpretation => 'misin,tә:pri'teiʃәn
misinterpreted => ˌmɪsɪnˈtɜ:prɪtid
misinterpreter => ,misin'tә:pritә
misinterpreting => ˌmɪsɪnˈtɜ:prɪtɪŋ
misinterprets => ˌmɪsɪnˈtɜ:prɪts
misjudge => mis'dʒʌdʒ
misjudged => mɪsˈdʒʌdʒd
misjudges => mɪsˈdʒʌdʒz
misjudging => mɪsˈdʒʌdʒɪŋ
miskey => ˌmɪsˈki:
miskick => ,mis'kik
Miskito => mis'ki:təu
Miskolc => 'miʃkәults
mislabeled => ,mɪs'leɪbəl
mislay => mis'lei
mislaying => mɪsˈleɪŋ
mislays => mɪsˈleɪz
mislead => mis'li:d
misleading => mis'li:diŋ
misleadingly => mis'li:diŋli
misleads => ˌmisˈli:dz
mislike => mis'laik
mismanage => mis'mænidʒ
mismanaged => mɪsˈmænɪdʒd
mismanages => mɪsˈmænɪdʒz
mismanaging => mɪsˈmænɪdʒɪŋ
mismatch => mis'mætʃ
mismatches => ˈmisˈmætʃiz
mismatching => 'mis'mætʃiŋ
mismated => mɪs'meɪt
misname => mis'neim
misnamed => mis'neimd
misnames => mɪs'neɪm
misnaming => mɪs'neɪm
misnomer => mis'nәumә
misnomers => misˈnəuməz
miso => 'mi:sәu
misogamist => mi'sɒgәmist
misogamy => mi'sɒgәmi
misogynist => mai'sɒdʒinist
misogynists => miˈsɔdʒinists
misogynous => mai'sɒdʒinәs
misogyny => mai'sɒdʒini
misperceive => .mispә'si:v
misperception => mɪspə'sepʃn
mispickel => 'mispikәl
misplace => mis'pleis
misplaced => ˌmɪsˈpleɪst
misplacement => mɪsp'leɪsmənt
misplaces => mɪsˈpleɪsiz
misplacing => mɪsˈpleɪsɪŋ
misplay => mis'plei
misplayed => ˈmisˈpleid
misplaying => ˈmisˈpleiŋ
misplays => ˈmisˈpleiz
misprint => mis'print
misprints => mɪsˈprɪnts
misprision => mis'priʒәn
misprize => .mis'praiz
mispronounce => .misprә'nauns
mispronounced => ˌmɪsprəˈnaʊnst
mispronounces => ˌmɪsprəˈnaʊnsiz
mispronouncing => ˌmɪsprəˈnaʊnsɪŋ
mispronunciation => 'misprә,nʌnsi'eiʃәn
misquotation => ,miskwәj'teiʃәn
misquote => mis'kwәut
misquoted => mɪsˈkwəʊtid
misquotes => mɪsˈkwəʊts
misquoting => mɪsˈkwəʊtɪŋ
misread => mis'ri:d
misreads => mɪsˈri:dz
misremember => .misri'membә
misreport => ,misri'pɔ:t
misrepresent => 'mis.repri'zent
misrepresentation => 'mis,reprizen'teiʃәn
misrepresentations => ,mɪsreprɪzen'teɪʃn
misrepresentative => ,misrepri'zentәtiv
misrepresented => mɪsˌreprɪˈzentid
misrepresenting => mɪsˌreprɪˈzentɪŋ
misrepresents => mɪsˌreprɪˈzents
misrule => mis'ru:l
misruled => ˈmisˈru:ld
miss => mis
Missa => 'misә
missable => 'misәbl
missal => 'misl
missel thrush => ˈmizəl θrʌʃ
misses => 'mɪsɪz
misshape => .mis'ʃeip
misshapen => .mis'ʃeipәn
missile => 'misail
missilery => 'misailri
missiles => 'mɪsaɪlz
missing => 'misiŋ
missing link => ˈmisiŋ liŋk
missiology => ,misi'ɔlәdʒi
mission => 'miʃәn
mission statement => ˈmiʃən ˈsteitmənt
mission-critical => ˈmiʃən ˈkritikəl
missionaries => ˈmiʃənəriz
missionary => 'miʃәnәri
missionary position => ˈmiʃənəri pəˈziʃən
missioner => 'miʃәnә
missionization => ,miʃənai'zeiʃən; -ni'z-
missis => 'misiz
missish => 'misiʃ
Mississauga => ,misi'sɔ:^ә
Mississippi => .misi'sipi
Mississippian => .misi'sipiәn
missive => 'misiv
missives => ˈmisivz
Missouri => mi'zuәri
Missourian => mi'zuәriәn
misspeak => mis'spi:k
misspell => .mis'spel
misspelled => mɪsˈspeld
misspelling => .mis'speliŋ
misspelt => ,mis'spelt
misspend => .mis'spend
misspent => ˌmɪsˈspent
misstate => .mis'steit
misstated => ˈmisˈsteitid
misstatement => .mis'steitmәnt
misstates => ˈmisˈsteits
misstating => ˈmisˈsteitɪŋ
misstep => .mis'step
missus => 'misiz
missy => 'misi
mist => mist
mistakable => mis'teikәbl
mistake => mis'teik
mistaken => mis'teikәn
mistakenly => mɪ'steɪkənlɪ
mistakes => misˈteiks
mistaking => misˈteikɪŋ
misteach => mi'sti:tʃ
misted => mistid
Mister => 'mistә
mistily => 'mistili
mistime => .mis'taim
mistimed => 'mɪstaɪmd
mistiming => 'mis'taimiŋ
mistiness => 'mistinis
misting => mistɪŋ
mistitle => mɪs'taɪtl
mistle thrush => ˈmɪsl θrʌʃ
mistletoe => 'misltәu
mistook => mis'tuk
mistral => 'mistrәl
mistranslate => .mistræns'leit
mistranslated => mɪstræns'leɪt; -trɑːns-; -nz-
mistranslates => mɪstræns'leɪt; -trɑːns-; -nz-
mistranslating => mɪstræns'leɪt; -trɑːns-; -nz-
mistreat => .mis'tri:t
mistreated => mɪsˈtri:tid
mistreating => mɪsˈtri:tɪŋ
mistreats => mɪsˈtri:ts
mistress => 'mistris
mistresses => ˈmistrisiz
mistrial => .mis'traiәl
mistrust => .mis'trʌst
mistrusted => mɪsˈtrʌstid
mistrustful => .mis'trʌstful
mistrusting => mɪsˈtrʌstɪŋ
mistrusts => mɪsˈtrʌsts
misty => 'misti
misunderstand => .misʌndә'stænd
misunderstanding => .misʌndә'stændiŋ
misunderstands => ˌmisʌndəˈstændz
misunderstood => ,misʌndә'stjd
misusage => .mis'ju:zidʒ
misuse => .mis'ju:z
misused => mɪsˈju:zd
misuser => 'misju:zә
misuses => mɪsˈju:ziz
misusing => mɪsˈju:zɪŋ
mit => mit
mitch => mitʃ
mitchell => 'mitʃel
mite => mait
miter => 'maitә
mitered => 'mɑitәd
mites => 'maɪts
Mitford => 'mitfәd
mithan => maɪ'θæn
mither => 'miðә(r)
mithra => 'miθrə
Mithraic => mip'reiik
Mithraism => 'mipreiizәm,-rә-
Mithraist => 'miθrәist
Mithras => 'miθræs
mithridatize => miθ'ridәtaiz
mitigable => 'miti^әbl
mitigate => 'mitigeit
mitigated => ˈmɪtˌɪgeɪtid
mitigates => ˈmɪtˌɪgeɪts
mitigating => ˈmɪtɪgeɪtɪŋ
mitigation => .miti'geiʃәn
mitigator => 'mitigeitә
mitigatory => 'mitigәtәri
mitochondria => ,maitә'kɔndriә
mitochondrial => ˌmaɪtəʊ'kɒndrɪəl
mitochondrion => ,maitәj'kɔndriәn,,mi-
mitogen => 'mitә,dʒәn
mitogenic => ,mɑitәj 'dʒenik, ,mi-
mitomycin => ,maitә'maisin
mitosis => mai'tәusis
mitotic => mai'tɒtik
Mitra => 'maitrә
mitral => 'maitrәl
mitral valve => ˈmaitrəl vælv
mitre => 'maitә
mitred => 'maitәd
mitres => 'maɪtə
Mitsubishi => mi'tsubiʃi
Mitsui => mi'tsu:i
mitt => mit
mitten => 'mitn
mittens => 'mɪtnz
mitts => mits
mitzvah => mits'vɑ:
mix => miks
mixed => mikst
mixed bag => mɪkst bæɡ
mixed blessing => mɪkst ˈblesɪŋ
mixed economy => mɪkst iˈkɔnəmi
mixed farming => mɪkst ˈfɑ:miŋ
mixed grill => mɪkst ɡril
mixed metaphor => mɪkst ˈmetəfə
mixed up => mɪkst ʌp
mixer => 'miksә
mixing => 'miksiŋ
mixmaster => miks'mɑ:stə
mixologist => mik'sɒlәdʒist
mixology => mik'sɔlәdʒi
Mixtec => 'mi:stek
mixture => 'mikstʃә
Mizo => 'mi:zәj
Mizoram => mi'zɔ:rәm
mizzen => 'mizn
mizzle => 'mizl
mizzled => ˈmizld
mizzles => ˈmizlz
mizzling => ˈmizlɪŋ
mizzly => 'mizli
MLitt => .em 'lɪt
MMR => ,em em 'a:(r)
mnemonic => ni:'mɒnik
mnemonics => ni:'mɒniks
mnemonist => 'ni:mәnist
Mnemosyne => ni:'mɔsәni:
mnemotechnic => ,ni:mәj'teknik
mnemotechnics => ,ni:mәj'tekniks
mo => mәu
moa => 'mәuә
Moab => 'mәuæb
Moabite => 'mәuәbait
moan => mәun
moaned => məund
moaner => məʊnə(r)
moaners => 'məunə
moanful => 'mәunful
moaning => 'məʊnɪŋ
moat => mәut
moated => məʊt
moats => məʊts
mob => mɒb
mobe => mәjb,'mәjbi
mobile => 'mәubil
mobile home => ˈməubail həum
mobile phone => ˈməubail fəun
mobiles => 'məʊbaɪlz
mobilisation => ˌməʊbɪlaɪ'zeɪʃən
mobilise => 'mәjbilɑiz
mobility => mәu'biliti
mobility allowance => məʊˈbɪlɪti: əˈlauəns
mobilizable => 'mәubilaizәbl
mobilization => .mәubilai'zeiʃәn
mobilize => 'mәubilaiz
mobilized => ˈməubilaizd
mobilizer => 'məʊbɪlaɪzər
mobilizes => ˈməubilaiziz
mobilizing => ˈməubilaizɪŋ
moblog => 'mɒblɒɡ
mobocracy => mɒ'bɒkrәsi
mobster => 'mɒbstә
mobsters => ˈmɔbstəz
moby => 'mɔbi
moccasin => 'mɒkәsin
moccasins => ˈmɔkəsɪnz
mocha => 'mәukә
mochi => 'mɔtʃi
mock => mɒk
mock orange => mɔk ˈɔrindʒ
mock sun => mɔk sʌn
mock turtle soup => mɔk ˈtə:tl su:p
mock-heroic => 'mɒkhɪr'əʊɪk
mock-up => 'mɔkʌp
mocked => mɔkt
mocker => 'mɒkә
mockeries => ˈmɔkəri:z
mockery => 'mɒkәri
mocking => 'mɔkiŋ
mockingbird => 'mɒkiŋbә:d
mockingly => 'mɒkiŋli
mocks => mɔks
mockumentary => mɒkə'mentrɪ
mocky => 'mɔki
mocock => mәj'kɔk
mod cons => ˌmɒd ˈkɒnz
modacrylic => ,mɔdә'krilik
modal => 'mәudl
modal auxiliary => ˈməʊdl ɔ:ɡˈziljəri
modal verb => ˈməʊdl və:b
modalism => 'məʊdlɪzəm
modalities => məuˈdælitiz
modality => mәu'dæliti
modals => 'məʊdlz
mode => mәud
model => 'mɒdәl
model home => ˈmɔdəl həum
modeler => 'mɑdlɚ
modeling => 'mɔdliŋ
modeller => ˈmɒdələ(r)
models => 'mɒdlz
modem => 'mәudem
modems => 'məʊdemz
modena => 'mɒdinә
moderate => 'mɒdәrәt
moderate gale => ˈmɔdərit ɡeil
moderated => 'mɔdәreitid
moderately => 'mɒdәrәtli
moderation => .mɒdә'reiʃәn
moderatism => 'mɔdәrәtizәm
moderato => .mɔdә'rɑ:tәu
moderator => 'mɒdәreitә
moderatorship => 'mɔdәreitәʃip
modern => 'mɒdәn
modern dance => ˈmɔdən dɑ:ns
modern pentathlon => ˈmɔdən penˈtæθlɔn
modern-day => ˈmɔdən dei
moderne => 'mɒdn
modernisation => ,mɔdәnai'zeiʃәn;-ni'z-
modernise => 'mɔdәnaiz
modernised => 'mɒdənaɪz
modernising => 'mɒdənaɪz
modernism => 'mɒdәnizm
modernist => 'mɒdәnist
modernistic => .mɒdә'nistik
modernists => 'mɒdənɪsts
modernity => mɒ'dә:nәti
modernization => .mɒdәnai'zeiʃәn
modernize => 'mɒdәnaiz
modernized => 'mɒdə(:)naɪzd
modernizer => 'mɒdənaɪzə
modernizes => ˈmɔdəˌnaɪziz
modernizing => ˈmɔdəˌnaɪzɪŋ
modernness => 'mɒdənnɪs
modest => 'mɒdist
modesty => 'mɒdisti
MODI => 'mәudai
modicum => 'mɒdikәm
modifiable => 'mɒdifaiәbl
modification => .mɒdifi'keiʃәn
modifications => ˌmɔdəfɪˈkeɪʃənz
modificatory => 'mɒdifikәtәri
modified => 'mɔdifaid
modifier => 'mɒdifaiә
modifiers => 'mɒdɪfaɪəz
modifies => ˈmɔdifaiz
modify => 'mɒdifai
modillion => mәu'diljәn
modiolus => mәu'daiәlәs
modish => 'mәudiʃ
modiste => mәu'di:st
mods => mɔdz
modular => 'mɒdjulә
modularity => ,mɔdju'læriti
modulate => 'mɒdjuleit
modulated => 'mɔdjuleitid
modulates => ˈmɔdʒəˌleɪts
modulation => .mɒdju'leiʃәn
modulator => 'mɒdjuleitә
module => 'mɒdju:l
moduli => 'mɔdjulai
modulo => 'mɔdjulәu
modulus => 'mɒdjulәs
modus => 'mәudәs
modus operandi => mәjdәs ɔpә'rændi
modus vivendi => mәjdәs vi'vendi
moffie => 'mɔfi
mofo => 'mɒfəʊ
mog => mɒg
Mogadishu => ,mɔ:^ɑ:'di:ʃu:
Mogadon => 'mɔɡədɔn
moggie => ˈmɒɡi
moggy => 'mɒgi
mogul => mәu'^ʌl, 'mәu^ʌl
moguls => 'məʊɡlz
mohair => 'mәuhєә
Mohammed => mu'hæmәd
Mohammedan => mu'hæmәdәn
Mohawk => 'mәuhɒ:k
mohawks => ˈməuhɔ:ks
Mohegan => məu'hi:ɡən
mohel => 'mәjәl,mәj'heil
Mohican => mәu'hi:kәn
Moho => 'mәuhәu
moidore => 'mɒidɒ:
moieties => ˈmɔɪɪti:z
moiety => 'mɒiәti
moil => mɒil
moiled => mɔild
moiling => mɔilɪŋ
moils => mɔilz
Moira => 'mɔirә
Moirai => 'mɔiərai
moire => mwɑ:
Moissan => mwɑ:'s:ŋ
moist => mɒist
moisten => 'mɒisәn
moistening => 'mɔisniŋ
moistens => ˈmɔɪsənz
moister => mɔistə
moistly => 'mɒistli
moisture => 'mɒistʃә
moistureless => 'mɔistʃәlis
moisturise => 'mɔɪstʃəraɪz
moisturize => 'mɒistʃәraiz
moisturized => 'mɔɪstʃəˌraɪzd
moisturizer => ˈmɔɪstʃəraɪzə(r)
moisturizes => ˈmɔɪstʃəˌraɪziz
moisturizing => ˈmɔɪstʃəˌraɪzɪŋ
moisty => 'mɔisti
mojo => 'mәudʒәu
moke => mәuk
moko => 'mәukәu
moksha => 'mәjkʃә
mol => mәul
mola => 'mәulә
molal => 'mәulәl
molality => mәu'læliti
molar => 'mәulә
molarity => mәu'læriti
molars => məʊ'ləz
molasses => mә'læsiz
mold => mәuld
moldable => 'mәuldәbl
Moldau => 'mɔ:ldɑj
Moldavia => mɔl'deivjә
Moldavian => mɔl'deiviən; -vjən
molder => 'mәuldә
moldering => 'məuldəriŋ
molding => 'mәuldiŋ
Moldova => mɔl'dɔvɑ:
moldy => 'mәuldi
mole => mәul
mole cricket => məʊl ˈkrikit
mole rat => məʊl ræt
molecular => mә'lekjulә
molecular biology => məˈlekjələ baiˈɔlədʒi
molecularity => mәu.lekju'læriti
molecule => 'mɒlikju:l
molehill => 'mәulhil
molehills => 'məʊlhɪlz
moleskin => 'mәulskin
molest => mә'lest
molestation => .mәule'steiʃәn
molested => məˈlestid
molester => mə'lestə
molesting => məˈlestɪŋ
molests => məˈlests
moline => mәu'lain
Molise => 'mәjli:zei
moll => mɒl
mollie => 'mɔli
mollification => .mɒlifi'keiʃәn
mollified => ˈmɔləˌfaɪd
mollifier => 'mɔlifaiә
mollifies => ˈmɔləˌfaɪz
mollify => 'mɒlifai
mollifying => 'mɔlifaiiŋ
molls => mɔl
mollusc => 'mɔlәsk
molluscan => mɔ'lʌskәn
molluscs => 'mɑ:ləsk
mollusk => 'mɔlәsk
molly => 'mɔli
mollycoddle => 'mɒlikɒdl
mollycoddled => ˈmɔli:ˌkɔdld
mollycoddles => ˈmɔli:ˌkɔdlz
mollycoddling => ˈmɔli:ˌkɔdlɪŋ
mollymawk => 'mɔlimɔ:k
Moloch => 'mәulɒk
Molotov => 'mɔlәtɔf
Molotov cocktail => 'mɔlәtɔf
molt => mәult
molted => məʊltid
molten => 'mәultәn
molting => 'mәultiŋ
molto => 'mɔltәu
molts => məʊlts
Moluccan => mәu'lʌkәn
moly => 'mәuli
molybdate => mә'libdeit
molybdenite => mɒ'libdinait
molybdenum => mɒ'libdinәm
mom => mʌm
mom-and-pop => ˈmɔmənˈpɔp
Mombasa => mɔm'bæsә
moment => 'mәumәnt
moment of truth => ˈməumənt ɔv tru:θ
momenta => mәj'mentә
momentarily => 'mәumәntәrili
momentariness => 'mәumәntәrinis
momentary => 'mәumәntәri
momently => 'mәumәntli
momentous => mәu'mentәs
momentousness => mouˊmentәsnis
momentum => mәu'mentәm
momism => 'mɒmizәm
mommies => ˈmɔmi:z
Mommsen => 'mɔmzәn
mommy => 'mɒmi
mommy track => ˈmɔmi: træk
mon => mәun
mon- => mɔn
Mon-Khmer => 'məun'kmεə
mona => 'mәjnә,'mɔ:nɑ:
Mona Lisa => 'mәunә'li:sә, -zә
Monaco => 'mɒnәkәu
monad => 'mɒnæd
monadelphous => .mɒnә'delfәs
monadic => mә'nædik
monadism => 'mɒnәdizm
monadnock => mә'nædnɒk
Monaghan => 'mənəɡən
monal => 'mɔnɔ:l
monamine => ,mɔnә'mi:n,-'æmi:n
monarch => 'mɒnәk
monarchal => mɔ'nɑ:kәl
monarchial => mɔ'nɑ:kiәl
Monarchian => mɔ'nɑ:kiәn,mә-
monarchic => mɔ'nɑ:kik
monarchical => mɔ'nɑ:kikәl
monarchies => ˈmɔnəkiz
monarchism => 'mɒnәkizm
monarchist => 'mɒnәkist
monarchists => ˈmɔnəkists
monarchs => ˈmɔnəks
monarchy => 'mɒnәki
monasteries => 'mɒnəstrɪz
monastery => 'mɒnәstәri
monastic => mә'næstik
monasticism => mә'næstisizm
Monastral => mɔ'næstrәl
monatomic => .mɒnә'tɒmik
monaural => .mɒn'ɒ:rәl
monazite => 'mɔnәzait
Monbazillac => mjŋbɑ:zi:'jɑ:k,mɔn'bæzilæk
mond => mɔnd
mondaine => m:n'dein
Monday => 'mʌndi
monde => m:nd
mondegreen => mɔndə'ɡri:n
mondial => 'mɒndiәl
mondo => mɔn'dәj
Mondrian => 'mɔndriɑ:n
Monel => mәu'nel
monetarily => 'mʌnitәrili
monetarism => 'mʌnitәrizәm
monetarist => 'mʌnitәrist,'mɔn-
monetarists => ˈmʌnitərists
monetary => 'mʌnitәri
monetization => .mʌnitai'zeiʃәn
monetize => 'mʌnitaiz
monetized => ˈmʌnitaizd
monetizes => ˈmʌnitaiziz
monetizing => ˈmʌnitaizɪŋ
money => 'mʌni
money supply => ˈmʌni səˈplai
money-spinner => ˈmʌni ˈspinə
moneybag => 'mʌnibæg
moneybags => 'mʌnibægs
moneybox => 'mʌnɪbɒks
moneychanger => 'mʌnitʃeindʒә(r)
moneyed => 'mʌnid
moneylender => 'mʌni.lendә
moneylending => 'mʌni,lendiŋ
moneyless => 'mʌnilis
moneymaker => ˈmʌnimeɪkə(r)
moneymaking => 'mʌni.meikiŋ
moneyman => 'mʌnimæn
moneys => ˈmʌniz
mong => mɔŋ
monger => 'mʌŋgә
mongering => 'mʌŋ^әriŋ
monging => 'mʌŋ^iŋ
mongo => 'mɔŋ^әu
mongol => 'mɔŋ^ɔl
Mongolia => mɒŋ'gәuljә
Mongolian => mɒŋ'gәuljәn
mongolians => mɔŋˈgəʊli:ənz
mongolism => mɒŋ'gәulizm
Mongoloid => 'mɒŋgәlɒid
mongols => ˈmɔŋgəlz
mongoose => 'mɔŋɡu:s. mɔn-
mongooses => ˈmɔŋɡu:siz
mongrel => 'mʌŋgrәl
mongrelization => ,mʌŋ^rәli'zei-ʃәn
mongrelize => 'mʌŋɡrɪlaɪz
mongrels => ˈmʌŋgrəlz
monial => 'mәjniәl
Monica => 'mɔnikә
monied => 'mʌnid
monies => 'mʌniz
moniker => 'mɔnikә(r)
moniliform => mәu'nilifɒ:m
monism => 'mɒnizm
monist => 'mɒnist
monistic => mɔ'nistik,mәj-
monition => mәu'niʃәn
monitor => 'mɒnitә
monitorial => .mɒni'tɒ:riәl
monitoring => 'mɔnitәriŋ
monitorship => 'mɒnɪtəʃɪp
monitory => 'mɒnitәri
monk => mʌŋk
monk seal => mʌŋk si:l
monkery => 'mʌŋkәri
monkey => 'mʌŋki
monkey jacket => ˈmʌŋki ˈdʒækit
monkey nut => ˈmʌŋki nʌt
monkey puzzle => ˈmʌŋki ˈpʌzl
monkeyish => 'mʌŋkiʃ
monkeyshines => 'mʌŋki:ʃaɪnz
monkfish => 'mʌŋkfɪʃ
monkish => 'mʌŋkiʃ
monkshood => 'mʌŋkshjd
monmouth => 'mɔnmәθ(ʃiә(r))
Monmouthshire => 'mɔnməθʃiə
mono => 'mɔnәu
mono- => 'mɔnәj
monoamine => ,mɔnәu'æmi:n
monoamine oxidase inhibitor => ˌmɔnəuˈæmi:n ˈɔksideis inˈhibitə
monobasic => .mɒnәu'beisik
monobloc => 'mɔnә,blɔk
monocarpic => ,mɔnә'kɑ:pik
Monoceros => mә'nɔsәrәs
monochasium => ,mɔnәu'keiʒiәm, -ziәm
monochord => 'mɒnәukɒ:d
monochromatic => .mɒnәukrәu'mætik
monochromator => mɔnәu'krәumeitә
monochrome => 'mɒnәkrәum
monochromic => ,mɔnәj'krәjmik
monocle => 'mɒnәkl
monocled => 'mɔnәkld
monocles => ˈmɔnəklz
monoclinal => .mɒnәu'klainәl
monocline => 'mɒnәuklain
monoclinic => mɒnə(ʊ)'klɪnɪk
monoclonal => ,mɔnә'klәjnәl
monocoque => 'mɒnәukәuk
monocot => 'mɒnəkɒt
monocotyledon => ,mɔnәu,kɔti'li:dәn
monocotyledonous => mɒ'nəʊkɒtɪli:dənəs
monocracy => mɒ'nɒkrәsi
monocrat => 'mɒnәkræt
monocratic => ,mɒnə'krætɪk
monocrystalline => ,mɔnәu'kristәlain
monocular => mɒ'nɒkjulә
monocultural => .mɔnәu'kʌltʃәrәl
monoculture => 'mɒnәkʌltʃә
monocycle => 'mɔnәusaikl
monocyte => 'mɒnәsait
monocytes => mɒnə'sɪts
Monod => mә'nәu
monodactyl => ,mɔnә'dæktil
monodic => mə'nɔdik
monodist => 'mɒnәdist
monodrama => 'mɒnәdrɑ:mә
monody => 'mɒnәdi
monoecious => mɒ'ni:ʃәs
monoecy => mɒ'nəʊsɪ
monofilament => 'mɔnәu'filәmәnt
monogamist => mɒ'nɒgәmist
monogamous => mɒ'nɒgәmәs
monogamy => mɒ'nɒgәmi
monogenean => ,mɔnәj'dʒi:niәn
monogenesis => ,mɔnәu'dʒenisis
monogenic => ,mɔnәu'dʒenik
monogenism => mɒ'nɒdʒenizm
monogenist => mɔ'nɔdʒinist,mә-
monogeny => mɒnɒd'ʒenɪ
monoglot => 'mɔnә^lɔt
monogram => 'mɒnәgræm
monogrammatic => ,mɔnəɡrə'mætik
monogrammed => 'mɔnә^ræmd
monograms => ˈmɔnəuɡræmz
monograph => 'mɒnәgrɑ:f
monographer => mɒ'nɒgrәfә
monographic => .mɒnәu'græfik
monographist => mɔ'nɔ^rәfist,mә-
monographs => ˈmɔnəˌgræfs
monohull => 'mɔnәjhʌl
monohybrid => ,mɔnәu'haibrid
monohydrate => mɒnə(ʊ)'haɪdreɪt
monohydric => ,mɔnәu'haidrik
monokini => ,mɔnә'ki:ni:
monolatrist => mɔ'nɔlәtrist,mә-
monolatry => mɒ'nɒlәtri
monolayer => 'mɔnәu'leiә
monolingual => .mɒnәu'liŋgwәl
monolingualism => mɒ'nəʊlɪŋɡwəlɪzəm
monolith => 'mɒnәuliθ
monolithic => .mɒnәu'liθik
monoliths => ˈmɔnəuliθs
monologist => mɔ'nɔlәdʒist,-^ist,'mɔnә,lɔ^ist
monologize => mɒ'nɒlәdʒaiz
monologue => 'mɔnәlɔ^
monologues => ˈmɔnəlɔɡz
monomania => .mɒnәu'meiniә
monomaniac => .mɒnәu'meiniæk
monomaniacal => .mɒnәumә'naiәkl
monomer => 'mɒnәmә
monomeric => ,mɔnә'merik
monometallic => .mɒnәumi'tælik
monometallism => .mɒnәu'metәlizm
monometallist => .mɒnәu'metәlist
monometer => mɔ'nɔmitә(r),mә-
monometric => ,mɔnəu'metrik
monomial => mɒ'nәumiәl
monomolecular => .mɒnәumә'lekjulә
monomorphemic => ,mɔnәjmɔ:'fi:mik
mononucleosis => ,mɔnәu,nju:kli:'әusis, -nu:-
monophagous => mә'nɔfә^әs
monophonic => ,mɔnә'fɔnik
monophony => mә'nɔfәni
monophthong => 'mɒnәfθɒŋ
monophthongal => ,mɔnəf'θɔŋɡəl
monophyletic => ,mɔnәufai'letik
Monophysite => mә'nɔfi,sait
monoplane => 'mɒnәplein
monoplegia => ,mɔnәu'pli:dʒiә
monoploid => 'mɔnәu,plɔid
monopodial => ,mɔnәu'pәudiәl
monopodium => ,mɔnәu'pәudiәm
monopole => 'mɔnәpәul
monopolies => məˈnɔpəliz
monopolise => mә'nɔpәlaiz
monopolist => mɒ'nɒpәlist
monopolistic => mә.nɒpә'listik
monopolization => mә.nɒpәlai'zeiʃәn
monopolize => mә'nɒpәlaiz
monopolized => məˈnɔpəˌlaɪzd
monopolizer => mә'nɒpәlaizә
monopolizes => məˈnɔpəˌlaɪziz
monopolizing => məˈnɔpəˌlaɪzɪŋ
monopoly => mә'nɒpәli
monopropellant => ,mɔnәuprә'pelәnt
monopsony => mә'nɔpsәni
monopteral => mә'nɔptәrәl
monopteros => mɔ'nɔptәrɔs
monorail => 'mɒnәreil
monorails => ˈmɔnəˌreɪlz
monorchid => mɔ'nɔ:ki:d
monosaccharide => ,mɔnәu'sækәraid
monosemous => mə'nəʊsməs
monosemy => ,mɔnә'si:mi
monoski => ˈmɒnəski:
monosodium glutamate => mɔnәj'sәjdiәm '^lu:tәmeit
monosome => 'mɔnәusәum
monosomic => ,mɔnәj'sәjmik
monosomy => ,mɔnә'sәumi
monospecific => ,mɔnәjspi'sifik
monostable => ,mɔnәu'steibl
monostrophic => ,mɔnәj'strɔfik
monosyllabic => .mɒnәusi'læbik
monosyllable => 'mɒnәusilәbl
monosyllables => ˈmɔnəˌsɪləbəlz
monosynaptic => ,mɔnәjsi'næptik
monotechnic => ,mɔnәj'teknik
monotheism => 'mɒnәθi:izm
monotheist => 'mɒnәθi:ist
monotheistic => .mɒnәuθi:'istik
monotheistically => ,mɔnəuθi:'istikəli
Monothelite => mәj'nɔθilait
monotone => 'mɒnәtәun
monotones => ˈmɔnəˌtəʊnz
monotonic => mɔnәu'tɔnik
monotonically => mɒnə'tɒnɪklɪ
monotonicity => ,mɔnәtә'nisiti
monotonous => mә'nɒtәnәs
monotonously => mə'nɒtənəslɪ
monotony => mә'nɒtәni
monotreme => 'mɒnәutri:m
monotropy => mә'nɔtrәpi
monotype => 'mɒnәutaip
monotypic => mɒnəʊ'tɪpɪk
monounsaturate => 'mɒnə,ʌn'sætʃəreɪt
monounsaturated => ˌmɒnəʌn'sætʃəˌreɪtɪd
monovalent => .mɒnәu'veilәnt
monoxide => mɒ'nɒksaid
monozygotic => ,mɔnәzai'^ɔtik
monroe => mәn'rәu
monrovia => mәn'rәuviә
mons => mɔnz
Monsieur => mә'sjә:
monsignor => mɔn'si:njә(r)
monsignors => mɔnˈsi:njəz
monsoon => mɒn'su:n
monsoonal => mɒn'su:nl
monsoons => mɒn'su:nz
monster => 'mɒnstә
monstera => 'mɔnsterә
monsters => 'mɒnstəz
monstrance => 'mɔnstrәns
monstrosities => mɔnˈstrɔsɪti:z
monstrosity => mɒns'trɒsiti
monstrous => 'mɒnstrәs
monstrously => 'mɔnstrəsli
monstrousness => 'mɒnstrəsnəs
montage => mɒn'tɑ:ʒ
montages => mɔnˈtɑ:ʒz
Montagnard => ,mɔntәn'jɑ:d
Montague => 'mɔntəɡju:
Montaigne => man'tɛn
Montana => mɒn'tænә
Montanan => mɒn'tænәn
montane => 'mɒntein
Montanist => 'mɔntәnist
montbretia => mɒn'bri:ʃjә
Monte => 'mɔnti
Monte Carlo => mɔnti 'kɑ:lәu
Monteith => mɔn'ti:θ
Montenegrin => .mɒnti'ni:grin
Montenegro => .mɒnti'ni:grәu
Montepulciano => ,mɔntepjl'tʃjɑ:nәj
Monterey => ,mɔntә'rei
Monterrey => ,mɔntә'rei
Montesquieu => ,mɔntes'kju:
Montessori => ,mɔnti'sɔ:ri
Montevideo => .mɒntә'vidiәu
Montfort => 'mɔntfәt
Montgolfier => mɔnt'^ɔlfiә
montgomery => mәnt'^ʌmәri
Montgomeryshire => mәnt'^ʌmәriʃiә(r),mɔnt-
month => mʌnθ
monthly => 'mʌnθli
Montmartre => ,mɔnt'mʌtə
montmorillonite => ,mɔntәmә'rilә,nait
Montonero => ,mɔntәj'neәrәj
Montparnasse => mɔnt'pɑ:nəsi
Montpelier => mɔnt'pi:ljә(r)
Montpellier => mjŋpe'ljei
Montrachet => muŋtrɑ:'ʃe
montreal => ,mɔntri'ɔ:l
Montserrat => ,mɔntse'ræt
montuno => mɔn'tu:nəu; 'mɔntu:nəu
monty => 'mɔnti
monument => 'mɒnjumәnt
monumental => .mɒnju'mentәl
monumentalism => ,mɒnjʊ'mentəlɪzəm
monumentality => ,mɔnjumәn'tæliti
monumentalize => ,mɔnju'mentәlaiz
monumentalized => ˌmɔnjuˈmentəlaizd
monumentalizing => ˌmɔnjuˈmentəlaizɪŋ
monumentally => .mɒnju'mentli
monuments => ˈmɔnjumənts
mony => 'mɔni
monzonite => 'mɔnzәnait
moo => mu:
moo-cow => 'mu:kaj
mooch => mu:tʃ
mooched => mu:tʃt
moocher => 'mu:tʃә
mooches => mu:tʃiz
mooching => mu:tʃɪŋ
mood => mu:d
mood music => mu:d ˈmju:zik
moodier => ˈmu:di:ə
moodily => 'mu:dɪlɪ
moody => 'mu:di
mooed => mu:d
mooing => mu:ɪŋ
mook => mu:k
moola => 'mu:lә
moolah => ˈmu:lɑ:
mooli => ˈmu:li
moon => mu:n
moon shot => mu:n ʃɔt
moon-faced => 'mu:nfeist
moonbeam => 'mu:nbi:m
moonbeams => ˈmu:nbi:mz
mooncalf => 'mu:nkɑ:f
mooned => mu:nd
mooney => 'mu:ni
moonfish => 'mu:nfiʃ
moonflower => 'mu:nflaʊər
Moonie => 'mu:ni
mooning => 'mu:niŋ
moonless => 'mu:nlis
moonlet => 'mu:nlit
moonlight => 'mu:nlait
moonlighted => ˈmu:nˌlaɪtid
moonlighter => 'mu:nˌlaɪtə
moonlighting => 'mu:n,laitiŋ
moonlights => ˈmu:nˌlaɪts
moonlit => 'mu:nlit
moonquake => 'mu:nkweik
moonraker => 'muːnreɪkə
moonrat => 'mu:n,ræt
moonrise => 'mu:nraiz
moonscape => 'mu:nskeip
moonseed => 'mu:nsi:d
moonset => 'mu:nset
moonshee => 'mu:nʃi:
moonshine => 'mu:nʃain
moonshiner => 'mu:nʃainә
moonshot => 'mu:nʃɒt
moonstone => 'mu:nstәun
moonstruck => 'mu:nstrʌk
moonwalk => 'mu:n,wɔ:k
moonwort => mu:n'wɜ:t
moony => 'mu:ni
moor => muә
moorage => 'muәridʒ
moorcock => 'muәkɒk
moore => 'muә
moorfowl => 'muәfaul
moorhen => 'muәhen
moorhens => 'mɔːhen; 'mʊə-
mooring => 'muәriŋ
Moorish => 'muәriʃ
moorland => 'muәlәnd
moorlands => ˈmuələndz
moors => mʊəz
moory => 'mjәri,'mɔ:-
moos => mu:z
moose => mu:s
moosewood => 'mu:swjd
moot => mu:t
mooted => 'mu:tid
mooter => 'mu:tə
mooting => mu:tɪŋ
moots => mu:ts
mop => mɒp
mopboard => 'mɔpbɔ:d
mope => mәup
moped => 'mәuped
mopery => 'mәupәri
mopes => məʊps
mopey => 'mәjpi
moping => məʊpɪŋ
mopish => 'mәupiʃ
mopoke => 'mәupәuk
moppet => 'mɒpit
moppy => 'mɔpi
mops => mɔps
moquette => mәu'ket
mor => mɒ:
Moradabad => ,mɔrədə'bɑ:d
moraine => mɒ'rein
morainic => mə'reɪnɪk
moral => 'mɒrәl
moral majority => ˈmɔ:rəl məˈdʒɔriti
moral sense => ˈmɔ:rəl sens
moral victory => ˈmɔ:rəl ˈviktəri
morale => mɒ'rɑ:l
moralise => 'mɔrәlaiz; 'mɔ: -
moralism => 'mɒrәlizm
moralist => 'mɒrәlist
moralistic => .mɒrә'listik
moralistically => mɒrәˊlistikәli
moralists => ˈmɔ:rəlɪsts
moralities => məˈrælitiz
morality => mә'ræliti
morality play => məˈræliti plei
moralization => .mɒrәlai'zeiʃәn
moralize => 'mɒrәlaiz
moralized => ˈmɔrəlaizd
moralizer => 'mɒrəlaɪzə
moralizes => ˈmɔrəlaiziz
morally => 'mɒrәli
morass => mә'ræs
morasses => məˈræsiz
moratorium => .mɒrә'tɒ:riәm
moratoriums => ˌmɔ:rəˈtɔ:ri:əmz
Moravia => mә'reiviә
Moravian => mә'reiviәn
moray => 'mɒ:rei
morbid => 'mɒ:bid
morbidity => mɒ:'biditi
morbidness => 'mɔ:bɪdnɪs
morbific => mɒ:'bifik
morbilli => mɒ:'bilai
morceau => mɔ:'sәu
morcha => 'mɔ:tʃɑ:
mordacious => mɒ:'deiʃәs
mordancy => 'mɒ:dәnsi
mordant => 'mɒ:dәnt
Morden => 'mɔdən
mordent => 'mɔ:dәnt
Mordred => 'mɔ:dred
Mordvin => 'mɔ:dvin
more => mɒ:
moreen => mɒ:'ri:n
moreish => ˈmɔ:rɪʃ
morel => mә'rel
Morelia => mɔ:'reljɑ:
morello => mә'relәu
moreover => mɒ:'әuvә
morepork => 'mɔ:pɔ:k
mores => 'mɔ:ri:z
Moresco => mә'reskәj
Moresque => mә'resk
Moreton => 'mɔ:tən
Morgan => 'mɒ:gәn
morganatic => .mɒ:gә'nætik
morganatically => mɒːgәˊnætikәli
morganite => 'mɔ:^ә,nait
Morgans => 'mɔ:ɡən
morgen => 'mɔ:^әn
morgue => mɔ:^
morgues => mɔ:ɡz
moribund => 'mɒ:ribʌnd
moribundity => ,mɔri'bʌndəti
morion => 'mɒ:riɒn
Morisco => mә'riskәu
Mormon => 'mɒ:mәn
mormons => ˈmɔ:mənz
morn => mɒ:n
mornay => 'mɔ:nei, mɔ:'nei
morning => 'mɒ:niŋ
morning coat => ˈmɔ:niŋ kəut
morning dress => ˈmɔ:niŋ dres
morning glory => ˈmɔ:niŋ ˈɡlɔ:ri
morning room => ˈmɔ:niŋ ru:m
morning star => ˈmɔ:niŋ stɑ:
morning-after pill => ˈmɔ:nɪŋˈæftə
Moro => 'mәurәu
Moroccan => mә'rɒkәn
moroccans => məˈrɔkəŋz
Morocco => mә'rɒkәu
moron => 'mɒ:rɒn
Moroni => mә'rɔni
moronic => mɒ:'rɒnik
morons => ˈmɔ:rˌɔnz
morose => mә'rәus
morosely => mə'rəʊslɪ
moroseness => mə'rɔsəti
morph => mɔf
morphallaxis => ,mɔfә'læksis
morphed => mɔft
morpheme => 'mɒ:fi:m
morphemic => mɔ:'fi:mik
morphemically => mɔ:'fi:mikəli
morphemics => mɔ:'fi:miks
Morpheus => 'mɒ:fju:s
morphia => 'mɔ:fjә
morphine => 'mɒ:fi:n
morphing => 'mɔ:fiŋ
morphinism => 'mɔ:finizəm
morpho => 'mɔ:fәj
morphogen => 'mɔfәdʒin
morphogenesis => mɔ:fә'dʒenisis
morphogenic => ,mɔrfə'dʒɛnɪk
morpholine => 'mɔ:fɔ,li:n
morphologic => ,mɔ:fә'lɔdʒik
morphological => ,mɔ:fә'lɔdʒikәl
morphologist => mɒ:'fɒlәdʒist
morphology => mɒ:'fɒlәdʒi
morphometrically => ,mɔ:fə'metrikəli
morphometrics => ,mɔ:fәj'metriks
morphometry => mɔ:'fɔmitri
morphophoneme => 'mɔ:fәu'fәuni:m
morphophonemics => ,mɔ:fәufә'ni:miks
morphophonology => ,mɔ:fәjfәj'nɔlәdʒi
morphosyntax => ,mɔ:fәu'sintæks
morphs => mɔfs
morris => 'mɒ:ris
morris dance => 'mɔris
morris dancer => ˈmɔris ˈdɑ:nsə
morris dancing => 'mɒrɪs ˌdɑːnsɪŋ, -ˌdæns-
morrison => 'mɔrisn
morrow => 'mɒrәu
morse => mɒ:s
Morse code => mɔ:s
morsel => 'mɒ:sl
morsels => ˈmɔ:səlz
mort => mɒ:t
mortadella => ,mɔ:tә'delә
mortal => 'mɒ:tәl
mortal sin => ˈmɔ:təl sin
mortality => mɒ:'tælәti
mortally => 'mɔ:t(ә)li
mortals => ˈmɔ:təlz
mortar => 'mɒ:tә
mortar board => ˈmɔ:tə bɔ:d
mortarboard => 'mɒ:tәbɒ:d
mortared => 'mɔ:təd
mortarless => mɔ:tər'les
mortars => ˈmɔ:təz
mortgage => 'mɒ:gidʒ
mortgaged => ˈmɔ:ɡidʒd
mortgagee => .mɒ:gi'dʒi:
mortgagees => ,mɔːgɪ'dʒiː
mortgaging => ˈmɔ:ɡidʒɪŋ
mortgagor => ,mɔ:^i'dʒɔ:(r),'mɔ:^idʒә(r)
mortice => 'mɔ:tis
morticed => ˈmɔ:tɪst
mortician => mɒ:'tiʃәn
morticians => mɔ:ˈtiʃənz
morticing => ˈmɔ:tɪsɪŋ
mortification => .mɒ:tifi'keiʃәn
mortified => ˈmɔ:təˌfaɪd
mortify => 'mɒ:tifai
mortifying => 'mɒ:tifaiiŋ
mortimer => 'mɔ:timә
mortise => 'mɒ:tis
mortise lock => ˈmɔ:tɪs lɔk
mortised => ˈmɔ:tɪst
mortiser => 'mɔ:tisә
mortises => ˈmɔ:tɪsiz
mortising => ˈmɔ:tɪsɪŋ
Mortlake => 'mɔ:tleik
mortmain => 'mɔ:tmein
morton => 'mɔ:tən
mortuaries => ˈmɔ:tʃu:ˌeri:z
mortuary => 'mɒ:tʃuәri
morula => 'mɔ:rjulә, 'mɔrulә
morwong => 'mɔ:wɔŋ
mosaic => mәu'zeiik
mosaicist => mәu'zeiisist
mosaics => məʊ'zeɪɪks
mosasaur => 'mәjsәsɔ:(r),'mɔ-
moschatel => ,mɔskә'tel,'mɔs-
Moscow => 'mɒskau
moselle => mә'zel
Moses => 'mәuziz
mosey => 'mәuzi
moseyed => ˈməʊzi:d
moseying => ˈməʊzi:ɪŋ
moseys => ˈməʊzi:z
MOSFET => 'mɔsfet
mosh => mɔʃ
moshav => mәu'ʃɑ:v
moshed => mɔʃt
moshes => mɔʃiz
moshing => 'mɒʃɪŋ
Moskva => mɔs'kvɑ:
Moslem => 'mɒzlәm
Mosley => 'mɔzli, 'mәuzli
Mosleyite => 'mɔzliait,'mәj-
Mosotho => mj'su:tj
mosque => mɒsk
mosques => 'mɒsks
mosquito => mә'ski:tәu
mosquito fish => məsˈki:təu fiʃ
mosquito net => məsˈki:təu net
moss => mɒs
moss agate => mɔs ˈægɪt
moss animal => mɔs ˈæniməl
moss campion => mɔs ˈkæmpjən
moss green => mɔs ɡri:n
moss-grown => 'mɔs^rәjn,'mɔ:s-
moss-like => 'mɔslaik, 'mɔ:s-
Mossad => 'mɔsæd
mossback => 'mɒsbæk
mossbacked => 'mɔsbækt
Mossi => 'mɔ:si:
mossiness => 'mɒsinis
mosstrooper => 'mɔs,tru:pә(r),'mɔ:s-
mossy => 'mɒsi
most => mәust
mostly => 'mәustli
Mosul => mәj'su:l,'mәjsəl
MOT => mәu
mot juste => mәj 'ʒu:st
mote => mәut
moted => 'məʊtɪd
motel => mәu'tel
motels => məʊ'telz
motes => məʊts
motet => mәu'tet
moth => mɒθ
moth-eaten => 'mɔθ,i:tən;'mɔ:θ-
mothball => 'mɒθbɒ:l
mothballed => ˈmɔθˌbɔ:ld
mothballing => 'mɒθb'ɔ:lɪŋ
mothballs => ˈmɔθˌbɔ:lz
mother => 'mʌðә
mother figure => ˈmʌðə ˈfiɡə
mother hen => ˈmʌðə hen
Mother Hubbard => 'hʌbəd
mother lode => ˈmʌðə ləud
mother ship => ˈmʌðə ʃip
mother-to-be => ˈmʌðə tu: bi:
motherboard => 'mʌðәbɒ:d
mothercraft => 'mʌðəkrɑ:ft
mothered => 'mʌðə
motherfucker => ˈmʌðəfʌkə(r)
motherfucking => 'mʌðә,fʌkiŋ
motherhood => 'mʌðәhud
mothering => 'mʌðәriŋ
motherland => 'mʌðәlænd
motherless => 'mʌðәlis
motherliness => 'mʌðәlinis
motherly => 'mʌðәli
mothership => 'mʌðəʃɪp
mothproof => 'mɔθpru:f
moths => mɔθs
mothy => 'mɒθi
motif => mәu'ti:f
motifs => məʊˈti:fs
motile => 'mәutail
motility => mәu'tiliti
motion => 'mәuʃәn
motionless => 'mәuʃәnlis
motions => ˈməuʃənz
motivate => 'mәutiveit
motivated => 'mәutiveitid
motivates => ˈməutiveits
motivating => ˈməutiveitɪŋ
motivation => .mәuti'veiʃәn
motivational => .mәuti'veiʃәnәl
motivations => məʊtɪ'veɪʃnz
motivator => 'mәjtiveitә(r)
motive => 'mәutiv
motiveless => 'mәutivlis
motives => ˈməutivz
motivic => mәu'tivik
motley => 'mɒtli
motmot => 'mɔtmɔt
moto => 'mәutәu
motocross => ˈməʊtəʊkrɒs
motocrosser => 'məʊtə(ʊ)krɒs
motoneuron => ,mәutә'njuәrɔn, -nuәr-
motor => 'mәutә
motor bus => ˈməutə bʌs
motor car => ˈməutə kɑ:
motor coach => ˈməutə kəutʃ
motor cortex => ˈməutə ˈkɔː(r)teks
motor inn => ˈməutə in
motor lodge => ˈməutə lɔdʒ
motor pool => ˈməutə pu:l
motor racing => ˈməutə ˈreisiŋ
motorable => 'mәjtәrәbl
Motorail => 'mәjtәjreil
motorbike => 'mәjtәbaik
motorbikes => ˈməʊtəˌbaɪks
motorboats => ˈməʊtəˌbəʊts
motorcade => 'mәutәkeid
motorcades => ˈməʊtəˌkeɪdz
motorcar => 'mәutәkɑ:
motorcoach => 'mәjtәkәjtʃ
motorcycle => 'mәutәsaikl
motorcycling => ˈməʊtəsaɪklɪŋ
motorcyclist => 'mәutәsaiklist
motorcyclists => ˈməʊtəˌsaɪklɪsts
motordrome => 'mәutәdrәum
motored => 'mәutәd
motorhome => ˈməʊtəhəʊm
motoric => mәj'tɔ:rik
motoring => 'mәutәriŋ
motorised => 'məutəraiz
motorist => 'mәutәrist
motorists => ˈməʊtərɪsts
motorization => .mәutәrai'zeiʃәn
motorize => 'mәutәraiz
motorizes => ˈməʊtəˌraɪziz
motorizing => ˈməʊtəˌraɪzɪŋ
motorman => 'mәjtәmæn
motormouth => ˈməʊtəmaʊθ
motorway => 'mәutәwei
motorways => ˈməʊtəˌweɪz
Motown => 'mәutaun
Mott => mɔt
motte => mɒt
mottle => 'mɒtl
mottled => 'mɒtld
mottling => 'mɔtliŋ
motto => 'mɒtәu
moue => mu:
mouflon => 'mu:flɔn
mould => mәuld
moulded => 'məʊldɪd
moulder => 'mәuldә
mouldered => ˈməʊldəd
mouldering => 'məʊldərɪŋ
moulders => ˈməʊldəz
mouldier => 'moldi
mouldiest => 'moldi
mouldiness => 'məʊldɪnəs
moulding => 'mәuldiŋ
moulds => 'məʊldz
mouldwarp => 'mәjld,wɔ:p
mouldy => 'mәuldi
moule => mu:l
Mouli => 'mu:li
Moulin => mu:'læŋ
Moulmein => mu:l'mein
moult => mәult
moulted => məʊltid
moults => məʊlts
moulvi => 'majlvi
Mounce => mauns
mound => maund
mounds => maundz
mount => maunt
mountain => 'mauntin
mountain avens => ˈmauntin ˈævinz
mountain beaver => ˈmauntin ˈbi:və
mountain bike => ˈmauntin baik
mountain dew => ˈmauntin dju:
mountain goat => ˈmauntin ɡəut
mountain laurel => ˈmauntin ˈlɔ:rəl
mountain range => ˈmauntin reindʒ
mountain sheep => ˈmauntin ʃi:p
mountaineer => .maunti'niә
mountaineering => .maunti'niәriŋ
mountaineers => ˌmaʊntəˈnɪəz
mountainous => 'mauntinәs
mountainside => 'mauntinsaid
mountainsides => ˈmaʊntənˌsaɪdz
mountaintop => 'mauntintɒp
mountant => 'maʊntənt
MOUNTBATTEN => maunt'bætn
mountebank => 'mauntәbæŋk
mountebankery => 'maʊntɪbæŋkərɪ
mountebanks => 'maʊntɪbæŋk
mounted => 'mauntid
mounting => 'mauntiŋ
mourn => mɒ:n
mourned => mɔ:nd
mourner => 'mɒ:nә
mourners => ˈmɔ:nəz
mournful => 'mɒ:nful
mournfully => 'mɔ:nfəlɪ
mourning => 'mɔ:niŋ
mourning dove => ˈmɔ:nɪŋ dʌv
mourning ring => ˈmɔ:nɪŋ riŋ
mourns => mɔ:nz
mouse => maus
mouse mat => maus mæt
mouse potato => maus pəˈteitəu
mouse-ear => 'majsiә(r)
moused => maʊs
mouser => 'mauzә
mousetrap => 'maustræp
mousetraps => ˈmausətræps
mousey => 'mausi
mousiness => 'mausinis
mousing => 'mauziŋ
moussaka => mu:'sɑ:kә
mousse => mu:s
mousseline => mu:s'li:n
mousses => mu:siz
moustache => 'mʌstæʃ
moustaches => 'məstɑ:ʃɪz
moustachioed => məs'tæʃiəʊd,-'tætʃəʊd
mousy => 'mausi
mouth => mauθ
mouth off => mauθ ɔf
mouth-to-mouth resuscitation => ˈmaʊθtəˈmaʊθ
mouthbrooder => maʊθb'ru:dər
mouther => 'mauðә
mouthfeel => mu:θ'fi:l
mouthful => 'mauθful
mouthfuls => ˈmaʊθˌfʊlz
mouthing => 'mauðiŋ
mouthless => 'majθlis
mouthpart => 'majθpɑ:t
mouthpiece => 'mauθpi:s
mouthpieces => ˈmaʊθˌpi:siz
mouths => maʊðz
mouthwash => 'majθwɔʃ
mouthwashes => 'maʊðwɒʃɪz
mouthwatering => 'maʊðwɔ:tərɪŋ
mouthy => 'mauði
mouton => 'mu:tɔn
movability => .mu:vә'biliti
movable => 'mu:vәbl
movable feast => ˈmu:vəbəl fi:st
movably => 'mu:vәbli
move => mu:v
moveable => 'mu:vәbl
moveless => 'mu:vlis
movement => 'mu:vmәnt
mover => 'mu:vә
movers => ˈmu:vəz
moves => mu:vz
movie => 'mu:vi
movie star => ˈmu:vi stɑ:
movie theatre => ˈmu:vi ˈθiətə
moviegoer => 'mu:vi.gәuә
moviegoers => ˈmu:viˌɡəuəz
moviemaker => 'mu:vi.meikә
movies => 'mu:vis
moving => 'mu:viŋ
moving van => ˈmu:vɪŋ væn
moving-coil => 'mu:vɪŋk'ɔɪl
mow => mau. mәu
mower => 'mәuә
mowers => ˈməʊəz
mowing => 'mәuiŋ
mown => mәun
moxa => 'mɒksә
moxibustion => .mɒksi'bʌstʃәn
moxie => 'mɒksi
Moya => 'mɔiә
Moyle => mɔil
Mozambican => ,məuzəm'bi:kən
Mozambique => .mәuzәm'bi:k
Mozarab => mәu'zærәb
Mozart => 'mәutsɑ:t
mozzarella => .mɒtsә'relә
mozzetta => mәu'zetә
Mr => 'mistә(r)
mridangam => m'rɪdəŋɡəm
Mrs => 'misiz
MS => miz
MS-DOS => emes'dɔs
MSS => em'esiz
mu => mju:
much => mʌtʃ
muchacha => mu:'tʃɑ:tʃә
muchacho => mʌ'keɪkəʊ
muchly => 'mʌtʃli
muchness => 'mʌtʃnis
mucilage => 'mju:silidʒ
mucilaginous => .mju:si'lædʒinәs
mucin => 'mju:sin
muck => mʌk
muckamuck => 'mʌkәmʌk
mucked => mʌkt
mucker => 'mʌkә
muckheap => 'mʌkhi:p
muckier => ˈmʌkiə
mucking => 'mʌkiŋ
muckle => 'mʌkl
muckrake => 'mʌkreik
muckraked => ˈmʌkˌreɪkt
muckraker => 'mʌkreikә
muckrakes => ˈmʌkˌreɪks
muckraking => ˈmʌkreɪkɪŋ
mucks => mʌks
mucky => 'mʌki
muco- => 'mu:kəʊ
mucociliary => ,mju:kәj'siliәri
mucoid => 'mju:kɔid
mucopolysaccharide => ,mju:kәu,pɔli'sækә,raid
mucormycosis => ,mju:kәmai'kәusis
mucosa => mju:'kәusә
mucosity => mju:'kɒsiti
mucous => 'mju:kәs
mucous membrane => ˈmju:kəs ˈmemˌbreɪn
mucro => 'mju:krәu
mucronate => 'mju:krәnit
mucus => 'mju:kәs
mud => mʌd
mud pack => mʌd pæk
mud pie => mʌd pai
mud turtle => mʌd ˈtə:tl
mudbank => 'mʌdbæŋk
muddied => ˈmʌdid
muddier => ˈmʌdiə
muddies => ˈmʌdiz
muddily => 'mʌdili
muddiness => 'mʌdinis
mudding => 'mʌdiŋ
muddle => 'mʌdl
muddle-headed => ˈmʌdlˌhedɪd
muddled => 'mʌdld
muddler => 'mʌdlә
muddles => ˈmʌdlz
muddling => ˈmʌdlɪŋ
muddy => 'mʌdi
mudfish => 'mʌdfiʃ
mudflap => ˊmʌdflæp
mudflat => ˈmʌdflæt
mudflats => 'mʌdflæts
mudflow => 'mʌdflәu
mudguard => 'mʌdgɑ:d
mudguards => ˈmʌdˌɡɑ:dz
mudhole => 'mʌdhəʊl
mudlark => 'mʌdlɑ:k
mudra => mә'drɑ:
mudroom => 'mʌdru:m
mudskipper => 'mʌd,skipә(r)
mudslide => 'mʌdslaid
mudslinging => 'mʌd.sliŋiŋ
mudstone => 'mʌdstәun
mudwort => 'mʌdwɜ:t
muesli => ˈmju:zli
muezzin => mju:'ezin
muff => mʌf
muffed => mʌft
muffin => 'mʌfin
muffin top => ˈmʌfɪn tɔp
muffing => mʌfɪŋ
muffins => 'mʌfɪnz
muffle => 'mʌfl
muffler => 'mʌflә
mufflers => 'mʌfləz
muffles => ˈmʌfəlz
muffs => mʌfs
mufti => 'mʌfti
muftis => ˈmʌftiz
mug => mʌg
mugful => 'mʌ^fjl
mugged => mʌgd
mugger => 'mʌgә
muggers => ˈmʌgəz
mugginess => 'mʌginis