muffin top => ˈmʌfɪn tɔp
muffing => mʌfɪŋ
muffins => 'mʌfɪnz
muffle => 'mʌfl
muffler => 'mʌflә
mufflers => 'mʌfləz
muffles => ˈmʌfəlz
muffs => mʌfs
mufti => 'mʌfti
muftis => ˈmʌftiz
mug => mʌg
mugful => 'mʌ^fjl
mugged => mʌgd
mugger => 'mʌgә
muggers => ˈmʌgəz
mugginess => 'mʌginis
mugging => 'mʌ^iŋ
muggins => 'mʌginz
muggle => 'mʌg(ə)l
Muggletonian => ,mʌ^l'tәjniәn
muggy => 'mʌgi
mughal => 'mu:^ʌl, mj'^ʌl
mugwort => 'mʌgwә:t
mugwump => 'mʌ^wʌmp
Muhammadan => mu'hæmәdәn
Muharram => mu'hærәm
mujahedeen => mu:d'ʒəhedi:n
mujahedin => ˌmu:dʒəhəˈdi:n
mujahideen => ˌmu:dʒəhə'di:n
mujahidin => mu:d'ʒɑ:aɪdɪn
Mukalla => mj'kælә
mukhtar => 'mjktɑ:(r)
mukluk => 'mʌklʌk
muktuk => 'muktәk
mulatto => mju'lætәu
mulberries => ˈmʌlˌberi:z
mulberry => 'mʌlbәri
mulch => mʌltʃ
mulched => mʌltʃt
mulches => mʌltʃiz
mulching => mʌltʃɪŋ
mulct => mʌlkt
mulcted => mʌlktid
mulcting => mʌlktɪŋ
mulcts => mʌlkts
mule => mju:l
mule deer => mju:l diə
mules => mju:lz
muleta => ,mju:'leitә, -'letә
muleteer => ,mju:li'tiә
muley => 'mju:li
Mulhouse => mju:'lu:z
muliebrity => .mju:li'ebriti
mulish => 'mju:liʃ
mull => mʌl
mullah => 'mʌlә
mullahs => ˈmʌləz
mulled => mʌld
mulled wine => ˌmʌld ˈwaɪn
mullein => 'mʌlin
Mullen => 'mʌlәn
muller => 'mʌlә
mullered => 'mʌlə
mullet => 'mʌlit
mulligan => 'mʌligәn
mulligatawny => mʌli^ә'tɔ:ni
mulling => 'mʌliŋ
mullion => 'mʌljәn
mullioned => 'mʌljәnd
mullock => 'mʌlәk
mulloway => 'mʌlәwei
mulls => mʌlz
Multan => mjl'tɑ:n
multangular => mʌl'tæŋgjulә
multi- => 'mʌlti
multi-role => mʌl'tɪr'əʊl
multi-storey => mʌl'tɪst'ɔ:rɪ
multi-track => mʌl'tɪtr'æk
multiaxial => ,mʌlti'æksiәl
multibillion => ,mʌltɪ'bɪljən
multicellular => .mʌlti'seljulә
multichannel => .mʌlti'tʃænl
multicoloured => .mʌlti'kʌlәd
multicomponent => ,mʌltikәm'pәunәnt
multicultural => .mʌlti'kʌltʃәrәl
multiculturalism => ˌmʌltiˈkʌltʃərəlɪzəm
multidimensional => .mʌltidi'menʃәnl
multidirectional => mʌltɪdɪ'rekʃənl
multidisciplinary => ,mʌlti'disiplinәri
multifaceted => .mʌlti'fæsitid
multifactor => 'mʌlti,fæktә(r)
multifactorial => ,mʌltifæk'tɔ:riәl
multifarious => .mʌlti'fєәriәs
multifariousness => ,mʌlti'fεəriəs
multifid => 'mʌltifid
multifilament => ,mʌlti'filәmәnt
multiflora => ,mʌlti'flɔ:rә
multifocal => 'mʌltɪfəʊkl
multifoil => 'mʌltifɒil
multifold => 'mʌlti'fәuld
multiform => 'mʌltifɒ:m
multiformity => .mʌlti'fɒ:mәti
multigrade => 'mʌlti^reid
multigravida => ,mʌlti'^rævidә
multihull => 'mʌltihʌl
multilane => 'mʌlti,lein
multilateral => .mʌlti'lætәrәl
multilayer => 'mʌlti,leiә
multilayered => mʌltɪ'leɪəd
multilevel => ,mʌlti'levәl
multileveled => ,mʌlti'levəl
multilingual => .mʌlti'liŋgwәl
multilingualism => mʌltɪ'lɪŋɡwəlɪzəm
multimedia => .mʌlti'mi:diә
multimete => 'mʌltɪmi:t
multimillion => .mʌlti'miliәn
multimillionaire => .mʌltimiljә'nєә
multimode => 'mʌltimәud
multinational => .mʌlti'næʃәnl
multinomial => .mʌlti'nәumiәl
multipack => ,mʌlti'pæk
multipara => mʌl'tipәrә
multiparous => mʌ'ltipәrәs
multipartite => ,mʌlti'pɑ:tait
multiparty => ,mʌlti'pɑ:ti
multiphase => 'mʌltifeiz
multiplayer => 'mʌltɪpleɪə
multiple => 'mʌltipl
multiple choice => ˈmʌltipl tʃɔis
multiple fruit => ˈmʌltipl fru:t
multiple sclerosis => ˈmʌltipl skləˈrəʊsɪs
multiple star => ˈmʌltipl stɑ:
multiple store => ˈmʌltipl stɔ:
multiplet => 'mʌltiplet
multiplex => 'mʌltipleks
multiplexer => 'mʌlti,pleksә
multiplexers => 'mʌltɪpleksəz
multiplexing => 'mʌltipleksiŋ
multipliable => 'mʌlti,plaiәbl
multiplicable => 'mʌlti,plikәbl, ,mʌlti'pli-
multiplicand => .mʌltipli'kænd
multiplication => .mʌltipli'keiʃәn
multiplicative => ,mʌlti'plikәtiv
multiplicities => ˌmʌltiˈplisitiz
multiplicity => .mʌlti'plisiti
multiplied => 'mʌltɪplaɪd
multiplier => 'mʌltiplaiә
multiplies => 'mʌltɪplaɪz
multiply => 'mʌltiplai
multipoint => 'mʌltipɔint
multipolar => .mʌlti'pәulә
multipolarity => mʌlti:pəʊ'lærɪtɪ
multipole => 'mʌltipәul
multiprocessing => 'mʌlti,prɔsesiŋ
multiprocessor => 'mʌlti'prәusesә
multiprocessors => mʌltɪ'prəʊsesə
multipurpose => 'mʌlti'pә:pәs
multiracial => .mʌlti'reiʃәl
multiracialism => mʌltɪ'reɪʃəlɪzəm
multisensory => ,mʌlti'sensәri
multispectral => ,mʌlti'spektrәl
multistage => 'mʌltisteidʒ
multitalented => ,mʌltɪ'tælənt
multitask => 'mʌlti.tɑ:sk
multitasking => 'mʌlti.tɑ:skiŋ
multituberculate => ,mʌltitju'bә:kjulit
multitude => 'mʌltitju:d
multitudes => ˈmʌltitju:dz
multitudinous => .mʌlti'tju:dinәs
multitudinousness => ,mʌltɪ'tjʊdɪnəsnɪs
multivalence => .mʌlti'veilәns
multivalency => 'mʌltaɪvələnsɪ
multivalent => .mʌlti'veilәnt
multivalve => 'mʌltivælv
multivariate => ,mʌlti'veәriit, -eit
multiverse => 'mʌltiv\\\\:s
multivibrator => 'mʌltivai'breitә
multivitamin => .mʌlti'vaitәmin
multivocal => .mʌl'tivәkl
multiway => 'mʌlti,wei
multum in parvo => 'mʌltәmin'pɑ:vәu
multure => 'mʌltʃә
mum => mʌm
mumble => 'mʌmbl
mumbles => ˈmʌmblz
mumblety-peg => 'mʌmbltɪ,peɡ
mumchance => 'mʌmtʃɑ:ns; -tʃæns
Mumm => mʌm
mummed => mʌm
mummer => 'mʌmә
Mummerset => 'mʌmәset
mummery => 'mʌmәri
mummichog => 'mʌmitʃɔ^
mummies => ˈmʌmi:z
mummification => .mʌmifi'keiʃәn
mummified => 'mʌmɪˌfaɪd
mummifies => ˈmʌmifaiz
mummify => 'mʌmifai
mummifying => ˈmʌmifaiŋ
mumming => 'mʌmɪŋ
mummy => 'mʌmi
mumpish => 'mʌmpiʃ
mumps => mʌmps
mums => mʌmz
mun => mu:n
munch => mʌntʃ
Munchausen => mʌn'tʃɒ:zn
munched => mʌntʃt
munches => mʌntʃiz
munching => mʌntʃɪŋ
munchkin => 'mʌntʃkɪn
Munda => 'mundә
mundane => 'mʌndein
mundanely => 'mʌndeinli
mundaneness => dj:'mʌndenɪs
mundanity => mʌn'dæniti
mung => mʌŋ
mung bean => mʌŋ bi:n
mungo => 'mʌŋgәu
muni => 'mju:ni
Munich => 'mju:nik
municipal => mju:'nisipl
municipalities => mjuˌnisiˈpælitiz
municipality => .mju:nisi'pæliti
municipalization => mju:,nisipәlai'zeiʃәn; -li'z-
municipalize => mju:'nisipәlaiz
municipally => mju:'nisipәli
munificence => mju:'nifisns
munificent => mju:'nifisnt
muniment => 'mju:nimәnt
munition => mju:'niʃәn
munitioned => mjuˈniʃənd
munitioner => mju:'niʃәnә(r)
munitioning => mjuˈniʃənɪŋ
munsif => 'mu:nsif
munt => mjnt
muntin => 'mʌntin
muntjac => 'mʌntdʒæk
muon => 'mju:ɔn
muonic => mju:'ɔnik
muppet => 'mʌpit
murage => 'mjuәridʒ
mural => 'mjuәrәl
muralist => 'mjjәrәlist
murals => ˈmjʊərəlz
Murcia => 'mə:ʃiə; 'mu:rθjɑ:
murder => 'mә:dә
murdered => ˈmə:dəd
murderer => 'mә:dәrә
murderers => ˈmɜ:dəəz
murderess => 'mә:dәris
murdering => ˈmə:dərɪŋ
murderous => 'mә:dәrәs
murders => ˈmə:dəz
MURDOCH => 'mә:dɔk
mure => mjuә
mures => mu'reʃ
murex => 'mjuәreks
muriate => 'mjuәriit
muricate => 'mjuәri,keit
murid => 'mjuәrid
murine => 'mjuәrain
murk => mә:k
murkier => 'mɜ:kɪər
murkily => 'mә:kili
murkiness => 'mә:kinis
murky => 'mә:ki
Murmansk => muә'mɑ:nsk
murmur => 'mә:mә
murmurous => 'mә:mәrәs
murmurs => ˈmə:məz
murphy => 'mә:fi
murrain => 'mʌrin
murray => 'mʌri, 'm\\\\:-
murre => mә:
murrelet => 'mә:lit
murrey => 'mʌri
Murrumbidgee => ,mʌrәm'bidʒi
murther => 'mә:ðә
Musa => 'mju:zә
Musca => 'mʌskә
muscadel => 'mʌskә'del
muscadine => 'mʌskәdain
muscarine => 'mʌskәrin
muscat => 'mʌskәt
muscatel => ,mʌskә'tel
muscid => 'mʌsid
muscle => 'mʌsl
muscle tone => ˈmʌsl təun
muscleless => 'mʌsllis
muscleman => 'mʌslmæn
muscly => 'mʌsli
muscovado => .mʌskә'vɑ:dәu
Muscovite => 'mʌskәvait
muscovites => 'mʌskəvaɪt
Muscovy => 'mʌskәvi
muscular => 'mʌskjulә
muscular dystrophy => ˌmʌskjələ ˈdɪstrəfi
muscularity => .mʌskju'læriti
musculature => 'mʌskjulәtʃә
musculoskeletal => ,mʌskjulәu'skelitәl
muse => mju:z
mused => m'ju:zd
museology => ,mju:zi'ɔlәdʒi
musette => mju:'zet
museum => mju:'ziәm
mush => mʌʃ
mushed => mʌʃt
musher => ˈmʌʃə(r)
mushes => mʌʃiz
mushily => 'mʌʃili
mushing => mʌʃɪŋ
mushroom => 'mʌʃrum
mushroom cloud => ˈmʌʃrum klaud
mushroomed => 'mʌʃrʊmd
mushrooming => 'mʌʃrumiŋ
mushroomy => 'mʌʃ,ru:mi, -,rjmi
mushy => 'mʌʃi
music => 'mju:zik
music box => ˈmju:zik bɔks
music drama => ˈmju:zik ˈdrɑ:mə
music hall => ˈmju:zik hɔ:l
music stool => ˈmju:zik stu:l
musical => 'mju:zikl
musical box => ˈmju:zikəl bɔks
musical instrument => ˈmju:zikəl ˈinstrumənt
musical saw => ˈmju:zikəl sɔ:
musicale => .mju:zi'kæl
musicality => ,mju:zi'kæliti
musicalize => 'mju:zikәlaiz
musically => 'mju:zikli
musician => mju:'ziʃәn
musicianly => mju:'ziʃәnli
musicians => mju:'zɪʃənz
musicianship => mju:'ziʃәnʃip
musicologist => .mju:zi'kɒlәdʒist
musicologists => ,mju:zi'kɔlədʒist
musicology => .mju:zi'kɒlәdʒi
musing => 'mju:ziŋ
musingly => m'ju:zɪŋlɪ
musk => mʌsk
musk deer => mʌsk diə
musk ox => mʌsk ɔks
musk rose => mʌsk rəuz
musk thistle => mʌsk ˈθɪsəl
muskeg => 'mʌskeg
muskellunge => 'mʌskәlʌndʒ
musket => 'mʌskit
musketeer => .mʌski'tiә
musketry => 'mʌskitri
muskets => ˈmʌskɪts
muskie => 'mʌski
muskiness => 'mʌskinis
muskmelon => 'mʌskmelәn
Muskogean => mʌs'kәj^iәn
Muskogee => mʌs'kəuɡi:
muskrat => 'mʌskræt
muskwood => 'mʌskwjd
musky => 'mʌski
Muslim => 'mjzlim; (?@) 'mʌzlem
muslin => 'mʌzlin
muso => 'mju:zәj
musquash => 'mʌskwɒʃ
muss => mʌs
mussed => mʌst
mussel => 'mʌsl
musses => mʌsiz
mussing => mʌsɪŋ
Mussolini => ,musә'li:ni(:)
Mussulman => 'mæsәlmәn
mussy => 'mʌsi
must => mʌst
must- => mʌst
must-have => 'mʌsth'æv
must-see => ˈmʌstˈsi:
mustache => 'mʌstæʃ
mustached => mə'stɑːʃ
mustachio => mәs'tɑ:ʃiәu
Mustafa => 'mjstɑ:fɑ:
mustang => 'mʌstæŋ
mustangs => ˈmʌstæŋz
mustard => 'mʌstәd
mustardy => 'mʌstәdi
mustelid => 'mʌstɪlɪd
muster => 'mʌstә
muster roll => ˈmʌstə rəul
mustered => ˈmʌstəd
mustering => ˈmʌstərɪŋ
musters => ˈmʌstəz
musth => mʌst
mustiness => 'mʌstinis
mustn't => 'mʌsnt
musty => 'mʌsti
mutability => .mju:tә'biliti
mutable => 'mju:tәbl
mutagen => 'mju:tәdʒәn
mutagenesis => ,mjutә'dʒenisis
mutagenic => .mju:tә'dʒenik
mutagenize => 'mju:tәdʒә,naiz
mutant => 'mju:tәnt
mutants => m'ju:tənts
mutate => 'mju:teit
mutated => mju:ˈteitid
mutates => mju:ˈteits
mutating => mju:ˈteitɪŋ
mutation => mju:'teiʃәn
mutatis mutandis => mju:'tɑ:tis mju:'tændis
mutative => 'mju:tәtiv
mutch => mʌtʃ
mutchkin => 'mʌtʃkin
mute => mju:t
mute swan => mju:t swɔn
mutely => 'mju:tli
muteness => 'mju:tnis
mutes => mju:ts
mutha => 'mʌθʌ
muti => 'mu:tɪ
mutilate => 'mju:tileit
mutilated => m'ju:tɪleɪtɪd
mutilates => ˈmju:tlˌeɪts
mutilating => ˈmju:tlˌeɪtɪŋ
mutilation => .mju:ti'leiʃәn
mutilations => ,mjuːt(ɪ)'leɪʃn
mutilator => 'mju:tileitә
mutineer => .mju:ti'niә
mutineers => ˌmju:tnˈɪəz
mutinied => ˈmju:tni:d
mutinies => ˈmju:tni:z
mutinous => 'mju:tinәs
mutinously => 'mju:tənəslɪ
mutiny => 'mju:tini
mutinying => ˈmju:tni:ɪŋ
mutism => 'mju:tizm
muton => 'mju:tɔn
Mutsuhito => 'mu:tsj'hi:tɔ:
mutt => mʌt
mutter => 'mʌtә
muttered => ˈmʌtəd
mutters => ˈmʌtəz
mutton => 'mʌtn
mutton chop => ˈmʌtn tʃɔp
muttonhead => 'mʌtnhed
muttony => 'mʌtәni
mutts => mʌts
mutual => 'mju:tʃuәl
mutual fund => ˈmju:tʃuəl fʌnd
mutualism => 'mju:tʃuәlizm
mutualist => 'mju:tjuәlist
mutuality => .mju:tʃu'æliti
mutually => 'mju:tʃuәli
mutuel => 'mju:tjuәl, 'mju:tʃuәl
mutule => 'mju:tʃu:l
muumuu => 'mu:mu:
mux => mʌks
muzak => 'mju:zæk
muzhik => 'mu:ʒik, mu:'ʒik
muzz => mʌz
muzziness => 'mʌzɪnəs
muzzle => 'mʌzl
muzzled => ˈmʌzld
muzzleloader => 'mʌzl,lәjdә(r)
muzzles => ˈmʌzlz
muzzling => ˈmʌzlɪŋ
muzzy => 'mʌzi
mx => 'em'eks
my => mai
my bad => mai bæd
my pleasure => mai ˈpleʒə
my- => mai
myalgia => mai'ældʒiә
myalgic => maiˈældʒik
myalgic encephalomyelitis => maɪˌældʒɪk enˌsefələʊmaɪəˈlaɪtɪs
myalism => 'maiәlizәm
myall => 'maiɒ:l
Myanmar => 'mjænmɑ:(r)
myasthenia => 'maiæs'θi:niә
mycelial => mai'si:liәl
mycelium => mai'si:liәm
Mycenae => mai'si:ni:
Mycenaean => .maisi'ni:әn
mycetoma => maisi'tәumә
mycobacteria => mi:kəʊbæk'tɪərɪə
mycobacterial => maɪkɒ'bæktɪərɪəl
mycological => maɪkɒ'lɒdʒɪkl
mycologically => ,maikəu'lɔdʒikəli
mycologist => mai'kɒlәdʒist
mycology => mai'kɒlәdʒi
mycoplasma => ,maikәu'plæzmә
mycoprotein => ,maikәu'prәuti:n
mycosis => mai'kәusis
mycotoxin => ,maikәu'tɔksin
mycotrophy => mai'kɔtrәfi
mydriasis => mi'draiәsis
myelin => 'maiәli(:)n
myelinated => 'maiәlineitid, ,maiәli'n-
myelination => ,maiәli'nәiʃәn
myelitis => maiә'laitis
myelogenous => ,maiә'lɔdʒәnәs
myeloid => 'maiә,lɔid
myeloma => ,maiә'lәumә
myelopathy => ,maiә'lɔpәθi
mylar => 'mailɑ:
mylodon => 'mailәdɔn
mylonite => 'mailәu,nait
mynah => 'mainә
myo- => 'maiәj
myocardial => ,maiәu'kɑ:diәl
myocardial infarction => ˌmaiəuˈkɑ:diəl inˈfɑ:kʃən
myocarditis => ,maiәukɑ:'daitis
myocardium => ,maiәu'kɑ:diәm
myoclonus => mai'ɔklәnәs
myocyte => 'maiә,sait
myoelectric => 'maiәui'lektrik
myofibril => ,maiәj'faibril
myoglobin => .maiәu'glәubin
myological => ,maiəu'lɔdʒikəl
myology => mai'ɔlәdʒi
myopathy => mai'ɔpәθi
myope => 'maiәup
myopia => mai'әupiә
myopic => mai'ɔpik
myopically => mai'ɔpikəli
myosin => 'maiәsin
myosis => mai'әusis
myositis => ,maiәu'saitis
myosotis => .maiәu'sәutis
myotome => 'maiәutәu m
myotonia => ,maiәu'tәuniә
myra => 'mairә
myriad => 'miriәd
myriads => 'mɪrɪədz
myriapod => 'miriәpɒd
myringotomy => ,miriŋ'^ɔtәmi
myristate => mi'risteit
myrmecological => 'mә:mikәu'lɔdʒikl
myrmecology => ,mә:mi'kɔlәdʒi
myrmecophile => 'm\\\\:mikәjfail, -fil
myrmecophilous => 'mɜ:mi:kɒfɪləs
myrmecophily => ,mә:mi'kɔfili
myrmidon => 'mә:midɒn
myrrh => mә:
myrrhy => 'mә:ri
myrtle => 'mә:tl
myself => mai'self
Mysia => 'misiə
mysid => 'maisid
mystagogue => 'mistәgɒg
mystagogy => 'mistәgɒdʒi
mysterious => mis'tiәriәs
mysteriously => mɪ'stɪərɪəslɪ
mysteriousness => mɪ'stɪərɪəsnəs
mystery => 'mistәri
mystery play => ˈmistəri plei
mystic => 'mistik
mystical => 'mistikl
mystically => 'mɪstɪklɪ
mysticism => 'mistisizm
mystification => .mistifi'keiʃәn
mystified => ˈmɪstəˌfaɪd
mystify => 'mistifai
mystifying => ˈmɪstəˌfaɪŋ
mystique => mis'ti:k
myth => miθ
mythic => 'miθik
mythical => 'miθikә l
mythically => ˊmiθikәli
mythicism => 'miθisizm
mythicize => 'miθisaiz
mythographer => mi'θɒgrәfә
mythography => mi'θɔ^rәfi
mythologer => mi'θɔlәdʒә(r)
mythologic => miθә'lɔdʒik
mythological => .miθә'lɒdʒikәl
mythologically => miθәˊlɒdʒikәli
mythologies => miˈθɔlədʒiz
mythologist => mi'θɒlәdʒist
mythologize => mi'θɒlәdʒaiz
mythologized => miˈθɔlədʒaizd
mythologizes => miˈθɔlədʒaiziz
mythologizing => miˈθɔlədʒaizɪŋ
mythology => mi'θɒlәdʒi
mythomania => ,miθә'meiniә
mythomaniac => ,miθəu'meiniæk
mythopoeia => ,miθәj'pi:ә
mythopoeic => ,miθәj'pi:ik
mythopoetic => ,miθəupəu'etik;-kəl
mythos => 'maiθɒs
myths => 'mɪθs
mythus => 'maiθәs
Mytilene => ,miti'li:ni
myxoedema => ,miksi'di:mә
myxoid => 'miksɔid
myxoma => mik'sәumә
myxomatosis => .miksәumә'tәusis
myxomycete => ,miksәumai'si: t
myxovirus => 'miksәu,vaiәrәs
mzee => әmzei
mzungu => әm'zjŋ^u: